time,open,high,low,close,Volume,Volume MA,OnBalanceVolume,Smoothing Line,ADX,RSI,RSI-based MA,Upper Bollinger Band,Lower Bollinger Band,Plot
1644613200,1.13416,1.1352,1.13404,1.13493,650,3949.2,-199572,-202726.4,29.320316321050793,35.64750394718354,41.558771475969586,NaN,NaN,50
1644615000,1.13493,1.13507,1.13448,1.13472,604,3907.5,-200176,-202279.2,30.896179976526263,34.94994907620193,40.95177821340589,NaN,NaN,50
1644789600,1.13472,1.13472,1.13392,1.13427,4998,4033.3,-205174,-201658.2,32.610392469318086,33.439896472245266,39.64911302892062,NaN,NaN,50
1644791400,1.13427,1.13486,1.13416,1.13434,983,3977.9,-204191,-201867,33.99104532808296,33.918193460349244,38.315884253753424,NaN,NaN,50
1644793200,1.13434,1.136,1.1343,1.136,2942,3984.75,-201249,-202072.4,33.71739432509929,44.16492768154984,37.70094019420109,NaN,NaN,50
1644795000,1.136,1.13672,1.13578,1.13646,1289,3901.7,-199960,-202150,32.6373709682597,46.63437405408343,37.14939005898703,NaN,NaN,50
1644796800,1.13646,1.13692,1.13591,1.13636,2246,3872,-202206,-202556,31.41519871942417,46.15645775756602,36.79425274044805,NaN,NaN,50
1644798600,1.13636,1.13638,1.13594,1.13626,1433,3698.55,-203639,-202249,30.28032448836261,45.652613840747065,36.61771146801458,NaN,NaN,50
1644800400,1.13626,1.1365,1.1358,1.1358,2356,3579.15,-205995,-202609.8,29.350707868374958,43.310544717537226,36.450045359555816,NaN,NaN,50
1644802200,1.1358,1.13598,1.13522,1.13536,2632,3519.25,-208627,-204085.4,28.98454302231533,41.13663096811122,37.43388173233137,NaN,NaN,50
1644804000,1.13536,1.13537,1.13406,1.13428,2252,3477.7,-210879,-206269.2,29.47467214786804,36.31797372094768,37.691950043969726,NaN,NaN,50
1644805800,1.13428,1.13474,1.13418,1.13433,2475,3496.3,-208404,-207508.8,29.929792050166988,36.68773048641228,38.44636536448098,NaN,NaN,50
1644807600,1.13433,1.13484,1.13426,1.13436,1981,3514.7,-206423,-208065.6,30.20585806851287,36.92437516912528,38.992628244973616,NaN,NaN,50
1644809400,1.13436,1.13456,1.13412,1.13432,2011,3548.6,-208434,-208553.4,30.567486406877492,36.72725965178591,39.40488792884613,NaN,NaN,50
1644811200,1.13432,1.1347,1.13412,1.13469,1498,3566.4,-206936,-208215.2,30.677053794269888,39.92209761409595,39.71021604791131,NaN,NaN,50
1644813000,1.13469,1.13487,1.13448,1.13454,1711,3034.35,-208647,-207768.8,30.4984654677334,39.06100507893211,40.00386290524917,NaN,NaN,50
1644814800,1.13454,1.13482,1.1342,1.13477,1615,2380,-207032,-207494.4,30.58944611460333,41.15682437694237,40.55507204129896,NaN,NaN,50
1644816600,1.13477,1.13524,1.13473,1.13516,1133,2143.3,-205899,-207389.6,29.969753442964247,44.6339738168951,41.32048492390938,NaN,NaN,50
1644818400,1.13516,1.13522,1.13442,1.13484,1543,1963.85,-207442,-207191.2,29.707393878411576,42.41905265063351,41.195779564558215,NaN,NaN,50
1644820200,1.13484,1.13486,1.13388,1.13444,1958,1915.5,-209400,-207684,29.965297503920034,39.76282870382811,40.70495489668284,NaN,NaN,50
1644822000,1.13444,1.13493,1.13375,1.13476,4066,2086.3,-205334,-207021.4,30.31958180483782,42.8461843618761,40.4685067969907,NaN,NaN,50
1644823800,1.13476,1.13498,1.1336,1.13382,4374,2274.8,-209708,-207556.6,30.78372721316111,36.875080933436976,39.84154016075427,NaN,NaN,50
1644825600,1.13382,1.13434,1.13221,1.13224,7806,2415.2,-217514,-209879.6,32.229813906126836,29.446716067828547,38.85126668577508,NaN,NaN,50
1644827400,1.13224,1.1324,1.13038,1.13092,8096,2770.85,-225610,-213513.2,34.41838961695637,24.928579935574945,37.693548754879636,NaN,NaN,50
1644829200,1.13092,1.13186,1.1308,1.13148,5374,2892.45,-220236,-215680.4,36.45063849129808,29.84638465827632,37.23129239326024,NaN,NaN,50
1644831000,1.13148,1.13217,1.131,1.13122,4373,3046.65,-224609,-219535.4,37.8101524675602,28.89979571839021,36.675011338401525,NaN,NaN,50
1644832800,1.13122,1.13141,1.13014,1.13096,4538,3161.25,-229147,-223423.2,39.45196107613173,27.945323018091372,36.03365047047053,NaN,NaN,50
1644834600,1.13096,1.13182,1.13081,1.13137,4264,3302.8,-224883,-224897,40.31351121574307,31.77203977471588,35.67970619353695,NaN,NaN,50
1644836400,1.13137,1.13142,1.13008,1.1303,3004,3335.2,-227887,-225352.4,41.458652761852335,27.64560615222223,34.802813946260265,NaN,NaN,50
1644838200,1.1303,1.13118,1.13008,1.13111,3529,3380.05,-224358,-226176.8,42.521998483239514,34.57304064780318,34.48224505832248,NaN,NaN,50
1644840000,1.13111,1.13112,1.1302,1.13086,4066,3470.75,-228424,-226939.8,43.509390938813326,33.506740727801926,33.9358105119553,NaN,NaN,50
1644841800,1.13086,1.13426,1.13022,1.13272,12378,3965.9,-216046,-224319.6,40.53223964465259,46.68234296999818,34.08212259431981,NaN,NaN,50
1644843600,1.13272,1.13312,1.13128,1.1327,7788,4256.25,-223834,-224109.8,37.76774201436048,46.575473938891335,34.37900982919537,NaN,NaN,50
1644845400,1.1327,1.13294,1.13112,1.13152,9911,4651.25,-233745,-225281.4,35.34228650854703,40.66102550424119,34.44316674351059,NaN,NaN,50
1644847200,1.13152,1.13198,1.131,1.13124,7397,4946.2,-241142,-228638.2,33.2003226874933,39.383037198158824,34.195799088959355,NaN,NaN,50
1644849000,1.13124,1.13212,1.13049,1.13201,9043,5312.8,-232099,-229373.2,31.67387447389039,44.54491049346293,34.74364405753264,NaN,NaN,50
1644850800,1.13201,1.13201,1.13006,1.1304,8361,5650.1,-240460,-234256,30.6248073691893,37.37776347170435,35.31014744352377,NaN,NaN,50
1644852600,1.1304,1.13098,1.12916,1.1306,8804,6033.65,-231656,-235820.4,30.341329397031792,38.697285757499934,36.293626430804125,NaN,NaN,50
1644854400,1.1306,1.13106,1.12961,1.1306,6611,6287.05,-231656,-235402.6,29.978339509738177,38.697285757499934,36.92583365217724,NaN,NaN,50
1644856200,1.1306,1.13144,1.12983,1.13063,6626,6520.45,-225030,-232180.2,29.163540241537245,38.92117819893805,37.641646686502085,NaN,NaN,50
1644858000,1.13063,1.13072,1.12988,1.1306,3230,6478.65,-228260,-231412.4,28.40694092106495,38.768693741082046,38.41474459528713,NaN,NaN,50
1644859800,1.1306,1.13138,1.13044,1.13106,2385,6379.2,-225875,-228495.4,26.88191188251628,42.48926623101557,39.180260770737114,NaN,NaN,50
1644861600,1.13106,1.13144,1.1308,1.13116,2750,6126.4,-223125,-226789.2,25.393795990684243,43.29590212465976,40.298139054482654,NaN,NaN,50
1644863400,1.13116,1.13128,1.1297,1.12974,5636,6003.4,-228761,-226210.2,25.06415877968421,35.64952940633893,40.375031108663784,NaN,NaN,50
1644865200,1.12974,1.13018,1.12801,1.12882,8218,6145.6,-236979,-228600,25.923637056449948,31.738594981521402,40.24873498392946,NaN,NaN,50
1644867000,1.12882,1.12996,1.12837,1.12948,8564,6355.15,-228415,-228631,26.721724027732424,37.07207798303789,39.56228748486086,NaN,NaN,50
1644868800,1.12948,1.13029,1.1293,1.13024,4381,6347.3,-224034,-228262.8,27.02636806709366,42.63072846962353,39.28051995134173,NaN,NaN,50
1644870600,1.13024,1.13048,1.12938,1.12944,2882,6278.2,-226916,-229021,27.057653958471533,38.75044260117433,39.144049743979814,NaN,NaN,50
1644872400,1.12944,1.1303,1.12943,1.1303,966,6176.3,-225950,-228458.8,27.08670514332242,44.589298586223904,39.515925557413034,NaN,NaN,50
1644874200,1.1303,1.1308,1.13028,1.13064,1053,6052.5,-224897,-226042.4,26.423126449433955,46.75054901484712,39.67347116608334,NaN,NaN,50
1644876000,1.13064,1.1307,1.13011,1.13047,393,5868.85,-225290,-225417.4,25.96560573581951,45.78887885058775,40.27426512171787,NaN,NaN,50
1644877800,1.13047,1.1306,1.1303,1.13052,529,5276.4,-224761,-225562.8,25.540765073177525,46.139802899568714,40.80587348900849,NaN,NaN,50
1644879600,1.13052,1.13065,1.1304,1.13046,738,4923.9,-225499,-225279.4,25.06797626568995,45.75702360411121,41.310140478052155,NaN,NaN,50
1644881400,1.13046,1.13078,1.13042,1.13061,675,4462.1,-224824,-225054.2,24.41715360566786,46.94210294849706,41.883063674449225,NaN,NaN,50
1644883200,1.13061,1.13128,1.13034,1.13116,1438,4164.15,-223386,-224752,23.037473684434147,51.15588684527548,42.76786318189162,NaN,NaN,50
1644885000,1.13116,1.13134,1.13082,1.13119,1019,3762.95,-222367,-224167.4,21.66660918412539,51.38269379957739,43.403108008217465,NaN,NaN,50
1644886800,1.13119,1.13146,1.13104,1.13136,1403,3415.05,-220964,-223408,20.20749516273968,52.7224070271422,44.07642978696621,NaN,NaN,50
1644888600,1.13136,1.13143,1.13086,1.13106,1471,3048.4,-222435,-222795.2,19.12746887341453,50.098762638412275,45.10851787497145,NaN,NaN,50
1644890400,1.13106,1.13128,1.13091,1.1312,1174,2776.55,-221261,-222082.6,18.12458731904118,51.316306797520134,46.5069258618285,NaN,NaN,50
1644892200,1.1312,1.13226,1.1312,1.1319,2037,2547.1,-219224,-221250.2,17.948712701924592,56.9696226383066,47.928179051490545,NaN,NaN,50
1644894000,1.1319,1.13199,1.13152,1.13182,1582,2464.7,-220806,-220938,17.785400557459184,56.166879396075345,48.895046974808544,NaN,NaN,50
1644895800,1.13182,1.13225,1.13169,1.13176,2308,2460.85,-223114,-221368,17.9787804898867,55.53483908226697,50.09393243774373,NaN,NaN,50
1644897600,1.13176,1.13206,1.13164,1.13192,1233,2385,-221881,-221257.2,18.057456549901037,56.92679377878535,50.97518209435526,NaN,NaN,50
1644899400,1.13192,1.13208,1.13182,1.13194,1217,2164.05,-220664,-221137.8,18.1595533456385,57.10754483123165,51.714967509811295,NaN,NaN,50
1644901200,1.13194,1.13212,1.13149,1.13152,2019,1854.1,-222683,-221829.6,17.554839938951584,52.157653576117674,52.16987999020629,NaN,NaN,50
1644903000,1.13152,1.13209,1.13151,1.13175,1588,1505.3,-221095,-221887.4,16.993320347028025,54.48428080804686,52.76591412652616,NaN,NaN,50
1644904800,1.13175,1.13188,1.13139,1.13162,1708,1371.65,-222803,-221825.2,16.21012808517593,52.917830697542364,53.27740034748553,NaN,NaN,50
1644906600,1.13162,1.1324,1.13138,1.1322,2230,1339.05,-220573,-221563.6,16.388262919295894,58.632301629187374,54.1124145389634,NaN,NaN,50
1644908400,1.1322,1.13282,1.132,1.13231,3373,1459.4,-217200,-220870.8,17.16343145599096,59.63298250741574,54.717921371973425,NaN,NaN,50
1644910200,1.13231,1.13244,1.13116,1.13126,3014,1557.45,-220214,-220377,16.20682682895127,47.757371666720665,54.45896979105509,NaN,NaN,50
1644912000,1.13126,1.13458,1.13094,1.13388,10382,2056.9,-209832,-218124.4,17.62814997715962,65.96878242217429,55.40513946212881,NaN,NaN,50
1644913800,1.13388,1.1349,1.13337,1.1346,6732,2367.05,-203100,-214183.8,19.182227114809255,69.15130342906112,56.76603523288944,NaN,NaN,50
1644915600,1.1346,1.13504,1.13405,1.13463,5086,2584.45,-198014,-209672,20.72754039354536,69.28021307986457,58.04917139591404,NaN,NaN,50
1644917400,1.13463,1.13464,1.13358,1.13462,4342,2767.8,-202356,-206703.2,21.371289450141848,69.17644344901024,58.92108716810716,NaN,NaN,50
1644919200,1.13462,1.13539,1.13386,1.13476,5389,2965.35,-196967,-202053.8,22.566664965416557,69.85714717707654,59.89896343817867,NaN,NaN,50
1644921000,1.13476,1.13522,1.13418,1.13482,3956,3112.2,-193011,-198689.6,23.676656515314505,70.161280121557,60.94370922669939,NaN,NaN,50
1644922800,1.13482,1.1353,1.13442,1.13478,3973,3240.7,-196984,-197466.4,24.771543093142416,69.65669389035583,61.85298780609728,NaN,NaN,50
1644924600,1.13478,1.13481,1.1341,1.13459,3521,3343.2,-200505,-197964.6,25.203853800323873,67.18503391437628,62.57280845489332,NaN,NaN,50
1644926400,1.13459,1.13508,1.13366,1.13388,4940,3531.5,-205445,-198582.4,24.85618203309252,58.790062522654516,63.04655195107453,NaN,NaN,50
1644928200,1.13388,1.13496,1.13375,1.13407,4321,3645.7,-201124,-199413.8,24.53334396352055,60.22246314861814,63.456422118258196,NaN,NaN,50
1644930000,1.13407,1.13512,1.13406,1.13495,4237,3778.45,-196887,-200189,24.419650599074366,66.0997766916162,64.39798968926347,NaN,NaN,50
1644931800,1.13495,1.13602,1.13421,1.1356,5967,3961.4,-190920,-198976.2,25.22416938340828,69.66509992956975,65.18604671071935,NaN,NaN,50
1644933600,1.1356,1.13592,1.13483,1.13483,5377,4168.6,-196297,-198134.6,25.97122254028977,61.42381064999263,65.3139630066177,NaN,NaN,50
1644935400,1.13483,1.13563,1.13202,1.1322,8443,4529.9,-204740,-197993.6,25.19688321872731,42.799855899898134,64.95985473755894,NaN,NaN,50
1644937200,1.1322,1.13518,1.13217,1.13466,7559,4806.9,-197181,-197205,24.47785384870503,56.182614738014095,64.26084276011893,NaN,NaN,50
1644939000,1.13466,1.13576,1.13438,1.13548,6412,5048.1,-190769,-195981.4,23.13360278560593,59.577572305471485,63.57700482271967,NaN,NaN,50
1644940800,1.13548,1.13684,1.13547,1.13587,5750,5250.2,-185019,-194801.2,22.145830195428122,61.12049462551399,62.994167790266054,NaN,NaN,50
1644942600,1.13587,1.13676,1.13587,1.13626,3890,5333.2,-181129,-191767.6,21.228612790263014,62.655578427766514,62.528391717320076,NaN,NaN,50
1644944400,1.13626,1.13631,1.13462,1.13478,2438,5286.45,-183567,-187533,20.29476099216633,53.950224960596145,61.39218298757148,NaN,NaN,50
1644946200,1.13478,1.136,1.1347,1.13588,2641,5267.8,-180926,-184282,19.427612893933695,58.55887619184745,60.56343984973508,NaN,NaN,50
1644948000,1.13588,1.13644,1.13582,1.13623,1583,4827.85,-179343,-181996.8,18.149485003324724,59.93290007617961,59.868883148722496,NaN,NaN,50
1644949800,1.13623,1.13626,1.13554,1.13556,1122,4547.35,-180465,-181086,17.245837124413978,56.09843368853269,59.076983132590804,NaN,NaN,50
1644951600,1.13556,1.13618,1.13546,1.13579,1644,4375.25,-178821,-180624.4,16.489337763715305,57.11282335250883,58.95718033472326,NaN,NaN,50
1644953400,1.13579,1.13637,1.13573,1.13596,1773,4246.8,-177048,-179320.6,15.555669150945054,57.88736186554978,58.79038738593266,NaN,NaN,50
1644955200,1.13596,1.13638,1.13594,1.13598,1360,4045.35,-175688,-178273,14.676005957572347,57.98350121486635,58.210653423307676,NaN,NaN,50
1644957000,1.13598,1.13621,1.13547,1.13584,2415,3968.3,-178103,-178025,14.411864913873185,57.002509301364285,57.30618266415014,NaN,NaN,50
1644958800,1.13584,1.13594,1.1356,1.13572,833,3811.3,-178936,-177719.2,14.166591087581107,56.12598718604353,56.9277667024395,NaN,NaN,50
1644960600,1.13572,1.13599,1.1356,1.13586,659,3668.2,-178277,-177610.4,13.861390396536258,56.95755432133807,57.93903087539949,NaN,NaN,50
1644962400,1.13586,1.1361,1.1357,1.13598,195,3430.95,-178082,-177817.2,13.400404589383259,57.69765750129546,58.04724821563387,NaN,NaN,50
1644964200,1.13598,1.13622,1.13578,1.1358,371,3233.45,-178453,-178370.2,12.773714209059486,56.138352975280874,57.80158969204883,NaN,NaN,50
1644966000,1.1358,1.13599,1.13573,1.13584,666,3054.9,-177787,-178307,12.270021913405397,56.42021077228934,57.46585513110421,NaN,NaN,50
1644967800,1.13584,1.13588,1.13552,1.13554,465,2779.8,-178252,-178170.2,12.134831873747617,53.63633312589789,56.821623323827886,NaN,NaN,50
1644969600,1.13554,1.13596,1.13544,1.13562,961,2559,-177291,-177973,12.009298265493964,54.284125582152576,56.845473368224766,NaN,NaN,50
1644971400,1.13562,1.13573,1.13548,1.13573,725,2173.1,-176566,-177669.8,11.892731343544142,55.21078248708133,56.60632381788434,NaN,NaN,50
1644973200,1.13573,1.13573,1.1351,1.13534,1271,1858.7,-177837,-177546.6,12.427179919000844,51.244735998867604,55.9857406695049,NaN,NaN,50
1644975000,1.13534,1.13534,1.13487,1.13521,1393,1607.75,-179230,-177835.2,13.2771682980292,49.9565176408112,55.54703238038194,NaN,NaN,50
1644976800,1.13521,1.13536,1.13486,1.13486,1105,1375.5,-180335,-178251.8,14.015657103676421,46.56270544852091,54.79345253009709,NaN,NaN,50
1644978600,1.13486,1.13502,1.1345,1.13473,1631,1262.55,-181966,-179186.8,15.245875170454621,45.3308782939751,53.89656084641318,NaN,NaN,50
1644980400,1.13473,1.13484,1.13453,1.1346,980,1189.65,-182946,-180462.8,16.388220518177235,44.07516582855173,52.903108318819285,NaN,NaN,50
1644982200,1.1346,1.13472,1.1345,1.1346,905,1102.85,-182946,-181484.6,17.495888028160643,44.075165828551725,51.97972664218981,NaN,NaN,50
1644984000,1.1346,1.13482,1.13454,1.1347,722,1059.8,-182224,-182083.4,18.212081444983188,45.423894615057264,51.21529145854793,NaN,NaN,50
1644985800,1.1347,1.13491,1.13468,1.1348,544,1030.9,-181680,-182352.4,18.593524717242165,46.805460680665355,50.490141912785596,NaN,NaN,50
1644987600,1.1348,1.13518,1.1348,1.13518,782,987.8,-180898,-182138.8,18.14115341689183,51.79884342254466,50.068798050017676,NaN,NaN,50
1644989400,1.13518,1.13556,1.13516,1.13539,1031,950.7,-179867,-181523,16.945236221163654,54.34917593184279,49.940999689772106,NaN,NaN,50
1644991200,1.13539,1.13599,1.13534,1.13598,1114,938.4,-178753,-180684.4,16.74415917616465,60.64880118767979,50.2430418623,NaN,NaN,50
1644993000,1.13598,1.13638,1.13584,1.13638,1348,885.05,-177405,-179720.6,17.24437931655241,64.25066075425143,51.0012081214681,NaN,NaN,50
1644994800,1.13638,1.13708,1.13631,1.13658,3231,1004.95,-174174,-178219.4,18.678135153734686,65.92984225359527,51.83304502657115,NaN,NaN,50
1644996600,1.13658,1.13786,1.13647,1.13754,3455,1144.75,-170719,-176183.6,20.797362316413746,72.58605358114083,53.07413581900397,NaN,NaN,50
1644998400,1.13754,1.13878,1.13732,1.13827,4790,1374.5,-165929,-173396,23.439233262183038,76.36705704053259,54.868587321980044,NaN,NaN,50
1645000200,1.13827,1.13954,1.13802,1.13899,4478,1579.85,-161451,-169935.6,26.31396784132259,79.38683198836804,56.97075263251982,NaN,NaN,50
1645002000,1.13899,1.139,1.13755,1.13802,4738,1783.45,-166189,-167692.4,27.9874931587235,66.97120140129232,58.428502343432065,NaN,NaN,50
1645003800,1.13802,1.13853,1.13712,1.13776,4057,1963.05,-170246,-166906.8,28.713352797054792,64.07840224414643,59.76761119701573,NaN,NaN,50
1645005600,1.13776,1.13841,1.13733,1.13756,3265,2078.25,-173511,-167465.2,29.387365318362423,61.86472347673773,61.03829388617187,NaN,NaN,50
1645007400,1.13756,1.13866,1.13744,1.13807,2841,2184.05,-170670,-168413.4,30.2324304382366,65.16912055224572,62.54500493786429,NaN,NaN,50
1645009200,1.13807,1.13836,1.13743,1.1381,2466,2243.8,-168204,-169764,30.99562087851814,65.359266977318,63.9689601065972,NaN,NaN,50
1645011000,1.1381,1.13884,1.13804,1.13852,3570,2352.65,-164634,-169453,32.123357899022515,67.99361455002486,65.4823996686943,NaN,NaN,50
1645012800,1.13852,1.13869,1.13752,1.1378,4062,2500.5,-168696,-169143,32.0820263942451,59.622824716269974,66.04125547538897,NaN,NaN,50
1645014600,1.1378,1.13787,1.13645,1.13656,4867,2662.3,-173563,-169153.4,30.28626213493028,48.53955355113858,65.62628244819582,NaN,NaN,50
1645016400,1.13656,1.13744,1.13639,1.13656,4206,2823.6,-173563,-169732,28.533454086035313,48.53955355113858,64.76133618844287,NaN,NaN,50
1645018200,1.13656,1.13724,1.13548,1.1363,8053,3181,-181616,-172414.4,27.250157472153276,46.440269657440815,63.489165395813544,NaN,NaN,50
1645020000,1.1363,1.13635,1.13532,1.13556,5105,3400.15,-186721,-176831.8,26.239836667410817,41.00462237156408,61.708792547097026,NaN,NaN,50
1645021800,1.13556,1.13729,1.13556,1.13653,6959,3720.9,-179762,-179045,24.659373459479013,49.37005967417521,60.05050726802806,NaN,NaN,50
1645023600,1.13653,1.13706,1.136,1.13684,5061,3934.85,-174701,-179272.6,23.191800480685195,51.72597055075733,58.29042966161554,NaN,NaN,50
1645025400,1.13684,1.13734,1.13602,1.13654,5065,4136.55,-179766,-180513.2,22.171264701826395,49.333547217179195,56.14376646367349,NaN,NaN,50
1645027200,1.13654,1.13732,1.13606,1.13724,3303,4246,-176463,-179482.6,21.223624335743224,54.609009362507976,55.260752746617456,NaN,NaN,50
1645029000,1.13724,1.13811,1.13715,1.13808,3108,4334,-173355,-176809.4,21.258011974530408,59.99231855197401,54.96888962574799,NaN,NaN,50
1645030800,1.13808,1.13828,1.1377,1.13803,2871,4316,-176226,-176102.2,21.466316570197733,59.53966963535726,54.80281435136367,NaN,NaN,50
1645032600,1.13803,1.13805,1.13736,1.13744,2449,4265.7,-178675,-176897,21.09558044259458,54.33041538508968,54.02862112513824,NaN,NaN,50
1645034400,1.13744,1.13784,1.13712,1.13762,2943,4173.35,-175732,-176090.2,20.36826093914516,55.606540629058024,53.331997814548245,NaN,NaN,50
1645036200,1.13762,1.13826,1.13742,1.1377,2676,4083.25,-173056,-175408.8,20.201777944190912,56.19243259323688,52.489056246206246,NaN,NaN,50
1645038000,1.1377,1.1396,1.13718,1.13911,9823,4337.5,-163233,-173384.4,21.309096791622046,64.96803372934173,52.87085688999708,NaN,NaN,50
1645039800,1.13911,1.13938,1.13836,1.13905,4309,4350.1,-167542,-171647.6,22.337321435665242,64.37704985648818,54.00210662609347,NaN,NaN,50
1645041600,1.13905,1.13938,1.1381,1.13844,2933,4333.5,-170475,-170007.6,22.84369235941525,58.54612639490014,54.7168618292193,NaN,NaN,50
1645043400,1.13844,1.13891,1.13806,1.13819,2608,4321.85,-173083,-169477.8,23.243577042650966,56.29564251133622,55.42081703306898,NaN,NaN,50
1645045200,1.13819,1.13826,1.13728,1.13731,1121,4254.6,-174204,-169707.4,22.3513076060076,49.135805039764115,56.001615795083254,NaN,NaN,50
1645047000,1.13731,1.13752,1.13725,1.13736,630,4107.6,-173574,-171775.6,21.477898110906217,49.52858191118523,56.01293881201254,NaN,NaN,50
1645048800,1.13736,1.13778,1.13734,1.13748,262,3917.6,-173312,-172929.6,20.98966338885278,50.51620816841422,55.92652721327375,NaN,NaN,50
1645050600,1.13748,1.1377,1.13746,1.13756,240,3686.25,-173072,-173449,20.536302575517443,51.201766861702545,56.05997147359685,NaN,NaN,50
1645052400,1.13756,1.1385,1.13752,1.13844,1131,3532.5,-171941,-173220.6,21.042855628260114,58.0814072048062,56.307999890903865,NaN,NaN,50
1645054200,1.13844,1.13847,1.13672,1.13728,1911,3225.4,-173852,-173150.2,20.229928015144313,48.395754317600826,55.47967387416292,NaN,NaN,50
1645056000,1.13728,1.13812,1.13726,1.13787,1359,3038.1,-172493,-172934,19.475066660108215,52.71487207531948,54.99218833416022,NaN,NaN,50
1645057800,1.13787,1.13829,1.13782,1.13796,1318,2756.05,-171175,-172506.6,18.990480264738267,53.35619791120505,54.922601371739894,NaN,NaN,50
1645059600,1.13796,1.13808,1.13756,1.13776,1600,2583,-172775,-172447.2,18.119246278902267,51.678790049406274,54.64204775890762,NaN,NaN,50
1645061400,1.13776,1.13822,1.13739,1.13818,1489,2404.2,-171286,-172316.2,17.039130540366898,54.886287673636524,54.54875169322189,NaN,NaN,50
1645063200,1.13818,1.13836,1.1379,1.13806,1602,2319.15,-172888,-172123.4,16.24789206104073,53.78771627645249,53.75015758944408,NaN,NaN,50
1645065000,1.13806,1.1385,1.138,1.13829,1113,2219.4,-171775,-171979.8,15.727173382421933,55.62117648144887,53.12473806265556,NaN,NaN,50
1645066800,1.13829,1.13843,1.13788,1.1384,1239,2137.8,-170536,-171852,15.021305925330362,56.509874577410535,52.979291504263436,NaN,NaN,50
1645068600,1.1384,1.13848,1.13295,1.13366,6010,2315.85,-176546,-172606.2,17.7518153674214,29.290582909674697,51.05035867557333,NaN,NaN,50
1645070400,1.13366,1.13646,1.13232,1.13454,15316,2934.5,-161230,-170595,20.525557170005808,35.50196144970157,50.07651270485457,NaN,NaN,50
1645072200,1.13454,1.13527,1.13422,1.13423,3994,3000.4,-165224,-169062.2,23.1011745581199,34.35700302150083,48.992828498448546,NaN,NaN,50
1645074000,1.13423,1.13586,1.13422,1.1357,3964,2707.45,-161260,-166959.2,24.688397119855843,43.63927456218337,48.50161895514634,NaN,NaN,50
1645075800,1.1357,1.13596,1.13539,1.13564,2149,2599.45,-163409,-165533.8,26.027742178484303,43.36970494945477,47.94218596141435,NaN,NaN,50
1645077600,1.13564,1.13724,1.13516,1.1372,2275,2566.55,-161134,-162451.4,25.718697787189466,51.72027676604272,47.48781950150268,NaN,NaN,50
1645079400,1.1372,1.13744,1.13524,1.13604,5050,2688.65,-166184,-163442.2,25.215561232403356,46.258015573084826,47.33512387689439,NaN,NaN,50
1645081200,1.13604,1.13665,1.13571,1.13618,4479,2856.55,-161705,-162738.4,24.748363002959113,46.98572694804004,46.925899224945866,NaN,NaN,50
1645083000,1.13618,1.13755,1.1361,1.13752,3791,3014.6,-157914,-162069.2,23.340800134333904,53.47889879794244,46.934663573998535,NaN,NaN,50
1645084800,1.13752,1.13863,1.1353,1.13673,8061,3404.55,-165975,-162582.4,22.28326706270892,49.62029320848717,46.787628085361455,NaN,NaN,50
1645086600,1.13673,1.1373,1.13497,1.13584,11276,3956.35,-177251,-165805.8,20.984976809823717,45.62627072869003,46.12619830357956,NaN,NaN,50
1645088400,1.13584,1.13638,1.13428,1.13571,7632,4281.4,-184883,-169545.6,19.818357196934414,45.05579150666009,45.50248939145153,NaN,NaN,50
1645090200,1.13571,1.13646,1.13546,1.13614,5700,4470.85,-179183,-173041.2,18.65735228095357,47.39857499423403,44.915160713793334,NaN,NaN,50
1645092000,1.13614,1.13696,1.13551,1.13666,4166,4611.2,-175017,-176461.8,17.55388371141885,50.16587739984851,44.462018058253186,NaN,NaN,50
1645093800,1.13666,1.13766,1.13644,1.13754,3199,4705.25,-171818,-177630.4,17.149754836471125,54.52588621213644,46.264539722714744,NaN,NaN,50
1645095600,1.13754,1.13795,1.13702,1.13707,2984,4774.45,-174802,-177140.6,17.016789607441225,51.913480832090734,47.43679110717111,NaN,NaN,50
1645097400,1.13707,1.13716,1.13625,1.13658,2920,4846,-177722,-175708.4,16.07663330187273,49.26348104736148,48.50153953758973,NaN,NaN,50
1645099200,1.13658,1.13762,1.13654,1.13748,3140,4922.9,-174582,-174788.2,15.615529267547279,53.91657236610615,49.23563223786993,NaN,NaN,50
1645101000,1.13748,1.13792,1.13708,1.13778,3715,5053,-170867,-173958.2,15.448310760149766,55.385368916265946,50.093893949785006,NaN,NaN,50
1645102800,1.13778,1.13791,1.1358,1.1362,5992,5290.65,-176859,-174966.4,14.6640669553189,46.90596273043864,49.75001437581329,NaN,NaN,50
1645104600,1.1362,1.13701,1.13517,1.13595,7379,5359.1,-184238,-176853.6,14.458955056565514,45.7133992431301,49.71111320938795,NaN,NaN,50
1645106400,1.13595,1.1376,1.13591,1.13668,8695,5028.05,-175543,-176417.8,13.695411462374604,49.732323322671945,49.907298664718795,NaN,NaN,50
1645108200,1.13668,1.13719,1.13506,1.13594,8961,5276.4,-184504,-178402.2,13.675089607895405,46.01357590065701,49.374061314912694,NaN,NaN,50
1645110000,1.13594,1.13795,1.13548,1.13616,9237,5540.05,-175267,-179282.2,12.943462410035139,47.2758201785331,49.20659895563026,NaN,NaN,50
1645111800,1.13616,1.13716,1.13564,1.13693,7858,5825.5,-167409,-177392.2,12.264094297736321,51.54595524668525,49.62943356405849,NaN,NaN,50
1645113600,1.13693,1.13757,1.13628,1.13674,5789,6001.2,-173198,-175184.2,11.52840950814368,50.45996412112197,50.01544589366291,NaN,NaN,50
1645115400,1.13674,1.1371,1.13622,1.13627,3589,5928.15,-176787,-175433,10.785872073755964,47.77837637953928,50.04257456404185,NaN,NaN,50
1645117200,1.13627,1.13697,1.13599,1.13627,3299,5869.15,-176787,-173889.6,10.169831604579096,47.778376379539274,49.87203877687691,NaN,NaN,50
1645119000,1.13627,1.1367,1.13584,1.13594,2374,5798.3,-179161,-174668.4,9.754095673182636,45.796560145483326,49.248515486401686,NaN,NaN,50
1645120800,1.13594,1.13642,1.13571,1.13638,2495,5520,-176666,-176519.8,9.507757739383207,48.84344938766205,49.02922752608536,NaN,NaN,50
1645122600,1.13638,1.13647,1.13611,1.13629,1770,5044.7,-178436,-177567.4,9.215244691852362,48.24604820016023,48.956553751285256,NaN,NaN,50
1645124400,1.13629,1.13646,1.13605,1.13634,1567,4741.45,-176869,-177583.8,9.01616535626388,48.62201457447712,48.57837105188319,NaN,NaN,50
1645126200,1.13634,1.13672,1.13629,1.13642,2070,4559.95,-174799,-177186.2,8.468583627309123,49.25717697055785,48.14064305576118,NaN,NaN,50
1645128000,1.13642,1.1365,1.13569,1.13609,2322,4467.75,-177121,-176778.2,8.707097865004691,46.69288735453781,48.12542338605398,NaN,NaN,50
1645129800,1.13609,1.13634,1.13592,1.13601,2204,4418,-179325,-177310,8.928575371436292,46.06678378650028,48.15066513915185,NaN,NaN,50
1645131600,1.13601,1.13617,1.13592,1.13616,730,4305.3,-178595,-177341.8,9.134233055979921,47.48857302935815,47.990397261058014,NaN,NaN,50
1645133400,1.13616,1.13624,1.13596,1.13622,711,4194.85,-177884,-177544.8,9.203714033388707,48.078194601513005,48.137870025404865,NaN,NaN,50
1645135200,1.13622,1.13662,1.136,1.1362,791,4077.4,-178675,-178320,8.625926354508112,47.88518268568736,48.18139591877303,NaN,NaN,50
1645137000,1.1362,1.13631,1.1361,1.13615,432,3913.25,-179107,-178717.2,8.089409224118986,47.373155550980215,47.883338797651234,NaN,NaN,50
1645138800,1.13615,1.13698,1.13612,1.13691,1697,3698.5,-177410,-178334.2,8.46552282868792,55.21245658163408,48.222802544830664,NaN,NaN,50
1645140600,1.13691,1.13694,1.13638,1.13638,819,3370.5,-178229,-178261,8.814771175787646,49.65725663291174,48.35700827721441,NaN,NaN,50
1645142400,1.13638,1.1366,1.1359,1.13608,1522,3011.85,-179751,-178634.4,8.278669707508024,46.78764030133016,48.28624141448519,NaN,NaN,50
1645144200,1.13608,1.1361,1.1358,1.13596,863,2606.95,-180614,-179022.2,7.762319589648779,45.65122206294591,48.27586012287537,NaN,NaN,50
1645146000,1.13596,1.13616,1.13577,1.13604,1492,2219.7,-179122,-179025.2,7.239878290600895,46.58272073698403,48.1143795049698,NaN,NaN,50
1645147800,1.13604,1.13714,1.13598,1.13681,4761,2064.85,-174361,-178415.4,8.225389993312483,54.64098482438519,48.57116069241444,NaN,NaN,50
1645149600,1.13681,1.13716,1.1367,1.13673,2357,1893.25,-176718,-178113.2,9.16602903263564,53.73401472997503,48.93630356066429,NaN,NaN,50
1645151400,1.13673,1.13683,1.13627,1.13672,1717,1799.65,-178435,-177850,9.217188597077964,53.6142168556677,49.247520695314996,NaN,NaN,50
1645153200,1.13672,1.1369,1.1364,1.13684,1654,1717.4,-176781,-177083.4,9.369960539362786,54.91323386532131,49.834688303228106,NaN,NaN,50
1645155000,1.13684,1.13704,1.13668,1.13676,1433,1670.35,-178214,-176901.8,9.727252437779406,53.830915238735436,50.3892691212449,NaN,NaN,50
1645156800,1.13676,1.13688,1.13667,1.13678,1052,1598.2,-177162,-177462,10.037697815814818,54.07461528269934,50.859700710769275,NaN,NaN,50
1645158600,1.13678,1.13684,1.13628,1.13637,1098,1564.6,-178260,-177770.4,9.520894922471964,48.430896156791896,50.884893679003476,NaN,NaN,50
1645160400,1.13637,1.13662,1.13614,1.13614,1008,1536.65,-179268,-177937,8.910816559329012,45.558340124695796,50.71869063893264,NaN,NaN,50
1645162200,1.13614,1.13674,1.13612,1.1366,1399,1503.1,-177869,-178154.6,8.441256270780709,51.7254151296842,51.029566323125785,NaN,NaN,50
1645164000,1.1366,1.13696,1.13657,1.13678,1201,1447.05,-176668,-177845.4,8.430071617086691,53.92486392499147,50.93759541907988,NaN,NaN,50
1645165800,1.13678,1.1372,1.13667,1.1371,1365,1405.1,-175303,-177473.6,8.857101844239226,57.621471407033845,51.50646790294575,NaN,NaN,50
1645167600,1.1371,1.13736,1.13674,1.13709,2618,1499.5,-177921,-177405.8,9.533297074756533,57.46630963697269,52.26922999834879,NaN,NaN,50
1645169400,1.13709,1.13739,1.13676,1.137,2554,1591.65,-180475,-177647.2,10.21458745001972,56.00463226440435,53.008759298452965,NaN,NaN,50
1645171200,1.137,1.13736,1.1366,1.13723,3750,1739.6,-176725,-177418.4,10.422453311628962,58.88289697775631,53.88734331565098,NaN,NaN,50
1645173000,1.13723,1.13772,1.137,1.13758,4075,1921.75,-172650,-176614.8,11.28534079792348,62.86433432748309,54.474725423015116,NaN,NaN,50
1645174800,1.13758,1.13771,1.1364,1.13668,3486,2011.2,-176136,-176781.4,10.666366078916722,49.57171733815921,54.17741846645684,NaN,NaN,50
1645176600,1.13668,1.13726,1.13648,1.1371,3423,2141.4,-172713,-175739.8,10.091603839839017,54.41580429760568,54.23467471230955,NaN,NaN,50
1645178400,1.1371,1.13725,1.13627,1.13664,3817,2256.15,-176530,-174950.8,9.636728793830462,48.87792211428359,53.803581015806856,NaN,NaN,50
1645180200,1.13664,1.13688,1.13608,1.1361,2956,2360.8,-179486,-175503,9.604988326325472,43.306201137207275,53.05181572284056,NaN,NaN,50
1645182000,1.1361,1.13623,1.13468,1.13478,2795,2425.95,-182281,-177429.2,11.590840203020237,33.31033414761377,51.56865278462016,NaN,NaN,50
1645183800,1.13478,1.13637,1.13474,1.13626,2973,2336.55,-179308,-178063.6,13.11706882422847,47.84588324335665,51.526866147946215,NaN,NaN,50
1645185600,1.13626,1.1364,1.1359,1.13626,2883,2362.85,-179308,-179382.6,14.463848614779733,47.84588324335665,51.69026208499342,NaN,NaN,50
1645187400,1.13626,1.13684,1.13575,1.13603,3404,2447.2,-182712,-180619,14.725992777348226,46.037381217272646,51.2839739483926,NaN,NaN,50
1645189200,1.13603,1.13617,1.13498,1.13512,5815,2655.25,-188527,-182427.2,15.934301375407205,39.651355012689464,50.26443759751389,NaN,NaN,50
1645191000,1.13512,1.13614,1.1348,1.1349,5066,2836.9,-193593,-184689.6,17.25104030857634,38.26926546250116,48.8821371729044,NaN,NaN,50
1645192800,1.1349,1.13518,1.13387,1.13462,6038,3086.2,-199631,-188754.2,19.325117419915703,36.524325884780566,47.38628119060497,NaN,NaN,50
1645194600,1.13462,1.1351,1.13406,1.13482,6501,3356.35,-193130,-191518.6,21.251046166159394,38.67523857417371,46.148467355588494,NaN,NaN,50
1645196400,1.13482,1.13542,1.13409,1.13452,4944,3553.15,-198074,-194591,22.333292066744473,36.66808925630514,44.56169537548484,NaN,NaN,50
1645198200,1.13452,1.13457,1.13274,1.13412,8421,3904.25,-206495,-198184.6,24.405308193799485,34.12510268057714,42.50889311499156,NaN,NaN,50
1645200000,1.13412,1.13423,1.13148,1.13353,9560,4322.2,-216055,-202677,26.99318721982537,30.738844765684448,41.16368793124336,NaN,NaN,50
1645201800,1.13353,1.13382,1.13258,1.13259,4781,4493,-220836,-206918,29.396217743992263,26.266732978808605,39.153039979900704,NaN,NaN,50
1645203600,1.13259,1.13294,1.13167,1.13196,3183,4521.25,-224019,-213095.8,32.015405717263505,23.770626453253854,37.35966171839858,NaN,NaN,50
1645205400,1.13196,1.13256,1.1314,1.13224,4548,4620.95,-219471,-217375.2,34.54982267157443,27.087005456431413,36.2011477412003,NaN,NaN,50
1645207200,1.13224,1.13322,1.13219,1.13294,2464,4556.65,-217007,-219477.6,35.70675140734235,34.731836489231114,36.3026836227444,NaN,NaN,50
1645209000,1.13294,1.13326,1.13273,1.133,1700,4437.9,-215307,-219328,36.711216980887684,35.357468847928175,35.41065402307093,NaN,NaN,50
1645210800,1.133,1.13332,1.13278,1.13314,2333,4380.25,-212974,-217755.6,37.5330333263464,36.87787934674456,34.62722517331293,NaN,NaN,50
1645212600,1.13314,1.13358,1.13312,1.13313,2589,4338.55,-215563,-216064.4,37.807607302588174,36.81127845335296,33.968217833032945,NaN,NaN,50
1645214400,1.13313,1.13319,1.13254,1.13286,2580,4276.7,-218143,-215798.8,38.48044932013569,34.974671567661446,33.63416901553095,NaN,NaN,50
1645216200,1.13286,1.13297,1.1324,1.13247,2081,4232.95,-220224,-216442.2,39.20054485302848,32.45576163551094,33.2189187421745,NaN,NaN,50
1645218000,1.13247,1.13294,1.13247,1.13276,633,4124.85,-219591,-217299,39.86920499071465,36.13886334710904,33.19138570376939,NaN,NaN,50
1645219800,1.13276,1.13296,1.1323,1.13237,1027,4027.55,-220618,-218827.8,40.61643958180639,33.4937715437363,32.821280915881005,NaN,NaN,50
1645394400,1.13237,1.13276,1.13198,1.13228,308,3898.8,-220926,-219900.4,41.54148177354539,32.89540935535608,32.55180378009893,NaN,NaN,50
1645396200,1.13228,1.13232,1.13186,1.13193,502,3753.7,-221428,-220557.4,42.485489832755036,30.605541727620775,32.300406569173475,NaN,NaN,50
1645398000,1.13193,1.13238,1.13148,1.13148,2724,3599.15,-224152,-221343,43.62192042226529,27.914987934131958,32.09870250977687,NaN,NaN,50
1645399800,1.13148,1.13198,1.13132,1.13166,2290,3460.35,-221862,-221797.2,44.78171873458042,30.545187060326953,32.404306372742475,NaN,NaN,50
1645401600,1.13166,1.13205,1.13132,1.13154,1286,3222.75,-223148,-222303.2,45.672504677850156,29.76544763061247,32.83250788541094,NaN,NaN,50
1645403400,1.13154,1.13358,1.13152,1.13326,2462,3020.8,-220686,-222255.2,43.384491287907885,49.617922758932416,34.44185912130387,NaN,NaN,50
1645405200,1.13326,1.13367,1.13284,1.13352,2570,2902.1,-218116,-221592.8,41.119759024550454,51.834239602937394,35.663459343711466,NaN,NaN,50
1645407000,1.13352,1.1358,1.13348,1.13536,3499,2656,-214617,-219685.8,39.786101280100894,63.9278706656789,37.704202330693654,NaN,NaN,50
1645408800,1.13536,1.13568,1.1353,1.13554,1645,2260.25,-212972,-217907.8,38.54770480311201,64.85745932385367,39.702743757630024,NaN,NaN,50
1645410600,1.13554,1.13582,1.13536,1.13572,1353,2088.85,-211619,-215602,37.52386261496999,65.80642016380207,41.773825308376395,NaN,NaN,50
1645412400,1.13572,1.1368,1.1357,1.13654,1453,2002.35,-210166,-213498,37.366032306714054,69.80638585519469,44.26180490034306,NaN,NaN,50
1645414200,1.13654,1.13655,1.13604,1.13608,973,1823.6,-211139,-212102.6,37.21947559190496,65.19873535028663,46.600588737112744,NaN,NaN,50
1645416000,1.13608,1.13629,1.13586,1.1359,611,1730.95,-211750,-211529.2,36.790948871925494,63.43429156148779,48.55026218099694,NaN,NaN,50
1645417800,1.1359,1.13624,1.13584,1.13622,707,1681.3,-211043,-211143.4,36.35921974818035,65.23551114566754,50.817529295420606,NaN,NaN,50
1645419600,1.13622,1.13644,1.13608,1.13626,693,1599.3,-210350,-210889.6,36.14331324317362,65.46452030752624,53.14389436343276,NaN,NaN,50
1645421400,1.13626,1.13644,1.13612,1.13626,656,1502.65,-210350,-210926.4,35.94282863138165,65.46452030752624,55.63382140485458,NaN,NaN,50
1645423200,1.13626,1.13698,1.13624,1.13691,1018,1424.55,-209332,-210565,36.255807220884414,69.2785295407599,58.58836009104228,NaN,NaN,50
1645425000,1.13691,1.13697,1.13653,1.13689,940,1367.5,-210272,-210269.4,36.54643019685126,69.02593157635309,61.33698469932987,NaN,NaN,50
1645426800,1.13689,1.13754,1.13682,1.13754,2599,1465.8,-207673,-209595.4,37.301078728606896,72.53132623905937,64.39169031421893,NaN,NaN,50
1645428600,1.13754,1.13789,1.13733,1.13736,2589,1543.9,-210262,-209577.8,38.2660644625335,70.16326837208646,65.8592150008728,NaN,NaN,50
1645430400,1.13736,1.13909,1.13734,1.13775,4383,1747.65,-205879,-208683.6,39.88328583968463,72.27534480719041,67.31929394403372,NaN,NaN,50
1645432200,1.13775,1.1378,1.13562,1.1357,4862,1965.65,-210741,-208965.4,38.6196898479226,51.59900545656945,66.43866071481162,NaN,NaN,50
1645434000,1.1357,1.13684,1.1354,1.13649,3712,2015.05,-207029,-208316.8,37.16636730924737,56.73556608310154,65.85852548332933,NaN,NaN,50
1645435800,1.13649,1.13681,1.13578,1.13635,2045,2002.8,-209074,-208597,35.81685352333465,55.60927411586719,65.13015790847683,NaN,NaN,50
1645437600,1.13635,1.13666,1.13602,1.13606,2210,2049,-211284,-208801.4,34.56373357927284,53.251084634235475,63.94763639269403,NaN,NaN,50
1645439400,1.13606,1.13634,1.13552,1.13565,1620,2006.9,-212904,-210206.4,32.69506205590223,50.02141579228775,62.863542138551246,NaN,NaN,50
1645441200,1.13565,1.13615,1.13496,1.13504,2269,1991.85,-215173,-211092.8,30.467686414166646,45.59104807855469,61.589024746913175,NaN,NaN,50
1645443000,1.13504,1.13521,1.13459,1.1348,3405,1987.15,-218578,-213402.6,28.829232903881536,43.94201322707593,60.068060609870926,NaN,NaN,50
1645444800,1.1348,1.13496,1.13397,1.13467,2579,2033.85,-221157,-215819.2,27.963747323254783,43.034027452069544,58.46588254876688,NaN,NaN,50
1645446600,1.13467,1.13504,1.1333,1.13345,3688,2150.6,-224845,-218531.4,27.776403908920884,35.59963049760313,56.33267613377236,NaN,NaN,50
1645448400,1.13345,1.13389,1.13269,1.13292,3152,2235.55,-227997,-221550,28.094181268748375,32.9375240027062,53.73689002391138,NaN,NaN,50
1645450200,1.13292,1.13408,1.13206,1.133,4672,2420.5,-223325,-223180.4,28.83957201217706,33.7429228598528,51.21667511558993,NaN,NaN,50
1645452000,1.133,1.13462,1.13252,1.13378,5350,2657.45,-217975,-223059.8,28.749281044754554,41.162435994135535,48.97604009809537,NaN,NaN,50
1645453800,1.13378,1.13402,1.13292,1.13338,3483,2796.25,-221458,-223120,28.66543943214794,38.765072920228405,46.733311851534076,NaN,NaN,50
1645455600,1.13338,1.13446,1.13259,1.13314,3728,2948,-225186,-223188.2,27.95399937443714,37.35913704489112,44.23929701136984,NaN,NaN,50
1645457400,1.13314,1.13417,1.13299,1.13362,4100,3120.2,-221086,-221806,27.293376463705677,41.89784101187826,43.546356693891894,NaN,NaN,50
1645459200,1.13362,1.13406,1.13351,1.1339,2715,3205.05,-218371,-220815.2,26.679940903740746,44.42735268691157,42.66719859416404,NaN,NaN,50
1645461000,1.1339,1.13472,1.1338,1.13466,1859,3251,-216512,-220522.6,25.133139171938318,50.7010342398471,42.316610031591175,NaN,NaN,50
1645462800,1.13466,1.13494,1.13392,1.13436,1761,3209.1,-218273,-219885.6,23.39879650139867,48.379295895573435,41.96862512168674,NaN,NaN,50
1645464600,1.13436,1.13444,1.13356,1.13364,1341,3146.7,-219614,-218771.2,22.25170035978005,43.2592762251956,41.48561515260873,NaN,NaN,50
1645466400,1.13364,1.13433,1.13174,1.13236,1939,3024.5,-221553,-218864.6,22.92497254966799,35.9709730666668,40.79846693747389,NaN,NaN,50
1645468200,1.13236,1.13288,1.1317,1.13174,1152,2839,-222705,-219731.4,23.58030533789755,33.06505827472394,40.021541583734454,NaN,NaN,50
1645470000,1.13174,1.13176,1.13066,1.13091,2370,2771.9,-225075,-221444,24.90411376836322,29.61580334805238,39.06309700487609,NaN,NaN,50
1645471800,1.13091,1.13206,1.13074,1.13188,2451,2792.2,-222624,-222314.2,25.688671233294563,37.784170029114826,39.21913554284121,NaN,NaN,50
1645473600,1.13188,1.13189,1.13082,1.13092,823,2722.85,-223447,-223080.8,26.417188879302238,33.62500113052741,39.268241051971295,NaN,NaN,50
1645475400,1.13092,1.13152,1.13074,1.1315,637,2673.7,-222810,-223332.2,27.15488460535339,38.06110367178698,39.57668253853802,NaN,NaN,50
1645477200,1.1315,1.1319,1.13131,1.13138,914,2605.95,-223724,-223536,27.214740393943615,37.5026375937133,39.315268367079284,NaN,NaN,50
1645479000,1.13138,1.13166,1.13082,1.131,839,2477.65,-224563,-223433.6,27.690142086765935,35.71549530163345,39.09744139432251,NaN,NaN,50
1645480800,1.131,1.13143,1.13075,1.13088,320,2364.7,-224883,-223885.4,28.190166875531865,35.145915587010336,38.939354147331024,NaN,NaN,50
1645482600,1.13088,1.13088,1.13066,1.13072,278,2194.2,-225161,-224228.2,28.733228628741113,34.35911756790868,38.40087390133319,NaN,NaN,50
1645484400,1.13072,1.13088,1.12973,1.13013,1915,2132.35,-227076,-225081.4,29.96282300323144,31.55394980743739,37.48134512422789,NaN,NaN,50
1645486200,1.13013,1.13094,1.12964,1.13093,2010,1999.25,-225066,-225349.8,31.167194188160106,38.84472068657147,36.63446558470821,NaN,NaN,50
1645488000,1.13093,1.13176,1.13072,1.13168,2036,1833.55,-223030,-225043.2,30.845995621776474,44.782916106617535,36.37758131406851,NaN,NaN,50
1645489800,1.13168,1.13199,1.13114,1.1314,1932,1756,-224962,-225059,30.18752806271404,43.100310313034164,36.366226606056976,NaN,NaN,50
1645491600,1.1314,1.13164,1.13016,1.13052,3360,1737.6,-228322,-225691.2,30.44078686070965,38.237683819048726,36.5281345169414,NaN,NaN,50
1645493400,1.13052,1.1309,1.12996,1.13038,3145,1689.85,-231467,-226569.4,30.83136760385426,37.51258441589907,36.845814955596765,NaN,NaN,50
1645495200,1.13038,1.13096,1.12979,1.13056,2481,1678.15,-228986,-227353.4,31.32762576125998,39.111302209651846,37.52406487428244,NaN,NaN,50
1645497000,1.13056,1.13078,1.13009,1.13046,2030,1686.7,-231016,-228950.6,31.788436907422437,38.521649499113416,37.57674197928234,NaN,NaN,50
1645498800,1.13046,1.13046,1.12966,1.12996,2042,1700.75,-233058,-230569.8,32.56675320306158,35.62926777875673,37.719903882727294,NaN,NaN,50
1645500600,1.12996,1.12998,1.1288,1.12925,2253,1746.35,-235311,-231967.6,33.88378974027565,31.959612528274633,37.284083086762124,NaN,NaN,50
1645502400,1.12925,1.13002,1.12925,1.12992,1771,1737.95,-233540,-232382.2,35.02888789657288,38.40655777657922,37.348648814109694,NaN,NaN,50
1645504200,1.12992,1.13003,1.1293,1.12988,1659,1763.3,-235199,-233624.8,36.07142155636333,38.17400325818496,37.524256525291946,NaN,NaN,50
1645506000,1.12988,1.13082,1.12977,1.13074,1655,1727.55,-233544,-234130.4,35.52556393999987,45.77609844953418,38.2835553011865,NaN,NaN,50
1645507800,1.13074,1.13094,1.1305,1.13068,1871,1698.55,-235415,-234601.8,34.8109387473205,45.35706890890106,39.06912325411453,NaN,NaN,50
1645509600,1.13068,1.13081,1.13,1.13076,2075,1761.15,-233340,-234207.6,34.63811606516441,46.06598049480852,40.10569687464105,NaN,NaN,50
1645511400,1.13076,1.13126,1.13,1.13042,2832,1870.9,-236172,-234734,33.701519636214286,43.48395381091115,40.43707066923673,NaN,NaN,50
1645513200,1.13042,1.13056,1.12927,1.12964,4895,2069.95,-241067,-235907.6,33.53473217789434,38.194812629306206,39.966491849428785,NaN,NaN,50
1645515000,1.12964,1.13058,1.12941,1.12969,6070,2331.5,-234997,-236198.2,33.3452685761367,38.70945989226815,39.652859676516925,NaN,NaN,50
1645516800,1.12969,1.13264,1.1293,1.13216,9102,2770.6,-225895,-234294.2,31.470806752391184,57.525392432387775,41.03055314889828,NaN,NaN,50
1645518600,1.13216,1.1328,1.1313,1.1326,5656,3039.5,-220239,-231674,29.88749826493616,59.887771038878235,42.628780764825365,NaN,NaN,50
1645520400,1.1326,1.13368,1.13233,1.13351,4834,3185.45,-215405,-227520.6,29.214742945182042,64.30908365602528,44.42862229670925,NaN,NaN,50
1645522200,1.13351,1.13353,1.13146,1.13196,4608,3315.35,-220013,-223309.8,27.592953876410586,53.493490254036395,45.49803949348946,NaN,NaN,50
1645524000,1.13196,1.1344,1.13184,1.13402,5382,3482.65,-214631,-219236.6,26.827871932360058,62.516281409414795,47.418540467107896,NaN,NaN,50
1645525800,1.13402,1.1367,1.13348,1.13524,8785,3825.3,-205846,-215226.8,27.542561870217746,66.64373219274219,49.89597758599844,NaN,NaN,50
1645527600,1.13524,1.13588,1.13498,1.13531,6251,3969.85,-199595,-211098,28.20620252679989,66.86915334308594,51.92902012646321,NaN,NaN,50
1645529400,1.13531,1.13541,1.13372,1.13461,4869,4056.05,-204464,-208909.8,27.52908909141715,62.33268652716921,53.65464035996207,NaN,NaN,50
1645531200,1.13461,1.13594,1.13432,1.13541,5204,4192.2,-199260,-204759.2,27.228647477703426,65.23540994610606,55.04459118114578,NaN,NaN,50
1645533000,1.13541,1.13556,1.13468,1.13509,4559,4318.65,-203819,-202596.8,26.949665979254974,63.139433648224305,56.31476009109745,NaN,NaN,50
1645534800,1.13509,1.13536,1.1341,1.13476,5085,4470.8,-208904,-203208.4,26.100692784255664,60.964100457491426,57.37891151700337,NaN,NaN,50
1645536600,1.13476,1.13489,1.13371,1.13414,3920,4554.15,-212824,-205854.2,24.93222093942025,56.99130557067621,58.34372235698658,NaN,NaN,50
1645538400,1.13414,1.13468,1.13372,1.13398,4745,4702.85,-217569,-208475.2,23.847211369215934,55.97751427266163,59.61391533151197,NaN,NaN,50
1645540200,1.13398,1.13483,1.13356,1.13466,6514,4945.6,-211055,-210834.2,22.670912111870344,59.29183895039882,61.08408526423558,NaN,NaN,50
1645542000,1.13466,1.13506,1.13321,1.13322,6538,5189.75,-217593,-213589,21.208348531546193,50.603456417276625,60.58966126315621,NaN,NaN,50
1645543800,1.13322,1.13501,1.13307,1.13354,9016,5547,-208577,-213523.6,19.70153947530485,52.27702566275348,60.046036593433016,NaN,NaN,50
1645545600,1.13354,1.13458,1.13312,1.13412,6794,5782.95,-201783,-211315.4,18.302359637366457,55.23726252204298,59.39804936957713,NaN,NaN,50
1645547400,1.13412,1.13542,1.13406,1.13434,4830,5882.85,-196953,-207192.2,17.889002321568817,56.343447524641114,59.60161774604891,NaN,NaN,50
1645549200,1.13434,1.13434,1.13249,1.13295,3021,5789.15,-199974,-204976,17.324209053850094,48.233201636600754,58.581397762276474,NaN,NaN,50
1645551000,1.13295,1.1335,1.13288,1.13337,2720,5621.65,-197254,-200908.2,16.799758162396998,50.54942849441536,57.43180464096741,NaN,NaN,50
1645552800,1.13337,1.13382,1.13278,1.13286,2750,5304.05,-200004,-199193.6,15.95822083370173,47.75523581609212,56.066524817610706,NaN,NaN,50
1645554600,1.13286,1.1332,1.13253,1.13288,1807,5111.6,-198197,-198476.4,15.424982280139696,47.87691456042909,55.03396967712927,NaN,NaN,50
1645556400,1.13288,1.13331,1.13221,1.13284,3826,5061.2,-202023,-199490.4,15.243612592389852,47.63794661013834,53.77700801027443,NaN,NaN,50
1645558200,1.13284,1.13412,1.13266,1.13348,5025,5082.05,-196998,-198895.2,14.167450307776857,51.78465458975432,52.965952363240866,NaN,NaN,50
1645560000,1.13348,1.13412,1.13346,1.13398,2716,4948.75,-194282,-198300.8,13.168156757779078,54.796505738268195,52.52540988329635,NaN,NaN,50
1645561800,1.13398,1.13398,1.13236,1.13246,3272,4673.1,-197554,-197810.8,13.318006943230401,45.492921102524186,51.70409670699977,NaN,NaN,50
1645563600,1.13246,1.13294,1.13241,1.13266,700,4395.55,-196854,-197542.2,13.457153544006632,46.773471514976755,51.046665081450854,NaN,NaN,50
1645565400,1.13266,1.13285,1.13251,1.13264,567,4180.45,-197421,-196621.8,13.586361101870272,46.65543111774501,50.14406452197558,NaN,NaN,50
1645567200,1.13264,1.13284,1.13259,1.13275,204,3930.45,-197217,-196665.6,13.70633954845794,47.44107352373847,49.91818002958,NaN,NaN,50
1645569000,1.13275,1.13292,1.13262,1.13266,253,3715.15,-197470,-197303.2,13.695432330000697,46.83332459292045,49.52934423887764,NaN,NaN,50
1645570800,1.13266,1.13318,1.13262,1.13306,801,3500.95,-196669,-197126.2,13.284404541607211,49.904939497503946,49.14846402283914,NaN,NaN,50
1645572600,1.13306,1.1331,1.1327,1.1329,644,3337.15,-197313,-197218,12.902735880956115,48.69311563332253,48.60201174488781,NaN,NaN,50
1645574400,1.1329,1.13357,1.13285,1.13336,949,3147.35,-196364,-197006.6,12.137820786422514,52.280780221358334,48.89112450094193,NaN,NaN,50
1645576200,1.13336,1.13353,1.13323,1.13334,793,2861.3,-197157,-196994.6,11.427542484355598,52.110165895559604,49.0026057438808,NaN,NaN,50
1645578000,1.13334,1.13348,1.13312,1.1334,1468,2607.8,-195689,-196638.4,10.635993094044192,52.60981803172377,49.349361616425924,NaN,NaN,50
1645579800,1.1334,1.1336,1.13293,1.1335,1324,2223.2,-194365,-196177.6,10.215508835234512,53.48095932213384,49.749650527976264,NaN,NaN,50
1645581600,1.1335,1.1339,1.13278,1.13279,1214,1944.2,-195579,-195830.8,9.669479081233089,46.890334554599846,49.69624966686637,NaN,NaN,50
1645583400,1.13279,1.1328,1.13203,1.13224,1407,1773.05,-196986,-195955.2,9.955342202134043,42.5191330951869,49.034426702968695,NaN,NaN,50
1645585200,1.13224,1.13254,1.132,1.1325,851,1664.55,-196135,-195750.8,10.262564764743699,45.12348322402716,48.343496523380054,NaN,NaN,50
1645587000,1.1325,1.13266,1.13231,1.13258,749,1566,-195386,-195690.2,10.316408442578107,45.93517691358534,48.375086224170126,NaN,NaN,50
1645588800,1.13258,1.13264,1.1324,1.13248,510,1454,-195896,-195996.4,10.366406143424344,45.03840230177115,48.251152708941156,NaN,NaN,50
1645590600,1.13248,1.13257,1.13232,1.13256,614,1394.35,-195282,-195937,10.54920170767764,45.94753666313586,48.20058881932622,NaN,NaN,50
1645592400,1.13256,1.13304,1.13228,1.13232,1231,1264.6,-196513,-195842.4,9.836506358362183,43.61662039341416,47.92741359573163,NaN,NaN,50
1645594200,1.13232,1.13259,1.13219,1.13256,887,1057.7,-195626,-195740.6,9.265880984751105,46.53740262481079,47.906276312295226,NaN,NaN,50
1645596000,1.13256,1.13305,1.13254,1.13276,1134,978.6,-194492,-195561.8,9.32264415701963,48.91242026662514,47.83538208151816,NaN,NaN,50
1645597800,1.13276,1.13283,1.13222,1.13225,913,860.65,-195405,-195463.6,8.742194167420443,43.59415589468085,47.471170671615184,NaN,NaN,50
1645599600,1.13225,1.13254,1.1316,1.13232,3285,989.9,-192120,-194831.2,9.072245215609646,44.486357582264276,46.91442619739418,NaN,NaN,50
1645601400,1.13232,1.1343,1.13216,1.13399,4249,1174,-187871,-193102.8,9.943241322385179,60.52753652915198,47.5156669569365,NaN,NaN,50
1645603200,1.13399,1.13424,1.13339,1.13392,5002,1413.9,-192873,-192552.2,10.752023421533885,59.748195385068755,48.025551053604,NaN,NaN,50
1645605000,1.13392,1.13474,1.13378,1.13474,3605,1581.5,-189268,-191507.4,12.017295024285325,65.37280533106076,48.8749686256702,NaN,NaN,50
1645606800,1.13474,1.13493,1.13444,1.13448,3689,1725.9,-192957,-191017.8,13.376499670698738,62.395623484211754,49.98248926349963,NaN,NaN,50
1645608600,1.13448,1.13592,1.1338,1.13556,4446,1916,-188511,-190296,15.467718559229688,68.75998163666924,51.85683558789122,NaN,NaN,50
1645610400,1.13556,1.13584,1.13499,1.13548,3973,2067.2,-192484,-191218.6,17.409564670008425,67.84401703880818,53.47973086037558,NaN,NaN,50
1645612200,1.13548,1.13582,1.13504,1.13512,3531,2204.1,-196015,-191847,19.21270748716011,63.729840127627966,54.75077823280719,NaN,NaN,50
1645614000,1.13512,1.13531,1.13412,1.13424,3661,2313.75,-199676,-193928.6,19.221605123651248,54.95666788944275,55.45922577478374,NaN,NaN,50
1645615800,1.13424,1.13452,1.13401,1.13404,2981,2396.6,-202657,-195868.6,19.054168253340382,53.16534262718658,55.9747833436445,NaN,NaN,50
1645617600,1.13404,1.13462,1.13402,1.1343,2963,2484.05,-199694,-198105.2,19.01613414588718,55.20929148824373,56.80283127898947,NaN,NaN,50
1645619400,1.1343,1.1349,1.13371,1.13374,3436,2585.5,-203130,-200234.4,18.456395068957235,50.134282194286556,57.05975124823774,NaN,NaN,50
1645621200,1.13374,1.13471,1.13364,1.1347,3709,2728.4,-199421,-200915.6,17.818785512377435,57.368949893851116,57.66378907875388,NaN,NaN,50
1645623000,1.1347,1.13524,1.13446,1.13515,3832,2882.55,-195589,-200098.2,17.924262516929648,60.27813969817014,58.85550220757454,NaN,NaN,50
1645624800,1.13515,1.13518,1.13378,1.13407,4502,3082.15,-200091,-199585,16.916263831185702,51.24049492436914,59.33794058915346,NaN,NaN,50
1645626600,1.13407,1.13442,1.13298,1.13335,6867,3394.8,-206958,-201037.8,16.482797497115037,46.26080773457181,58.31888853239774,NaN,NaN,50
1645628400,1.13335,1.13378,1.13217,1.13246,6047,3635.6,-213005,-203012.8,16.93000424416796,40.961633408979885,56.97699124839139,NaN,NaN,50
1645630200,1.13246,1.13314,1.13207,1.13246,6431,3912.8,-213005,-205729.6,17.44145888821263,40.96163340897988,55.2333361110999,NaN,NaN,50
1645632000,1.13246,1.13263,1.13062,1.13197,6139,4163.05,-219144,-210440.6,19.07648520405163,38.16979509021049,53.50291979724266,NaN,NaN,50
1645633800,1.13197,1.13199,1.13103,1.13142,4119,4323.35,-223263,-215075,20.594723925902127,35.26442725147196,51.1103801983,NaN,NaN,50
1645635600,1.13142,1.13186,1.13126,1.1315,2897,4303.95,-220366,-217756.6,22.004517024763302,36.02718866286616,48.83774960001843,NaN,NaN,50
1645637400,1.1315,1.13174,1.13076,1.13124,2549,4218.95,-222915,-219738.6,23.67320884307665,34.600288829051536,46.757067364405835,NaN,NaN,50
1645639200,1.13124,1.13125,1.13045,1.13056,2629,4100.3,-225544,-222246.4,25.43082696502316,31.127865229389343,45.055010031544874,NaN,NaN,50
1645641000,1.13056,1.1311,1.13038,1.13092,2865,4063.3,-222679,-222953.4,27.11019799095006,34.8553022957303,43.74715000786942,NaN,NaN,50
1645642800,1.13092,1.13122,1.13066,1.13094,2986,4028.15,-219693,-222239.4,28.423965453040285,35.06556103006862,42.30831211799977,NaN,NaN,50
1645644600,1.13094,1.13104,1.13038,1.13076,2877,3949.7,-222570,-222680.2,29.857362469649523,34.00189500510061,41.15599874734363,NaN,NaN,50
1645646400,1.13076,1.13106,1.13045,1.13062,2183,3860.2,-224753,-223047.8,31.14381922523196,33.15939235965436,39.42674463775814,NaN,NaN,50
1645648200,1.13062,1.13067,1.13012,1.13054,2294,3798.35,-227047,-223348.4,32.59703072346604,32.66136961394092,37.454118203170346,NaN,NaN,50
1645650000,1.13054,1.13078,1.1303,1.13049,824,3656.5,-227871,-224386.8,33.68320560758763,32.33450080840662,36.10369005203017,NaN,NaN,50
1645651800,1.13049,1.13056,1.13028,1.13046,1093,3562.1,-228964,-226241,34.70947176699494,32.12675043311272,35.09411453049738,NaN,NaN,50
1645653600,1.13046,1.13111,1.13033,1.13058,493,3438.6,-228471,-227421.2,34.360484522456886,33.95469196845086,34.59361871331673,NaN,NaN,50
1645655400,1.13058,1.13063,1.1304,1.13042,701,3301.85,-229172,-228305,34.03642493824298,32.69051228891759,34.002824347598,NaN,NaN,50
1645657200,1.13042,1.1305,1.13002,1.13032,1154,3174.1,-230326,-228960.8,34.18560732758274,31.891329117272477,33.554362492388144,NaN,NaN,50
1645659000,1.13032,1.13088,1.1303,1.13056,589,3011.95,-229737,-229334,33.46680390200253,35.93907933661778,33.60255192704142,NaN,NaN,50
1645660800,1.13056,1.13062,1.12917,1.12921,1840,2878.85,-231577,-229856.6,33.992755419444364,26.42553577308108,32.916719577771055,NaN,NaN,50
1645662600,1.12921,1.12944,1.12752,1.12762,2887,2679.85,-234464,-231055.2,35.56816605960932,19.783210088631364,31.858356810598185,NaN,NaN,50
1645664400,1.12762,1.12874,1.12762,1.1284,3789,2566.95,-230675,-231355.8,37.03104736833392,29.186782134514218,31.719708018107106,NaN,NaN,50
1645666200,1.1284,1.12944,1.12819,1.12932,4299,2460.35,-226376,-230565.8,37.137352925230935,38.36453138631756,31.97036723886334,NaN,NaN,50
1645668000,1.12932,1.1294,1.12816,1.12822,3321,2319.45,-229697,-230557.8,37.25871556466395,32.87779513200498,31.814098246144514,NaN,NaN,50
1645669800,1.12822,1.12854,1.12649,1.12733,7007,2463.85,-236704,-231583.2,38.403224131999075,29.234742360721114,31.473587342974547,NaN,NaN,50
1645671600,1.12733,1.1279,1.12561,1.12585,9578,2797.9,-246282,-233946.8,39.860369160117806,24.394090958122405,30.84749438572226,NaN,NaN,50
1645673400,1.12585,1.12604,1.1235,1.12382,9798,3160.35,-256080,-239027.8,41.90147515070648,19.600236408939963,29.914556299650762,NaN,NaN,50
1645675200,1.12382,1.1243,1.12085,1.12224,10226,3540.2,-266306,-247013.8,44.3384852444605,16.828283947829547,28.806969381038112,NaN,NaN,50
1645677000,1.12224,1.1249,1.12181,1.12454,8663,3830.1,-257643,-252603,45.9056168320018,31.92173013659348,28.792325074143886,NaN,NaN,50
1645678800,1.12454,1.12461,1.12271,1.12357,7221,4041.85,-264864,-258235,47.36081044900443,29.4910305911082,28.47349211861941,NaN,NaN,50
1645680600,1.12357,1.12392,1.12208,1.1238,6398,4217.9,-258466,-260671.8,48.864141205459724,30.83585825823451,28.341016830713475,NaN,NaN,50
1645682400,1.1238,1.12536,1.12378,1.12498,5480,4382.75,-252986,-260053,48.64204421213131,37.42957419614082,28.73660576491836,NaN,NaN,50
1645684200,1.12498,1.125,1.12323,1.12454,5261,4531.1,-258247,-258441.2,48.638948196335555,36.04949570402491,28.74449264830458,NaN,NaN,50
1645686000,1.12454,1.12557,1.12362,1.1237,10765,5028.15,-269012,-260715,48.04933689352245,33.50930884863716,29.25047643941573,NaN,NaN,50
1645687800,1.1237,1.12544,1.12353,1.12454,11241,5535.55,-257771,-259296.4,47.54149379378026,38.19902422960188,30.565891735199337,NaN,NaN,50
1645689600,1.12454,1.12624,1.1243,1.12533,14117,6216.75,-243654,-256334,46.245980339900065,42.319498043913434,31.503942871584997,NaN,NaN,50
1645691400,1.12533,1.12534,1.12332,1.12397,10770,6720.2,-254424,-256621.6,45.534403651047064,37.66391776604309,31.453899041565393,NaN,NaN,50
1645693200,1.12397,1.12506,1.12388,1.1243,9667,7145.85,-244757,-253923.6,44.87365386854071,39.40582063683484,31.920186577624666,NaN,NaN,50
1645695000,1.1243,1.12454,1.1209,1.12114,11174,7675.1,-255931,-251307.4,45.42415235261457,30.590646235383602,32.01703685438627,NaN,NaN,50
1645696800,1.12114,1.12124,1.11806,1.11854,12584,8212.3,-268515,-253456.2,46.639588688159634,25.530133062120754,32.09818271895758,NaN,NaN,50
1645698600,1.11854,1.11857,1.11634,1.11782,9813,8558.6,-278328,-260391,48.08858708538109,24.329835530439553,32.43601122763612,NaN,NaN,50
1645700400,1.11782,1.11809,1.11552,1.11601,11448,8941.55,-289776,-267461.4,49.570563133646154,21.582743293007056,32.77561546657738,NaN,NaN,50
1645702200,1.11601,1.118,1.11556,1.11742,11079,9280.55,-278697,-274249.4,50.94668374989227,28.368001195915028,32.52177768510034,NaN,NaN,50
1645704000,1.11742,1.11822,1.11614,1.11814,10471,9638.05,-268226,-276708.4,52.011561120027416,31.621655181949507,32.67396515587472,NaN,NaN,50
1645705800,1.11814,1.1185,1.11652,1.11704,10039,9789.65,-278265,-278658.4,52.720430976224584,29.42281629961292,32.57303358740175,NaN,NaN,50
1645707600,1.11704,1.11778,1.11614,1.1166,9976,9809.55,-288241,-280641,53.46943379280995,28.567119446520294,31.940001105286,NaN,NaN,50
1645709400,1.1166,1.11803,1.11528,1.1162,10740,9856.65,-298981,-282482,54.36268213362606,27.77625618428209,31.349055425304368,NaN,NaN,50
1645711200,1.1162,1.11716,1.11464,1.11528,11916,9941.15,-310897,-288922,55.33034726616791,25.993806219699337,30.81223380895167,NaN,NaN,50
1645713000,1.11528,1.11626,1.11442,1.1147,13504,10183.2,-324401,-300157,56.276156429667026,24.908586752904768,29.86291684633045,NaN,NaN,50
1645714800,1.1147,1.11505,1.11306,1.11322,12295,10436.9,-336696,-311843.2,57.42537030931661,22.345008239367857,28.43616757457719,NaN,NaN,50
1645716600,1.11322,1.11358,1.1108,1.11098,10027,10618.35,-346723,-323539.6,58.84313856351711,19.13505797070603,27.112677589195975,NaN,NaN,50
1645718400,1.11098,1.11572,1.11064,1.11444,16751,11181.9,-329972,-329737.8,58.21768673888153,34.731750589731405,26.778815442974302,NaN,NaN,50
1645720200,1.11444,1.11546,1.1136,1.11502,8725,11355.1,-321247,-331807.8,57.63691004457707,36.92782288879489,27.231470918217962,NaN,NaN,50
1645722000,1.11502,1.11734,1.11409,1.11701,7487,11191.2,-313760,-329679.6,55.64886159157035,43.90212628419502,28.54375614836613,NaN,NaN,50
1645723800,1.11701,1.11789,1.11626,1.11668,7494,11003.85,-321254,-326591.2,53.42417956775118,43.05196458585243,29.88105108089562,NaN,NaN,50
1645725600,1.11668,1.1172,1.116,1.11685,5693,10582.65,-315561,-320358.8,51.468233406866545,43.65726858397181,31.457802887393104,NaN,NaN,50
1645727400,1.11685,1.12068,1.1166,1.1191,9350,10511.65,-306211,-315606.6,47.975038342696244,51.0701486330887,33.079384847191214,NaN,NaN,50
1645729200,1.1191,1.12005,1.11842,1.11868,11841,10620.35,-318052,-314967.6,44.731357211680965,49.75422555974914,34.374568445605476,NaN,NaN,50
1645731000,1.11868,1.12126,1.1185,1.11876,10711,10597.2,-307341,-313683.8,42.30289434218397,50.018404912561756,35.84568191795896,NaN,NaN,50
1645732800,1.11876,1.12214,1.11844,1.12099,7101,10323.05,-300240,-309481,40.440801215702976,56.83178989154911,37.86458694974674,NaN,NaN,50
1645734600,1.12099,1.12162,1.1199,1.1199,7345,10199.65,-307585,-307885.8,38.71171474111348,53.02679143796879,39.66819661072436,NaN,NaN,50
1645736400,1.1199,1.1205,1.11937,1.11955,1432,9698.85,-309017,-308447,36.76353080170989,51.826892821510924,41.513417082282324,NaN,NaN,50
1645738200,1.11955,1.11974,1.11912,1.11938,873,9188.55,-309890,-306814.6,34.79107374267657,51.22063173420826,43.39284886666115,NaN,NaN,50
1645740000,1.11938,1.12012,1.11918,1.11981,148,8672.4,-309742,-307294.8,33.170515259056764,52.7269688914279,45.56298891323687,NaN,NaN,50
1645741800,1.11981,1.12033,1.1197,1.11972,1389,8239.9,-311131,-309473,31.78490115738389,52.36249611430804,47.93637735206558,NaN,NaN,50
1645743600,1.11972,1.12005,1.11946,1.11955,886,7785.4,-312017,-310359.4,30.312714698935455,51.6364243524802,49.14385404940479,NaN,NaN,50
1645745400,1.11955,1.11956,1.11897,1.11905,879,7292.35,-312896,-311135.2,28.566094028330852,49.46395427290657,50.039292005412754,NaN,NaN,50
1645747200,1.11905,1.12052,1.11863,1.1205,1954,6794.25,-310942,-311345.6,27.560279926344826,55.332995404977375,50.85578265689721,NaN,NaN,50
1645749000,1.1205,1.12096,1.11953,1.12016,2922,6265.15,-313864,-312170,26.890576436867015,53.756500811043104,51.62039238726798,NaN,NaN,50
1645750800,1.12016,1.12058,1.11896,1.11968,6489,5974.85,-320353,-314014.4,25.78818681169987,51.52462439518645,52.18234637378331,NaN,NaN,50
1645752600,1.11968,1.12039,1.11929,1.12038,5470,5747,-314883,-314587.6,24.764539302616093,54.49197347791282,52.42676243412789,NaN,NaN,50
1645754400,1.12038,1.121,1.11988,1.1209,2726,5045.75,-312157,-314439.8,24.231343694397257,56.61649941009616,52.916924852009814,NaN,NaN,50
1645756200,1.1209,1.12141,1.12022,1.12136,2732,4746.1,-309425,-314136.4,24.005518581040562,58.46380976750256,53.520168055934164,NaN,NaN,50
1645758000,1.12136,1.12136,1.12054,1.12087,2382,4490.85,-311807,-313725,23.79582383292363,55.74102593787354,53.442256344957336,NaN,NaN,50
1645759800,1.12087,1.12181,1.12064,1.12175,2868,4259.55,-308939,-311442.2,23.910314899294782,59.398176687884884,53.89735529137992,NaN,NaN,50
1645761600,1.12175,1.12269,1.1216,1.12268,1967,4073.25,-306972,-309860,24.568372259270934,62.888274709218564,54.687453997644745,NaN,NaN,50
1645763400,1.12268,1.12288,1.12168,1.12216,2757,3743.6,-309729,-309374.4,25.291728443651678,59.7933502457577,55.29979103418399,NaN,NaN,50
1645765200,1.12216,1.12235,1.12143,1.1216,2095,3256.3,-311824,-309854.2,25.65324128459142,56.56488125084057,55.57392763128489,NaN,NaN,50
1645767000,1.1216,1.12258,1.12155,1.12256,1472,2794.35,-310352,-309563.2,26.14291544662482,60.50206770779849,56.15532560224849,NaN,NaN,50
1645768800,1.12256,1.12256,1.12152,1.12191,1686,2523.6,-312038,-310183,26.556638734879318,56.75107784357103,56.52065799446927,NaN,NaN,50
1645770600,1.12191,1.12192,1.1201,1.12021,2949,2303.8,-314987,-311786,25.237166228490597,48.3143826974629,56.43854573908043,NaN,NaN,50
1645772400,1.12021,1.12136,1.1197,1.12102,5299,2497.15,-309688,-311777.8,23.610567353796256,51.97760158384162,56.19887475185645,NaN,NaN,50
1645774200,1.12102,1.12223,1.1206,1.121,6658,2786.4,-316346,-312682.2,22.85644279061265,51.87982804147739,56.064826696887465,NaN,NaN,50
1645776000,1.121,1.12154,1.11764,1.1179,10249,3291.45,-326595,-315930.8,22.589415028217783,39.4825424336243,55.20467798534731,NaN,NaN,50
1645777800,1.1179,1.11858,1.11702,1.11777,8664,3655.2,-335259,-320575,22.68993486322656,39.06100338062451,54.102465835541004,NaN,NaN,50
1645779600,1.11777,1.11884,1.11717,1.11756,7352,3978.5,-342611,-326099.8,22.54840696649419,38.34873386042895,52.797625439136205,NaN,NaN,50
1645781400,1.11756,1.11846,1.11693,1.11816,6356,4252.35,-336255,-331413.2,22.56245439022004,41.62403814712424,51.594784609109176,NaN,NaN,50
1645783200,1.11816,1.11834,1.1171,1.11744,5350,4422.15,-341605,-336465,22.5754984265369,38.94991100220896,50.3954192565617,NaN,NaN,50
1645785000,1.11744,1.11804,1.1166,1.11803,5283,4540.2,-336322,-338410.4,22.910045687297313,42.22542028855879,49.16879379946698,NaN,NaN,50
1645786800,1.11803,1.1184,1.11682,1.11764,4613,4446.4,-340935,-339545.6,22.826712832447974,40.67201251228294,47.581917928257305,NaN,NaN,50
1645788600,1.11764,1.11872,1.11742,1.11852,5346,4440.2,-335589,-338141.2,22.402905438611192,45.54043655002682,46.563852664276524,NaN,NaN,50
1645790400,1.11852,1.12188,1.11838,1.12078,6835,4645.65,-328754,-336641,22.080715562084965,55.61403997366312,46.495935430192425,NaN,NaN,50
1645792200,1.12078,1.12367,1.12027,1.12214,11627,5090.4,-317127,-331745.4,22.682633630225073,60.365227931276564,46.48616116044086,NaN,NaN,50
1645794000,1.12214,1.12295,1.1212,1.12288,11431,5542.85,-305696,-325620.2,23.24155755064088,62.704549606091675,46.911409143478046,NaN,NaN,50
1645795800,1.12288,1.12416,1.1216,1.12368,9238,5861.35,-296458,-316724.8,24.294178059520284,65.10255503212325,48.1105643102395,NaN,NaN,50
1645797600,1.12368,1.12386,1.12186,1.12222,8011,6163.55,-304469,-310500.8,25.271611389194014,57.798583789129175,48.52634875347433,NaN,NaN,50
1645799400,1.12222,1.12497,1.12222,1.12326,11425,6596.95,-293044,-303358.8,26.63391680685438,61.142823703187155,49.18799130073931,NaN,NaN,50
1645801200,1.12326,1.12496,1.12319,1.12424,12253,7104.85,-280791,-296091.6,27.89891469468186,64.03501924622717,50.94173964449666,NaN,NaN,50
1645803000,1.12424,1.1251,1.12338,1.12442,9031,7482.8,-271760,-289304.4,29.13235673419307,64.55683836002103,52.76287071445355,NaN,NaN,50
1645804800,1.12442,1.1267,1.12388,1.1258,7444,7770.7,-264316,-282876,30.88088960753697,68.34846988188232,54.90570900170023,NaN,NaN,50
1645806600,1.1258,1.12649,1.12431,1.12592,6210,7933.75,-258106,-273603.4,32.50452727564202,68.66240949163311,56.83702124059372,NaN,NaN,50
1645808400,1.12592,1.12619,1.12466,1.12487,4096,7873.6,-262202,-267435,34.01219082459671,62.793482460636056,58.540133487624225,NaN,NaN,50
1645810200,1.12487,1.12488,1.1235,1.12409,3879,7734.65,-266081,-264493,34.069290937553816,58.7744784347383,59.722209069494184,NaN,NaN,50
1645812000,1.12409,1.12526,1.12408,1.1252,3048,7374.6,-263033,-262747.6,34.31503531260912,62.45700468019647,61.27827993863087,NaN,NaN,50
1645813800,1.1252,1.12606,1.12519,1.1257,2891,7085.95,-260142,-261912.8,34.92615100295692,64.01626160539325,62.59798172829989,NaN,NaN,50
1645815600,1.1257,1.12608,1.12523,1.12597,2642,6850.45,-257500,-261791.6,35.50301892299058,64.8648727601066,63.258755498760145,NaN,NaN,50
1645817400,1.12597,1.1266,1.12498,1.12634,3138,6689.55,-254362,-260223.6,36.28544723194815,66.04657665540235,63.66456612191199,NaN,NaN,50
1645819200,1.12634,1.12687,1.12582,1.12612,3299,6587,-257661,-258539.6,37.13735938144843,64.65415987204435,63.80382399805147,NaN,NaN,50
1645821000,1.12612,1.12714,1.1261,1.12658,3513,6498.5,-254148,-256762.6,38.05455726302248,66.25605692109133,63.88621699012061,NaN,NaN,50
1645822800,1.12658,1.1273,1.12648,1.1273,1178,6326.75,-252970,-255328.2,38.9823376054734,68.65091873054888,64.66138377165059,NaN,NaN,50
1645824600,1.1273,1.12744,1.12692,1.12712,1139,6116.4,-254109,-254650,39.912646428508545,67.36374972293362,65.10573563020391,NaN,NaN,50
1645999200,1.12712,1.12712,1.11474,1.11508,2019,5875.6,-256128,-255003.2,40.385957527917206,28.65806520864902,62.57881034180547,NaN,NaN,50
1646001000,1.11508,1.1159,1.11461,1.1152,5599,5574.2,-250529,-253576.8,40.85370561722438,29.095348284669072,60.045846764994614,NaN,NaN,50
1646002800,1.1152,1.11742,1.115,1.11668,9509,5478.1,-241020,-250951.2,40.39383672604557,34.433204798901485,57.62332783049599,NaN,NaN,50
1646004600,1.11668,1.11882,1.11647,1.11804,7471,5389.75,-233549,-247067,39.21864783351815,38.97922891185355,55.50310064622602,NaN,NaN,50
1646006400,1.11804,1.11937,1.11778,1.11834,5934,5285.9,-227615,-241768.2,37.844849569272284,39.968004169255984,53.87270933969887,NaN,NaN,50
1646008200,1.11834,1.11946,1.118,1.1182,4325,4930.9,-231940,-236930.6,36.52124624330383,39.64515366513819,52.50632899901314,NaN,NaN,50
1646010000,1.1182,1.11862,1.11677,1.11682,7485,4692.5,-239425,-234709.8,35.73051446197611,36.51413432762259,50.65326683097216,NaN,NaN,50
1646011800,1.11682,1.11768,1.11594,1.11712,6182,4550.05,-233243,-233154.4,35.275157756714286,37.66663990121296,48.77115099495928,NaN,NaN,50
1646013600,1.11712,1.1174,1.11621,1.11664,4107,4383.2,-237350,-233914.6,34.85232653039974,36.524154075539435,46.746813946061614,NaN,NaN,50
1646015400,1.11664,1.11688,1.11461,1.11576,5170,4331.2,-242520,-236895.6,34.98862636520008,34.460478777728696,44.490664097656364,NaN,NaN,50
1646017200,1.11576,1.11596,1.11493,1.11504,3708,4311.8,-246228,-239753.2,35.11519049751469,32.8262352102828,42.21724090753054,NaN,NaN,50
1646019000,1.11504,1.1161,1.11504,1.1151,3157,4275.7,-243071,-240482.4,35.12989804256452,33.11091338991237,39.849730655303475,NaN,NaN,50
1646020800,1.1151,1.11532,1.11446,1.11481,2371,4241.85,-245442,-242922.2,35.350769014284076,32.39628360366876,37.26011386052632,NaN,NaN,50
1646022600,1.11481,1.11494,1.11422,1.1146,2612,4227.9,-248054,-245063,35.64233295331469,31.860039848645513,34.724134583791454,NaN,NaN,50
1646024400,1.1146,1.11518,1.1146,1.11486,2128,4202.2,-245926,-245744.2,35.70724061448182,33.33142697354333,35.05794613842676,NaN,NaN,50
1646026200,1.11486,1.11587,1.11447,1.11566,2408,4165.7,-243518,-245202.2,35.18093403744303,37.78321009388467,35.67850769622787,NaN,NaN,50
1646028000,1.11566,1.11682,1.11548,1.11652,3566,4179.05,-239952,-244578.4,33.94171713623722,42.24773269060284,36.236688259920825,NaN,NaN,50
1646029800,1.11652,1.11674,1.11568,1.11588,4165,4211.65,-244117,-244313.4,32.79101572797469,39.95024557245686,36.30604659282106,NaN,NaN,50
1646031600,1.11588,1.11874,1.11557,1.11808,9863,4645.9,-234254,-241553.4,30.577230041837606,50.01333305174479,37.02357008442741,NaN,NaN,50
1646033400,1.11808,1.12001,1.118,1.11898,10900,5133.95,-223354,-237039,29.238954312102255,53.450049841875,38.00963409705146,NaN,NaN,50
1646035200,1.11898,1.11967,1.1165,1.1175,10665,5566.25,-234019,-235139.2,27.22423418928584,47.648515955062955,38.80494707044006,NaN,NaN,50
1646037000,1.1175,1.11844,1.1164,1.1179,7889,5680.75,-226130,-232374.8,25.411365664978437,49.251756520608254,39.632455400396864,NaN,NaN,50
1646038800,1.1179,1.11844,1.1165,1.11654,7354,5573,-233484,-230248.2,23.727987749550135,44.28585266707624,40.18686244264949,NaN,NaN,50
1646040600,1.11654,1.11854,1.11652,1.11781,7634,5581.15,-225850,-228567.4,22.09634863492093,49.41502851292451,41.255044566592055,NaN,NaN,50
1646042400,1.11781,1.11914,1.11779,1.11912,5656,5567.25,-220194,-227935.4,20.868135459441124,54.10822967546236,42.77518702839059,NaN,NaN,50
1646044200,1.11912,1.12322,1.11799,1.123,9476,5824.8,-210718,-223275.2,21.736863624684002,64.58784106264054,45.02353900501403,NaN,NaN,50
1646046000,1.123,1.123,1.12066,1.12106,8847,5892.9,-219565,-221962.2,22.543539778123815,57.51569203062061,46.81778246408202,NaN,NaN,50
1646047800,1.12106,1.12114,1.11892,1.11991,5998,5883.7,-225563,-220378,22.079869105017625,53.75797291488831,48.38192054024222,NaN,NaN,50
1646049600,1.11991,1.1206,1.11914,1.12048,5744,5965.55,-219819,-219171.8,21.649317765704733,55.31626592188798,49.9522661794097,NaN,NaN,50
1646051400,1.12048,1.12082,1.11928,1.1193,7338,6073.95,-227157,-220564.4,21.35967712156732,51.45084655817485,50.928525926858995,NaN,NaN,50
1646053200,1.1193,1.12002,1.11792,1.1182,7712,6274.15,-234869,-225394.6,20.175389238058088,48.07808031868837,51.34497932886511,NaN,NaN,50
1646055000,1.1182,1.12168,1.1182,1.12124,9786,6605.6,-225083,-226498.2,19.92788800822144,56.554363593067706,52.530987758908736,NaN,NaN,50
1646056800,1.12124,1.12158,1.12048,1.12128,6339,6804,-218744,-225134.4,19.698065437658844,56.6546330116386,53.00536632747258,NaN,NaN,50
1646058600,1.12128,1.12298,1.121,1.12221,8835,7115.15,-209909,-223152.4,20.134163226100927,59.02259345064565,53.40340515667049,NaN,NaN,50
1646060400,1.12221,1.12366,1.12135,1.12152,9787,7498.1,-219696,-221660.2,20.825411520229814,56.55401994055191,54.03951258420541,NaN,NaN,50
1646062200,1.12152,1.12358,1.12008,1.12318,12875,8021.45,-206821,-216050.6,20.55855427380141,60.80158432452598,54.864500284485246,NaN,NaN,50
1646064000,1.12318,1.12468,1.12173,1.12446,11747,8430.5,-195074,-210048.8,20.806796089645747,63.74495767534443,56.25443635650441,NaN,NaN,50
1646065800,1.12446,1.12448,1.12168,1.12244,8644,8654.45,-203718,-207043.6,21.00112953270782,56.530764293018834,56.76270319793972,NaN,NaN,50
1646067600,1.12244,1.12285,1.12074,1.12089,5881,8455.35,-209599,-206981.6,20.507831992806754,51.69611616229874,56.59040937557089,NaN,NaN,50
1646069400,1.12089,1.12093,1.11974,1.12051,4686,8144.65,-214285,-205899.4,19.394173864137507,50.554612313203236,55.58803589346822,NaN,NaN,50
1646071200,1.12051,1.1211,1.12036,1.12077,3486,7785.7,-210799,-206695,18.45863590070035,51.34622086585457,55.147359381699225,NaN,NaN,50
1646073000,1.12077,1.1216,1.12076,1.12151,2607,7521.6,-208192,-209318.6,17.884089886940263,53.622048210292995,55.13765047422813,NaN,NaN,50
1646074800,1.12151,1.12152,1.12036,1.12068,4035,7355.65,-212227,-211020.4,17.062841927124968,50.75438991908638,54.81180218831373,NaN,NaN,50
1646076600,1.12068,1.12236,1.12048,1.12224,3431,7145.5,-208796,-210859.8,16.80991822241565,55.56440252272128,55.10562761435276,NaN,NaN,50
1646078400,1.12224,1.12232,1.12092,1.12133,4070,7066.2,-212866,-210576,16.57506049661414,52.35211506658185,55.41091581063086,NaN,NaN,50
1646080200,1.12133,1.1216,1.12099,1.12104,3386,6761.7,-216252,-211666.6,16.35697832265559,51.33361539247117,55.03800522487397,NaN,NaN,50
1646082000,1.12104,1.12165,1.121,1.12162,1080,6373.35,-215172,-213062.6,16.18927852479685,53.29085181283167,54.7977351392449,NaN,NaN,50
1646083800,1.12162,1.122,1.12162,1.12194,597,6103.3,-214575,-213532.2,16.28382516419702,54.38095365823619,54.46618943978708,NaN,NaN,50
1646085600,1.12194,1.12209,1.12179,1.12208,150,5823.6,-214425,-214658,16.43735778620205,54.87711703860919,54.346410661076895,NaN,NaN,50
1646087400,1.12208,1.12212,1.12191,1.12202,417,5477.55,-214842,-215053.2,16.603166125775385,54.60302080146596,53.903656123715464,NaN,NaN,50
1646089200,1.12202,1.12203,1.12151,1.12183,869,5135.4,-215711,-214945,16.29754726658008,53.68852794741599,53.185339714577715,NaN,NaN,50
1646091000,1.12183,1.12196,1.12143,1.12144,410,4666.6,-216121,-215134.8,15.921213964943377,51.771833513232274,52.84541608745011,NaN,NaN,50
1646092800,1.12144,1.12147,1.12072,1.12118,1172,4408.25,-217293,-215678.4,14.784270112462858,50.478033250670826,52.75841016519097,NaN,NaN,50
1646094600,1.12118,1.12145,1.12054,1.12058,2025,4067.75,-219318,-216657,13.916507477615742,47.526343691153166,52.542105263615966,NaN,NaN,50
1646096400,1.12058,1.12086,1.1203,1.12086,1432,3650,-217886,-217265.8,13.364684539700722,49.02437964816243,52.37625946235223,NaN,NaN,50
1646098200,1.12086,1.12108,1.12018,1.1202,2354,3123.95,-220240,-218171.6,12.588363064280959,45.711704038721194,51.811234878668536,NaN,NaN,50
1646100000,1.1202,1.12056,1.1193,1.11972,2367,2654.95,-222607,-219468.8,12.7752900483554,43.41407786805099,51.28692687502315,NaN,NaN,50
1646101800,1.11972,1.11991,1.11952,1.11964,1885,2317,-224492,-220908.6,12.948865104995955,43.02591365543098,50.391320527359554,NaN,NaN,50
1646103600,1.11964,1.12012,1.11942,1.11998,2247,2135.3,-222245,-221494,12.823522113959566,45.26575698165592,49.88515209272198,NaN,NaN,50
1646105400,1.11998,1.12006,1.11922,1.11922,1982,2000.1,-224227,-222762.2,12.925848290068725,41.352310405672554,49.172201736522084,NaN,NaN,50
1646107200,1.11922,1.11978,1.11908,1.11966,1406,1896.1,-222821,-223278.4,13.176025727561274,44.35191239904749,48.53370606410893,NaN,NaN,50
1646109000,1.11966,1.11998,1.1195,1.11965,1519,1841.7,-224340,-223625,13.096360173703502,44.29646083997583,47.81338514851891,NaN,NaN,50
1646110800,1.11965,1.12032,1.11956,1.12001,1729,1726.4,-222611,-223248.8,12.507987921996952,46.871682730088324,47.24156841219599,NaN,NaN,50
1646112600,1.12001,1.12012,1.11936,1.11962,1527,1631.2,-224138,-223627.4,12.22748077696247,44.472988083658095,46.517994646638286,NaN,NaN,50
1646114400,1.11962,1.12002,1.11946,1.11985,1930,1524.2,-222208,-223223.6,11.967009856573307,46.22092463452796,45.984594410003425,NaN,NaN,50
1646116200,1.11985,1.12078,1.11967,1.1206,2182,1464,-220026,-222664.6,11.63976852010254,51.574163282085195,45.970475107778626,NaN,NaN,50
1646118000,1.1206,1.1224,1.12052,1.12198,4780,1649,-215246,-220845.8,13.005384740494321,59.552271411195946,46.61863497638757,NaN,NaN,50
1646119800,1.12198,1.123,1.12148,1.12298,5596,1898.95,-209650,-218253.6,14.725769795164942,64.16008924499582,47.8067596588049,NaN,NaN,50
1646121600,1.12298,1.12332,1.12118,1.1213,7358,2259.35,-217008,-216827.6,16.547522173901058,53.19596768757085,48.104730233048365,NaN,NaN,50
1646123400,1.1213,1.1227,1.12117,1.12267,6228,2549.9,-210780,-214542,18.222354780539703,59.30345278032397,49.07556942887713,NaN,NaN,50
1646125200,1.12267,1.12298,1.12204,1.12226,6291,2821,-217071,-213951,19.983826575977375,56.910048445041646,50.03956732723361,NaN,NaN,50
1646127000,1.12226,1.12226,1.119,1.11963,10163,3308.65,-227234,-216348.6,19.168318980907646,44.502698873992145,50.14505198570226,NaN,NaN,50
1646128800,1.11963,1.11988,1.11722,1.11724,8623,3681.2,-235857,-221590,19.619557757003133,36.677184568124765,49.53158252759289,NaN,NaN,50
1646130600,1.11724,1.11866,1.11663,1.11816,9111,4035.5,-226746,-223537.6,20.368341182140213,40.97951649004948,49.50495439076268,NaN,NaN,50
1646132400,1.11816,1.11826,1.11731,1.11814,8233,4375.55,-234979,-228377.4,21.063640076910357,40.914436553138884,49.259420401769205,NaN,NaN,50
1646134200,1.11814,1.11863,1.11738,1.11759,6852,4600.45,-241831,-233329.4,21.308554549389317,39.07656946560352,48.88657101788546,NaN,NaN,50
1646136000,1.11759,1.11808,1.1169,1.11768,5587,4761.45,-236244,-235131.4,21.842428684836094,39.55504757039919,48.36395422076482,NaN,NaN,50
1646137800,1.11768,1.11774,1.11562,1.11602,6446,4989.5,-242690,-236498,23.051789339021887,34.21713321145708,47.63139315846474,NaN,NaN,50
1646139600,1.11602,1.11702,1.11405,1.11501,8988,5326.55,-251678,-241484.4,24.858468580881933,31.437334344151594,46.57542242343785,NaN,NaN,50
1646141400,1.11501,1.11688,1.115,1.11604,8334,5644.15,-243344,-243157.4,26.536099305466266,37.053523330844925,45.53823385549212,NaN,NaN,50
1646143200,1.11604,1.11621,1.11432,1.11518,8526,6000.15,-251870,-245165.2,28.362547091877033,34.51158595639558,43.749613465863526,NaN,NaN,50
1646145000,1.11518,1.11604,1.11427,1.11514,10595,6453.95,-262465,-250409.4,30.078145344291908,34.393402495983906,41.62342155521982,NaN,NaN,50
1646146800,1.11514,1.11515,1.11282,1.11392,12477,6991.35,-274942,-256859.8,32.18768875594803,30.915966572384022,40.03199290413505,NaN,NaN,50
1646148600,1.11392,1.1145,1.11318,1.11402,10469,7438.45,-264473,-259418.8,34.146550495343,31.527088185637638,38.04796686165746,NaN,NaN,50
1646150400,1.11402,1.11444,1.11078,1.1116,8770,7780.45,-273243,-265398.6,36.616606885795214,25.620489877958846,35.81299839258011,NaN,NaN,50
1646152200,1.1116,1.11168,1.1099,1.11032,10268,8184.75,-283511,-271726.8,39.09301794202996,23.149995997823112,34.28780532999661,NaN,NaN,50
1646154000,1.11032,1.11084,1.10896,1.1103,7404,8315.95,-290915,-277416.8,41.568995610781926,23.112494563001178,33.31889890105921,NaN,NaN,50
1646155800,1.1103,1.11264,1.11024,1.11092,7019,8387.1,-283896,-279207.6,41.997947136660834,27.057296449937837,32.32445461247981,NaN,NaN,50
1646157600,1.11092,1.11132,1.10986,1.11008,5705,8304.45,-289601,-284233.2,42.520296077224025,25.172889182836485,31.200058371743925,NaN,NaN,50
1646159400,1.11008,1.11262,1.11,1.11226,7573,8371.7,-282028,-285990.2,41.845391957058744,37.36477538904218,31.077787366275256,NaN,NaN,50
1646161200,1.11226,1.11242,1.11132,1.11218,4910,8302.65,-286938,-286675.6,41.21869527404813,37.1257164740124,30.904263716533343,NaN,NaN,50
1646163000,1.11218,1.11351,1.11187,1.11222,5118,8050.4,-281820,-284856.6,39.72764129887453,37.34157872633714,31.127438396167634,NaN,NaN,50
1646164800,1.11222,1.11328,1.11166,1.1121,4056,7822.05,-285876,-285252.6,38.45380418972971,36.93193001121785,31.519909515243793,NaN,NaN,50
1646166600,1.1121,1.11331,1.11168,1.11304,3635,7548.25,-282241,-283780.6,37.24496879135025,42.27413627963298,31.89281044015723,NaN,NaN,50
1646168400,1.11304,1.11381,1.11259,1.11272,1378,7205.5,-283619,-284098.8,35.681089452849726,41.00089344653107,32.356332403738335,NaN,NaN,50
1646170200,1.11272,1.11304,1.11229,1.11231,925,6909.15,-284544,-283620,34.42125067876708,39.364962742088686,32.711443849888674,NaN,NaN,50
1646172000,1.11231,1.11288,1.11231,1.11263,276,6643.6,-284268,-284109.6,33.25140038854747,41.33248687217055,33.45548101415914,NaN,NaN,50
1646173800,1.11263,1.11295,1.11172,1.11198,943,6368.45,-285211,-283976.6,32.56111484780795,38.593095436355185,33.96019581778182,NaN,NaN,50
1646175600,1.11198,1.11275,1.11178,1.11273,1068,5972.45,-284143,-284357,31.920135417121255,43.26551928036542,35.22055506081087,NaN,NaN,50
1646177400,1.11273,1.11344,1.11272,1.11324,1051,5608.3,-283092,-284251.6,30.58306220909629,46.25996579527591,36.87126718920035,NaN,NaN,50
1646179200,1.11324,1.11337,1.11218,1.11286,2006,5282.3,-285098,-284362.4,29.751586321866686,44.38039477167592,38.39040291839141,NaN,NaN,50
1646181000,1.11286,1.11292,1.11236,1.11265,1367,4820.9,-286465,-284801.8,28.979501569439194,43.33257093965604,39.55292252479985,NaN,NaN,50
1646182800,1.11265,1.11314,1.11228,1.11302,1666,4280.35,-284799,-284719.4,28.005089623794277,45.762340911786644,41.02359764829629,NaN,NaN,50
1646184600,1.11302,1.11356,1.11248,1.11283,1932,3853.5,-286731,-285237,26.617072063682496,44.70235852554007,41.54771072947471,NaN,NaN,50
1646186400,1.11283,1.11319,1.11114,1.11171,1952,3512.6,-288683,-286355.2,26.423525657446252,38.97188012818239,41.679579561915425,NaN,NaN,50
1646188200,1.11171,1.11282,1.11166,1.11254,2291,3113.75,-286392,-286614,26.243803994512593,44.63600259609689,42.200609838326834,NaN,NaN,50
1646190000,1.11254,1.1129,1.11186,1.11187,1239,2805.5,-287631,-286847.2,25.975316718229756,41.30349718565598,42.512864636500986,NaN,NaN,50
1646191800,1.11187,1.11232,1.1118,1.1119,1231,2516.1,-286400,-287167.4,25.776873640515973,41.51405347927835,42.45857300790423,NaN,NaN,50
1646193600,1.1119,1.11236,1.11178,1.11214,1533,2307.5,-284867,-286794.6,25.534943672309968,43.2673827789711,42.620465103078516,NaN,NaN,50
1646195400,1.11214,1.11232,1.11178,1.1123,1709,2014.3,-283158,-285689.6,25.31029441611868,44.462718800209544,42.98459053580143,NaN,NaN,50
1646197200,1.1123,1.11232,1.11133,1.11151,2431,1890.35,-285589,-285529,25.53830554608124,39.98324483993687,42.8882161049276,NaN,NaN,50
1646199000,1.11151,1.11178,1.11134,1.1115,1953,1732.1,-287542,-285511.2,25.750030166760762,39.92840823103023,42.98359559026153,NaN,NaN,50
1646200800,1.1115,1.11182,1.11109,1.11126,2448,1651.7,-289990,-286229.2,26.193274906908343,38.561490761323455,42.6475935531871,NaN,NaN,50
1646202600,1.11126,1.11154,1.10968,1.10976,4018,1670.85,-294008,-288057.4,27.70721779623116,31.340038789251082,41.58188448132819,NaN,NaN,50
1646204400,1.10976,1.11043,1.10838,1.11006,7729,1988.4,-286279,-288681.6,29.80375889815288,34.002085097592186,40.84057664746506,NaN,NaN,50
1646206200,1.11006,1.11126,1.10852,1.10935,9360,2410.15,-295639,-290691.6,30.491828983190988,30.944251732151642,39.95569670407189,NaN,NaN,50
1646208000,1.10935,1.10993,1.10796,1.10978,11645,2978.6,-283994,-289982,31.45683833589076,34.77028328982472,39.170549731074615,NaN,NaN,50
1646209800,1.10978,1.11042,1.10836,1.10858,8342,3348.55,-292336,-290451.2,31.670762460950204,29.807045168497822,38.106598777000166,NaN,NaN,50
1646211600,1.10858,1.10905,1.10588,1.10636,8965,3743.4,-301301,-291909.8,33.11250442687895,23.207172876815676,36.980548259045406,NaN,NaN,50
1646213400,1.10636,1.1099,1.10602,1.10826,13668,4374.25,-287633,-292180.6,33.48315696690177,36.22285641216921,36.37960924590771,NaN,NaN,50
1646215200,1.10826,1.10946,1.10759,1.10936,7891,4668.5,-279742,-289001.2,33.82733432549438,42.31833588439522,36.452097724389084,NaN,NaN,50
1646217000,1.10936,1.11022,1.10883,1.10976,7630,4981.65,-272112,-286624.8,33.31008566953995,44.39934834103268,36.65819021451439,NaN,NaN,50
1646218800,1.10976,1.11032,1.10882,1.10952,6682,5232.45,-278794,-283916.4,32.722535085258606,43.38790510609929,36.6667989521664,NaN,NaN,50
1646220600,1.10952,1.11018,1.10852,1.10996,6807,5476.2,-271987,-278053.6,32.374445395083015,45.82455709786442,36.7640731162846,NaN,NaN,50
1646222400,1.10996,1.11133,1.10944,1.11128,6779,5717.55,-265208,-273568.6,30.84381974775372,52.438303737828036,37.65372018041968,NaN,NaN,50
1646224200,1.11128,1.11196,1.10962,1.11171,8315,6018.75,-256893,-268998.8,28.849107215275797,54.39160435195712,38.68680561762875,NaN,NaN,50
1646226000,1.11171,1.11174,1.10944,1.10964,9053,6409.45,-265946,-267765.6,27.147900700513944,44.8438503774523,39.13554559020938,NaN,NaN,50
1646227800,1.10964,1.11101,1.10887,1.11048,8850,6790.4,-257096,-263426,26.037197993955697,48.773532180780975,40.3807951181758,NaN,NaN,50
1646229600,1.11048,1.11049,1.1084,1.10994,8771,7152.3,-265867,-262202,25.371072145850178,46.48088618324385,41.2721380528652,NaN,NaN,50
1646231400,1.10994,1.10995,1.1076,1.10938,9749,7554.3,-275616,-264283.6,25.322840093664663,44.16250195680359,42.21629878319749,NaN,NaN,50
1646233200,1.10938,1.10984,1.10736,1.10944,11570,8011.25,-264046,-265714.2,25.439640229811232,44.48201794362757,42.90999411561198,NaN,NaN,50
1646235000,1.10944,1.10956,1.10575,1.10686,16553,8741.25,-280599,-268644.8,26.4784741218245,35.16409310926113,43.29264039709507,NaN,NaN,50
1646236800,1.10686,1.1094,1.10634,1.10894,12790,9258.35,-267809,-270787.4,27.443105592979684,45.14129160280938,44.85936316323748,NaN,NaN,50
1646238600,1.10894,1.11441,1.10878,1.11026,19867,10050.8,-247942,-267202.4,26.54214872628276,50.361707853705475,45.869281123347214,NaN,NaN,50
1646240400,1.11026,1.11038,1.10815,1.10854,8548,10091.75,-256490,-263377.2,25.2925157050064,44.428851414056346,46.02003223260873,NaN,NaN,50
1646242200,1.10854,1.11038,1.10789,1.11026,5144,9880.95,-251346,-260837.2,23.961633198275425,50.685256395122266,46.469025665043695,NaN,NaN,50
1646244000,1.11026,1.11175,1.10998,1.11148,4676,9532.5,-246670,-254051.4,23.46249556881925,54.590418335552556,47.269205181433215,NaN,NaN,50
1646245800,1.11148,1.11314,1.11142,1.11282,4970,9363.9,-241700,-248829.6,23.63787104742281,58.47956085059217,48.17313402091377,NaN,NaN,50
1646247600,1.11282,1.11344,1.11237,1.11296,4265,9128.9,-237435,-246728.2,23.92997710545692,58.87584912409199,48.63295869136119,NaN,NaN,50
1646249400,1.11296,1.11328,1.11164,1.11242,3670,8629,-241105,-243651.2,23.652353749317356,56.630668035838184,48.79289181163841,NaN,NaN,50
1646251200,1.11242,1.11305,1.11196,1.11251,3906,8429.75,-237199,-240821.8,23.394560632902046,56.92549548512837,49.6558664621867,NaN,NaN,50
1646253000,1.11251,1.11288,1.11176,1.11271,3698,8233.15,-233501,-238188,22.994349403686996,57.61505065768808,50.28740349625149,NaN,NaN,50
1646254800,1.11271,1.11294,1.11208,1.11218,1024,7950.25,-234525,-236753,22.658094500649277,55.097871598965455,50.902902454517324,NaN,NaN,50
1646256600,1.11218,1.11251,1.11204,1.1123,596,7639.7,-233929,-236051.8,22.30947701565594,55.57116790923387,51.7178071654052,NaN,NaN,50
1646258400,1.1123,1.1123,1.11142,1.11191,376,7319.55,-234305,-234691.8,21.421642561333307,53.59396990349838,52.36866087682454,NaN,NaN,50
1646260200,1.11191,1.11216,1.11148,1.11194,2357,7021.65,-231948,-233641.6,20.597224853748003,53.73034598967958,53.694821796854434,NaN,NaN,50
1646262000,1.11194,1.1122,1.11103,1.11108,3210,6729.5,-235158,-233973,19.412351433472157,49.26114216014086,53.98909683666382,NaN,NaN,50
1646263800,1.11108,1.11182,1.11108,1.11125,1496,6361.8,-233662,-233800.4,18.312111828930302,50.14394473589815,53.97354232824902,NaN,NaN,50
1646265600,1.11125,1.11156,1.11055,1.11057,1753,6010.9,-235415,-234097.6,17.22306249597252,46.64773003521049,54.13203365833145,NaN,NaN,50
1646267400,1.11057,1.11061,1.11008,1.11023,1238,5585.35,-236653,-234567.2,16.634125733740714,44.95978420827285,53.72307135927078,NaN,NaN,50
1646269200,1.11023,1.11042,1.10941,1.10989,2543,5134,-239196,-236016.8,16.643929546380374,43.27348534127378,52.914719002536586,NaN,NaN,50
1646271000,1.10989,1.1103,1.10955,1.10976,2570,4434.85,-241766,-237338.4,16.653033086688627,42.61533463479089,51.781559987122215,NaN,NaN,50
1646272800,1.10976,1.11006,1.109,1.11001,2705,3930.6,-239061,-238418.2,17.109562000378066,44.367649814007784,50.745260036401916,NaN,NaN,50
1646274600,1.11001,1.11068,1.11,1.1106,2515,3063,-236546,-238644.4,16.796713943131675,48.3742793052182,50.155517984214775,NaN,NaN,50
1646276400,1.1106,1.11069,1.10968,1.10968,1809,2726.05,-238355,-238984.8,16.78373547728325,43.155076570839086,49.17191663319411,NaN,NaN,50
1646278200,1.10968,1.10998,1.10956,1.10998,1438,2540.75,-236917,-238529,16.8768796785331,45.23022297743756,48.287286084604794,NaN,NaN,50
1646280000,1.10998,1.11034,1.10988,1.10999,1806,2397.25,-235111,-237198,16.50804690017202,45.30190210482927,47.58757397788078,NaN,NaN,50
1646281800,1.10999,1.11002,1.10972,1.10978,1296,2213.55,-236407,-236667.2,16.324390184081988,43.99962125850329,46.76103493140003,NaN,NaN,50
1646283600,1.10978,1.11046,1.10978,1.11024,1157,2058.15,-235250,-236408,15.588943777301289,47.555994166508086,46.32975095018644,NaN,NaN,50
1646285400,1.11024,1.11044,1.11012,1.11017,1467,1948,-236717,-236080.4,14.906029256719208,47.06615898072886,45.853737592404244,NaN,NaN,50
1646287200,1.11017,1.11044,1.10945,1.10973,1928,1849.1,-238645,-236426,15.004860755050261,43.99840211080318,45.477827588880125,NaN,NaN,50
1646289000,1.10973,1.11064,1.10939,1.11046,2231,1775.75,-236414,-236686.6,14.814935120357578,49.83991465516649,45.45611115454215,NaN,NaN,50
1646290800,1.11046,1.1106,1.10951,1.11007,2708,1859.95,-239122,-237229.6,14.638575602428656,47.018174070843074,45.482571442801614,NaN,NaN,50
1646292600,1.11007,1.11013,1.10912,1.10976,3881,2024.2,-243003,-238780.2,14.920803294353608,44.84480393886162,45.4743585664151,NaN,NaN,50
1646294400,1.10976,1.11002,1.10893,1.10954,5319,2271.35,-248322,-241101.2,15.392365516570191,43.314604771756784,45.477295668592454,NaN,NaN,50
1646296200,1.10954,1.10974,1.10826,1.10914,6101,2458.55,-254423,-244256.8,16.50485521096526,40.601890331023135,45.33347821832333,NaN,NaN,50
1646298000,1.10914,1.10952,1.10744,1.10744,5541,2575.1,-259964,-248966.8,18.212947906948436,31.55642144227339,44.418390477485154,NaN,NaN,50
1646299800,1.10744,1.10844,1.10718,1.10799,4737,2737.15,-255227,-252187.8,19.98910119951231,36.48645247170129,43.56925998937681,NaN,NaN,50
1646301600,1.10799,1.1088,1.10779,1.10864,3514,2825.2,-251713,-253929.8,21.000293172681666,41.82011072201303,43.47390528588924,NaN,NaN,50
1646303400,1.10864,1.10942,1.10843,1.10865,3352,2930.9,-248361,-253937.6,20.944831362453396,41.90094567769731,43.23609976447921,NaN,NaN,50
1646305200,1.10865,1.10868,1.10782,1.10838,3583,2982.9,-251944,-253441.8,21.457855736619553,40.273904668338254,42.876957090444144,NaN,NaN,50
1646307000,1.10838,1.10878,1.10786,1.10869,3587,3033.75,-248357,-251120.4,21.776918535895337,43.010148604665254,42.80628047231285,NaN,NaN,50
1646308800,1.10869,1.1097,1.10846,1.10916,4068,3101.9,-244289,-248932.8,20.764257120586326,46.976404326027364,42.7648811979928,NaN,NaN,50
1646310600,1.10916,1.10959,1.10726,1.10754,5555,3253.9,-249844,-248559,20.944094222635563,37.332161035692216,42.069595630490184,NaN,NaN,50
1646312400,1.10754,1.108,1.1072,1.10773,5730,3449.95,-244114,-247709.6,21.160711878837233,38.916099895262235,41.70657404366583,NaN,NaN,50
1646314200,1.10773,1.10876,1.10644,1.10858,6945,3725.3,-237169,-244754.6,21.361856845310214,45.54690512404263,41.39993050572841,NaN,NaN,50
1646316000,1.10858,1.10952,1.10746,1.10888,10208,4145.4,-226961,-240475.4,20.50885715765295,47.7045999254878,41.44896092391732,NaN,NaN,50
1646317800,1.10888,1.10925,1.10766,1.108,9349,4548.05,-236310,-238879.6,19.716786019114064,42.397537666555394,41.27415619018116,NaN,NaN,50
1646319600,1.108,1.10872,1.10626,1.10633,8987,4939.55,-245297,-237970.2,20.278805400479936,34.54370972831275,40.64766368707802,NaN,NaN,50
1646321400,1.10633,1.10688,1.10577,1.10618,7572,5244.8,-252869,-239721.2,21.164188189341722,33.93563603885194,40.17150266620865,NaN,NaN,50
1646323200,1.10618,1.10654,1.10377,1.10484,9702,5633.5,-262571,-244801.6,23.12127723837252,29.02093736938548,39.99039666100237,NaN,NaN,50
1646325000,1.10484,1.10572,1.10466,1.10543,6354,5839.65,-256217,-250652.8,24.93857421247255,33.58192685312817,39.78293054539,NaN,NaN,50
1646326800,1.10543,1.10554,1.10335,1.10378,6234,6015.95,-262451,-255881,27.184611236659954,28.13667258504489,38.80554210703514,NaN,NaN,50
1646328600,1.10378,1.10679,1.10376,1.10511,12825,6463.15,-249626,-256746.8,27.760970735784547,37.003734439245314,38.455741304288566,NaN,NaN,50
1646330400,1.10511,1.10654,1.10474,1.10634,6375,6515.95,-243251,-254823.2,28.29616169925738,43.89801280331663,38.71460617107273,NaN,NaN,50
1646332200,1.10634,1.10667,1.10567,1.10626,3908,6406.3,-247159,-251740.8,28.638206883997107,43.56407005570245,38.754171989003964,NaN,NaN,50
1646334000,1.10626,1.10658,1.10592,1.10654,2875,6273,-244284,-249354.2,28.955820269826855,45.137176244863106,38.62279855463509,NaN,NaN,50
1646335800,1.10654,1.10654,1.10551,1.10578,2857,6179,-247141,-246292.2,29.515556472293586,41.73654824090412,38.937397640721656,NaN,NaN,50
1646337600,1.10578,1.1063,1.10564,1.10619,3055,6156.05,-244086,-245184.2,30.035311517441272,44.179815395636034,39.31337731931978,NaN,NaN,50
1646339400,1.10619,1.10639,1.10581,1.10632,3162,6146.55,-240924,-244718.8,30.38204258537997,44.96783232002787,39.27201497617586,NaN,NaN,50
1646341200,1.10632,1.1066,1.10623,1.10649,870,6010.9,-240054,-243297.8,30.37863943571681,46.040590215686784,39.153157139761504,NaN,NaN,50
1646343000,1.10649,1.10668,1.10627,1.10656,733,5868.2,-239321,-242305.2,30.24826530953712,46.50302250140755,39.44640605653667,NaN,NaN,50
1646344800,1.10656,1.10668,1.1064,1.10661,120,5670.8,-239201,-240717.2,30.127203620941707,46.853381472548485,40.32566832398207,NaN,NaN,50
1646346600,1.10661,1.10669,1.1066,1.10662,174,5401.75,-239027,-239705.4,29.99663489509958,46.92824359510528,41.25371172085731,NaN,NaN,50
1646348400,1.10662,1.10672,1.1063,1.1065,1026,5166.55,-240053,-239531.2,30.182885409424674,46.08926247692825,42.47287779996751,NaN,NaN,50
1646350200,1.1065,1.10681,1.10637,1.1066,647,4851.65,-239406,-239401.6,30.175600765321363,46.94056504778448,43.42706624244296,NaN,NaN,50
1646352000,1.1066,1.10668,1.10204,1.10304,6593,4670.9,-245999,-240737.2,32.64821456078506,29.239147178048725,43.50581442765752,NaN,NaN,50
1646353800,1.10304,1.10358,1.10102,1.10126,9167,4661.8,-255166,-243930.2,35.225511113322014,24.30407484072832,42.598695884906306,NaN,NaN,50
1646355600,1.10126,1.10284,1.10112,1.10232,11214,4773.15,-243952,-244915.2,37.618715054963474,31.69735079423495,41.727220027114754,NaN,NaN,50
1646357400,1.10232,1.10522,1.10178,1.1049,10406,4914.85,-233546,-243613.8,37.040543066982615,45.61949621736584,41.87403618151928,NaN,NaN,50
1646359200,1.1049,1.10496,1.10328,1.10362,6123,4735.9,-239669,-243666.4,36.50366907814325,41.139268119368424,41.58847131541252,NaN,NaN,50
1646361000,1.10362,1.10407,1.10257,1.10291,4529,4644.65,-244198,-243306.2,36.37971998045475,38.85955337705343,41.382971682280335,NaN,NaN,50
1646362800,1.10291,1.10315,1.10193,1.10266,4424,4554.15,-248622,-241997.4,36.578513857879464,38.059798721230095,40.945827634108475,NaN,NaN,50
1646364600,1.10266,1.10308,1.10222,1.1026,2880,4056.9,-251502,-243507.4,36.76310817263098,37.8584182456602,40.438012343082214,NaN,NaN,50
1646366400,1.1026,1.1034,1.10236,1.10332,2319,3854.1,-249183,-246634.8,36.56080385669876,41.83558815753508,40.13765505321424,NaN,NaN,50
1646368200,1.10332,1.10368,1.10291,1.10357,2979,3807.65,-246204,-247941.8,36.04563242459641,43.19505977323366,39.901372001201814,NaN,NaN,50
1646370000,1.10357,1.10394,1.1031,1.10322,2643,3796.05,-248847,-248871.6,35.26159885336556,41.72471591750072,39.53503874726983,NaN,NaN,50
1646371800,1.10322,1.10326,1.10236,1.10287,2279,3767.15,-251126,-249372.4,35.0263274569136,40.249256143747644,39.057968215029994,NaN,NaN,50
1646373600,1.10287,1.10318,1.10247,1.10296,2153,3722.05,-248973,-248866.6,34.807861160208205,40.8286905951955,38.682213080620514,NaN,NaN,50
1646375400,1.10296,1.10296,1.10148,1.10155,2614,3694.65,-251587,-249347.4,35.21239762958485,35.08780963258053,37.83558769382023,NaN,NaN,50
1646377200,1.10155,1.10238,1.10086,1.10143,5761,3939.2,-257348,-251576.2,35.91861851602167,34.64137789192871,38.22146131624023,NaN,NaN,50
1646379000,1.10143,1.10171,1.10085,1.10122,5271,4166.1,-262619,-254330.6,36.579683569467306,33.830181762348246,38.90189752492737,NaN,NaN,50
1646380800,1.10122,1.10172,1.10087,1.10148,6475,4483.85,-256144,-255334.2,37.17849137206911,35.83362460208035,39.19734565405918,NaN,NaN,50
1646382600,1.10148,1.10158,1.10084,1.10122,5262,4738.25,-261406,-257820.8,37.75286056720038,34.70211651720393,38.41753281833333,NaN,NaN,50
1646384400,1.10122,1.10243,1.1012,1.10214,4760,4924.95,-256646,-258832.6,36.99404385829897,41.71537853773659,38.45868356250248,NaN,NaN,50
1646386200,1.10214,1.10243,1.10132,1.10142,4307,5107.95,-260953,-259553.6,36.28942834289051,38.252698303990314,38.4153367715694,NaN,NaN,50
1646388000,1.10142,1.10199,1.1001,1.10146,6141,5085.35,-254812,-257992.2,36.52909759494109,38.55783531327898,38.45091081385861,NaN,NaN,50
1646389800,1.10146,1.10146,1.09998,1.10013,4933,4873.65,-259745,-258712.4,36.82867662776428,32.760779735598575,38.08679377742563,NaN,NaN,50
1646391600,1.10013,1.10066,1.09803,1.09842,7655,4695.7,-267400,-259911.2,38.11541820529634,27.11597205035251,37.035392626912596,NaN,NaN,50
1646393400,1.09842,1.09848,1.09732,1.09758,5009,4425.85,-272409,-263063.8,39.58578083987591,24.85079063348249,35.72508768835894,NaN,NaN,50
1646395200,1.09758,1.09822,1.09624,1.09652,5651,4402.25,-278060,-266485.2,41.3132449103007,22.31724015310897,34.33883941947382,NaN,NaN,50
1646397000,1.09652,1.09668,1.09342,1.09372,6520,4501.8,-284580,-272438.8,43.581380978528514,17.29993359741782,32.69960209473597,NaN,NaN,50
1646398800,1.09372,1.09448,1.09242,1.09339,7654,4663.3,-292234,-278936.6,45.85920366388908,16.819983259950746,30.984694427932777,NaN,NaN,50
1646400600,1.09339,1.09448,1.08857,1.0909,17962,5417.4,-310196,-287495.8,48.44755397403972,13.725720986864744,29.45883095323879,NaN,NaN,50
1646402400,1.0909,1.09282,1.09034,1.09114,10165,5809.7,-300031,-293020.2,50.8510221191796,15.342291489086094,28.080324781607175,NaN,NaN,50
1646404200,1.09114,1.09243,1.08962,1.09088,12905,6306,-312936,-299995.4,53.15358479942681,15.014076267378869,26.73631724625222,NaN,NaN,50
1646406000,1.09088,1.09152,1.0903,1.09122,9221,6634.9,-303715,-303822.4,55.29167871679922,17.499582673064708,25.426742822751105,NaN,NaN,50
1646407800,1.09122,1.0924,1.09012,1.09191,8664,6954.15,-295051,-304385.8,56.32581964974859,22.456033015199054,24.5520225726079,NaN,NaN,50
1646409600,1.09191,1.0923,1.09131,1.09183,7589,7225.95,-302640,-302874.6,57.286093373201574,22.28883635835973,23.164412416938124,NaN,NaN,50
1646411400,1.09183,1.09205,1.09084,1.09086,7937,7492.1,-310577,-304983.8,58.2708692790451,20.31389508116993,21.88306932959381,NaN,NaN,50
1646413200,1.09086,1.09238,1.0908,1.09232,6725,7540.3,-303852,-303167,58.799537037320114,30.321524924832786,21.294761444704797,NaN,NaN,50
1646415000,1.09232,1.09264,1.09156,1.09261,5081,7530.8,-298771,-302178.2,58.981728078860485,32.14442962838143,21.250736437046434,NaN,NaN,50
1646416800,1.09261,1.09318,1.09216,1.0928,4186,7416.35,-294585,-302085,58.51549701163214,33.37426680121041,21.69775749067914,NaN,NaN,50
1646418600,1.0928,1.09336,1.0924,1.09334,3134,7309.95,-291451,-299847.2,57.871231036876466,36.87598785537948,22.556700149386067,NaN,NaN,50
1646420400,1.09334,1.09347,1.09242,1.09331,3488,7246.35,-294939,-296719.6,57.138318190344705,36.76039476072305,23.588354049929933,NaN,NaN,50
1646422200,1.09331,1.09369,1.09098,1.09132,4617,7261.85,-299556,-295860.4,57.022640342014554,30.034815425677664,24.497988466234204,NaN,NaN,50
1646424000,1.09132,1.09262,1.09127,1.09244,4988,7204.2,-294568,-295019.8,56.91522519713656,37.01889876697272,25.940768145307203,NaN,NaN,50
1646425800,1.09244,1.09363,1.092,1.09344,3853,7150.2,-290715,-294245.8,55.60062183008985,42.534597565103965,27.998545043752863,NaN,NaN,50
1646427600,1.09344,1.09352,1.09274,1.09291,1619,6848.4,-292334,-294422.4,54.37991870354647,40.509669742507434,29.79621491899724,NaN,NaN,50
1646429400,1.09291,1.09409,1.09256,1.09376,2511,6723.5,-289823,-293399.2,52.585524781355254,45.0295242440379,31.9401754887586,NaN,NaN,50
1646604000,1.09376,1.09376,1.09254,1.0927,219,6451.9,-290042,-291496.4,50.93202403070794,40.86033489567142,33.608800647516226,NaN,NaN,50
1646605800,1.0927,1.0929,1.09217,1.09261,641,6157.95,-290683,-290719.4,49.63738081300843,40.51731739978043,34.89889238927204,NaN,NaN,50
1646607600,1.09261,1.09265,1.08637,1.08775,12561,6403.3,-303244,-293225.2,50.57770218990299,27.225823048263763,35.25153429569376,NaN,NaN,50
1646609400,1.08775,1.08833,1.0865,1.0874,4023,5706.35,-307267,-296211.8,51.450857754162236,26.55033208490441,35.69699408167479,NaN,NaN,50
1646611200,1.0874,1.08848,1.08711,1.08724,4489,5422.55,-311756,-300598.4,52.10800280812767,26.229946802660493,35.404738501519624,NaN,NaN,50
1646613000,1.08724,1.088,1.08624,1.08625,3148,4934.7,-314904,-305570.8,52.93247847119966,24.277802700876165,34.842836578126395,NaN,NaN,50
1646614800,1.08625,1.08662,1.08215,1.08304,9644,4955.85,-324548,-312343.8,54.421099247691615,19.26996806813905,33.8353866686213,NaN,NaN,50
1646616600,1.08304,1.08485,1.0828,1.08435,9335,4989.4,-315213,-314737.6,55.80338996871986,25.980227259037648,33.057118054596884,NaN,NaN,50
1646618400,1.08435,1.08536,1.08376,1.08455,5722,4896.05,-309491,-315182.4,56.606421260901854,26.97815785837406,32.35838684728624,NaN,NaN,50
1646620200,1.08455,1.08538,1.08358,1.08456,4842,4741.3,-304649,-313761,57.38622709924892,27.03112967934028,32.143837865405,NaN,NaN,50
1646622000,1.08456,1.08866,1.0841,1.08736,5843,4697.2,-298806,-310541.4,55.459513008029084,40.12777906070288,32.36590074352858,NaN,NaN,50
1646623800,1.08736,1.0876,1.08664,1.08712,5706,4728.45,-304512,-306534.2,53.67042135189638,39.47379175632082,32.14727175718693,NaN,NaN,50
1646625600,1.08712,1.08749,1.08628,1.08645,3395,4688.9,-307907,-305073,52.145441387894685,37.630021094817344,31.941582568066206,NaN,NaN,50
1646627400,1.08645,1.08802,1.08637,1.08798,3289,4696.65,-304618,-304098.4,50.33554326064703,44.05618030903141,31.87205800128003,NaN,NaN,50
1646629200,1.08798,1.08876,1.0871,1.08758,4148,4729.65,-308766,-304921.8,48.12086577160614,42.814193743509584,32.01161934755418,NaN,NaN,50
1646631000,1.08758,1.08805,1.08665,1.0877,3736,4685.6,-305030,-306166.6,46.27860384050349,43.330332722176514,32.21254901343962,NaN,NaN,50
1646632800,1.0877,1.08896,1.08756,1.08876,4830,4677.7,-300200,-305304.2,43.91346321056259,47.81122796160458,33.68293507867825,NaN,NaN,50
1646634600,1.08876,1.08877,1.08713,1.08736,4702,4720.15,-304902,-304703.2,41.94498669127767,42.97770083831555,34.85631856106476,NaN,NaN,50
1646636400,1.08736,1.08982,1.08722,1.0886,8684,5073.4,-296218,-303023.2,39.38532671966005,47.9927635880126,36.41080547430419,NaN,NaN,50
1646638200,1.0886,1.08878,1.08666,1.08712,8576,5376.65,-304794,-302228.8,37.331333787137325,43.11838914090415,37.756561648591905,NaN,NaN,50
1646640000,1.08712,1.08908,1.08676,1.08692,12060,5968.7,-316854,-304593.6,35.21052859232702,42.490350440552106,39.41516038947856,NaN,NaN,50
1646641800,1.08692,1.08783,1.0854,1.08626,9047,6389,-325901,-309733.8,34.01007510665487,40.39915426834538,40.445083747286255,NaN,NaN,50
1646643600,1.08626,1.08708,1.08566,1.08628,8458,6183.85,-317443,-312242,32.89536829853073,40.494726265871115,41.41055291925033,NaN,NaN,50
1646645400,1.08628,1.08688,1.08502,1.08584,7650,6365.2,-325093,-318017,32.20883248699281,39.01258258739155,42.26637098411113,NaN,NaN,50
1646647200,1.08584,1.08597,1.08172,1.08172,7171,6499.3,-332264,-323511,32.93739904365024,28.49546358300978,41.435491307133056,NaN,NaN,50
1646649000,1.08172,1.0834,1.0806,1.08326,7401,6711.95,-324863,-325112.8,33.95744990952978,35.49535443936492,41.15131721306477,NaN,NaN,50
1646650800,1.08326,1.0843,1.08284,1.08302,6659,6562.7,-331522,-326237,34.195928925842715,34.92159876259514,40.9578584750489,NaN,NaN,50
1646652600,1.08302,1.08646,1.0826,1.08594,8129,6502.4,-323393,-327427,32.96250901515237,46.29578087813257,41.11782994427041,NaN,NaN,50
1646654400,1.08594,1.08935,1.08556,1.08894,12794,6856,-310599,-324528.2,30.8697864539141,54.99813751219249,41.98811164203347,NaN,NaN,50
1646656200,1.08894,1.09252,1.0884,1.08877,19401,7583.95,-330000,-324075.4,30.11153426381715,54.45960084902446,42.783059365379756,NaN,NaN,50
1646658000,1.08877,1.09098,1.08852,1.09037,13835,7983.55,-316165,-322335.8,29.407442944441403,58.57132594704399,43.551637792911144,NaN,NaN,50
1646659800,1.09037,1.09214,1.08899,1.08976,12067,8301.6,-328232,-321677.8,29.141588441751402,56.47770146909421,44.51592355225248,NaN,NaN,50
1646661600,1.08976,1.09326,1.08943,1.0923,12791,8771.4,-315441,-320087.4,29.24577072090865,62.49010528362277,45.55144795908177,NaN,NaN,50
1646663400,1.0923,1.09236,1.08896,1.08914,12430,9228.45,-327871,-323541.8,29.07179764842579,52.73042408458061,46.2380218836301,NaN,NaN,50
1646665200,1.08914,1.08966,1.08578,1.08658,10400,9541.05,-338271,-325196,27.329261757824458,46.407088078069485,46.51778885773848,NaN,NaN,50
1646667000,1.08658,1.08837,1.08646,1.08762,10726,9890.55,-327545,-327472,25.71119271655179,49.07863665679604,47.137751885484946,NaN,NaN,50
1646668800,1.08762,1.08775,1.08588,1.08614,7705,10034.3,-335250,-328875.6,23.94247561573732,45.595349119895864,47.50208208934386,NaN,NaN,50
1646670600,1.08614,1.08723,1.08485,1.08599,8273,10212.85,-343523,-334492,22.624214141155015,45.244855378624145,47.94724443157476,NaN,NaN,50
1646672400,1.08599,1.08787,1.08584,1.08778,5713,10064.3,-337810,-336479.8,21.09182000378029,50.16771012079829,49.49526204141679,NaN,NaN,50
1646674200,1.08778,1.08898,1.08709,1.08753,9742,10122.6,-347552,-338336,20.014698567344567,49.498358151095665,50.495476592254704,NaN,NaN,50
1646676000,1.08753,1.09004,1.08717,1.08974,8729,9956.05,-338823,-340591.6,19.471335220136503,55.19005344170254,51.94322335504808,NaN,NaN,50
1646677800,1.08974,1.08988,1.08738,1.08802,5862,9796.8,-344685,-342478.6,18.966783540586153,50.42665248353423,52.238285612576774,NaN,NaN,50
1646679600,1.08802,1.08908,1.08639,1.08648,5290,9638.4,-349975,-343769,17.94710423136933,46.55250345087942,51.6350260367687,NaN,NaN,50
1646681400,1.08648,1.08648,1.08458,1.08481,7189,9615.35,-357164,-347639.8,17.220445232979984,42.71963307641218,50.79645691015354,NaN,NaN,50
1646683200,1.08481,1.08714,1.08466,1.08702,5725,9543.05,-351439,-348417.2,16.20183401921821,48.735005145753846,50.09386256720425,NaN,NaN,50
1646685000,1.08702,1.08718,1.08606,1.08704,4543,9400.15,-346896,-350031.8,15.234602695956903,48.787420166615725,49.54455675988436,NaN,NaN,50
1646686800,1.08704,1.0872,1.08585,1.08604,1019,9118.15,-347915,-350677.8,14.448881792478025,46.24162965367435,48.38395135774518,NaN,NaN,50
1646688600,1.08604,1.08622,1.0852,1.08546,1066,8765,-348981,-350479,14.069111115352515,44.782038098044815,47.81620950156405,NaN,NaN,50
1646690400,1.08546,1.08564,1.08494,1.08527,5567,8403.65,-354548,-349955.8,13.85637285903468,44.28886087379085,47.664907558401296,NaN,NaN,50
1646692200,1.08527,1.08548,1.08522,1.08542,311,7449.15,-354237,-350515.4,13.658830192453836,44.80565324729305,47.35969445772251,NaN,NaN,50
1646694000,1.08542,1.08602,1.08522,1.0856,1432,6829,-352805,-351697.2,13.08373676933418,45.45947490392939,47.349989156582055,NaN,NaN,50
1646695800,1.0856,1.08664,1.08553,1.08664,790,6265.15,-352015,-352517.2,12.182539294811598,49.20354223225148,47.63275250326972,NaN,NaN,50
1646697600,1.08664,1.08698,1.0859,1.08633,1598,5705.5,-353613,-353443.6,11.579283955244938,48.14265933189048,47.48810601834773,NaN,NaN,50
1646699400,1.08633,1.08654,1.08493,1.08574,2162,5192.1,-355775,-353689,11.164625394581549,46.1051683582815,47.245735318861,NaN,NaN,50
1646701200,1.08574,1.08718,1.08532,1.08679,3616,4852.9,-352159,-353273.4,10.416811529130253,50.14872781712847,46.885640631391425,NaN,NaN,50
1646703000,1.08679,1.08808,1.08589,1.0875,4406,4536.9,-347753,-352263,10.32371987987912,52.7312528425677,47.05025494275096,NaN,NaN,50
1646704800,1.0875,1.0885,1.08744,1.08774,3383,4320.8,-344370,-350734,10.502553430923943,53.60616834446693,47.55408814943579,NaN,NaN,50
1646706600,1.08774,1.08823,1.08708,1.0875,3902,4102.25,-348272,-349665.8,10.375678403235906,52.55850983073687,48.256865060458985,NaN,NaN,50
1646708400,1.0875,1.08794,1.08708,1.0872,2686,3950.9,-350958,-348702.4,10.257865877525587,51.21120861198155,48.433736736618094,NaN,NaN,50
1646710200,1.0872,1.08766,1.08674,1.08678,2606,3594.1,-353564,-348983.4,9.851109374130377,49.305613013304686,48.470750511381596,NaN,NaN,50
1646712000,1.08678,1.08729,1.08652,1.08722,2057,3260.5,-351507,-349734.2,9.279309931237801,51.34807423792145,48.83549655311352,NaN,NaN,50
1646713800,1.08722,1.08728,1.08666,1.087,2217,3078.25,-353724,-351605,8.748353305694692,50.25775981083822,49.226619532598775,NaN,NaN,50
1646715600,1.087,1.08705,1.08584,1.08586,3556,2991.55,-357280,-353406.6,8.72631427016354,44.93344014587276,49.272660909176054,NaN,NaN,50
1646717400,1.08586,1.0866,1.0856,1.08599,2805,2772.35,-354475,-354110,8.907612995373055,45.64066628661145,49.332304697698795,NaN,NaN,50
1646719200,1.08599,1.08666,1.08549,1.08572,4069,2689.55,-358544,-355106,9.171030203102948,44.36620189624996,49.254213768578836,NaN,NaN,50
1646721000,1.08572,1.08619,1.08522,1.08606,3543,2639.55,-355001,-355804.8,9.65372243704689,46.39608971531529,49.05368144594053,NaN,NaN,50
1646722800,1.08606,1.08708,1.08512,1.08706,6808,2929,-348193,-354698.6,9.11458981960048,51.94923917334814,49.32558000604466,NaN,NaN,50
1646724600,1.08706,1.08841,1.08597,1.08616,8859,3318.65,-357052,-354653,9.487321503627582,47.209053268083714,49.40442892817338,NaN,NaN,50
1646726400,1.08616,1.09218,1.0856,1.09176,20099,4045.25,-336953,-351148.6,11.849774884590529,67.2396794659155,50.62521118880102,NaN,NaN,50
1646728200,1.09176,1.09214,1.08824,1.08968,15777,4818.55,-352730,-349985.8,14.043481595484696,58.37927115305087,51.028641068121246,NaN,NaN,50
1646730000,1.08968,1.09054,1.0866,1.08785,11104,5302.15,-363834,-351752.4,14.628934600325957,51.89944634216192,50.90673235367088,NaN,NaN,50
1646731800,1.08785,1.08964,1.08741,1.08877,8723,5698.8,-355111,-353136,15.172569533392846,54.626112729509686,51.0544182750118,NaN,NaN,50
1646733600,1.08877,1.08879,1.08672,1.08742,8073,6022.55,-363184,-354362.4,15.109546316201271,50.1350036378522,50.97754649114542,NaN,NaN,50
1646735400,1.08742,1.09048,1.08654,1.08983,8361,6332.5,-354823,-357936.4,15.947422040254002,56.940911934742246,51.52292498553381,NaN,NaN,50
1646737200,1.08983,1.09038,1.08918,1.0893,6545,6478.95,-361368,-359664,16.725449498302968,55.15795056752723,51.79505900907708,NaN,NaN,50
1646739000,1.0893,1.08938,1.08818,1.08912,5393,6528.3,-366761,-360249.4,16.620673652397358,54.53340881242322,52.1004625091903,NaN,NaN,50
1646740800,1.08912,1.09213,1.08912,1.09072,7829,6750.6,-358932,-361013.6,17.811753720434012,58.97957484359364,53.103757844741786,NaN,NaN,50
1646742600,1.09072,1.09138,1.0896,1.09056,7923,6951.65,-366855,-361747.8,18.917756640753762,58.36492202888689,54.012633254904316,NaN,NaN,50
1646744400,1.09056,1.0907,1.08836,1.08982,10863,7360.5,-377718,-366326.8,18.991117369618678,55.4848769539854,54.80682433045685,NaN,NaN,50
1646746200,1.08982,1.09177,1.08873,1.09156,9529,7706.65,-368189,-367691,19.54615436380171,60.429377907652764,55.80920205848095,NaN,NaN,50
1646748000,1.09156,1.09246,1.09063,1.09132,8601,8033.85,-376790,-369696.8,20.353626135474997,59.4485277474733,56.34486552806133,NaN,NaN,50
1646749800,1.09132,1.09151,1.09019,1.09044,12008,8523.4,-388798,-375670,20.758287548004486,55.867792826402805,56.96334692508412,NaN,NaN,50
1646751600,1.09044,1.09064,1.08748,1.08923,16544,9172.8,-405342,-383367.4,19.363105878313416,51.29295049507212,55.82429485573816,NaN,NaN,50
1646753400,1.08923,1.08926,1.08721,1.08756,12539,9659.5,-417881,-391400,18.041947770523546,45.72741390921327,54.92059076689261,NaN,NaN,50
1646755200,1.08756,1.08928,1.08751,1.08812,9823,9947.2,-408058,-399373.8,16.80329607686735,47.77382925577322,54.62590383215057,NaN,NaN,50
1646757000,1.08812,1.08874,1.08759,1.08808,8050,10172.55,-416108,-407237.4,15.653119504186606,47.6356629552565,54.12658599113248,NaN,NaN,50
1646758800,1.08808,1.09386,1.08778,1.09374,15922,10628.25,-400186,-409515,16.846604643872887,63.653805285846076,55.0922146802749,NaN,NaN,50
1646760600,1.09374,1.09562,1.09291,1.09424,18015,11086.05,-382171,-404880.8,18.478417366430428,64.68162170058928,55.64512252069254,NaN,NaN,50
1646762400,1.09424,1.09584,1.09246,1.09288,13054,10733.8,-395225,-400349.6,19.704554112973163,59.73362860192345,55.971956666006555,NaN,NaN,50
1646764200,1.09288,1.09296,1.09044,1.09174,12376,10563.75,-407601,-400258.2,19.652701267559287,55.87513822017124,56.0677944808457,NaN,NaN,50
1646766000,1.09174,1.09174,1.09046,1.09149,9712,10494.15,-417313,-400499.2,19.60455219681783,55.03555887393868,55.78607905444177,NaN,NaN,50
1646767800,1.09149,1.09152,1.09024,1.09064,8194,10467.7,-425507,-405563.4,19.429970242596166,52.16550435274741,55.343263506146094,NaN,NaN,50
1646769600,1.09064,1.09136,1.09004,1.09008,5350,10331.55,-430857,-415300.6,19.144499558912354,50.304252055878685,54.97321887056704,NaN,NaN,50
1646771400,1.09008,1.09103,1.08996,1.09066,4425,10134.75,-426432,-421542,18.827394094751813,52.20628180155779,54.38585486298882,NaN,NaN,50
1646773200,1.09066,1.09095,1.09048,1.09076,753,9845.15,-425679,-425157.6,18.532939020888453,52.54353042809412,53.892640768747455,NaN,NaN,50
1646775000,1.09076,1.09082,1.08949,1.08949,1080,9629.5,-426759,-427046.8,17.579164912967755,47.918923470660005,53.3248643861944,NaN,NaN,50
1646776800,1.08949,1.0901,1.08949,1.09006,165,9246.3,-426594,-427264.2,16.693517527041397,50.04411489370777,53.235661843239804,NaN,NaN,50
1646778600,1.09006,1.09038,1.08986,1.0901,412,8870.75,-426182,-426329.2,16.050716328746947,50.197695846368376,53.554967695893744,NaN,NaN,50
1646780400,1.0901,1.0905,1.08901,1.08906,2312,8443.2,-428494,-426741.6,14.968273772917708,46.21909671061213,53.44391537123938,NaN,NaN,50
1646782200,1.08906,1.0898,1.08902,1.0898,998,8016.65,-427496,-427105,13.963148542504841,49.29839106772284,53.562681664986975,NaN,NaN,50
1646784000,1.0898,1.09066,1.08968,1.09034,2155,7694.35,-425341,-426821.4,13.518593118230523,51.481508641888865,52.693231904704305,NaN,NaN,50
1646785800,1.09034,1.09146,1.08998,1.0914,2220,7204.95,-423121,-426126.8,13.626228382525731,55.529368514836904,52.03949953429343,NaN,NaN,50
1646787600,1.0914,1.09202,1.09104,1.09152,3404,6547.95,-419717,-424833.8,14.067217677208882,55.97714006709759,51.771178924663005,NaN,NaN,50
1646789400,1.09152,1.09201,1.09136,1.09141,2938,6067.9,-422655,-423666,14.47670773655752,55.426212470983,51.73911279972099,NaN,NaN,50
1646791200,1.09141,1.09201,1.09127,1.09192,2438,5698.65,-420217,-422210.2,14.7682582818873,57.51402538851454,51.916146122190696,NaN,NaN,50
1646793000,1.09192,1.09203,1.09129,1.09161,2483,5420.3,-422700,-421682,15.0533771139039,55.80304076130829,52.17597015137362,NaN,NaN,50
1646794800,1.09161,1.09175,1.09082,1.0911,2059,4727.15,-424759,-422009.6,14.818256447558387,53.00910766716865,52.36917412360861,NaN,NaN,50
1646796600,1.0911,1.0916,1.09052,1.09074,2044,3928.6,-426803,-423426.8,14.28915467517799,51.065525305714054,52.28769151676263,NaN,NaN,50
1646798400,1.09074,1.09138,1.0907,1.09126,1799,3365.85,-425004,-423896.6,13.797845886539047,53.70588887298126,52.37071711996886,NaN,NaN,50
1646800200,1.09126,1.09192,1.09126,1.0917,1888,2841.45,-423116,-424476.4,13.83870582878511,55.87540817410117,52.93903745592894,NaN,NaN,50
1646802000,1.0917,1.09296,1.0915,1.09243,2004,2456.05,-421112,-424158.8,14.70153860450221,59.28459929506235,53.5990720560257,NaN,NaN,50
1646803800,1.09243,1.0927,1.09143,1.0916,2321,2162.4,-423433,-423893.6,15.415667410114006,54.160762013467064,53.882148210818464,NaN,NaN,50
1646805600,1.0916,1.0928,1.09158,1.09249,2726,2031.2,-420707,-422674.4,16.157720173379573,58.32055715212457,54.746538242355065,NaN,NaN,50
1646807400,1.09249,1.09256,1.0914,1.09174,3033,1961.6,-423740,-422421.6,16.598208979073735,53.88301603153704,55.07401145405607,NaN,NaN,50
1646809200,1.09174,1.09256,1.09093,1.09236,4951,2171.5,-418789,-421556.2,16.376670713990684,56.80872965153954,55.4545272404597,NaN,NaN,50
1646811000,1.09236,1.0924,1.0912,1.09166,5336,2384.3,-424125,-422158.8,16.17095661069928,52.74049363080891,55.255321891600545,NaN,NaN,50
1646812800,1.09166,1.0951,1.09109,1.09502,8765,2814.3,-415360,-420544.2,17.986173776706647,65.50862820236034,55.93614247269074,NaN,NaN,50
1646814600,1.09502,1.09562,1.09461,1.09496,6718,3129.6,-422078,-420818.4,19.93500235848482,65.17003139652365,56.63212953880079,NaN,NaN,50
1646816400,1.09496,1.09704,1.09401,1.09674,7887,3408.35,-414191,-418908.6,22.356479373707373,70.1064821871103,57.53159073870048,NaN,NaN,50
1646818200,1.09674,1.0973,1.09606,1.09701,7334,3725.15,-406857,-416522.2,24.703711188749743,70.78291864110861,58.60158201582908,NaN,NaN,50
1646820000,1.09701,1.09916,1.09686,1.09914,7276,3981.2,-399581,-411613.4,27.48277905837549,75.49402116884875,60.20764726594909,NaN,NaN,50
1646821800,1.09914,1.09926,1.09654,1.0967,6317,4186.05,-405898,-409721,29.671159269718117,62.968303344252305,61.05784569727326,NaN,NaN,50
1646823600,1.0967,1.09704,1.09417,1.09448,7252,4378.45,-413150,-407935.4,29.318473958799007,54.16306477345247,61.090501118735496,NaN,NaN,50
1646825400,1.09448,1.0972,1.09443,1.09712,6753,4569.2,-406397,-406376.6,29.072263069537556,61.124934676619944,61.46546729748683,NaN,NaN,50
1646827200,1.09712,1.09829,1.09636,1.09735,6819,4788.25,-399578,-404920.8,29.372314246139936,61.671126233352496,61.635933507364705,NaN,NaN,50
1646829000,1.09735,1.09889,1.09716,1.09856,5339,4931.05,-394239,-403852.4,29.917276529261688,64.49717095036004,62.37424843142849,NaN,NaN,50
1646830800,1.09856,1.10047,1.09834,1.1002,6676,5161.9,-387563,-400185.4,31.038875890234856,67.94676507008255,63.06183471128263,NaN,NaN,50
1646832600,1.1002,1.10166,1.0993,1.10142,6624,5390.9,-380939,-393743.2,32.46830068145482,70.26161619652316,64.23173472306736,NaN,NaN,50
1646834400,1.10142,1.10488,1.10042,1.1048,17694,6185.65,-363245,-385112.8,34.58380039750954,75.53348770942891,65.56921744148802,NaN,NaN,50
1646836200,1.1048,1.10504,1.10282,1.10311,13762,6779.35,-377007,-380598.6,36.58047251388608,68.95165503264951,66.7271575416195,NaN,NaN,50
1646838000,1.10311,1.10388,1.10156,1.10158,8654,7111.85,-385661,-378883,37.36869747181197,63.55245932379302,66.58743119315041,NaN,NaN,50
1646839800,1.10158,1.10481,1.10115,1.1044,10677,7529.65,-374984,-376367.2,38.3550952769315,68.45535234001518,66.82209697482837,NaN,NaN,50
1646841600,1.1044,1.10882,1.10429,1.10852,9925,7889.6,-365059,-373191.2,40.108008205349776,73.96553123365925,67.09774333529616,NaN,NaN,50
1646843400,1.10852,1.10918,1.10665,1.10706,10439,8259.9,-375498,-375641.8,41.795816658819575,69.34296893125418,66.99488978459226,NaN,NaN,50
1646845200,1.10706,1.10789,1.10652,1.10722,6917,8358.2,-368581,-373956.6,43.26082329971475,69.56743143960027,66.5715619467888,NaN,NaN,50
1646847000,1.10722,1.10952,1.10706,1.1092,8324,8507.6,-360257,-368875.8,44.90545813302581,72.2729315917715,67.23617825018303,NaN,NaN,50
1646848800,1.1092,1.1095,1.10742,1.10765,6079,8373.3,-366336,-367146.2,46.4326190496718,67.23388523822157,68.16980828338082,NaN,NaN,50
1646850600,1.10765,1.10802,1.10634,1.10658,4249,8249.85,-370585,-368251.4,46.95936050917689,63.920661924540546,68.36950308680372,NaN,NaN,50
1646852400,1.10658,1.10752,1.10617,1.10648,3768,8043.9,-374353,-368022.4,47.310476377414204,63.60519343706909,68.50765074421204,NaN,NaN,50
1646854200,1.10648,1.10796,1.10648,1.10774,4284,7891.4,-370069,-368320,47.75279668620996,65.88951797537342,68.60710410314157,NaN,NaN,50
1646856000,1.10774,1.10834,1.1071,1.10764,3772,7716.2,-373841,-371036.8,48.26482913008897,65.53793705821761,68.43504495943694,NaN,NaN,50
1646857800,1.10764,1.10796,1.10624,1.10705,4502,7625.45,-378343,-373438.2,47.97455125162072,63.38882835026455,67.94413154184704,NaN,NaN,50
1646859600,1.10705,1.10712,1.10649,1.10678,1219,7323.8,-379562,-375233.6,47.705007507328766,62.38070806688827,67.00464728166556,NaN,NaN,50
1646861400,1.10678,1.10791,1.10664,1.10769,1346,7053.45,-378216,-376006.2,47.728370778533694,64.43375981833266,66.68194048064294,NaN,NaN,50
1646863200,1.10769,1.10769,1.10715,1.10718,2771,6851.05,-380987,-378189.8,47.75006524465255,62.37909118945896,66.59812847104764,NaN,NaN,50
1646865000,1.10718,1.10738,1.10679,1.1069,2098,6689,-383085,-380038.6,47.399959766577574,61.22476648033232,66.08165805249887,NaN,NaN,50
1646866800,1.1069,1.10784,1.1065,1.107,2315,6470.95,-380770,-380524,47.26252057024456,61.49879134026358,65.19117663154204,NaN,NaN,50
1646868600,1.107,1.1074,1.10683,1.10737,1388,6209.15,-379382,-380488,47.1348984593639,62.553265404942856,64.70619780823408,NaN,NaN,50
1646870400,1.10737,1.10738,1.10513,1.10513,2381,5443.5,-381763,-381197.4,45.30602881980243,53.075858181509,63.528228289799,NaN,NaN,50
1646872200,1.10513,1.10562,1.10472,1.10542,2117,4861.25,-379646,-380929.2,43.25189703092831,54.046574016161905,62.226345605826886,NaN,NaN,50
1646874000,1.10542,1.10581,1.10452,1.1046,3225,4589.8,-382871,-380886.4,41.1689721522223,50.84374437031963,61.055621258119594,NaN,NaN,50
1646875800,1.1046,1.10515,1.10416,1.10514,3141,4213,-379730,-380678.4,38.91484581296638,52.82632111442486,60.26316834311133,NaN,NaN,50
1646877600,1.10514,1.10539,1.10474,1.10511,2315,3832.5,-382045,-381211,36.99874295512548,52.699156273048715,59.48416568853845,NaN,NaN,50
1646879400,1.10511,1.1058,1.10511,1.10524,2525,3436.8,-379520,-380762.4,35.521028100814775,53.22461766734514,58.57952995225072,NaN,NaN,50
1646881200,1.10524,1.10546,1.10464,1.10471,2276,3204.75,-381796,-381192.4,33.68393409777378,50.74936390027467,57.52320329811193,NaN,NaN,50
1646883000,1.10471,1.10596,1.10453,1.1059,2784,2927.75,-379012,-380420.6,32.36624268585403,55.727811556079175,56.97598781281298,NaN,NaN,50
1646884800,1.1059,1.10609,1.10514,1.10567,2023,2724.95,-381035,-380681.6,31.24311961655438,54.57945474161065,56.41875543243601,NaN,NaN,50
1646886600,1.10567,1.10626,1.10528,1.1054,2066,2615.8,-383101,-380892.8,30.33615540950413,53.193702173088084,55.615894172061395,NaN,NaN,50
1646888400,1.1054,1.10573,1.1052,1.10538,1768,2515.8,-384869,-381962.6,29.397123287118603,53.08618225911743,54.95211496275129,NaN,NaN,50
1646890200,1.10538,1.10596,1.10533,1.1059,2143,2408.75,-382726,-382148.6,28.727472366174407,55.59910122155844,54.55028172998173,NaN,NaN,50
1646892000,1.1059,1.10676,1.10549,1.10644,2251,2332.7,-380475,-382441.2,28.75442441504253,58.10854925993642,54.30812158138692,NaN,NaN,50
1646893800,1.10644,1.10674,1.10522,1.10563,3157,2265.45,-383632,-382960.6,28.413894071611445,53.24717599665365,53.643400909366264,NaN,NaN,50
1646895600,1.10563,1.10644,1.10532,1.1059,5092,2459.1,-378540,-382048.4,28.09768732413972,54.610313135705766,53.75300483466604,NaN,NaN,50
1646897400,1.1059,1.1072,1.10586,1.1065,5726,2678.1,-372814,-379637.4,28.426179830126554,57.5708355326307,54.00473780012809,NaN,NaN,50
1646899200,1.1065,1.10652,1.10356,1.10445,10697,3074.4,-383511,-379794.4,26.637383215341604,46.4283576720992,53.68935303596949,NaN,NaN,50
1646901000,1.10445,1.10474,1.10264,1.10329,8544,3396.7,-392055,-382110.4,25.699911345687948,41.53020685514691,52.88248773173535,NaN,NaN,50
1646902800,1.10329,1.10802,1.10328,1.10529,14740,4017.95,-377315,-380847,25.226107223479826,51.10759193095347,52.768804564442824,NaN,NaN,50
1646904600,1.10529,1.10667,1.10358,1.10413,12711,4584.1,-390026,-383144.2,24.786146252858,46.363983705849364,52.27875928147885,NaN,NaN,50
1646906400,1.10413,1.1049,1.10314,1.1038,13237,5126.9,-403263,-389234,24.014083660848296,45.082043918988205,51.873950711386954,NaN,NaN,50
1646908200,1.1038,1.10383,1.10257,1.1035,7902,5416.15,-411165,-394764.8,22.839008667392694,43.89386270581555,51.02866865065384,NaN,NaN,50
1646910000,1.1035,1.10496,1.103,1.10452,10546,5782.2,-400619,-396477.6,22.45606997781797,48.831771514533614,50.61811984871976,NaN,NaN,50
1646911800,1.10452,1.10532,1.10376,1.10402,6708,5960.55,-407327,-402480,22.309700521444363,46.663734447501874,50.15169358260647,NaN,NaN,50
1646913600,1.10402,1.10493,1.10366,1.10454,6919,6190.75,-400408,-404556.4,22.083426900780808,49.19029061147546,49.873415607774895,NaN,NaN,50
1646915400,1.10454,1.11216,1.1033,1.10987,21536,7141.3,-378872,-399678.2,24.47206976634392,66.6361155340106,50.66177377295004,NaN,NaN,50
1646917200,1.10987,1.11058,1.10711,1.10835,15978,7826.4,-394850,-396415.2,26.690095284366812,60.27963826020339,50.8168515586834,NaN,NaN,50
1646919000,1.10835,1.11061,1.10515,1.10642,25274,8950.9,-420124,-400316.2,27.372913122432795,53.324128039850244,50.82234813319745,NaN,NaN,50
1646920800,1.10642,1.10702,1.10216,1.10245,18197,9759.6,-438321,-406515,26.360634663119654,42.468734815104774,49.955092538868804,NaN,NaN,50
1646922600,1.10245,1.10275,1.10002,1.10163,16984,10505.5,-455305,-417494.4,24.48798657872069,40.62895650450066,48.744958322573794,NaN,NaN,50
1646924400,1.10163,1.10236,1.10032,1.10039,11575,10995.85,-466880,-435096,22.7490990717788,37.951527590890066,48.13947045963029,NaN,NaN,50
1646926200,1.10039,1.10201,1.09802,1.10187,12379,11507.65,-454501,-447026.2,22.013085542011186,42.796893802853965,48.229948098752224,NaN,NaN,50
1646928000,1.10187,1.102,1.09959,1.10044,7659,11778.05,-462160,-455433.4,21.329644407226976,39.58072891740661,47.406600740641736,NaN,NaN,50
1646929800,1.10044,1.10113,1.10006,1.10067,6261,11933.25,-455899,-458949,20.69502049635592,40.35708577629944,46.97753660281675,NaN,NaN,50
1646931600,1.10067,1.10088,1.09933,1.09996,5102,11933.75,-461001,-460088.2,20.402574114499323,38.703775224129586,46.521945981755415,NaN,NaN,50
1646933400,1.09996,1.1006,1.099,1.09905,4140,11854.45,-465141,-459740.4,20.265561927217913,36.63235954223252,46.00326718435663,NaN,NaN,50
1646935200,1.09905,1.09928,1.09868,1.09924,3691,11504.15,-461450,-461130.2,20.272502534618727,37.38585952417989,45.1857020421885,NaN,NaN,50
1646937000,1.09924,1.0993,1.09866,1.09868,2795,11216.7,-464245,-461547.2,20.278947384348058,36.026130290369885,44.425873173821934,NaN,NaN,50
1646938800,1.09868,1.09938,1.09832,1.09876,3322,10645.8,-460923,-462552,20.441988965334982,36.38209836430732,43.511002299024206,NaN,NaN,50
1646940600,1.09876,1.09932,1.0983,1.09852,3361,10178.3,-464284,-463208.6,20.603042441895262,35.73961158766667,41.30410915999964,NaN,NaN,50
1646942400,1.09852,1.09911,1.09832,1.09852,2518,9642.35,-464284,-463037.2,20.752592098701236,35.73961158766667,39.5512501119613,NaN,NaN,50
1646944200,1.09852,1.09856,1.09765,1.09774,2319,9363.2,-466603,-464067.8,21.24223203402686,33.509160396770866,38.13589528031277,NaN,NaN,50
1646946000,1.09774,1.09854,1.09762,1.09838,1026,8887.2,-465577,-464334.2,21.712689198220808,36.98422006578527,37.744144226789956,NaN,NaN,50
1646947800,1.09838,1.0989,1.09836,1.09884,770,8590.3,-464807,-465111,21.80287398230605,39.43435139032449,37.658815290063096,NaN,NaN,50
1646949600,1.09884,1.09947,1.0985,1.099,301,8259.4,-464506,-465155.4,21.352523414310394,40.30377957847017,37.82683328917596,NaN,NaN,50
1646951400,1.099,1.09918,1.09872,1.0988,586,7211.9,-465092,-465317,20.934340744028717,39.53970549247038,37.59417698129141,NaN,NaN,50
1646953200,1.0988,1.09952,1.09865,1.09944,1149,6470.45,-463943,-464785,20.213021305110864,43.24744949537344,37.85608559400333,NaN,NaN,50
1646955000,1.09944,1.1015,1.09928,1.10134,2720,5342.75,-461223,-463914.2,19.594533352493155,52.55057262137343,38.72704894008005,NaN,NaN,50
1646956800,1.10134,1.1019,1.10082,1.10096,2741,4569.95,-463964,-463745.6,19.28618787485396,50.75845520591221,39.588097510207376,NaN,NaN,50
1646958600,1.10096,1.1013,1.0998,1.09982,2056,3823.55,-466020,-464048.4,18.146562358035055,45.721005548767494,40.23728651067415,NaN,NaN,50
1646960400,1.09982,1.10019,1.09806,1.09868,3102,3399.9,-469122,-464854.4,17.792848112839227,41.30628568583034,40.51731695079205,NaN,NaN,50
1646962200,1.09868,1.09964,1.09842,1.09878,3358,2948.85,-465764,-465218.6,17.464399170871673,41.83682226808781,40.93236637777189,NaN,NaN,50
1646964000,1.09878,1.10031,1.09874,1.1,2520,2691.9,-463244,-465622.8,16.62043768148885,48.011007527658585,41.7630027465827,NaN,NaN,50
1646965800,1.1,1.10022,1.09917,1.09946,2807,2519.2,-466051,-466040.2,15.83675915563337,45.698657451053,42.47436316539601,NaN,NaN,50
1646967600,1.09946,1.09984,1.09912,1.09967,2042,2366.2,-464009,-465638,15.147717014323266,46.77230234775124,43.26241250540205,NaN,NaN,50
1646969400,1.09967,1.1005,1.09938,1.10046,2121,2265.25,-461888,-464191.2,14.195464091452994,50.71974242378547,44.491739793045944,NaN,NaN,50
1646971200,1.10046,1.10054,1.10003,1.10054,1650,2163.2,-460238,-463086,13.345571642153764,51.11510912917681,45.50108901185963,NaN,NaN,50
1646973000,1.10054,1.10105,1.10008,1.10014,1836,2115.25,-462074,-462852,12.996061519321383,48.9983881880906,46.18423449741435,NaN,NaN,50
1646974800,1.10014,1.1004,1.09946,1.09952,2332,2065.75,-464406,-462523,12.081248334981598,45.830394612310386,46.57899271411723,NaN,NaN,50
1646976600,1.09952,1.10032,1.09936,1.09991,3254,2060.4,-461152,-461951.6,11.298303521312333,48.10339267916172,47.19068465602375,NaN,NaN,50
1646978400,1.09991,1.10078,1.09963,1.10071,2705,2069.75,-458447,-461263.4,10.85025712594912,52.50583536940691,47.85199793274042,NaN,NaN,50
1646980200,1.10071,1.10072,1.09986,1.10041,3405,2124.05,-461852,-461586.2,10.434214044540424,50.766637115303475,47.72457396802114,NaN,NaN,50
1646982000,1.10041,1.10089,1.09928,1.09963,5338,2339.65,-467190,-462609.4,9.942234457241526,46.45781713605242,47.41738553445973,NaN,NaN,50
1646983800,1.09963,1.10034,1.0981,1.09837,5460,2574.15,-472650,-464258.2,10.530533007811972,40.480738055283254,47.043080713496565,NaN,NaN,50
1646985600,1.09837,1.09922,1.09714,1.09816,9367,3027.45,-482017,-468431.2,11.762458816453828,39.567051318005014,46.91884968722332,NaN,NaN,50
1646987400,1.09816,1.09823,1.0966,1.09784,6359,3316.1,-488376,-474417,13.248681925379193,38.15385439305437,46.65578055329237,NaN,NaN,50
1646989200,1.09784,1.09859,1.09662,1.09764,5932,3555.25,-494308,-480908.2,14.198169441106664,37.258169574437176,45.887720699490835,NaN,NaN,50
1646991000,1.09764,1.09773,1.09602,1.09674,6121,3725.3,-500429,-487556,15.475758403786452,33.45240956956526,45.012988707956005,NaN,NaN,50
1646992800,1.09674,1.0983,1.0966,1.09816,4886,3832.55,-495543,-492134.6,15.985958091070582,43.29427279726158,44.764558025778165,NaN,NaN,50
1646994600,1.09816,1.09852,1.09746,1.09792,4427,3951.1,-499970,-495725.2,16.20636466493651,42.15940049283543,44.15310503071031,NaN,NaN,50
1646996400,1.09792,1.10436,1.09791,1.101,10172,4304.6,-489798,-496009.6,17.536205801054226,57.54123316980661,44.61211389075529,NaN,NaN,50
1646998200,1.101,1.10378,1.10016,1.1011,17860,5029.7,-471938,-491535.6,18.771058284592105,57.93239551928937,45.2502572715552,NaN,NaN,50
1647000000,1.1011,1.10322,1.10098,1.10202,9669,5387.15,-462269,-483903.6,19.91770701930585,61.45103597378061,46.36601736880307,NaN,NaN,50
1647001800,1.10202,1.10213,1.09737,1.09867,10272,5760.4,-472541,-479303.2,18.50145279935286,46.27350391437831,46.2353110284614,NaN,NaN,50
1647003600,1.09867,1.0998,1.09855,1.09936,10576,6187.1,-461965,-471702.2,17.186359595110797,49.06402641547716,45.98946753175213,NaN,NaN,50
1647005400,1.09936,1.10112,1.09887,1.09982,7716,6466.85,-454249,-464592.4,16.659753143581952,50.895138487393346,45.99864620118712,NaN,NaN,50
1647007200,1.09982,1.10016,1.098,1.0986,6547,6711.7,-460796,-462364,15.656006762674219,46.155942984413024,45.97708376178431,NaN,NaN,50
1647009000,1.0986,1.09932,1.09732,1.09818,9936,7116.7,-470732,-464056.6,14.73514315332007,44.61569677976254,46.27243795638997,NaN,NaN,50
1647010800,1.09818,1.09824,1.0956,1.09594,11502,7575.2,-482234,-465995.2,14.746831092792952,37.43975469457883,46.12048819757382,NaN,NaN,50
1647012600,1.09594,1.09684,1.0946,1.09652,9792,7902.1,-472442,-468090.6,15.198235815772781,40.12510334784086,46.26129169434428,NaN,NaN,50
1647014400,1.09652,1.09699,1.09342,1.0937,8851,8209.4,-481293,-473499.4,16.09287158285965,32.76175711572441,45.9401193758648,NaN,NaN,50
1647016200,1.0937,1.09469,1.09287,1.09358,8808,8479.55,-490101,-479360.4,17.13326915132872,32.48854114054602,45.871271630934864,NaN,NaN,50
1647018000,1.09358,1.09368,1.09202,1.09208,5139,8469.6,-495240,-484262,18.41293712001418,29.20942630120004,44.865211166930465,NaN,NaN,50
1647019800,1.09208,1.09254,1.09128,1.09164,3626,8377.9,-498866,-487588.4,19.86115852953105,28.30689000910803,43.87574613237852,NaN,NaN,50
1647021600,1.09164,1.09216,1.091,1.09119,3370,8078.05,-502236,-493547.2,21.303696855710694,27.375258026505293,41.721033622142706,NaN,NaN,50
1647023400,1.09119,1.09132,1.0902,1.09034,3122,7916.2,-505358,-498360.2,22.918384467294214,25.657516021007098,39.41568508655111,NaN,NaN,50
1647025200,1.09034,1.09134,1.0903,1.0912,3587,7798.95,-501771,-500694.2,24.399981002683905,30.41502276964738,37.19882700054159,NaN,NaN,50
1647027000,1.0912,1.0913,1.09062,1.09093,3208,7653.3,-504979,-502642,25.775749214117187,29.770877274625633,36.02006795484497,NaN,NaN,50
1647028800,1.09093,1.0913,1.09054,1.09102,2945,7556.25,-502034,-503275.6,27.085239902949247,30.300769127473814,34.67983529141616,NaN,NaN,50
1647030600,1.09102,1.09138,1.09062,1.09108,2940,7481.9,-499094,-502647.2,28.21381844272568,30.6762995794421,33.23563251227679,NaN,NaN,50
1647032400,1.09108,1.09166,1.09098,1.09138,1722,7059.4,-497372,-501050,28.94535960066113,32.630788995917726,32.269550084527125,NaN,NaN,50
1647034200,1.09138,1.09168,1.09088,1.09124,1789,6255.85,-499161,-500528,29.676450373074726,32.17489881289191,31.380921658322077,NaN,NaN,50
1647205200,1.09124,1.09278,1.09124,1.09248,169,5780.85,-498992,-499330.6,29.13754491731129,40.15063118830542,31.57455569358826,NaN,NaN,50
1647207000,1.09248,1.09248,1.09171,1.09184,126,5273.55,-499118,-498747.4,28.63713270838809,37.68732494850818,31.400428665064503,NaN,NaN,50
1647208800,1.09184,1.09364,1.09102,1.0936,2123,4850.9,-496995,-498327.6,27.035820582937696,47.268402129505056,32.43661759462026,NaN,NaN,50
1647210600,1.0936,1.0936,1.09255,1.09278,1911,4560.65,-498906,-498634.4,25.548887895019472,43.882928660218724,33.25050241745402,NaN,NaN,50
1647212400,1.09278,1.09361,1.09257,1.09336,2292,4347.9,-496614,-498125,24.158294099538757,46.78609834570562,34.505978992061564,NaN,NaN,50
1647214200,1.09336,1.0939,1.09282,1.09318,1665,3934.35,-498279,-497982.4,22.57118382868824,45.99089449596795,35.76912216969442,NaN,NaN,50
1647216000,1.09318,1.09328,1.092,1.09283,4397,3579.1,-502676,-498694,21.8417200088442,44.410282045755345,36.985909599640856,NaN,NaN,50
1647217800,1.09283,1.09316,1.0922,1.09292,3347,3256.85,-499329,-499160.8,21.164360747560444,44.93435700030556,38.36282681244789,NaN,NaN,50
1647219600,1.09292,1.09377,1.09214,1.09286,4543,3041.45,-503872,-500154,19.8614179201388,44.632263575873694,39.378344012892626,NaN,NaN,50
1647221400,1.09286,1.09291,1.0913,1.09172,4975,2849.8,-508847,-502600.6,19.419448482542855,39.23498847777286,40.05435195597456,NaN,NaN,50
1647223200,1.09172,1.0918,1.09091,1.09119,3880,2786.85,-512727,-505490.2,19.332566906259107,36.995104119438615,40.53251874111491,NaN,NaN,50
1647225000,1.09119,1.0913,1.09006,1.09096,4315,2821.3,-517042,-508363.4,19.892504653411088,36.033718117869505,40.91519149385972,NaN,NaN,50
1647226800,1.09096,1.09123,1.09072,1.09099,2285,2767.05,-514757,-511449,20.41244684719507,36.26636665170974,41.17487561213058,NaN,NaN,50
1647228600,1.09099,1.09119,1.09043,1.09046,2869,2754.4,-517626,-514199.8,21.111553781541854,33.919249611195994,41.29947209772373,NaN,NaN,50
1647230400,1.09046,1.0909,1.09012,1.09024,1537,2651.9,-519163,-516263,21.988475935860908,32.96552670772641,40.786250349110944,NaN,NaN,50
1647232200,1.09024,1.09174,1.0902,1.09173,1903,2586.65,-517260,-517169.6,21.682084071199778,44.373445216723944,41.26383036826922,NaN,NaN,50
1647234000,1.09173,1.09183,1.09106,1.09142,2472,2563,-519732,-517707.6,21.28500590649222,42.743625115533035,40.940632010128354,NaN,NaN,50
1647235800,1.09142,1.09177,1.09086,1.09114,1671,2499.55,-521403,-519036.8,21.102315796465547,41.26919714320049,40.75393690176991,NaN,NaN,50
1647237600,1.09114,1.09223,1.09094,1.09222,2331,2530,-519072,-519326,20.327035833305064,48.62980722784818,40.88563039335152,NaN,NaN,50
1647239400,1.09222,1.09231,1.09162,1.09176,2668,2573.95,-521740,-519841.4,19.50319319757707,45.98621595980429,40.88529621219698,NaN,NaN,50
1647241200,1.09176,1.09243,1.09108,1.09238,5089,2819.95,-516651,-519719.6,19.308539374410127,49.93652686120599,41.280027984729166,NaN,NaN,50
1647243000,1.09238,1.09406,1.09232,1.09318,5231,3075.2,-511420,-518057.2,18.57885474920032,54.55497432306878,41.96721493635511,NaN,NaN,50
1647244800,1.09318,1.09497,1.09302,1.09495,7415,3339.8,-504005,-514577.6,18.664519651491474,62.74410800693986,43.2609181100027,NaN,NaN,50
1647246600,1.09495,1.096,1.09465,1.09566,6657,3577.1,-497348,-510232.8,19.462158144150088,65.43477965859651,45.13233176577581,NaN,NaN,50
1647248400,1.09566,1.09675,1.09518,1.09622,6203,3772.65,-491145,-504113.8,20.65128846181604,67.43262928460663,47.306440706144954,NaN,NaN,50
1647250200,1.09622,1.099,1.09586,1.09824,7277,4053.25,-483868,-497557.2,22.77888105168217,73.40415476587934,49.97575760957424,NaN,NaN,50
1647252000,1.09824,1.09842,1.09686,1.09696,6348,4150.8,-490216,-493316.4,24.754502742272148,65.24085875895284,52.04536418866302,NaN,NaN,50
1647253800,1.09696,1.09724,1.09592,1.09606,4856,4226.25,-495072,-491529.8,25.53586748594044,60.17365339569568,53.92067874469871,NaN,NaN,50
1647255600,1.09606,1.09668,1.09498,1.09526,5193,4258.75,-500265,-492113.2,25.33608892498872,56.00935743293711,55.56666665364234,NaN,NaN,50
1647257400,1.09526,1.09572,1.09402,1.09432,5878,4303.9,-506143,-495112.8,24.317502065426126,51.49951950434696,56.07567195990112,NaN,NaN,50
1647259200,1.09432,1.0959,1.09429,1.09558,5214,4370.6,-500929,-498525,23.491250377872333,56.549841666074826,57.06183028493982,NaN,NaN,50
1647261000,1.09558,1.0965,1.09508,1.09576,7644,4537.05,-493285,-499138.8,23.118531373259415,57.23493357103941,58.20224002978546,NaN,NaN,50
1647262800,1.09576,1.0962,1.0944,1.09518,6212,4733.4,-499497,-500023.8,22.16652978974851,54.26583812168887,58.604813665059794,NaN,NaN,50
1647264600,1.09518,1.09558,1.0935,1.0943,7371,4958.5,-506868,-501344.4,20.611212664786077,50.025560413378386,58.89333826888652,NaN,NaN,50
1647266400,1.0943,1.0968,1.09394,1.09644,7027,5233,-499841,-500084,19.966085106607764,58.51492929404886,59.506081299803874,NaN,NaN,50
1647268200,1.09644,1.09718,1.0963,1.09653,6360,5455.85,-493481,-498594.4,19.609950753037204,58.83167018933218,59.81155957596554,NaN,NaN,50
1647270000,1.09653,1.09754,1.09616,1.09676,5153,5589.9,-488328,-497603,19.508554878730727,59.67892571492007,59.59261798367841,NaN,NaN,50
1647271800,1.09676,1.09864,1.09676,1.09792,7843,5898.5,-480485,-493800.6,20.060207106917975,63.73288185224374,59.47105385465322,NaN,NaN,50
1647273600,1.09792,1.09916,1.0976,1.09908,6314,6097.65,-474171,-487261.2,20.8493175293804,67.27609116160913,59.459872560153386,NaN,NaN,50
1647275400,1.09908,1.0994,1.0968,1.09742,6267,6277.6,-480438,-483380.6,20.822626371110037,58.47231782000937,58.39331277830553,NaN,NaN,50
1647277200,1.09742,1.09794,1.0964,1.09712,5196,6282.95,-485634,-481811.2,20.43779785665438,57.02009293866587,57.8061152197136,NaN,NaN,50
1647279000,1.09712,1.09775,1.09662,1.0975,4239,6233.35,-481395,-480424.6,20.080457093231267,58.42849401060558,57.68146097792145,NaN,NaN,50
1647280800,1.0975,1.09763,1.0964,1.09641,3569,6041.05,-484964,-481320.4,19.534308507956407,53.05771815356031,57.47062960082311,NaN,NaN,50
1647282600,1.09641,1.09684,1.09568,1.09579,3183,5867.35,-488147,-484115.6,18.35314960988857,50.22944969321626,57.379910328599486,NaN,NaN,50
1647284400,1.09579,1.09664,1.0956,1.09592,3583,5736.35,-484564,-484940.8,17.183210623171227,50.82139908352119,56.970735858417086,NaN,NaN,50
1647286200,1.09592,1.09593,1.09457,1.09496,2926,5518.8,-487490,-485312,16.697327594886836,46.42981084462516,56.19894137795893,NaN,NaN,50
1647288000,1.09496,1.09537,1.09444,1.0951,1184,5260.6,-486306,-486294.2,16.34985986865834,47.147085398927764,55.69045904061885,NaN,NaN,50
1647289800,1.0951,1.09524,1.09396,1.094,1104,5073,-487410,-486783.4,16.408359084206573,42.349131353766325,55.14214267921799,NaN,NaN,50
1647291600,1.094,1.09537,1.09308,1.09452,1018,4864.25,-486392,-486432.4,17.094196625669486,45.188788933184235,54.190275510584804,NaN,NaN,50
1647293400,1.09452,1.09463,1.0942,1.09445,355,4588.1,-486747,-486869,17.73104577131362,44.868398114032615,53.19289893377769,NaN,NaN,50
1647295200,1.09445,1.09492,1.0943,1.09452,693,4362.05,-486054,-486581.8,17.969615782701673,45.28616231488165,52.16484440520352,NaN,NaN,50
1647297000,1.09452,1.09478,1.09336,1.09359,2184,4089.05,-488238,-486968.2,18.869676058400273,40.85658519306331,50.53082321526205,NaN,NaN,50
1647298800,1.09359,1.09379,1.09308,1.09343,1993,3878.1,-490231,-487532.4,19.88979530112477,40.129340618784006,48.591769605060264,NaN,NaN,50
1647300600,1.09343,1.09455,1.09342,1.09428,1755,3597.3,-488476,-487949.2,19.90490194987839,45.662829834473925,47.67680617752201,NaN,NaN,50
1647302400,1.09428,1.09554,1.09428,1.09524,1640,3327.95,-486836,-487967,18.882010304943712,51.153842242609585,47.257788270660846,NaN,NaN,50
1647304200,1.09524,1.09552,1.09483,1.09504,2400,3129.95,-489236,-488603.4,17.932182348932944,50.01977045015427,46.657165159200034,NaN,NaN,50
1647306000,1.09504,1.0956,1.09409,1.09468,4117,3078.15,-493353,-489626.4,17.68983070372908,47.95872710718197,46.292951513030154,NaN,NaN,50
1647307800,1.09468,1.09553,1.09376,1.09548,5192,2945.6,-488161,-489212.4,17.73072471411355,52.62986044435866,46.46440942382604,NaN,NaN,50
1647309600,1.09548,1.09694,1.09536,1.09692,6521,2955.95,-481640,-487845.2,16.57037007422382,59.650403930221245,47.09505262716175,NaN,NaN,50
1647311400,1.09692,1.0977,1.0967,1.09713,4379,2861.55,-477261,-485930.2,16.11469717087035,60.56821644838902,48.10493874171631,NaN,NaN,50
1647313200,1.09713,1.09806,1.09689,1.0976,3047,2754.1,-474214,-482925.8,15.968264388759689,62.61769826947996,49.209982518184326,NaN,NaN,50
1647315000,1.0976,1.09804,1.09734,1.09776,2897,2687,-471317,-478518.6,15.832291091085505,63.31669147743742,50.707665384160826,NaN,NaN,50
1647316800,1.09776,1.0981,1.09748,1.09775,1735,2595.3,-473052,-475496.8,15.756783064709252,63.23710421030027,51.99683076109769,NaN,NaN,50
1647318600,1.09775,1.09854,1.09774,1.09825,1699,2521.1,-471353,-473439.4,16.05980674048885,65.5675951686708,53.47534483642899,NaN,NaN,50
1647320400,1.09825,1.0985,1.09788,1.09794,1847,2434.3,-473200,-472627.2,16.34118586799848,62.90503464941214,54.73383571746688,NaN,NaN,50
1647322200,1.09794,1.09836,1.09781,1.0983,2463,2411.15,-470737,-471931.8,16.50661202151797,64.69785517328239,56.43678357319681,NaN,NaN,50
1647324000,1.0983,1.09838,1.09737,1.0981,2801,2492,-473538,-472376,16.06376937422924,62.879644912431246,58.06180530845733,NaN,NaN,50
1647325800,1.0981,1.09812,1.097,1.0971,3369,2605.25,-476907,-473147,15.180509733498187,54.61505541102586,58.70124999249675,NaN,NaN,50
1647327600,1.0971,1.10199,1.09668,1.10004,11983,3153.5,-464924,-471861.2,17.131984113564585,67.9517355651379,59.90109951553449,NaN,NaN,50
1647329400,1.10004,1.10156,1.09912,1.10052,9720,3621.75,-455204,-468262,18.94406746648338,69.52622852494713,61.29441794944826,NaN,NaN,50
1647331200,1.10052,1.10194,1.09914,1.09936,11376,4155.9,-466580,-467430.6,20.806901810512667,61.64433096032433,62.27196108181557,NaN,NaN,50
1647333000,1.09936,1.1006,1.09878,1.10038,7065,4399.95,-459515,-464626,22.092877060239875,65.36270403219913,63.18144990951849,NaN,NaN,50
1647334800,1.10038,1.1004,1.0993,1.0993,4748,4537.7,-464263,-462097.2,23.28699693498657,58.8565213166329,63.1247440085479,NaN,NaN,50
1647336600,1.0993,1.10076,1.09912,1.10056,5306,4715.25,-458957,-460903.8,24.602709737752576,63.43005634130078,63.32916114375588,NaN,NaN,50
1647338400,1.10056,1.10056,1.09951,1.09958,5324,4899.45,-464281,-462719.2,25.82444305460673,58.02720671905379,63.001268890154016,NaN,NaN,50
1647340200,1.09958,1.09994,1.09926,1.09951,4764,5017.65,-469045,-463212.2,26.587198006688663,57.64947816948555,62.59646793958603,NaN,NaN,50
1647342000,1.09951,1.09972,1.09792,1.09826,4247,5024.15,-473292,-465967.6,25.59012774400128,51.235653522084625,61.73922146185634,NaN,NaN,50
1647343800,1.09826,1.09892,1.0978,1.09838,4265,4977.8,-469027,-466920.4,24.530828417693655,51.79016843739188,60.755119552479265,NaN,NaN,50
1647345600,1.09838,1.0997,1.09838,1.09934,5736,4938.55,-463291,-467787.2,24.21034769613195,56.0917812179079,60.26845859308611,NaN,NaN,50
1647347400,1.09934,1.10043,1.09888,1.09904,7692,5104.2,-470983,-469127.6,24.454774722057266,54.45654503197843,59.53693644013583,NaN,NaN,50
1647349200,1.09904,1.0995,1.09828,1.09846,6336,5268.65,-477319,-470782.4,23.97525524156104,51.34030349924185,58.712697767765164,NaN,NaN,50
1647351000,1.09846,1.1,1.09739,1.09974,8817,5564.65,-468502,-469824.4,22.60356156865084,57.16586377511273,58.894898365199936,NaN,NaN,50
1647352800,1.09974,1.09998,1.09846,1.09858,6401,5797.95,-474903,-470999.6,21.32984601523422,51.1852490221956,57.6972921835612,NaN,NaN,50
1647354600,1.09858,1.09894,1.09774,1.0983,5532,5989.6,-480435,-474428.4,20.166467287327936,49.83010459942885,56.29042618888133,NaN,NaN,50
1647356400,1.0983,1.09869,1.09668,1.09729,5655,6180,-486090,-477449.8,19.963247918776702,45.18318043651541,55.114629722894975,NaN,NaN,50
1647358200,1.09729,1.09858,1.0963,1.09727,10027,6558.2,-496117,-481209.4,20.05534558916778,45.09350343686743,53.66682968037128,NaN,NaN,50
1647360000,1.09727,1.09758,1.09404,1.09549,10590,6947.65,-506707,-488850.4,21.45395491730268,37.886378430822816,52.16896233138484,NaN,NaN,50
1647361800,1.09549,1.09608,1.09381,1.09514,7886,7173.5,-514593,-496788.4,22.86022822957128,36.64612935413505,50.25582468944443,NaN,NaN,50
1647363600,1.09514,1.0954,1.09454,1.09518,4419,6795.3,-510174,-502736.2,24.16605344810641,36.90036083405369,48.746764269087286,NaN,NaN,50
1647365400,1.09518,1.0952,1.09368,1.09384,3396,6479.1,-513570,-508232.2,25.789023356075457,32.23379776953979,46.93135852623402,NaN,NaN,50
1647367200,1.09384,1.0943,1.09281,1.0931,3690,6094.8,-517260,-512460.8,27.660758932423818,29.979059504781375,45.413030382140924,NaN,NaN,50
1647369000,1.0931,1.09424,1.09261,1.09405,3849,5934,-513411,-513801.6,29.478509177047425,36.153509234988576,44.29612615339783,NaN,NaN,50
1647370800,1.09405,1.09494,1.09397,1.09484,2663,5829.75,-510748,-513032.6,30.285392743073707,40.82640849118512,43.20574238720335,NaN,NaN,50
1647372600,1.09484,1.09532,1.09466,1.09528,3153,5722.1,-507595,-512516.8,30.582372849906296,43.31485833198835,42.40990762291834,NaN,NaN,50
1647374400,1.09528,1.09542,1.09437,1.09445,1076,5509.7,-508671,-511537,31.025066326151958,39.905708514064095,41.59315083826278,NaN,NaN,50
1647376200,1.09445,1.09522,1.09418,1.09522,751,5309.05,-507920,-509669,31.54693180482942,44.28663433908158,40.67320587854626,NaN,NaN,50
1647378000,1.09522,1.09548,1.09518,1.09532,871,5140.25,-507049,-508396.6,31.68672910853324,44.84895031423714,40.22061311369209,NaN,NaN,50
1647379800,1.09532,1.09534,1.09486,1.09508,501,4952.05,-507550,-507757,32.02651090253838,43.70873929972413,39.78337273514176,NaN,NaN,50
1647381600,1.09508,1.09634,1.09497,1.09603,912,4710.85,-506638,-507565.6,31.079857578998244,49.21281202060426,40.07120356257667,NaN,NaN,50
1647383400,1.09603,1.0965,1.09536,1.0965,937,4373.1,-505701,-506971.6,30.015639080734,51.72759801755472,40.5450674611972,NaN,NaN,50
1647385200,1.0965,1.09652,1.09588,1.09594,961,4104.35,-506662,-506720,29.003123248348793,48.637361463329654,41.31299482066196,NaN,NaN,50
1647387000,1.09594,1.09742,1.09578,1.0967,2024,3764.7,-504638,-506237.8,27.03419902839157,52.76187132751312,42.46411924733183,NaN,NaN,50
1647388800,1.0967,1.09722,1.09632,1.09662,2447,3567,-507085,-506144.8,25.205912252717006,52.28591097431766,43.56308711449354,NaN,NaN,50
1647390600,1.09662,1.09702,1.09552,1.0957,2496,3415.2,-509581,-506733.4,24.30803813259512,47.03152281723584,44.62006747504326,NaN,NaN,50
1647392400,1.0957,1.0965,1.0956,1.09592,4146,3339.75,-505435,-506680.2,23.474297878196225,48.367743277547234,45.933544887383675,NaN,NaN,50
1647394200,1.09592,1.09698,1.0959,1.09671,3512,3014,-501923,-505732.4,22.110674403962797,52.95702292098515,47.133795864954855,NaN,NaN,50
1647396000,1.09671,1.09749,1.09655,1.09745,2947,2631.85,-498976,-504600,20.794922028744136,56.82795333298013,48.27676335365451,NaN,NaN,50
1647397800,1.09745,1.09774,1.09696,1.09713,2395,2357.3,-501371,-503457.2,19.843023958391175,54.730683175005964,49.09217941387005,NaN,NaN,50
1647399600,1.09713,1.09729,1.09668,1.09678,2000,2236.35,-503371,-502215.2,18.612308160112097,52.450625748958544,49.98824493064823,NaN,NaN,50
1647401400,1.09678,1.0971,1.0967,1.09672,2107,2171.9,-505478,-502223.8,17.46950063313866,52.05030684438472,50.54279296674132,NaN,NaN,50
1647403200,1.09672,1.09693,1.09658,1.09686,1397,2057.25,-504081,-502655.4,16.247345912350227,52.95260990577595,51.12162579470837,NaN,NaN,50
1647405000,1.09686,1.09697,1.09664,1.0968,1142,1921.9,-505223,-503904.8,15.168161520158034,52.496671407864866,51.74933523100414,NaN,NaN,50
1647406800,1.0968,1.0974,1.09647,1.09725,1872,1882.35,-503351,-504300.8,14.75244591164779,55.58547213211284,52.20452523896904,NaN,NaN,50
1647408600,1.09725,1.0978,1.09712,1.09775,2377,1843.55,-500974,-503821.4,14.86370922385836,58.791688604586255,52.70910313804272,NaN,NaN,50
1647410400,1.09775,1.09776,1.0971,1.09766,3364,1957.95,-504338,-503593.4,14.93281078293614,57.98034323556957,53.376458978917,NaN,NaN,50
1647412200,1.09766,1.09824,1.09724,1.0979,3136,2077.2,-501202,-503017.6,15.57535165636161,59.582172448664565,53.863623344713524,NaN,NaN,50
1647414000,1.0979,1.098,1.09646,1.09698,5198,2293.55,-506400,-503253,14.896461701905658,51.48061195851193,53.806101986441696,NaN,NaN,50
1647415800,1.09698,1.09702,1.09559,1.09583,4122,2474.6,-510522,-504687.2,14.516680169915414,43.51551341665636,53.554958457828874,NaN,NaN,50
1647417600,1.09583,1.09998,1.09582,1.0991,11491,3003.55,-499031,-504298.6,15.542116773197895,61.67388350735725,54.505397045672446,NaN,NaN,50
1647419400,1.0991,1.10056,1.09857,1.09908,10551,3484.25,-509582,-505347.4,16.844573935668333,61.54356764791371,55.11872166902448,NaN,NaN,50
1647421200,1.09908,1.10014,1.09846,1.09852,5488,3710.6,-515070,-508121,17.921314371620475,57.85722028999496,55.19224073738269,NaN,NaN,50
1647423000,1.09852,1.09895,1.098,1.09868,4207,3819.75,-510863,-509013.6,18.36657905610053,58.61986477097905,55.470039422809336,NaN,NaN,50
1647424800,1.09868,1.10147,1.09846,1.10004,8407,4117.75,-502456,-507400.4,20.176286804696492,64.50050647877694,56.330745189224935,NaN,NaN,50
1647426600,1.10004,1.10054,1.09926,1.09992,6396,4312.75,-508852,-509364.6,21.85672971410703,63.641102168353115,57.15865914093696,NaN,NaN,50
1647428400,1.09992,1.10108,1.09983,1.10058,5658,4388.35,-503194,-508087,23.659202058880847,66.3006244263806,58.11208874955158,NaN,NaN,50
1647430200,1.10058,1.10248,1.10058,1.10124,5602,4492.85,-497592,-504591.4,25.876694383883038,68.76138507244153,59.27385401130706,NaN,NaN,50
1647432000,1.10124,1.10138,1.09994,1.10026,4878,4589.4,-502470,-502912.8,27.204819375241357,61.571913171045864,59.701456942659426,NaN,NaN,50
1647433800,1.10026,1.10056,1.09822,1.09892,8441,4891.7,-510911,-504603.8,26.77988169548303,53.35693104765961,59.31325997430752,NaN,NaN,50
1647435600,1.09892,1.1001,1.09856,1.09896,5704,5076.9,-505207,-503874.8,26.385296707136018,53.55613237563945,58.99724491288394,NaN,NaN,50
1647437400,1.09896,1.10057,1.09859,1.10001,6902,5316.65,-498305,-502897,26.291444729870587,58.55931163437195,58.92418342614875,NaN,NaN,50
1647439200,1.10001,1.104,1.09912,1.10266,13778,5935.7,-484527,-500284,27.6803847252605,67.94480933428773,60.10019752441845,NaN,NaN,50
1647441000,1.10266,1.10278,1.09868,1.10174,15617,6659.45,-500144,-499818.8,28.58805009739281,62.64068740966908,61.46628138106222,NaN,NaN,50
1647442800,1.10174,1.1022,1.09968,1.10022,10235,7077.6,-510379,-499712.4,29.43088222865852,55.0011134495587,60.989654948362315,NaN,NaN,50
1647444600,1.10022,1.10076,1.09904,1.0992,8544,7385.95,-518923,-502455.6,29.628850799504384,50.546170470313,60.20412657853369,NaN,NaN,50
1647446400,1.0992,1.10095,1.09915,1.1009,7569,7596.2,-511354,-505065.4,29.901297710231855,56.82320481242148,60.130268330135586,NaN,NaN,50
1647448200,1.1009,1.10136,1.09987,1.1001,5683,7723.55,-517037,-511567.4,30.34820903812068,53.38895601501282,59.75663199042372,NaN,NaN,50
1647450000,1.1001,1.1002,1.09872,1.09896,4528,7690.05,-521565,-515851.6,29.696309035868275,48.85750906853463,58.63927503254927,NaN,NaN,50
1647451800,1.09896,1.09974,1.09826,1.09835,5237,7745.8,-526802,-519136.2,28.70026903939341,46.579327408738976,57.42057683543397,NaN,NaN,50
1647453600,1.09835,1.10002,1.09516,1.09643,23362,8339.35,-550164,-525384.4,27.564777774656175,40.22197231589844,55.55781597039953,NaN,NaN,50
1647455400,1.09643,1.10106,1.095,1.10006,23496,8986.6,-526668,-528447.2,25.85102428881636,53.221313896393454,54.447810886396105,NaN,NaN,50
1647457200,1.10006,1.10274,1.09932,1.10261,16139,9519.15,-510529,-527145.6,24.671311074652852,59.82980033457666,54.32337425521973,NaN,NaN,50
1647459000,1.10261,1.10451,1.10147,1.1045,7107,9664.15,-503422,-523517,24.378121836522016,63.900436118285796,55.076481760264464,NaN,NaN,50
1647460800,1.1045,1.1047,1.10338,1.10366,2920,9389.8,-506342,-519425,24.18598113450988,60.944500680827694,55.60422235349218,NaN,NaN,50
1647462600,1.10366,1.104,1.10318,1.10354,1079,9123.95,-507421,-510876.4,23.87064119722247,60.51384270253097,55.74383171550354,NaN,NaN,50
1647464400,1.10354,1.10368,1.10326,1.1033,185,8850.3,-507606,-507064,23.57782554116987,59.60663391085327,55.14824775668679,NaN,NaN,50
1647466200,1.1033,1.10336,1.10306,1.1032,141,8577.25,-507747,-506507.6,23.152432131078406,59.2083352828544,54.90307974762861,NaN,NaN,50
1647468000,1.1032,1.1032,1.10078,1.10204,2063,8436.5,-509810,-507785.2,21.756511743362253,54.64669740503914,54.87776431587721,NaN,NaN,50
1647469800,1.10204,1.1021,1.1012,1.10181,1603,8094.6,-511413,-508799.4,20.460299954768683,53.7622541877962,55.107484581411725,NaN,NaN,50
1647471600,1.10181,1.1025,1.10169,1.10196,1145,7866.65,-510268,-509368.8,19.00320544544765,54.28194127146016,54.92596575705735,NaN,NaN,50
1647473400,1.10196,1.10226,1.10163,1.10216,1027,7572.9,-509241,-509695.8,17.682147057959522,55.008053041860165,55.0416155446893,NaN,NaN,50
1647475200,1.10216,1.10344,1.10204,1.10305,2610,7014.5,-506631,-509472.6,17.154966448672223,58.19032424936188,55.70824520046267,NaN,NaN,50
1647477000,1.10305,1.10525,1.10305,1.10515,4368,6452.05,-502263,-507963.2,17.63202480845409,64.5599100161449,56.992572529563084,NaN,NaN,50
1647478800,1.10515,1.1052,1.10396,1.10408,4168,6148.7,-506431,-506966.8,18.075007571108685,59.57933793764748,58.375241502545165,NaN,NaN,50
1647480600,1.10408,1.10438,1.10298,1.1036,4989,5970.95,-511420,-507197.2,17.720923797708732,57.438605718847874,58.67647663272049,NaN,NaN,50
1647482400,1.1036,1.10401,1.1031,1.10368,3328,5758.9,-508092,-506967.4,17.39213172240877,57.71133020362913,58.5251573376528,NaN,NaN,50
1647484200,1.10368,1.10426,1.10306,1.10418,2815,5615.5,-505277,-506696.6,17.24174159049964,59.45980284187582,58.207969246480666,NaN,NaN,50
1647486000,1.10418,1.10422,1.10335,1.10342,2603,5519.25,-507880,-507820,17.10209361086973,55.69063678807973,57.832693254141525,NaN,NaN,50
1647487800,1.10342,1.10382,1.10327,1.10352,1997,5357.25,-505883,-507710.4,16.896831004445374,56.08509845962023,57.5163543796479,NaN,NaN,50
1647489600,1.10352,1.10388,1.10302,1.1031,1674,4272.85,-507557,-506937.8,16.4617304976977,53.91416669632239,57.10974957860998,NaN,NaN,50
1647491400,1.1031,1.10386,1.10304,1.10346,1435,3169.8,-506122,-506543.8,16.057708598574862,55.504021069846466,56.84515570625227,NaN,NaN,50
1647493200,1.10346,1.10347,1.10256,1.1027,1927,2459.2,-508049,-507098.2,15.187457730325624,51.467400665403936,56.61806308199262,NaN,NaN,50
1647495000,1.1027,1.10284,1.10234,1.10236,1927,2200.2,-509976,-507517.4,14.157144823525995,49.725115369621605,56.32969602355157,NaN,NaN,50
1647496800,1.10236,1.10317,1.10222,1.103,2133,2160.85,-507843,-507909.4,13.527548327496747,52.953603131743954,56.234814727857554,NaN,NaN,50
1647498600,1.103,1.10389,1.10272,1.10364,2680,2240.9,-505163,-507430.6,13.604353303033264,55.996714519727334,56.30543340484807,NaN,NaN,50
1647500400,1.10364,1.10439,1.10356,1.1041,4432,2453.25,-500731,-506352.4,14.091516919363462,58.094794304369074,56.29860983734858,NaN,NaN,50
1647502200,1.1041,1.1046,1.10302,1.10445,3694,2630.9,-497037,-504150,13.911947450486567,59.67042850459924,55.94936115795246,NaN,NaN,50
1647504000,1.10445,1.10674,1.10397,1.1057,7363,2895.9,-489674,-500089.6,15.252790465339586,64.76582702104045,56.3198246639091,NaN,NaN,50
1647505800,1.1057,1.10601,1.105,1.1053,5137,3072.6,-494811,-497483.2,16.497858979131674,62.06357411554533,56.65017954938749,NaN,NaN,50
1647507600,1.1053,1.10538,1.10409,1.1044,4849,3257.8,-499660,-496382.6,16.65583015056292,56.36511215098549,56.554021117055804,NaN,NaN,50
1647509400,1.1044,1.10556,1.10413,1.10542,4975,3455.2,-494685,-495173.4,16.929927865650406,60.76222480221496,56.64705125708003,NaN,NaN,50
1647511200,1.10542,1.10542,1.10231,1.10359,10470,3848.2,-505155,-496797,15.916673228695208,50.85975373153713,56.30198818161269,NaN,NaN,50
1647513000,1.10359,1.10469,1.10339,1.10468,4807,3870.15,-500348,-498931.8,14.975793922951095,55.51054736537018,56.2609488177377,NaN,NaN,50
1647514800,1.10468,1.10584,1.10462,1.10554,4180,3870.75,-496168,-499203.2,14.618817275151322,58.82195115727865,56.611504850663145,NaN,NaN,50
1647516600,1.10554,1.10575,1.10488,1.10509,4741,3858.35,-500909,-499453,14.287338959337248,56.45412661288351,56.679369532308655,NaN,NaN,50
1647518400,1.10509,1.10648,1.10402,1.10504,11243,4254.1,-512152,-502946.4,13.3159245107862,56.18350585776647,57.016234188905976,NaN,NaN,50
1647520200,1.10504,1.10527,1.10412,1.1046,6624,4444.55,-518776,-505670.6,12.41389680856023,53.742060129613705,57.30315881461969,NaN,NaN,50
1647522000,1.1046,1.10612,1.10441,1.10606,4838,4556.3,-513938,-508388.6,12.197595370672158,59.95963630973445,57.80358975590473,NaN,NaN,50
1647523800,1.10606,1.10708,1.10563,1.10702,7465,4829.7,-506473,-510449.6,12.698891045376087,63.43941061367761,58.33521090547261,NaN,NaN,50
1647525600,1.10702,1.1085,1.10674,1.10844,6574,5074.7,-499899,-510247.6,14.014603705560008,67.88530066614553,59.034532788456644,NaN,NaN,50
1647527400,1.10844,1.10918,1.10766,1.10828,7243,5365.1,-507142,-509245.6,15.583797002920694,66.89816676201428,59.55079980684342,NaN,NaN,50
1647529200,1.10828,1.10918,1.108,1.10902,4379,5487.7,-502763,-506043,17.04090506475562,69.1337008861704,59.86279079720985,NaN,NaN,50
1647531000,1.10902,1.11114,1.10856,1.111,6408,5711.75,-496355,-502526.4,19.267246617763117,74.16185656675897,60.72695382943939,NaN,NaN,50
1647532800,1.111,1.11155,1.11046,1.11134,5367,5873.45,-490988,-499429.4,21.48715971310635,74.91746026412648,62.052121551806614,NaN,NaN,50
1647534600,1.11134,1.11336,1.11106,1.11312,4081,5943.5,-486907,-496831,24.130016461266898,78.46763880471713,63.31679398055677,NaN,NaN,50
1647536400,1.11312,1.11376,1.11278,1.1129,3945,5919.15,-490852,-493573,26.695457085931373,77.01669390829686,65.18514685032531,NaN,NaN,50
1647538200,1.1129,1.113,1.11231,1.11268,3482,5908.55,-494334,-491887.2,28.559032341745823,75.51297520994396,66.61389169636631,NaN,NaN,50
1647540000,1.11268,1.11274,1.11071,1.11076,3125,5696.65,-497459,-492108,28.73325813253687,63.804592745832835,66.96979466697732,NaN,NaN,50
1647541800,1.11076,1.11088,1.10988,1.11004,3151,5597.35,-500610,-494032.4,28.204620019854854,60.04477745799669,67.22626972734254,NaN,NaN,50
1647543600,1.11004,1.11004,1.10931,1.10963,2268,5468.3,-502878,-497226.6,27.26527533236527,57.950622950359545,67.35249237681349,NaN,NaN,50
1647545400,1.10963,1.10989,1.1093,1.10988,2201,5329.6,-500677,-499191.6,26.38499994250999,58.89207853268123,67.72035083417545,NaN,NaN,50
1647547200,1.10988,1.11002,1.10907,1.10924,1163,4864.25,-501840,-500692.8,25.37367074550601,55.46826949269459,67.3995389186726,NaN,NaN,50
1647549000,1.10924,1.10936,1.10894,1.10911,894,4668.6,-502734,-501747.8,24.320956620467175,54.771711903184226,66.78041758220878,NaN,NaN,50
1647550800,1.10911,1.10944,1.10911,1.10918,175,4468.35,-502559,-502137.6,23.40283892638326,55.09868411970646,65.86708782889171,NaN,NaN,50
1647552600,1.10918,1.10926,1.10908,1.10914,1675,4315.05,-504234,-502408.8,22.520490149562477,54.854644275413364,65.00683622270593,NaN,NaN,50
1647554400,1.10914,1.10962,1.10904,1.10938,750,3790.4,-503484,-502970.2,21.99440318679334,56.11071460123093,64.07662291663883,NaN,NaN,50
1647556200,1.10938,1.10953,1.10905,1.10939,657,3492.05,-502827,-503167.6,21.505893864221996,56.16544025607063,62.791164608732515,NaN,NaN,50
1647558000,1.10939,1.10963,1.10893,1.10963,1220,3311.15,-501607,-502942.2,20.908091784284526,57.53401824573481,61.5494901788474,NaN,NaN,50
1647559800,1.10963,1.11002,1.10934,1.10992,1638,3019.8,-499969,-502424.2,20.711651370157977,59.191962966822715,60.17265619042637,NaN,NaN,50
1647561600,1.10992,1.11186,1.10966,1.11062,4853,2933.75,-495116,-500600.6,21.85641345594957,62.95189191395451,59.16802747654477,NaN,NaN,50
1647563400,1.11062,1.1108,1.10989,1.10998,3167,2729.95,-498283,-499560.4,22.919406821327478,57.71593254429706,57.89681014328428,NaN,NaN,50
1647565200,1.10998,1.11039,1.10938,1.10942,3778,2699.9,-502061,-499407.2,23.24216197354739,53.5211840184467,57.162280948470986,NaN,NaN,50
1647567000,1.10942,1.10962,1.10857,1.10876,3503,2554.65,-505564,-500198.6,22.593259704340348,49.00100350223386,56.37343995163078,NaN,NaN,50
1647568800,1.10876,1.10906,1.10814,1.10868,2690,2420.8,-508254,-501855.6,21.53222187932398,48.466680248851084,55.69601547295161,NaN,NaN,50
1647570600,1.10868,1.10879,1.10818,1.10858,1900,2311.75,-510154,-504863.2,20.546972470380208,47.76553428718716,54.901262312559176,NaN,NaN,50
1647572400,1.10858,1.109,1.10774,1.10797,2209,2224.95,-512363,-507679.2,19.150712169183652,43.62013222082106,54.054966793139634,NaN,NaN,50
1647574200,1.10797,1.10843,1.10796,1.10842,1639,2132.8,-510724,-509411.8,17.854184746644,47.256660787377456,53.518177427724865,NaN,NaN,50
1647576000,1.10842,1.10874,1.10832,1.10871,1438,2048.45,-509286,-510156.2,16.99413204458891,49.516525074383615,53.11945178163038,NaN,NaN,50
1647577800,1.10871,1.10873,1.10766,1.10769,1575,1969.65,-510861,-510677.6,16.123163558488557,42.602421523718895,52.244293013652204,NaN,NaN,50
1647579600,1.10769,1.10832,1.10756,1.10818,1803,1946.4,-509058,-510458.4,15.423912463612483,46.469372331285015,51.555625708656066,NaN,NaN,50
1647581400,1.10818,1.10856,1.1081,1.10842,1881,1930.4,-507177,-509421.2,14.471108750132283,48.306383670471845,50.99426452397044,NaN,NaN,50
1647583200,1.10842,1.10932,1.10824,1.10923,2698,2007.15,-504479,-508172.2,14.163039131736952,54.03905345508337,50.74462418178104,NaN,NaN,50
1647585000,1.10923,1.10944,1.1082,1.10834,2693,2097.1,-507172,-507749.4,14.005224033573043,47.770472753763336,49.9288034522768,NaN,NaN,50
1647586800,1.10834,1.10896,1.10757,1.10768,4704,2323.55,-511876,-507952.4,13.046847788240084,43.7202173290305,48.55511241049652,NaN,NaN,50
1647588600,1.10768,1.10827,1.10714,1.10788,4517,2465.65,-507359,-507612.6,12.571853915238396,45.2354969000398,47.663652721621006,NaN,NaN,50
1647590400,1.10788,1.10808,1.10634,1.10663,5527,2704.5,-512886,-508754.4,12.947386869443509,38.29558759708414,46.57611012009511,NaN,NaN,50
1647592200,1.10663,1.10684,1.10552,1.10676,6183,2980.8,-506703,-509199.2,13.993391721735794,39.337928283611504,45.88589046162208,NaN,NaN,50
1647594000,1.10676,1.10706,1.10643,1.10656,4060,3122.8,-510763,-509917.4,14.662229022332193,38.266930856112126,45.157336933569304,NaN,NaN,50
1647595800,1.10656,1.10722,1.10532,1.10572,5582,3320,-516345,-510811.2,16.119650673631888,34.07127977754968,44.179175897166616,NaN,NaN,50
1647597600,1.10572,1.10604,1.105,1.105,5469,3350.8,-521814,-513702.2,17.682999271875037,30.939921023308102,43.273446525915695,NaN,NaN,50
1647599400,1.105,1.10515,1.10316,1.10382,6143,3499.6,-527957,-516716.4,20.104425372944696,26.62161879260914,41.79951495486081,NaN,NaN,50
1647601200,1.10382,1.10417,1.10364,1.10398,4392,3530.3,-523565,-520088.8,22.352892466795097,28.087242345507775,40.26885190279825,NaN,NaN,50
1647603000,1.10398,1.10406,1.10208,1.10226,4676,3588.95,-528241,-523584.4,25.053513953315047,22.81231170300613,38.855272629890194,NaN,NaN,50
1647604800,1.10226,1.10329,1.10162,1.10302,5178,3713.35,-523063,-524928,27.71281277481963,29.14446288790343,37.617779098220076,NaN,NaN,50
1647606600,1.10302,1.10364,1.10154,1.10206,7103,3973.5,-530166,-526598.4,29.6973728051941,26.21859337738158,36.04007979157078,NaN,NaN,50
1647608400,1.10206,1.10244,1.10041,1.10048,8000,4263.05,-538166,-528640.2,31.943734445465648,22.25803626518217,33.77000713514927,NaN,NaN,50
1647610200,1.10048,1.10263,1.1003,1.10254,7463,4554.25,-530703,-530067.8,33.77098656067135,35.861784386410264,32.919386537481195,NaN,NaN,50
1647612000,1.10254,1.1044,1.10252,1.10282,9317,4948.2,-521386,-528696.8,33.397757761201355,37.46359613122994,32.47248502335258,NaN,NaN,50
1647613800,1.10282,1.10332,1.10244,1.10299,6127,5175.8,-515259,-527136,33.09648522297958,38.46837059617583,31.98911885879087,NaN,NaN,50
1647615600,1.10299,1.10389,1.10269,1.10301,5195,5345.4,-510064,-523115.6,32.2284368808653,38.59337251786314,32.010389210275086,NaN,NaN,50
1647617400,1.10301,1.10538,1.10276,1.10481,11177,5810.2,-498887,-515259.8,30.10780855221541,48.695268373245014,32.67877064524891,NaN,NaN,50
1647619200,1.10481,1.10724,1.10424,1.10604,8738,6112.2,-490149,-507149,29.01971876712654,54.23556520541579,33.819387384484884,NaN,NaN,50
1647621000,1.10604,1.10673,1.10584,1.10607,5410,6248.05,-484739,-499819.6,28.00934968097259,54.365006971133546,35.26893932688373,NaN,NaN,50
1647622800,1.10607,1.10622,1.10506,1.10552,3855,6205.6,-488594,-494486.6,26.445124832469695,51.489646149975805,36.73677683593143,NaN,NaN,50
1647624600,1.10552,1.10642,1.10544,1.10586,3286,6144.05,-485308,-489535.4,25.131003472794518,53.13962938979477,38.63092045001611,NaN,NaN,50
1647626400,1.10586,1.10592,1.10424,1.1045,3194,6027.4,-488502,-487458.4,23.669000919031422,46.34872580959907,39.93531212602263,NaN,NaN,50
1647628200,1.1045,1.105,1.10422,1.10486,3155,5876,-485347,-486498,22.325775258258634,48.23453370306723,41.75118512602699,NaN,NaN,50
1647630000,1.10486,1.1057,1.10465,1.10558,2657,5805.85,-482690,-486088.2,20.934750483920734,51.87769585274027,43.3749874806582,NaN,NaN,50
1647631800,1.10558,1.10567,1.10478,1.10521,2831,5668.3,-485521,-485473.6,19.643084622035538,49.9328782256552,45.068864969820595,NaN,NaN,50
1647633600,1.10521,1.10541,1.10474,1.10487,1101,5449.9,-486622,-485736.4,18.40803331572039,48.14669280333222,46.9180547225456,NaN,NaN,50
1647635400,1.10487,1.10514,1.10484,1.10512,1038,5194.65,-485584,-485152.8,17.26119995985633,49.57503197518755,47.89757240745826,NaN,NaN,50
1647810000,1.10512,1.10611,1.10512,1.10596,129,4981.5,-485455,-485174.4,17.03381735733534,54.14550128219018,49.08913706109828,NaN,NaN,50
1647811800,1.10596,1.10596,1.10484,1.10515,360,4765.7,-485815,-485799.4,16.52945422343313,49.48748536942534,49.87621668775896,NaN,NaN,50
1647813600,1.10515,1.10576,1.10431,1.10527,1660,4589.8,-484155,-485526.2,15.524283198526492,50.17139423738629,50.703218239153465,NaN,NaN,50
1647815400,1.10527,1.10545,1.10436,1.10447,940,4281.65,-485095,-485220.8,14.590910103970328,45.726507469160914,50.49116388886175,NaN,NaN,50
1647817200,1.10447,1.10477,1.10432,1.10456,1103,3936.8,-483992,-484902.4,13.680689402468193,46.302866155782276,49.92454252817364,NaN,NaN,50
1647819000,1.10456,1.10467,1.1041,1.10426,816,3604.45,-484808,-484773,12.819015441336248,44.60255562118097,49.2272245746056,NaN,NaN,50
1647820800,1.10426,1.10476,1.10378,1.10436,1345,3205.85,-483463,-484302.6,12.374450816861346,45.32330791226447,48.7867718433405,NaN,NaN,50
1647822600,1.10436,1.10481,1.1042,1.10453,1193,2959.15,-482270,-483925.6,11.897363818905028,46.59537145199969,48.31932484778371,NaN,NaN,50
1647824400,1.10453,1.10538,1.10444,1.1051,1484,2773.6,-480786,-483063.8,11.34973135689803,50.734070714340355,48.63256376955095,NaN,NaN,50
1647826200,1.1051,1.1051,1.1045,1.10452,1170,2273.25,-481956,-482656.6,10.841215499320102,46.762852201799234,48.52744366231752,NaN,NaN,50
1647828000,1.10452,1.10506,1.10431,1.10478,1290,1900.85,-480666,-481828.2,10.108205554345362,48.701327360999244,48.30056019862173,NaN,NaN,50
1647829800,1.10478,1.10502,1.10464,1.10491,1068,1683.75,-479598,-481055.2,9.427553462583106,49.68777418484038,48.28305276713496,NaN,NaN,50
1647831600,1.10491,1.1052,1.10472,1.10494,967,1539.35,-478631,-480327.4,9.058730276138908,49.92706892399036,48.41022249003912,NaN,NaN,50
1647833400,1.10494,1.10502,1.1045,1.10454,864,1418.25,-479495,-480069.2,8.45352932024084,46.73532316527657,48.20738614647404,NaN,NaN,50
1647835200,1.10454,1.10456,1.10423,1.10438,733,1295.2,-480228,-479723.6,8.302836004666428,45.4828047154458,47.58862210599231,NaN,NaN,50
1647837000,1.10438,1.10442,1.10406,1.10412,805,1177.7,-481033,-479797,8.415699782089577,43.44520540364825,47.15703067986537,NaN,NaN,50
1647838800,1.10412,1.1042,1.1038,1.10394,1067,1098.2,-482100,-480297.4,8.89765943090186,42.04100692782709,46.57628872918257,NaN,NaN,50
1647840600,1.10394,1.10438,1.10378,1.10418,1194,1016.35,-480906,-480752.4,9.000887990355864,44.61157482619798,46.49665068325665,NaN,NaN,50
1647842400,1.10418,1.10438,1.10344,1.1041,1246,1023.6,-482152,-481283.8,9.599223706118295,43.91244267852557,46.32590614916688,NaN,NaN,50
1647844200,1.1041,1.10471,1.10363,1.10382,1117,1027.55,-483269,-481892,9.5193338447348,41.46322426224113,46.1016681949569,NaN,NaN,50
1647846000,1.10382,1.10561,1.10351,1.10468,4102,1226.2,-479167,-481518.8,9.644513051256789,50.58046953860514,46.47717973969552,NaN,NaN,50
1647847800,1.10468,1.1054,1.10448,1.10512,3602,1388.3,-475565,-480211.8,9.76075088588435,54.4863207415679,47.04081897466468,NaN,NaN,50
1647849600,1.10512,1.10629,1.10504,1.10517,6381,1624.35,-469184,-477867.4,10.963543315937443,54.922314925529264,47.33997927546388,NaN,NaN,50
1647851400,1.10517,1.1058,1.10464,1.10565,4138,1784.25,-465046,-474446.2,11.382656796857619,58.98435508142474,48.212943766865706,NaN,NaN,50
1647853200,1.10565,1.10704,1.10515,1.10591,5845,2021.35,-459201,-469632.6,12.988691352150703,61.03268488777664,49.09375501877838,NaN,NaN,50
1647855000,1.10591,1.1064,1.1057,1.1057,3581,2159.6,-462782,-466355.6,14.480009153494281,58.49185065181039,49.72261762356195,NaN,NaN,50
1647856800,1.1057,1.10584,1.10467,1.10498,3130,2248.85,-465912,-464425,14.288920271645072,50.6987700859302,49.77773913512908,NaN,NaN,50
1647858600,1.10498,1.10553,1.1045,1.10456,2737,2326.05,-468649,-464318,13.884197246732013,46.78311510975552,49.78115284544901,NaN,NaN,50
1647860400,1.10456,1.10456,1.10258,1.10274,5346,2519.15,-473995,-466107.8,14.27167817582919,34.388626666140155,48.988711556212884,NaN,NaN,50
1647862200,1.10274,1.10389,1.10266,1.10314,4377,2679.5,-469618,-468191.2,14.631481895705143,38.260120187655545,48.61834832649912,NaN,NaN,50
1647864000,1.10314,1.10438,1.10292,1.10311,4363,2833.15,-473981,-470431,14.362846289223263,38.07864101283556,48.33532218971401,NaN,NaN,50
1647865800,1.10311,1.10396,1.10296,1.1034,3789,2969.2,-470192,-471287,14.11339894034723,40.99237581655898,48.07680797473979,NaN,NaN,50
1647867600,1.1034,1.10442,1.10339,1.1043,3828,3112.25,-466364,-470830,13.315547755311558,49.0112452621137,48.44100815928181,NaN,NaN,50
1647869400,1.1043,1.10441,1.10326,1.10336,5306,3334.35,-471670,-470365,12.72232995284229,42.51299097642224,48.51599149600903,NaN,NaN,50
1647871200,1.10336,1.10457,1.10288,1.10382,6064,3600.9,-465606,-469562.6,12.5977799455603,46.26749613094921,48.207921966890744,NaN,NaN,50
1647873000,1.10382,1.10425,1.10336,1.10422,4578,3789.55,-461028,-466972,12.48212636736988,49.364387032685705,47.84206955911344,NaN,NaN,50
1647874800,1.10422,1.10479,1.10377,1.10464,4604,3966.4,-456424,-464218.4,11.630923209661592,52.462512717222296,47.66636940137723,NaN,NaN,50
1647876600,1.10464,1.10509,1.10422,1.1045,4642,4138.8,-461066,-463158.8,11.141588808871546,51.33500379395341,47.119987166557856,NaN,NaN,50
1647878400,1.1045,1.10525,1.10387,1.10408,5057,4329.35,-466123,-462049.4,10.472857125113725,48.00199739636135,46.1892237743139,NaN,NaN,50
1647880200,1.10408,1.10498,1.10263,1.10422,10990,4823,-455133,-459954.8,11.204554700738896,49.18631095958795,45.52454236772659,NaN,NaN,50
1647882000,1.10422,1.10438,1.10182,1.10306,7597,4997.75,-462730,-460295.2,12.560350099387893,40.8784519218795,44.82309107029439,NaN,NaN,50
1647883800,1.10306,1.10342,1.10274,1.10308,4696,5052.45,-458034,-460617.2,13.819302969561958,41.0632883038948,44.41453201273291,NaN,NaN,50
1647885600,1.10308,1.10312,1.10148,1.10242,3889,4927.85,-461923,-460788.6,15.872332808673706,36.957105885327636,44.597994814103444,NaN,NaN,50
1647887400,1.10242,1.10266,1.1015,1.1016,3898,4915.85,-465821,-460728.2,17.778717659277472,32.595939835244124,44.19341050321691,NaN,NaN,50
1647889200,1.1016,1.10198,1.10126,1.10171,3316,4789.4,-462505,-462202.6,19.703542236580173,33.72576925718164,43.88249109209878,NaN,NaN,50
1647891000,1.10171,1.10174,1.10102,1.10144,2594,4740.05,-465099,-462676.4,21.644858865933326,32.294847702741066,43.26123908396893,NaN,NaN,50
1647892800,1.10144,1.10176,1.10125,1.10149,1119,4639.5,-463980,-463865.6,23.41091696689531,32.86292482826801,42.10778762440852,NaN,NaN,50
1647894600,1.10149,1.10176,1.10134,1.1017,633,4534.3,-463347,-464150.4,25.050828060645724,35.31766345344265,41.59383565848141,NaN,NaN,50
1647896400,1.1017,1.10173,1.1016,1.10166,112,4272.6,-463459,-463678,26.57360264769968,35.054748627984736,40.79292512255537,NaN,NaN,50
1647898200,1.10166,1.10196,1.1016,1.10194,588,4083.15,-462871,-463751.2,27.488833612725838,38.505713982103906,40.01730561894239,NaN,NaN,50
1647900000,1.10194,1.1026,1.10173,1.10235,814,3905.7,-462057,-463142.8,27.09337402956889,43.26007810002645,39.35998886057126,NaN,NaN,50
1647901800,1.10235,1.10254,1.10206,1.10208,774,3754.95,-462831,-462913,26.72616155949458,41.011402102970806,38.62258873978679,NaN,NaN,50
1647903600,1.10208,1.10219,1.1015,1.1017,857,3606.4,-463688,-462981.2,27.01308976418121,38.016285201250625,37.90932358299317,NaN,NaN,50
1647905400,1.1017,1.102,1.10145,1.10168,923,3387.25,-464611,-463211.6,27.33252480473552,37.859568276712636,37.10027053421636,NaN,NaN,50
1647907200,1.10168,1.10174,1.10046,1.10058,1672,3167.65,-466283,-463894,28.539268986993875,30.4295603954766,36.353921139473286,NaN,NaN,50
1647909000,1.10058,1.10062,1.09812,1.09867,5479,3212.7,-471762,-465835,30.939763748280814,22.260475360117027,35.01086307206059,NaN,NaN,50
1647910800,1.09867,1.09972,1.09841,1.09932,3634,3164.2,-468128,-466894.4,33.168794598047256,29.223989911436135,34.45849764535406,NaN,NaN,50
1647912600,1.09932,1.09966,1.09898,1.09954,2992,3081.7,-465136,-467184,35.238608958544674,31.461750508363878,34.37748412200547,NaN,NaN,50
1647914400,1.09954,1.09979,1.09908,1.0994,1819,2919.8,-466955,-467652.8,36.908010381603,30.79449725084001,34.16810755012393,NaN,NaN,50
1647916200,1.0994,1.10026,1.09926,1.10019,3097,2525.15,-463858,-467167.8,37.57152037133306,38.6955274072599,34.62529895758956,NaN,NaN,50
1647918000,1.10019,1.10046,1.09968,1.10046,2197,2255.15,-461661,-465147.6,37.82608289440791,41.16770812536234,35.21849776452486,NaN,NaN,50
1647919800,1.10046,1.10054,1.10013,1.10025,1567,2098.7,-463228,-464167.6,37.914317949788014,39.82259795186711,35.54027880012661,NaN,NaN,50
1647921600,1.10025,1.1003,1.09863,1.09914,3641,2086.3,-466869,-464514.2,38.99229330356587,33.57751650987241,35.43476222026144,NaN,NaN,50
1647923400,1.09914,1.09938,1.09841,1.09855,3467,2064.75,-470336,-465190.4,40.11036160994234,30.811615089872106,34.885183727959166,NaN,NaN,50
1647925200,1.09855,1.09912,1.09828,1.099,2820,2039.95,-467516,-465922,41.21891960312926,35.19625011384444,34.30919601466046,NaN,NaN,50
1647927000,1.099,1.09908,1.09808,1.09816,3096,2065.05,-470612,-467712.2,42.358362584504434,31.219099131078764,33.60974580238245,NaN,NaN,50
1647928800,1.09816,1.09864,1.0974,1.09838,3573,2187.75,-467039,-468474.4,43.761548922845385,33.34354644206174,33.27597874815467,NaN,NaN,50
1647930600,1.09838,1.09858,1.09676,1.09679,2961,2304.15,-470000,-469100.6,45.3430125680117,26.88125221729851,32.49181331533938,NaN,NaN,50
1647932400,1.09679,1.0973,1.0961,1.0973,5116,2554.35,-464884,-468010.2,47.0606811618885,31.469200078376744,32.56607329268939,NaN,NaN,50
1647934200,1.0973,1.09832,1.09724,1.09822,3293,2689.6,-461591,-466825.2,46.895280121394684,38.91523350218985,33.755698874266024,NaN,NaN,50
1647936000,1.09822,1.09978,1.0981,1.09943,6815,2989.65,-454776,-463658,44.84769659789586,47.062059620721485,35.02984671064355,NaN,NaN,50
1647937800,1.09943,1.10117,1.09928,1.10074,7031,3302.5,-447745,-459799.2,41.67755873715962,54.186057820799036,36.65301151867463,NaN,NaN,50
1647939600,1.10074,1.10144,1.10028,1.10062,6603,3589.8,-454348,-456668.8,38.96149658588818,53.47613456711931,38.27312846983744,NaN,NaN,50
1647941400,1.10062,1.10076,1.09922,1.09964,5786,3832.95,-460134,-455718.8,36.80038180614969,47.950906827716985,38.934226999870084,NaN,NaN,50
1647943200,1.09964,1.09964,1.09872,1.09952,4673,3983,-464807,-456362,35.16603551211933,47.30636719353891,39.37270264759699,NaN,NaN,50
1647945000,1.09952,1.10068,1.09939,1.10034,4230,3920.55,-460577,-457522.2,32.72556452596026,52.04947960965139,40.246051337438715,NaN,NaN,50
1647946800,1.10034,1.10054,1.09965,1.10027,3616,3919.65,-464193,-460811.8,30.459412895955413,51.62229904005392,41.53496437530883,NaN,NaN,50
1647948600,1.10027,1.10045,1.09916,1.09995,9182,4229.15,-473375,-464617.2,28.767792516596575,49.61751884345667,42.87824321485058,NaN,NaN,50
1647950400,1.09995,1.10349,1.09994,1.1029,9293,4602.85,-464082,-465406.8,28.36841045541531,63.637324017419445,44.90974849367736,NaN,NaN,50
1647952200,1.1029,1.10346,1.10151,1.10157,7403,4818.15,-471485,-466742.4,27.997555684318424,56.062858800292254,46.684302755764044,NaN,NaN,50
1647954000,1.10157,1.10302,1.10152,1.10273,7242,5070.4,-464243,-467475.6,27.653190539728463,60.48097669743856,48.622690631148096,NaN,NaN,50
1647955800,1.10273,1.10436,1.10211,1.10413,7358,5359.95,-456885,-466014,28.067509996801576,65.04892121051637,51.348952702092234,NaN,NaN,50
1647957600,1.10413,1.10459,1.10288,1.10348,7063,5531.05,-463948,-464128.6,28.56693864992274,61.49487133022583,53.49364350579574,NaN,NaN,50
1647959400,1.10348,1.10374,1.10285,1.10339,5969,5656.15,-469917,-465295.6,28.998103708908886,60.997921787673434,55.07097838333028,NaN,NaN,50
1647961200,1.10339,1.10344,1.10254,1.10283,5078,5769.05,-474995,-465997.6,29.050122596089878,57.86452091033684,55.84258276115994,NaN,NaN,50
1647963000,1.10283,1.10298,1.1015,1.10217,6148,5921.65,-481143,-469377.6,28.02587322732047,54.32272860514319,55.85234496004167,NaN,NaN,50
1647964800,1.10217,1.10238,1.10118,1.10134,5079,5996.95,-486222,-475245,26.772128332989915,50.16434354428068,55.61578845841034,NaN,NaN,50
1647966600,1.10134,1.10179,1.10114,1.10179,3486,6023.2,-482736,-479002.6,25.56889354098852,52.29646900827925,55.92618575702193,NaN,NaN,50
1647968400,1.10179,1.10297,1.10146,1.1025,3648,5949.8,-479088,-480836.8,25.325549637889207,55.52925875736474,56.51353515443806,NaN,NaN,50
1647970200,1.1025,1.10274,1.10206,1.10234,2221,5896.2,-481309,-482099.6,25.09958744215413,54.6307742219886,56.69791334103358,NaN,NaN,50
1647972000,1.10234,1.10261,1.10224,1.10234,2001,5655.5,-481309,-482132.8,24.889765403257275,54.6307742219886,56.91280442545749,NaN,NaN,50
1647973800,1.10234,1.10245,1.10203,1.10222,1984,5403.15,-483293,-481547,24.439190996652158,53.872568526191976,57.216736545652864,NaN,NaN,50
1647975600,1.10222,1.10308,1.10204,1.10288,3024,5224.2,-480269,-481053.6,24.52383649953063,57.37642965811812,56.76952980570277,NaN,NaN,50
1647977400,1.10288,1.10321,1.10268,1.10304,2016,5035.7,-478253,-480886.6,24.702626610313573,58.205268103223105,56.92255904162641,NaN,NaN,50
1647979200,1.10304,1.10313,1.1027,1.10288,829,4843.5,-479082,-480441.2,24.868645998897733,57.01137279912164,56.67473019174662,NaN,NaN,50
1647981000,1.10288,1.1033,1.10288,1.10298,823,4673.15,-478259,-479831.2,25.16774620611234,57.59679253504914,56.142435286356104,NaN,NaN,50
1647982800,1.10298,1.10298,1.10276,1.10298,151,4499.9,-478259,-478824.4,25.25465752647137,57.59679253504914,55.864001086700625,NaN,NaN,50
1647984600,1.10298,1.10305,1.1025,1.10304,197,4050.65,-478062,-478383,24.91941162596389,57.99484198016766,55.6494953861645,NaN,NaN,50
1647986400,1.10304,1.10439,1.10298,1.10425,1471,3659.55,-476591,-478050.6,25.763684244861846,65.10827924178133,56.16690669555339,NaN,NaN,50
1647988200,1.10425,1.10426,1.10308,1.10321,1218,3350.3,-477809,-477796,26.547651676695654,56.28548857157389,56.30710383601273,NaN,NaN,50
1647990000,1.10321,1.10349,1.10293,1.1032,1381,3057.25,-479190,-477982.2,27.02403902060234,56.206619166457415,56.7386949518825,NaN,NaN,50
1647991800,1.1032,1.1032,1.10261,1.10294,1767,2777.7,-480957,-478521.8,26.93475386893493,54.08462597128798,56.86642044924026,NaN,NaN,50
1647993600,1.10294,1.10323,1.10222,1.10238,2876,2568.35,-483833,-479676,26.238058392628773,49.72978345593268,56.45217221342369,NaN,NaN,50
1647995400,1.10238,1.1026,1.10208,1.10254,2748,2407.3,-481085,-480574.8,25.375744166083937,50.945122521295716,56.18891137765991,NaN,NaN,50
1647997200,1.10254,1.10324,1.10223,1.10234,3970,2351.9,-485055,-482024,25.264389316101976,49.33938294290409,55.8109548577253,NaN,NaN,50
1647999000,1.10234,1.10264,1.10212,1.1026,2729,2180.95,-482326,-482651.2,24.9806784769507,51.48038876872225,55.6400848750489,NaN,NaN,50
1648000800,1.1026,1.10336,1.10257,1.10286,2599,2056.95,-479727,-482405.2,25.423655041724224,53.592516022601785,55.369805329654874,NaN,NaN,50
1648002600,1.10286,1.10342,1.10272,1.10324,2862,2025.75,-476865,-481011.6,25.88980313217583,56.5683200582584,55.25288046930025,NaN,NaN,50
1648004400,1.10324,1.10349,1.103,1.10324,2032,1944.95,-476865,-480167.6,26.389813353477514,56.5683200582584,55.22123384495287,NaN,NaN,50
1648006200,1.10324,1.10332,1.10257,1.10266,1259,1896.85,-478124,-478781.4,26.05917054053566,50.801855304032124,54.73588118559451,NaN,NaN,50
1648008000,1.10266,1.10278,1.10239,1.10256,1586,1876.1,-479710,-478258.2,25.435740182084338,49.858165324455825,54.183122099123565,NaN,NaN,50
1648009800,1.10256,1.1029,1.10255,1.10278,1120,1832.9,-478590,-478030.8,25.007145499797627,51.971909644544155,53.75291264657903,NaN,NaN,50
1648011600,1.10278,1.10344,1.1027,1.10337,1469,1755.15,-477121,-478082,25.2410754054205,57.184646279702555,53.1869388635734,NaN,NaN,50
1648013400,1.10337,1.104,1.10332,1.10372,1542,1731.45,-475579,-477824.8,26.017897215323586,59.96087808368683,53.449466685867186,NaN,NaN,50
1648015200,1.10372,1.104,1.10342,1.1038,1903,1785.15,-473676,-476935.2,26.739231753090735,60.58990652127835,53.76255863978297,NaN,NaN,50
1648017000,1.1038,1.10386,1.10306,1.1031,1890,1838.5,-475566,-476106.4,26.676821756460185,52.77683478055739,53.66914498330221,NaN,NaN,50
1648018800,1.1031,1.10362,1.10216,1.10254,3832,2022.55,-479398,-476268,25.10327485691403,47.499821604866455,53.50986199394033,NaN,NaN,50
1648020600,1.10254,1.10257,1.10146,1.10176,3769,2201.15,-483167,-477477.2,23.903114301674357,41.30487696147354,52.821273025381615,NaN,NaN,50
1648022400,1.10176,1.10238,1.10104,1.10144,5998,2427.5,-489165,-480194.4,23.273577570255693,39.054493535451066,52.086638067706396,NaN,NaN,50
1648024200,1.10144,1.10221,1.10138,1.10162,4365,2584.85,-484800,-482419.2,22.689007748224075,41.001656133006975,51.3381571651553,NaN,NaN,50
1648026000,1.10162,1.10177,1.101,1.10156,4050,2718.3,-488850,-485076,22.583372736002698,40.53674194790632,50.40560187410563,NaN,NaN,50
1648027800,1.10156,1.10162,1.09886,1.09972,6131,2936.5,-494981,-488192.6,24.197185071791846,29.492530896784686,48.47161693400036,NaN,NaN,50
1648029600,1.09972,1.1006,1.0996,1.10002,4264,3005.9,-490717,-489702.6,25.695725097881773,32.71148593035785,46.76755735343604,NaN,NaN,50
1648031400,1.10002,1.1007,1.09984,1.1002,3449,3040.95,-487268,-489323.2,26.91905208013508,34.63959006241754,45.613109836177856,NaN,NaN,50
1648033200,1.1002,1.10068,1.09802,1.09805,5275,3106.2,-492543,-490871.8,29.040083678383283,25.310474502605402,43.859703348902826,NaN,NaN,50
1648035000,1.09805,1.09861,1.09749,1.09832,5272,3233.35,-487271,-490556,31.227546066882805,27.935299203910418,42.142802603143274,NaN,NaN,50
1648036800,1.09832,1.09942,1.09812,1.0984,5889,3397.85,-481382,-487836.2,32.07570034626271,28.734454394608804,40.110646039922294,NaN,NaN,50
1648038600,1.0984,1.09944,1.09822,1.09868,5918,3550.65,-475464,-484785.6,32.83515467686563,31.593737303939477,38.084421698511775,NaN,NaN,50
1648040400,1.09868,1.0991,1.0972,1.09754,6374,3767.75,-481838,-483699.6,34.07748526150777,26.86730795331745,35.67566465794313,NaN,NaN,50
1648042200,1.09754,1.09798,1.0964,1.0966,7688,4089.2,-489526,-483096.2,35.585876297869746,23.716701610260145,33.599940860064756,NaN,NaN,50
1648044000,1.0966,1.09885,1.0966,1.0979,7698,4394.8,-481828,-482007.6,35.826466242844795,35.058734876770345,32.71129180805789,NaN,NaN,50
1648045800,1.0979,1.09868,1.09734,1.09779,6605,4669.05,-488433,-483417.8,36.049871191750206,34.59008649913996,32.2316639178912,NaN,NaN,50
1648047600,1.09779,1.09989,1.09766,1.09946,4680,4829.6,-483753,-485075.6,34.82390968162344,46.32170783975337,32.750750653912796,NaN,NaN,50
1648049400,1.09946,1.10056,1.09894,1.10016,5751,5040.05,-478002,-484308.4,33.01218770617027,50.34210553616279,33.41792561128106,NaN,NaN,50
1648051200,1.10016,1.10053,1.0998,1.10032,4618,5175.8,-473384,-481080,31.329874443249476,51.24104681781606,34.182518816274616,NaN,NaN,50
1648053000,1.10032,1.10074,1.10015,1.1002,2486,5205.6,-475870,-479888.4,29.54868657473626,50.50262767701219,35.68324001486229,NaN,NaN,50
1648054800,1.1002,1.10051,1.09972,1.09982,2828,5155.4,-478698,-477941.4,28.283750032224713,48.136976043924896,36.78506073725993,NaN,NaN,50
1648056600,1.09982,1.10072,1.09981,1.10058,2334,5083.65,-476364,-476463.6,26.871969015171253,52.88994627168336,38.088657609350356,NaN,NaN,50
1648058400,1.10058,1.10098,1.10046,1.10094,1723,4869.9,-474641,-475791.4,25.265843527574184,54.993974269189906,40.20890759267781,NaN,NaN,50
1648060200,1.10094,1.10112,1.10058,1.1009,2069,4755.1,-476710,-476456.6,23.613344452054612,54.70163952665194,42.120789044302214,NaN,NaN,50
1648062000,1.1009,1.1012,1.10042,1.10054,2108,4658,-478818,-477046.2,22.2599601888852,52.02139444211216,43.784141904838165,NaN,NaN,50
1648063800,1.10054,1.10074,1.10027,1.10048,1738,4438.35,-480556,-477417.8,21.17679234188765,51.567884395438284,45.21086669708807,NaN,NaN,50
1648065600,1.10048,1.10098,1.10041,1.10078,863,4268.3,-479693,-478083.6,19.849199088796805,53.739437813883505,47.13030454427137,NaN,NaN,50
1648067400,1.10078,1.10106,1.1007,1.10073,747,4133.2,-480440,-479243.4,18.507423415699392,53.31041285757893,49.24414106193699,NaN,NaN,50
1648069200,1.10073,1.10122,1.10064,1.1009,572,3898.05,-479868,-479875,17.333558480818493,54.636463000059365,50.642550213600494,NaN,NaN,50
1648071000,1.1009,1.10096,1.10075,1.10076,213,3645.1,-480081,-480127.6,16.243541041286228,53.29406119691548,51.97854840629874,NaN,NaN,50
1648072800,1.10076,1.10101,1.10011,1.10045,1425,3421.9,-481506,-480317.6,15.853072966527366,50.344417156187795,52.26588478604407,NaN,NaN,50
1648074600,1.10045,1.10057,1.10021,1.10026,470,3149.5,-481976,-480774.2,15.490495468536993,48.570079783642335,52.13931151800689,NaN,NaN,50
1648076400,1.10026,1.10069,1.10026,1.10051,705,2866.05,-481271,-480940.4,14.942971113578714,51.01636442821378,52.12326277589244,NaN,NaN,50
1648078200,1.10051,1.10073,1.10038,1.10062,1170,2540.15,-480101,-480987,14.361582455860683,52.09605614160538,52.23707909479196,NaN,NaN,50
1648080000,1.10062,1.10138,1.1005,1.10074,2396,2275.05,-477705,-480511.8,13.934812592886866,53.305234038973445,52.60624038015256,NaN,NaN,50
1648081800,1.10074,1.10108,1.10012,1.10026,2840,2086.8,-480545,-480319.6,12.976679609647872,48.077586887253865,52.26250042412188,NaN,NaN,50
1648083600,1.10026,1.10034,1.09824,1.0984,3851,2045.35,-484396,-480803.6,14.250864122066847,34.11563216144562,50.77119027356873,NaN,NaN,50
1648085400,1.0984,1.09916,1.09836,1.09883,4217,1968.65,-480179,-480585.2,15.434035455027326,38.55794835861414,49.61806947585173,NaN,NaN,50
1648087200,1.09883,1.09899,1.09835,1.09872,2397,1857.6,-482576,-481080.2,16.54196088781032,37.85478412654036,48.60616873902518,NaN,NaN,50
1648089000,1.09872,1.09874,1.09826,1.09854,2297,1848.15,-484873,-482513.8,17.658792465168666,36.67611822078534,47.5424711551214,NaN,NaN,50
1648090800,1.09854,1.09916,1.09846,1.0985,1889,1801.2,-486762,-483757.2,17.918632280130183,36.40484848471823,46.30428620303816,NaN,NaN,50
1648092600,1.0985,1.09871,1.09807,1.09854,2281,1798.55,-484481,-483774.2,18.587497169875007,36.90740057652876,45.13264246867743,NaN,NaN,50
1648094400,1.09854,1.09876,1.09834,1.09851,1727,1798.75,-486208,-484980,19.11410348308117,36.673326493725334,43.84956128965357,NaN,NaN,50
1648096200,1.09851,1.09866,1.09805,1.09858,1403,1765.45,-484805,-485425.8,19.925459784286833,37.66672000898554,42.73332263337286,NaN,NaN,50
1648098000,1.09858,1.09863,1.09804,1.09829,1756,1747.85,-486561,-485763.4,20.690078081305614,35.20295964508661,41.651789954008485,NaN,NaN,50
1648099800,1.09829,1.09836,1.09766,1.09776,2476,1784.75,-489037,-486218.4,21.819293066966612,31.18792172768407,40.41020723572575,NaN,NaN,50
1648101600,1.09776,1.09819,1.09754,1.09813,2271,1855.15,-486766,-486675.4,22.994704403024315,36.62238782435015,39.382066049735485,NaN,NaN,50
1648103400,1.09813,1.09892,1.09803,1.09861,2971,1966.35,-483795,-486192.8,22.556727863676766,42.92031942746142,38.72665628443949,NaN,NaN,50
1648105200,1.09861,1.09872,1.09774,1.0979,4389,2157.2,-488184,-486868.6,22.518997218509465,37.05477833708023,37.56590944858997,NaN,NaN,50
1648107000,1.0979,1.09826,1.09753,1.0978,3218,2307.45,-491402,-487836.8,22.741344805334442,36.302280291354286,36.724816120311424,NaN,NaN,50
1648108800,1.0978,1.09916,1.09722,1.0977,7576,2615,-498978,-489825,21.37025127870687,35.52534623400598,36.82550998263717,NaN,NaN,50
1648110600,1.0977,1.10011,1.09744,1.09778,8569,3019.95,-490409,-490553.6,20.82237898894913,36.69263725848945,36.69227347548541,NaN,NaN,50
1648112400,1.09778,1.09911,1.09775,1.09836,5935,3281.45,-484474,-490689.4,20.313640434174083,44.533179345862436,37.16930170543698,NaN,NaN,50
1648114200,1.09836,1.09968,1.09824,1.0988,3404,3393.15,-481070,-489266.6,20.481469307789588,49.62972113862033,38.094559056710914,NaN,NaN,50
1648116000,1.0988,1.09932,1.09818,1.09846,3941,3470.4,-485011,-487988.4,20.535353451947614,46.104423148089396,38.78738581838029,NaN,NaN,50
1648117800,1.09846,1.09896,1.09821,1.09879,3593,3508.05,-481418,-484476.4,20.585388728665784,49.829395379322854,39.71038544715129,NaN,NaN,50
1648119600,1.09879,1.09912,1.09866,1.09894,2773,3454.15,-478645,-482123.6,20.827290303742473,51.47123655360769,40.76737902285718,NaN,NaN,50
1648121400,1.09894,1.10012,1.09726,1.09878,8544,3670.5,-487189,-482666.6,19.811165297836833,49.606432476407115,41.620215627673005,NaN,NaN,50
1648123200,1.09878,1.09956,1.09788,1.09814,5512,3826.25,-492701,-484992.8,18.86762064949588,42.90962249025012,42.17069154518468,NaN,NaN,50
1648125000,1.09814,1.09849,1.09748,1.09833,5160,3969.4,-487541,-485498.8,18.49546068112274,45.27173183177008,43.17667798119083,NaN,NaN,50
1648126800,1.09833,1.09841,1.09764,1.09804,5708,4160.35,-493249,-487865,18.149883567633392,42.388906211932245,43.58857215173241,NaN,NaN,50
1648128600,1.09804,1.09828,1.09658,1.09738,8837,4488.15,-502086,-492553.2,18.99110103346109,36.666355722276265,43.141860458504894,NaN,NaN,50
1648130400,1.09738,1.09829,1.09715,1.09776,6805,4742.05,-495281,-494171.6,19.754499053118895,41.55833228693114,43.46354288349425,NaN,NaN,50
1648132200,1.09776,1.09986,1.09776,1.09956,6741,5008.95,-488540,-493339.4,18.485304360939843,58.07702229938966,45.01888159835392,NaN,NaN,50
1648134000,1.09956,1.10136,1.09937,1.10041,9498,5396.05,-479042,-491639.6,18.712496499639357,63.345778537852816,47.00605533434298,NaN,NaN,50
1648135800,1.10041,1.10085,1.09972,1.10062,6598,5602.15,-472444,-487478.6,18.92346062843177,64.53176733099924,48.994564625236535,NaN,NaN,50
1648137600,1.10062,1.10085,1.1,1.10016,4571,5717.15,-477015,-482464.4,19.119355890881863,59.95552497848954,50.09616074185276,NaN,NaN,50
1648139400,1.10016,1.1002,1.09851,1.09857,4823,5809.75,-481838,-479775.8,17.939244635633507,47.434183442670765,49.939336620713505,NaN,NaN,50
1648141200,1.09857,1.0989,1.09824,1.09878,3207,5750.65,-478631,-477794,17.104049045213305,48.95060213526864,50.14263511979773,NaN,NaN,50
1648143000,1.09878,1.09988,1.09878,1.09939,3864,5782.95,-474767,-476939,16.405451849056284,53.1761056649975,50.381685854488786,NaN,NaN,50
1648144800,1.09939,1.09969,1.09909,1.09934,2872,5547.75,-477639,-477978,15.756754452624765,52.79038974347148,50.4759110823362,NaN,NaN,50
1648146600,1.09934,1.1001,1.09909,1.09983,2623,5250.45,-475016,-477578.2,15.540693759000202,56.14743213668173,50.94312534378438,NaN,NaN,50
1648148400,1.09983,1.10058,1.09964,1.10056,2952,5101.3,-472064,-475623.4,15.767257524438664,60.63812777428764,52.20944714978706,NaN,NaN,50
1648150200,1.10056,1.1006,1.09985,1.09993,1959,5029.05,-474023,-474701.8,15.99543859105062,55.368458083861384,52.93064188207929,NaN,NaN,50
1648152000,1.09993,1.10004,1.09973,1.09974,1107,4887.35,-475130,-474774.4,16.04226492157789,53.84857711491368,53.749189803720824,NaN,NaN,50
1648153800,1.09974,1.09982,1.09961,1.09981,635,4739.45,-474495,-474145.6,15.915018014214342,54.345806679904,55.01200772926567,NaN,NaN,50
1648155600,1.09981,1.1,1.09948,1.09969,348,4618.2,-474843,-474111,15.993074494352946,53.28593729549549,55.84969380130598,NaN,NaN,50
1648157400,1.09969,1.0998,1.09964,1.09977,153,4198.65,-474690,-474636.2,16.06555551162451,53.930980348806685,55.55354794769291,NaN,NaN,50
1648159200,1.09977,1.10044,1.09977,1.10044,926,3969.35,-473764,-474584.4,16.82464945483481,59.033027131422706,55.24549427580506,NaN,NaN,50
1648161000,1.10044,1.10068,1.1004,1.10057,687,3745.7,-473077,-474173.8,17.7651897601761,59.9596156959506,54.91891201615873,NaN,NaN,50
1648162800,1.10057,1.10099,1.10037,1.10081,971,3508.85,-472106,-473696,18.93316874148979,61.682677247640584,55.0422800353838,NaN,NaN,50
1648164600,1.10081,1.10098,1.10042,1.10085,1183,3126.15,-470923,-472912,20.01772065270964,61.97636753955975,56.08100747087587,NaN,NaN,50
1648166400,1.10085,1.10114,1.10032,1.10086,3127,2942.25,-467796,-471533.2,21.18511629866279,62.05467036906268,57.017012344718296,NaN,NaN,50
1648168200,1.10086,1.10109,1.10054,1.1009,2787,2744.55,-465009,-469782.2,22.269126541333577,62.388320465083765,57.6750276875816,NaN,NaN,50
1648170000,1.1009,1.10238,1.1008,1.10236,4148,2477.05,-460861,-467339,24.373853153318844,72.04900242061194,59.050642878805924,NaN,NaN,50
1648171800,1.10236,1.10357,1.10221,1.10326,5064,2400.35,-455797,-464077.2,26.995492496762292,76.12074383329293,60.477307999992426,NaN,NaN,50
1648173600,1.10326,1.10357,1.10291,1.10297,3333,2338.45,-459130,-461718.6,29.42987188710263,72.4579771611663,61.32158295619804,NaN,NaN,50
1648175400,1.10297,1.10306,1.10237,1.10288,2113,2202.95,-461243,-460408,30.62675812582664,71.311163266277,62.46034761208488,NaN,NaN,50
1648177200,1.10288,1.10343,1.10264,1.10312,1942,2139.7,-459301,-459266.4,31.98361016349119,72.55845684453037,63.79676759277179,NaN,NaN,50
1648179000,1.10312,1.10313,1.10259,1.10276,2422,2067.6,-461723,-459438.8,33.14513931225139,67.79697629234005,64.75756542223151,NaN,NaN,50
1648180800,1.10276,1.1038,1.1026,1.10348,3724,2110.2,-457999,-459879.2,34.657292466238914,71.78492742462959,66.0789218600268,NaN,NaN,50
1648182600,1.10348,1.1037,1.10309,1.1032,2190,2088.55,-460189,-460091,36.06143468065591,68.24546588717207,67.10138511276719,NaN,NaN,50
1648184400,1.1032,1.1034,1.10252,1.10263,1864,2034.15,-462053,-460253,36.22201077350448,61.58810249968381,67.28389049621441,NaN,NaN,50
1648186200,1.10263,1.10316,1.10251,1.10287,1900,2031.2,-460153,-460423.4,36.3517951680654,63.21521561078818,67.51643334727423,NaN,NaN,50
1648188000,1.10287,1.10292,1.10241,1.10278,2357,2093.7,-462510,-460580.8,36.2689173519621,62.15199591232812,67.54995610903764,NaN,NaN,50
1648189800,1.10278,1.10286,1.10192,1.10278,2459,2184.9,-462510,-461483,35.24400369971213,62.151995912328125,67.5625009928068,NaN,NaN,50
1648191600,1.10278,1.10308,1.10214,1.10252,3392,2337.1,-465902,-462625.6,34.54502379802396,58.83650051178694,67.3326317172871,NaN,NaN,50
1648193400,1.10252,1.10304,1.10218,1.10232,3535,2506.2,-469437,-464102.4,33.895971032170664,56.34648797881916,66.90107225398249,NaN,NaN,50
1648195200,1.10232,1.10266,1.10108,1.10142,5504,2735.1,-474941,-467060,31.521147017545044,46.75694291113367,65.09449657473405,NaN,NaN,50
1648197000,1.10142,1.10204,1.10132,1.10162,4718,2936.65,-470223,-468602.6,29.315953289678394,48.840611601489286,63.145915701033786,NaN,NaN,50
1648198800,1.10162,1.10206,1.10007,1.10084,6274,3201.8,-476497,-471400,28.795604498842327,41.94605836301387,60.966492929737186,NaN,NaN,50
1648200600,1.10084,1.10136,1.1005,1.10052,3755,3330.4,-480252,-474270,28.312423478780264,39.48353092336164,58.69309061952895,NaN,NaN,50
1648202400,1.10052,1.10089,1.10017,1.10035,2515,3299.8,-482767,-476936,28.20805653527615,38.2004843601871,56.23894972779015,NaN,NaN,50
1648204200,1.10035,1.10148,1.10035,1.10144,2944,3307.65,-479823,-477912.4,27.147333992408086,49.52596662777978,54.933877608892985,NaN,NaN,50
1648206000,1.10144,1.10202,1.10106,1.10198,2977,3249.1,-476846,-479237,25.3940020008032,54.02147313777082,53.66505944554593,NaN,NaN,50
1648207800,1.10198,1.10224,1.10114,1.10184,3585,3175.15,-480431,-480023.8,23.68731529594818,52.71069755367478,52.555433136010414,NaN,NaN,50
1648209600,1.10184,1.10184,1.10076,1.10124,3462,3181.6,-483893,-480752,22.389942043919394,47.402236329226184,51.54215698097772,NaN,NaN,50
1648211400,1.10124,1.10166,1.10026,1.10034,4632,3307.55,-488525,-481903.6,21.78791186404041,40.76965131368404,49.93890238832743,NaN,NaN,50
1648213200,1.10034,1.10086,1.09922,1.10042,7190,3569.95,-481335,-482206,22.253361990774064,41.552507591142216,48.46751036538557,NaN,NaN,50
1648215000,1.10042,1.10187,1.10031,1.10118,10122,3954.95,-471213,-481079.4,21.324974281449215,48.514463667300085,47.49340091931214,NaN,NaN,50
1648216800,1.10118,1.10204,1.1007,1.10076,8447,4191.1,-479660,-480925.2,20.258391493914125,45.30293283638321,46.52671751392616,NaN,NaN,50
1648218600,1.10076,1.10246,1.10076,1.1018,6134,4388.3,-473526,-478851.8,18.850060983779372,53.50969726781428,46.32408960599724,NaN,NaN,50
1648220400,1.1018,1.10218,1.10015,1.1005,7504,4670.3,-481030,-477352.8,18.12933263610624,44.518058700397596,46.164169305230374,NaN,NaN,50
1648222200,1.1005,1.10098,1.0982,1.09827,8903,5020.45,-489933,-479072.4,19.034363184974282,33.97230625872106,45.102147495032646,NaN,NaN,50
1648224000,1.09827,1.09918,1.09824,1.09902,6733,5239.25,-483200,-481469.8,19.874748694637464,39.18976606681597,44.905269473875656,NaN,NaN,50
1648225800,1.09902,1.09916,1.09809,1.09878,5489,5390.75,-488689,-483275.6,20.75937910422645,38.15087002379534,44.81007940962092,NaN,NaN,50
1648227600,1.09878,1.09919,1.09842,1.09891,4639,5453.1,-484050,-485380.4,21.53809142888431,39.09272787862243,44.873811089509154,NaN,NaN,50
1648229400,1.09891,1.09935,1.09864,1.09909,4132,5482.95,-479918,-485158,22.023053085431226,40.44506010052144,44.2251749089907,NaN,NaN,50
1648231200,1.09909,1.09969,1.09874,1.09877,3580,5386.75,-483498,-483871,21.971317896333,38.79590212780205,43.13763412256436,NaN,NaN,50
1648233000,1.09877,1.09901,1.09835,1.09868,3298,5315.75,-486796,-484590.2,22.279525631966344,38.322610229764244,42.1099135994279,NaN,NaN,50
1648234800,1.09868,1.09906,1.0984,1.099,3222,5163.15,-483574,-483567.2,22.487477778924376,41.075151516065894,41.65797896991645,NaN,NaN,50
1648236600,1.099,1.09906,1.09823,1.09834,2350,5092.9,-485924,-483942,22.845057674176754,37.37074800381547,41.41520016206869,NaN,NaN,50
1648238400,1.09834,1.0986,1.09828,1.0983,1180,5026.15,-487104,-485379.2,23.177096148339675,37.15206110561566,41.10088255595965,NaN,NaN,50
1648240200,1.0983,1.09868,1.0982,1.09847,1425,4950.2,-485679,-485815.4,23.485417588633815,38.79143047901614,40.40638018536794,NaN,NaN,50
1648414800,1.09847,1.0988,1.09847,1.09864,159,4809.3,-485520,-485560.2,23.531109057172735,40.463872399129784,40.06073301127841,NaN,NaN,50
1648416600,1.09864,1.09864,1.09814,1.0985,292,4644.65,-485812,-486007.8,23.966830867471188,39.50652095068114,39.06050613148319,NaN,NaN,50
1648418400,1.0985,1.09859,1.09792,1.0982,1072,4525.15,-486884,-486199.8,24.62033577588897,37.461190725762926,38.556444133294995,NaN,NaN,50
1648420200,1.0982,1.09846,1.09798,1.09812,1146,4350.85,-488030,-486385,25.22716176227691,36.91238308398766,38.76644962081404,NaN,NaN,50
1648422000,1.09812,1.09844,1.09776,1.09825,1159,4049.3,-486871,-486623.4,26.050117917743464,38.48936541943574,38.71642100314403,NaN,NaN,50
1648423800,1.09825,1.09846,1.09804,1.09816,1024,3594.4,-487895,-487098.4,26.762627970739555,37.78517838680387,38.69030017193034,NaN,NaN,50
1648425600,1.09816,1.09845,1.09758,1.09778,2126,3278.35,-490021,-487940.2,27.95356186697868,34.8832296876957,38.389621729721284,NaN,NaN,50
1648427400,1.09778,1.09784,1.09674,1.09708,2809,3112.1,-492830,-489129.4,29.809031098654444,30.271154624347687,37.66291419570888,NaN,NaN,50
1648429200,1.09708,1.0975,1.09571,1.09596,6130,3043.4,-498960,-491315.4,32.17952679277074,24.65447023889982,36.652811917930144,NaN,NaN,50
1648431000,1.09596,1.09662,1.09538,1.09542,4660,2831.25,-503620,-494665.2,34.548753468966794,22.487956501419532,35.521765223048384,NaN,NaN,50
1648432800,1.09542,1.09622,1.0951,1.09552,5262,2757.7,-498358,-496757.8,36.88464917041438,23.822955121413088,34.28946548057318,NaN,NaN,50
1648434600,1.09552,1.0959,1.09518,1.09554,2922,2629.35,-495436,-497840.8,39.053695178901414,24.104496579328412,33.34187609310982,NaN,NaN,50
1648436400,1.09554,1.0959,1.09542,1.09548,1638,2479.3,-497074,-498689.6,41.067809329639374,23.82007192389557,32.389591151558385,NaN,NaN,50
1648438200,1.09548,1.09557,1.09504,1.09557,2040,2374.7,-495034,-497904.4,43.13722842445482,25.24497559363924,31.42198723117432,NaN,NaN,50
1648440000,1.09557,1.09564,1.0951,1.09522,2107,2301.05,-497141,-496608.6,44.85708572092233,23.41107214079105,30.203930069864413,NaN,NaN,50
1648441800,1.09522,1.09559,1.09512,1.09542,1605,2216.4,-495536,-496044.2,46.45409606764216,26.68840690481271,29.288350495159527,NaN,NaN,50
1648443600,1.09542,1.09542,1.09505,1.09512,1613,2135.95,-497149,-496386.8,47.981294071047905,24.962866209321803,28.395613029699444,NaN,NaN,50
1648445400,1.09512,1.09518,1.09449,1.09514,2812,2159.05,-494337,-495839.4,49.721128320710704,25.309571867185554,27.566840799927867,NaN,NaN,50
1648447200,1.09514,1.096,1.09482,1.09576,4523,2326.2,-489814,-494795.4,49.11010820170588,35.29106119892673,27.33839049846294,NaN,NaN,50
1648449000,1.09576,1.09656,1.09552,1.09552,4783,2494.1,-494597,-494286.6,47.358857031567254,33.428739779956004,27.027216312259522,NaN,NaN,50
1648450800,1.09552,1.09594,1.09474,1.09566,8425,2907.4,-486172,-492413.8,46.53924155109046,35.56480517222229,27.075900275439988,NaN,NaN,50
1648452600,1.09566,1.09611,1.0948,1.09518,5729,3179.25,-491901,-491364.2,45.44861984356467,31.797594427098772,27.184931689922212,NaN,NaN,50
1648454400,1.09518,1.0966,1.09446,1.0965,6946,3472.95,-484955,-489487.8,43.5419052510171,48.083795543440864,28.858454925960853,NaN,NaN,50
1648456200,1.0965,1.09993,1.09598,1.09908,14151,4123.2,-470804,-485685.8,42.57845894881257,65.44983236647333,31.92716034489327,NaN,NaN,50
1648458000,1.09908,1.09908,1.09702,1.09797,8806,4505.55,-479610,-482688.4,41.683830239622644,56.66732624256416,34.27318685354692,NaN,NaN,50
1648459800,1.09797,1.09916,1.09782,1.09794,5338,4721.25,-484948,-482443.6,40.90966887173948,56.44686476848188,36.583356009915015,NaN,NaN,50
1648461600,1.09794,1.09824,1.09746,1.09768,3558,4792.85,-488506,-481764.6,39.704684644610445,54.46904583744597,38.77256843231147,NaN,NaN,50
1648463400,1.09768,1.09906,1.09745,1.09887,5735,4939.15,-482771,-481327.8,39.19969649046243,61.174419169757925,41.3389572591771,NaN,NaN,50
1648465200,1.09887,1.09935,1.09826,1.09838,4634,4864.35,-487405,-484648,38.92957623183308,57.424294696001475,43.768473155977844,NaN,NaN,50
1648467000,1.09838,1.09846,1.09592,1.09636,5597,4911.2,-493002,-487326.4,36.17427448354681,45.13939677173943,45.08640100361546,NaN,NaN,50
1648468800,1.09636,1.097,1.09591,1.09694,6488,4972.5,-486514,-487639.6,33.62442272290549,48.543314085546164,46.77071870906006,NaN,NaN,50
1648470600,1.09694,1.09704,1.09512,1.09566,8583,5255.55,-495097,-488957.8,31.922340372324165,42.304880507811994,47.98466932624766,NaN,NaN,50
1648472400,1.09566,1.09604,1.09466,1.09554,6981,5522.7,-502078,-492819.2,30.699171197152207,41.76301200734872,48.44695152684924,NaN,NaN,50
1648474200,1.09554,1.09726,1.09554,1.09687,8084,5824.9,-493994,-494137,28.57064140586507,49.48576726895497,49.593882061777734,NaN,NaN,50
1648476000,1.09687,1.09772,1.0964,1.09717,7066,6072.85,-486928,-492922.2,26.966509920856964,51.062188262401605,50.70083799679054,NaN,NaN,50
1648477800,1.09717,1.09788,1.09649,1.09698,7331,6359.15,-494259,-494471.2,25.60654813935369,49.99797685523875,52.00086531308625,NaN,NaN,50
1648479600,1.09698,1.09764,1.09671,1.09712,5402,6548.6,-488857,-493223.2,24.343726485100657,50.81146548862788,52.19569888059961,NaN,NaN,50
1648481400,1.09712,1.09764,1.09662,1.09762,4533,6634.65,-484324,-489672.4,23.07513471988612,53.70811173730425,51.357004549944676,NaN,NaN,50
1648483200,1.09762,1.09888,1.0974,1.09848,3630,6590,-480694,-487012.4,22.937522683613338,58.26099768375985,51.4708382243158,NaN,NaN,50
1648485000,1.09848,1.09996,1.09826,1.0994,3844,6543.05,-476850,-484996.8,23.528330952924676,62.508984308262804,51.90384676287158,NaN,NaN,50
1648486800,1.0994,1.09992,1.09931,1.09978,2990,6271.3,-473860,-480917,24.076938631570926,64.13273658006571,52.594110387344415,NaN,NaN,50
1648488600,1.09978,1.09983,1.0983,1.0983,2456,6107.65,-476316,-478408.8,23.447118865384528,54.273501749878136,52.10118771449586,NaN,NaN,50
1648490400,1.0983,1.09844,1.09776,1.09788,2637,5892.2,-478953,-477334.6,22.323760552248228,51.838024163359705,51.70216839073573,NaN,NaN,50
1648492200,1.09788,1.09908,1.09773,1.09902,2761,5322.7,-476192,-476434.2,21.78854813546601,57.422889693136206,52.57956074226407,NaN,NaN,50
1648494000,1.09902,1.09904,1.09798,1.09818,2583,5011.55,-478775,-476819.2,21.29156517702538,52.5842505747146,52.86819906291896,NaN,NaN,50
1648495800,1.09818,1.09896,1.09746,1.09875,2938,4891.55,-475837,-477214.6,20.274834987666885,55.33461071253386,53.79889407754195,NaN,NaN,50
1648497600,1.09875,1.0989,1.0984,1.0988,1006,4763.95,-474831,-476917.6,19.330728383262574,55.578024205771605,54.78568066314359,NaN,NaN,50
1648499400,1.0988,1.09884,1.09846,1.09858,495,4501.95,-475326,-476192.2,18.45405796488714,54.17894773996664,55.120907839644424,NaN,NaN,50
1648501200,1.09858,1.09876,1.09822,1.09864,130,4276.75,-475196,-475993,17.352809472367568,54.51524048906031,55.3675544272629,NaN,NaN,50
1648503000,1.09864,1.09872,1.0986,1.09861,112,4002.5,-475308,-475299.6,16.33022158645654,54.30064916745761,55.674888163849964,NaN,NaN,50
1648504800,1.09861,1.09922,1.0985,1.09893,1081,3732.15,-474227,-474977.6,15.956880750472838,56.277668612061,56.06533124409519,NaN,NaN,50
1648506600,1.09893,1.09942,1.09882,1.09884,1215,3363.75,-475442,-475099.8,15.829895426149715,55.54978737366292,56.19687950383509,NaN,NaN,50
1648508400,1.09884,1.09979,1.09882,1.09976,1863,3107.85,-473579,-474750.4,16.107276495806403,61.08987969921751,56.398942504939214,NaN,NaN,50
1648510200,1.09976,1.09976,1.09895,1.09914,1528,2780.05,-475107,-474732.6,16.364844631916185,56.02238504513503,55.93561398614437,NaN,NaN,50
1648512000,1.09914,1.09973,1.0987,1.09876,5233,2688.4,-480340,-475739,16.19270445713298,53.114268390648085,55.14858054404312,NaN,NaN,50
1648513800,1.09876,1.09912,1.09688,1.09737,6136,2628.65,-486476,-478188.8,16.268290011368975,44.09699715870026,54.421687358958984,NaN,NaN,50
1648515600,1.09737,1.09877,1.09733,1.09852,5455,2631.3,-481021,-479304.6,16.338476597445254,51.44200698429242,54.393400417597036,NaN,NaN,50
1648517400,1.09852,1.09952,1.0985,1.09923,3315,2570.4,-477706,-480130,15.434402962058794,55.343138846619055,54.244846785702954,NaN,NaN,50
1648519200,1.09923,1.0995,1.0991,1.09926,2056,2491.7,-475650,-480238.6,14.594906014914223,55.50579889779603,54.4535288087802,NaN,NaN,50
1648521000,1.09926,1.0994,1.09873,1.09924,2700,2434.5,-478350,-479840.6,14.24263412083962,55.361025003308384,54.45541554383552,NaN,NaN,50
1648522800,1.09924,1.09941,1.0988,1.0988,1979,2383.95,-480329,-478611.2,13.901391241584237,52.13904852776254,54.20977442397773,NaN,NaN,50
1648524600,1.0988,1.09928,1.09845,1.09928,3543,2438.3,-476786,-477764.2,13.996312448791851,55.20206598987053,54.28285429897087,NaN,NaN,50
1648526400,1.09928,1.09974,1.09912,1.0996,2402,2426.55,-474384,-477099.8,13.403961011047649,57.169996152845975,54.472479703526986,NaN,NaN,50
1648528200,1.0996,1.09972,1.09851,1.09854,2499,2413.45,-476883,-477346.4,13.565199893915977,49.4247265105428,54.12419951374735,NaN,NaN,50
1648530000,1.09854,1.09884,1.09794,1.09828,2964,2432.5,-479847,-477645.8,14.293604422549341,47.7170935542381,53.51272986676001,NaN,NaN,50
1648531800,1.09828,1.09862,1.09792,1.09831,2945,2432.85,-476902,-476960.4,14.98967462556946,47.94059587444589,52.9692161882445,NaN,NaN,50
1648533600,1.09831,1.09946,1.09827,1.0992,3946,2579.85,-472956,-476194.4,14.390442160173937,54.19630140186328,52.47681773843349,NaN,NaN,50
1648535400,1.0992,1.10092,1.09918,1.10035,4708,2790.5,-468248,-474967.2,14.477369785715583,60.75805795211393,52.81508008893197,NaN,NaN,50
1648537200,1.10035,1.1015,1.09976,1.10146,6212,3094.6,-462036,-471997.8,15.051381591577432,65.84425467494228,53.72436482352442,NaN,NaN,50
1648539000,1.10146,1.10182,1.09994,1.10002,6229,3400.45,-468265,-469681.4,15.841026684239171,55.749262535274596,54.55666949327973,NaN,NaN,50
1648540800,1.10002,1.10055,1.0995,1.09994,5175,3605.15,-473440,-468989,15.995541810887094,55.24253572534525,54.82813583192636,NaN,NaN,50
1648542600,1.09994,1.09998,1.0979,1.0985,5619,3825.35,-479059,-470209.6,15.261399030141682,46.96718392286805,54.22985333737272,NaN,NaN,50
1648544400,1.0985,1.10292,1.0975,1.102,14066,4435.5,-464993,-469558.6,15.91190400026718,61.90460384743252,54.68691083377532,NaN,NaN,50
1648546200,1.102,1.10461,1.10197,1.10374,8214,4769.8,-456779,-468507.2,17.325123934082626,66.8965515396942,55.510877014945734,NaN,NaN,50
1648548000,1.10374,1.10579,1.10348,1.10511,6572,4836.75,-450207,-464895.6,19.102346117277953,70.20686924389561,56.801435637526666,NaN,NaN,50
1648549800,1.10511,1.10572,1.10436,1.10474,5328,4796.35,-455535,-461314.6,20.752623858816474,68.22264464121994,57.731476969765914,NaN,NaN,50
1648551600,1.10474,1.10547,1.10386,1.10417,5870,4817.1,-461405,-457783.8,21.80367183669782,65.16704085780239,58.302694448691376,NaN,NaN,50
1648553400,1.10417,1.11027,1.10318,1.10847,21742,5738.45,-439663,-452717.8,24.295356255709557,74.4602139521084,60.090943551660345,NaN,NaN,50
1648555200,1.10847,1.1117,1.1079,1.11155,16080,6439.65,-423583,-446078.6,26.90430231669546,78.81917903022841,62.31252108565965,NaN,NaN,50
1648557000,1.11155,1.11292,1.11012,1.1113,14805,7044.9,-438388,-443714.8,29.552487104934205,77.66056007664928,64.43537567153132,NaN,NaN,50
1648558800,1.1113,1.11294,1.10972,1.11257,11412,7516.55,-426976,-438003,31.68736277923004,79.32334968033602,66.23016483427938,NaN,NaN,50
1648560600,1.11257,1.11374,1.11206,1.11301,12437,7961.25,-414539,-428629.8,33.832722550055536,79.8820543350815,67.59616457591991,NaN,NaN,50
1648562400,1.11301,1.11322,1.11004,1.11024,13266,8504.45,-427805,-426258.2,34.29223845456929,67.51384746427189,67.71542120372918,NaN,NaN,50
1648564200,1.11024,1.11145,1.10902,1.10998,14495,9104.25,-442300,-430001.6,34.04472839601304,66.47348605856328,68.48143716967836,NaN,NaN,50
1648566000,1.10998,1.1117,1.10982,1.1105,10323,9472.2,-431977,-428719.4,33.90112655640781,67.55048256933895,69.36057622996363,NaN,NaN,50
1648567800,1.1105,1.11172,1.11037,1.11066,6360,9642.95,-425617,-428447.6,33.77507033645898,67.8922549988521,70.8552241639625,NaN,NaN,50
1648569600,1.11066,1.11069,1.10861,1.10862,5191,9705.2,-430808,-431701.4,32.482424078312725,59.31431213021649,70.6702033270185,NaN,NaN,50
1648571400,1.10862,1.10906,1.1078,1.10801,4363,9687.95,-435171,-433174.6,30.801682568602978,56.9953857355654,69.96297719815216,NaN,NaN,50
1648573200,1.10801,1.10829,1.10751,1.10786,4317,9593.2,-439488,-432612.2,29.070353923396386,56.41134914161829,68.97758290513234,NaN,NaN,50
1648575000,1.10786,1.108,1.10716,1.10777,3406,9452.05,-442894,-434795.6,27.25177859577669,56.040295487717934,68.10741510845362,NaN,NaN,50
1648576800,1.10777,1.10816,1.10734,1.10764,3523,9369.45,-446417,-438955.6,25.655758773569726,55.472705015991124,67.41496254832425,NaN,NaN,50
1648578600,1.10764,1.1091,1.10763,1.10892,4021,9289.55,-442396,-441273.2,24.706705859599072,59.790972586617016,66.36715959364629,NaN,NaN,50
1648580400,1.10892,1.10944,1.1086,1.10918,3227,8747.6,-439169,-442072.8,24.01108224213802,60.62626382266595,65.06766565024898,NaN,NaN,50
1648582200,1.10918,1.10922,1.10834,1.10884,2574,8465.6,-441743,-442523.8,23.169356442662032,58.90303757771415,63.72784261461076,NaN,NaN,50
1648584000,1.10884,1.10885,1.10838,1.10876,665,8170.25,-442408,-442426.6,22.38775391457719,58.481828048238555,62.23916249803237,NaN,NaN,50
1648585800,1.10876,1.10884,1.10854,1.10866,507,7929.2,-442915,-441726.2,21.661980138498404,57.92423735359301,60.67074699935461,NaN,NaN,50
1648587600,1.10866,1.10874,1.10831,1.10838,284,7649.9,-443199,-441886.8,20.782303824149693,56.3054575236947,59.87014771788481,NaN,NaN,50
1648589400,1.10838,1.10899,1.10828,1.1088,1127,6619.15,-442072,-442467.4,20.154327988138856,58.1928156768759,59.27867126205,NaN,NaN,50
1648591200,1.1088,1.10992,1.10873,1.10956,1474,5888.85,-440598,-442238.4,20.228914207287016,61.43866373183306,58.842112773656716,NaN,NaN,50
1648593000,1.10956,1.10974,1.10916,1.1092,1076,5202.4,-441674,-442091.6,20.298172839353164,59.09807975204561,58.21395739888483,NaN,NaN,50
1648594800,1.1092,1.10948,1.10918,1.10935,869,4675.25,-440805,-441669.6,20.36248442627173,59.78552530752473,58.247615482978276,NaN,NaN,50
1648596600,1.10935,1.10948,1.10902,1.1091,1559,4131.35,-442364,-441502.6,20.231859538758105,58.03480576685857,58.32185977092779,NaN,NaN,50
1648598400,1.1091,1.10982,1.10884,1.10914,4877,3711.9,-437487,-440585.6,20.389331303406077,58.24548833540789,58.45286971334133,NaN,NaN,50
1648600200,1.10914,1.1098,1.1088,1.10974,5528,3263.55,-431959,-438857.8,20.482794328960498,61.37771560830637,58.83411400766908,NaN,NaN,50
1648602000,1.10974,1.11103,1.10971,1.11031,7651,3129.95,-424308,-435384.6,21.500906495701173,64.13056635801408,59.452532674956394,NaN,NaN,50
1648603800,1.11031,1.11077,1.10994,1.11044,4582,3041.05,-419726,-431168.8,22.446296364817517,64.74770855270896,59.806585243962964,NaN,NaN,50
1648605600,1.11044,1.11092,1.11011,1.1108,4035,2983.25,-415691,-425834.2,23.431420081687747,66.4682335454624,60.22386879559128,NaN,NaN,50
1648607400,1.1108,1.11162,1.11053,1.11125,4648,2997.5,-411043,-420545.4,24.81824531166426,68.53546742738634,60.91189949913929,NaN,NaN,50
1648609200,1.11125,1.11209,1.11091,1.11156,5721,3067.7,-405322,-415218,26.390640498429512,69.91161777046312,61.72831305072676,NaN,NaN,50
1648611000,1.11156,1.11171,1.11098,1.11152,3317,3063.25,-408639,-412084.2,27.850721743282964,69.48929404619159,62.554388528769515,NaN,NaN,50
1648612800,1.11152,1.11216,1.1115,1.11205,3133,3043.75,-405506,-409240.2,29.479403585285684,71.91054600978374,63.669037706347304,NaN,NaN,50
1648614600,1.11205,1.11206,1.11095,1.11108,2849,2985.15,-408355,-407773,30.061925061381118,62.184226847176305,63.95413850422591,NaN,NaN,50
1648616400,1.11108,1.11118,1.11085,1.11108,2216,2934.6,-408355,-407235.4,30.43927317128291,62.18422684717631,64.0073930124647,NaN,NaN,50
1648618200,1.11108,1.11134,1.11076,1.11128,3040,2957.9,-405315,-407234,30.918372599202463,63.36899241237538,64.31245820248826,NaN,NaN,50
1648620000,1.11128,1.11204,1.11072,1.11161,6116,3230.45,-399199,-405346,31.884328243083637,65.30073115639449,64.70640147740754,NaN,NaN,50
1648621800,1.11161,1.11212,1.11056,1.1112,5367,3473.45,-404566,-405158,32.49471116991337,60.99683830849676,64.91797523038169,NaN,NaN,50
1648623600,1.1112,1.11349,1.1112,1.11196,10993,4008.9,-393573,-402201.6,33.92911119774623,65.5318259011016,65.43842791364553,NaN,NaN,50
1648625400,1.11196,1.11308,1.11154,1.11284,6906,4297.85,-386667,-397864,35.26105408073389,69.8964580761391,66.04690951849071,NaN,NaN,50
1648627200,1.11284,1.11332,1.11144,1.11234,8188,4633.55,-394855,-395772,36.632606728757935,64.87018023114962,66.09973908085753,NaN,NaN,50
1648629000,1.11234,1.11568,1.11198,1.11562,10035,5081.5,-384820,-392896.2,38.87026325563458,76.7046550807092,66.9538066900004,NaN,NaN,50
1648630800,1.11562,1.11617,1.11476,1.11574,6719,5374,-378101,-387603.2,41.09033263609596,77.00980122121561,67.70677580969706,NaN,NaN,50
1648632600,1.11574,1.11577,1.11434,1.11463,3877,5489.9,-381978,-385284.2,42.49314166114529,68.12094617888656,67.67716714908994,NaN,NaN,50
1648634400,1.11463,1.11464,1.11219,1.11302,9468,5719.45,-391446,-386240,41.15229907777293,57.71511110852889,66.80598810180892,NaN,NaN,50
1648636200,1.11302,1.11306,1.11164,1.11292,5101,5698.1,-396547,-386578.4,39.38009963052887,57.13135744783018,65.9232783447831,NaN,NaN,50
1648638000,1.11292,1.11421,1.11258,1.11392,4715,5551.3,-391832,-387980.8,38.44205793386507,61.342137888864954,65.16839205043176,NaN,NaN,50
1648639800,1.11392,1.11478,1.11348,1.11392,4977,5571.05,-391832,-390727,37.8841905846751,61.342137888864954,65.1082428391238,NaN,NaN,50
1648641600,1.11392,1.11404,1.11118,1.11158,7738,5756.2,-399570,-394245.4,35.45059849074988,48.431774395847214,64.125924806886,NaN,NaN,50
1648643400,1.11158,1.11304,1.11154,1.1125,7246,5886.1,-392324,-394421,33.19083440353361,52.65112737187591,63.36036301827891,NaN,NaN,50
1648645200,1.1125,1.11458,1.11193,1.11426,7695,5984.8,-384629,-392037.4,32.03715938008256,59.48125985125309,62.944686496483094,NaN,NaN,50
1648647000,1.11426,1.11658,1.11394,1.11642,9599,6298.9,-375030,-388677,31.921650769229853,65.96933268570035,63.29986466628337,NaN,NaN,50
1648648800,1.11642,1.11653,1.11508,1.11636,7601,6522.3,-382631,-386836.8,31.814392773438062,65.65484132332963,63.3086514821568,NaN,NaN,50
1648650600,1.11636,1.11712,1.1158,1.11628,9042,6831.95,-391673,-385257.4,31.97470761761198,65.20847227107981,62.97379535322399,NaN,NaN,50
1648652400,1.11628,1.11683,1.11556,1.11634,7171,7079.7,-384502,-383693,31.909112791788928,65.39847877176706,63.0115309632681,NaN,NaN,50
1648654200,1.11634,1.11686,1.11614,1.11632,4460,7150.7,-388962,-384559.6,31.863005622779937,65.27051841242275,62.194806915533356,NaN,NaN,50
1648656000,1.11632,1.11656,1.1155,1.11564,3345,7012.15,-392307,-388015,31.214540850322475,60.90698311552641,61.04460562226984,NaN,NaN,50
1648657800,1.11564,1.11595,1.1152,1.11572,2676,6877.6,-389631,-389415,30.3354383143525,61.23532278821415,60.552775380078955,NaN,NaN,50
1648659600,1.11572,1.11574,1.115,1.11518,2166,6436.25,-391797,-389439.8,29.33083625516955,57.7117987356852,60.55253878201869,NaN,NaN,50
1648661400,1.11518,1.1155,1.11483,1.11485,2482,6215.05,-394279,-391395.2,28.232804705717268,55.606070603830325,60.44358972173298,NaN,NaN,50
1648663200,1.11485,1.1156,1.11477,1.11533,1993,5905.3,-392286,-392060,27.289677350576973,58.00620098849672,60.20530851456382,NaN,NaN,50
1648665000,1.11533,1.11624,1.11532,1.1161,2222,5514.65,-390064,-391611.4,26.893321055137974,61.593368349312,60.22325354745289,NaN,NaN,50
1648666800,1.1161,1.11628,1.11533,1.11544,2299,5293.65,-392363,-392157.8,26.55483764329339,57.09166304136943,60.84181702213305,NaN,NaN,50
1648668600,1.11544,1.11557,1.11516,1.1152,2082,5203.9,-394445,-392687.4,26.034330845821575,55.503071970032764,61.04552735057283,NaN,NaN,50
1648670400,1.1152,1.11603,1.1152,1.116,967,4778.85,-393478,-392527.2,25.922536814163077,59.544039566098405,61.050011615918926,NaN,NaN,50
1648672200,1.116,1.11603,1.11574,1.11588,409,4544.25,-393887,-392847.4,25.81872807048019,58.68315536319873,60.52957037859738,NaN,NaN,50
1648674000,1.11588,1.11597,1.11579,1.11594,141,4315.55,-393746,-393583.8,25.72233423706037,59.00232411815704,60.05439057822791,NaN,NaN,50
1648675800,1.11594,1.1161,1.11576,1.11576,222,4077.8,-393968,-393904.8,25.752789094635286,57.56563610433965,59.50847370917503,NaN,NaN,50
1648677600,1.11576,1.1165,1.11572,1.11616,881,3734.95,-393087,-393633.2,26.143069049394175,59.90224271890667,59.11588541968501,NaN,NaN,50
1648679400,1.11616,1.11618,1.11582,1.11589,595,3402.4,-393682,-393674,26.505471864527426,57.596798056767426,58.5677625371382,NaN,NaN,50
1648681200,1.11589,1.11609,1.11582,1.116,856,3060.45,-392826,-393461.8,26.841988764294015,58.30092608823384,58.381615606617295,NaN,NaN,50
1648683000,1.116,1.1162,1.11579,1.11612,1419,2651.45,-391407,-392994,27.267605305343945,59.098850477811844,58.22901044158856,NaN,NaN,50
1648684800,1.11612,1.11671,1.11564,1.11592,4858,2514.3,-396265,-393453.4,28.157793803225605,57.13647457077417,58.18791585838063,NaN,NaN,50
1648686600,1.11592,1.11749,1.11591,1.11742,7120,2418.2,-389145,-392665,29.6094210956307,66.20112995093601,58.944705811745315,NaN,NaN,50
1648688400,1.11742,1.11849,1.11728,1.11822,4576,2288.45,-384569,-390842.4,31.57184748467542,69.86182665036642,59.79153621616457,NaN,NaN,50
1648690200,1.11822,1.11822,1.11712,1.11764,3146,2222.75,-387715,-389820.2,33.080297473965025,64.41467951186068,59.99305844206091,NaN,NaN,50
1648692000,1.11764,1.11764,1.11703,1.11716,2658,2188.4,-390373,-389613.4,34.299303504645025,60.22929938096978,60.217175323460935,NaN,NaN,50
1648693800,1.11716,1.1174,1.11661,1.11666,2627,2185.95,-393000,-388960.4,34.60267555865261,56.13748029382995,60.26249020373216,NaN,NaN,50
1648695600,1.11666,1.11694,1.11653,1.11688,2011,2178.2,-390989,-389329.2,34.72999406318279,57.50545832204239,60.116877257728156,NaN,NaN,50
1648697400,1.11688,1.11696,1.11616,1.11642,2465,2177.35,-393454,-391106.2,34.145838866764514,53.73200951148018,59.7632239826054,NaN,NaN,50
1648699200,1.11642,1.11643,1.11588,1.11591,1672,2161.3,-395126,-392588.4,33.101740219344784,49.82809161200455,59.10792166073737,NaN,NaN,50
1648701000,1.11591,1.11616,1.11577,1.11606,1716,2136,-393410,-393195.8,31.93635359748749,50.956724819892365,58.63585656899114,NaN,NaN,50
1648702800,1.11606,1.11639,1.11576,1.1158,1760,2109.05,-395170,-393629.8,31.14617252165263,48.90321679877121,57.85021186041003,NaN,NaN,50
1648704600,1.1158,1.11679,1.11575,1.1166,2365,2123.2,-392805,-393993,30.888588930010958,54.92263773585902,57.65920040891657,NaN,NaN,50
1648706400,1.1166,1.11726,1.1163,1.11654,4673,2308.5,-397478,-394797.8,31.14800967830381,54.40497640138065,57.38091828842706,NaN,NaN,50
1648708200,1.11654,1.11732,1.11513,1.11688,7241,2650.1,-390237,-393820,29.41670932773301,56.88488805253093,57.2227781151927,NaN,NaN,50
1648710000,1.11688,1.11757,1.11556,1.11566,7182,3002.15,-397419,-394621.8,28.108962500820788,47.00544373124613,56.499133055226416,NaN,NaN,50
1648711800,1.11566,1.11664,1.115,1.11508,5615,3271.8,-403034,-396194.6,26.11590170553918,43.16712056854404,54.85384667076984,NaN,NaN,50
1648713600,1.11508,1.11516,1.11326,1.11367,6983,3576.9,-410017,-399637,26.004935427334363,35.564174425587865,52.40401436899996,NaN,NaN,50
1648715400,1.11367,1.11383,1.11128,1.11296,6297,3862,-416314,-403404.2,27.154613043822106,32.463552613706185,50.12179101913177,NaN,NaN,50
1648717200,1.11296,1.11319,1.11158,1.11234,5863,4112.35,-422177,-409792.2,28.22217083056072,30.00359625174643,47.96281222418725,NaN,NaN,50
1648719000,1.11234,1.11287,1.11062,1.11118,6011,4341.95,-428188,-415946,29.691617561351613,26.029422312141577,45.81223665406666,NaN,NaN,50
1648720800,1.11118,1.11156,1.11012,1.11022,5419,4370,-433607,-422060.6,31.278842527027667,23.28105857770302,43.367636672328125,NaN,NaN,50
1648722600,1.11022,1.11026,1.1088,1.10938,5873,4307.65,-439480,-427953.2,33.25962353998339,21.17431452829929,41.04208703067235,NaN,NaN,50
1648724400,1.10938,1.11086,1.10926,1.11012,5115,4334.6,-434365,-431563.4,34.33365954098734,27.406546725572554,39.44054811021293,NaN,NaN,50
1648726200,1.11012,1.11064,1.10939,1.11028,5458,4450.2,-428907,-432909.4,35.33097868477673,28.718818256087545,37.85212621279829,NaN,NaN,50
1648728000,1.11028,1.1111,1.10944,1.1111,6199,4627.25,-422708,-431813.4,35.65834197023768,35.18543895311613,36.87228493810864,NaN,NaN,50
1648729800,1.1111,1.11134,1.1097,1.11022,6370,4814.4,-429078,-430907.6,35.65470220933933,31.84643576745212,35.22398479750815,NaN,NaN,50
1648731600,1.11022,1.11074,1.10682,1.10837,11641,5295.9,-440719,-431155.4,36.960248496226264,26.214377397608175,33.21037058295297,NaN,NaN,50
1648733400,1.10837,1.1099,1.10784,1.10926,9511,5648.2,-431208,-430524,38.17254147690699,32.40747527636033,31.46198395608364,NaN,NaN,50
1648735200,1.10926,1.10932,1.10706,1.1081,9547,6041.95,-440755,-432893.6,39.56824228578756,28.991888177267356,30.175301416513726,NaN,NaN,50
1648737000,1.1081,1.11328,1.10741,1.11196,17223,6817.3,-423532,-433058.4,37.37554977470406,48.45852764492896,30.553259064826936,NaN,NaN,50
1648738800,1.11196,1.11318,1.11012,1.11015,12828,7370.7,-436360,-434514.8,35.33947815726939,42.56575940727468,31.053372277804566,NaN,NaN,50
1648740600,1.11015,1.11052,1.10928,1.10928,6428,7573.85,-442788,-434928.6,33.90965092435393,40.04504691282026,31.59490758488414,NaN,NaN,50
1648742400,1.10928,1.1094,1.10806,1.10808,5233,7601.85,-448021,-438291.2,33.18491970080196,36.80729542331196,32.08088609713882,NaN,NaN,50
1648744200,1.10808,1.10862,1.1076,1.10818,4039,7441.75,-443982,-438936.6,32.72380771837645,37.262519492062125,32.883250181418866,NaN,NaN,50
1648746000,1.10818,1.10936,1.108,1.10884,4049,7285.1,-439933,-442216.8,31.72404921864783,40.31833963200094,34.10019882815443,NaN,NaN,50
1648747800,1.10884,1.10899,1.10794,1.10814,2718,7140.25,-442651,-443475,30.82753402435462,38.19348700785562,35.3158540052656,NaN,NaN,50
1648749600,1.10814,1.10816,1.10666,1.10688,3722,6977.2,-446373,-444192,30.640992096264174,34.65328700116342,35.83347831066495,NaN,NaN,50
1648751400,1.10688,1.1071,1.1064,1.10698,3804,6852.55,-442569,-443101.6,30.59026652092212,35.16691573186692,36.29405670179205,NaN,NaN,50
1648753200,1.10698,1.10756,1.10639,1.10648,3108,6714.8,-445677,-443440.6,30.139119271822405,33.738968842854334,36.19073740820192,NaN,NaN,50
1648755000,1.10648,1.10696,1.1061,1.10641,3722,6600.35,-449399,-445333.8,29.875483949030052,33.533677011058685,36.311254639888105,NaN,NaN,50
1648756800,1.10641,1.10724,1.1064,1.10674,1374,6398.1,-448025,-446408.6,29.36887679125523,35.525400748525385,36.976327736382196,NaN,NaN,50
1648758600,1.10674,1.10679,1.10648,1.10671,774,6143.15,-448799,-446893.8,28.898455859035753,35.42148384574264,37.19161406276664,NaN,NaN,50
1648760400,1.10671,1.10671,1.10648,1.10666,235,5899.15,-449034,-448186.8,28.461636421974816,35.23648321948154,37.63765656578194,NaN,NaN,50
1648762200,1.10666,1.10686,1.10666,1.1068,191,5635.8,-448843,-448820,27.88916116667282,36.24062084934493,36.76494893752594,NaN,NaN,50
1648764000,1.1068,1.10748,1.10667,1.10728,1339,5392.8,-447504,-448441,26.68586494814336,39.693074765274815,36.55975717738309,NaN,NaN,50
1648765800,1.10728,1.10764,1.10714,1.10734,1335,5141.05,-446169,-448069.8,25.40006935387826,40.12948158210987,36.56578822518949,NaN,NaN,50
1648767600,1.10734,1.10746,1.10673,1.10706,1081,4613.05,-447250,-447760,24.567222077509886,38.72127786915637,36.70250125703552,NaN,NaN,50
1648769400,1.10706,1.1074,1.10698,1.1073,1064,4190.7,-446186,-447190.4,23.793863892310682,40.64394824304147,36.94403188210548,NaN,NaN,50
1648771200,1.1073,1.10746,1.10623,1.10629,3510,3888.85,-449696,-447361,23.723360352469417,35.5840138663888,36.605865755990315,NaN,NaN,50
1648773000,1.10629,1.10685,1.10597,1.10672,3502,3202.8,-446194,-447099,23.866086708441973,39.06231146286292,36.6679246456337,NaN,NaN,50
1648774800,1.10672,1.10719,1.10632,1.10686,2416,2682.2,-443778,-446620.8,23.545211065962686,40.1946016098396,37.063732831967705,NaN,NaN,50
1648776600,1.10686,1.10732,1.10683,1.1072,3321,2526.85,-440457,-445262.2,23.073594785174905,42.96625674795186,37.62082861883092,NaN,NaN,50
1648778400,1.1072,1.10728,1.10686,1.10702,2087,2369.55,-442544,-444533.8,22.635665381586247,41.8601976046558,38.20091638753103,NaN,NaN,50
1648780200,1.10702,1.10728,1.1063,1.10646,2346,2284.9,-444890,-443572.6,22.776916239668434,38.536487315992595,38.558259980740594,NaN,NaN,50
1648782000,1.10646,1.1068,1.10614,1.10674,1971,2181,-442919,-442917.6,23.056864991616017,41.05655435885865,38.953342381478684,NaN,NaN,50
1648783800,1.10674,1.10688,1.1063,1.10654,1992,2144.7,-444911,-443144.2,23.184146844150145,39.801252688679654,39.266183013117036,NaN,NaN,50
1648785600,1.10654,1.10684,1.10634,1.1064,2257,2071.45,-447168,-444486.4,23.30233713578898,38.90454948401383,39.52818774629792,NaN,NaN,50
1648787400,1.1064,1.1068,1.10628,1.1064,1391,1950.8,-447168,-445411.2,23.47968301504689,38.90454948401383,39.71846836305998,NaN,NaN,50
1648789200,1.1064,1.10682,1.10636,1.10646,1378,1864.3,-445790,-445591.2,23.60393419704853,39.58112641618103,39.710472052410424,NaN,NaN,50
1648791000,1.10646,1.10745,1.10644,1.10682,1942,1775.3,-443848,-445777,22.534861826305765,43.61574162334224,39.95949062678417,NaN,NaN,50
1648792800,1.10682,1.10706,1.10527,1.10602,5581,1985.65,-449429,-446680.6,22.908641125574878,37.605964118297955,39.87982535886571,NaN,NaN,50
1648794600,1.10602,1.10758,1.10522,1.10736,6365,2265.2,-443064,-445859.8,22.424382345407004,50.02682207633226,40.55003063267219,NaN,NaN,50
1648796400,1.10736,1.10757,1.1043,1.10462,9139,2710.4,-452203,-446866.8,22.86071002051859,34.78026335055986,40.49261988154155,NaN,NaN,50
1648798200,1.10462,1.10666,1.10454,1.10528,7755,3088.6,-444448,-446598.4,23.265871433122207,39.558648360632446,40.52807251709652,NaN,NaN,50
1648800000,1.10528,1.10746,1.10485,1.10706,6863,3364.8,-437585,-445345.8,22.45049386022466,50.16361649385839,41.24014500881215,NaN,NaN,50
1648801800,1.10706,1.10717,1.10554,1.1061,5171,3556.6,-442756,-444011.2,21.69335754253408,45.52429622222422,41.422862114117315,NaN,NaN,50
1648803600,1.1061,1.1061,1.10446,1.10546,7558,3880.45,-450314,-445461.2,22.053701772562924,42.68975606991601,41.48211629020734,NaN,NaN,50
1648805400,1.10546,1.10586,1.10416,1.10558,6496,4152.05,-443818,-443784.2,22.639977103176285,43.40134865000574,41.82960638549399,NaN,NaN,50
1648807200,1.10558,1.10577,1.10477,1.1057,4023,4177.7,-439795,-442853.6,23.184375624460124,44.148177669912684,42.05043662199785,NaN,NaN,50
1648809000,1.1057,1.10676,1.10558,1.10674,4383,4221.75,-435412,-442419,22.24352098588197,50.27238028505524,42.798374307453244,NaN,NaN,50
1648810800,1.10674,1.10678,1.10546,1.10549,3754,4288.65,-439166,-441701,21.497705713783883,44.02405535773513,43.16405329843334,NaN,NaN,50
1648812600,1.10549,1.10573,1.1048,1.1048,4399,4342.55,-443565,-440351.2,21.469074675315138,40.9951195103852,43.31337972888844,NaN,NaN,50
1648814400,1.1048,1.10537,1.10434,1.1052,4238,4450.1,-439327,-439453,21.855615225580504,43.42518917272466,43.58795564007013,NaN,NaN,50
1648816200,1.1052,1.10596,1.10366,1.10442,10938,4879.7,-450265,-441547,22.760331700534508,39.968444297115525,43.3274344024825,NaN,NaN,50
1648818000,1.10442,1.1054,1.10402,1.10438,6318,5097.05,-456583,-445781.2,23.600425570134657,39.79350480076433,43.483687308372964,NaN,NaN,50
1648819800,1.10438,1.10473,1.10387,1.10449,5844,5289.65,-450739,-448095.8,24.502294248507,40.563943328685255,42.80776739782675,NaN,NaN,50
1648821600,1.10449,1.10499,1.10308,1.10319,7604,5557,-458343,-451051.4,25.92591108878818,34.88273713103645,42.815086953575076,NaN,NaN,50
1648823400,1.10319,1.104,1.1028,1.10374,7963,5885.6,-450380,-453262,27.433660583281704,38.78876677328217,42.760095411621485,NaN,NaN,50
1648825200,1.10374,1.104,1.10298,1.1037,5751,6104.25,-456131,-454435.2,28.833713685311412,38.6073857790948,41.93465036056694,NaN,NaN,50
1648827000,1.1037,1.10448,1.10359,1.10444,5265,6270.4,-450866,-453291.8,29.23944143395743,43.8394555535919,41.81430459852178,NaN,NaN,50
1648828800,1.10444,1.10491,1.10407,1.10448,3958,6189.25,-446908,-452525.6,28.886788551347703,44.116693357978896,41.91622869052627,NaN,NaN,50
1648830600,1.10448,1.10467,1.1039,1.10403,3858,6063.9,-450766,-451010.2,28.7286152280741,41.62706707606126,41.789494292387374,NaN,NaN,50
1648832400,1.10403,1.10408,1.10325,1.10356,3164,5765.15,-453930,-451720.2,29.179878560850987,39.14250501270527,41.43194624544399,NaN,NaN,50
1648834200,1.10356,1.10428,1.1035,1.10397,2510,5502.9,-451420,-450778,29.247196730834286,42.37371612235538,40.86775594810829,NaN,NaN,50
1648836000,1.10397,1.10477,1.10386,1.10472,2698,5294.65,-448722,-450349.2,28.494032391083334,47.83042347510677,41.139639385063404,NaN,NaN,50
1648837800,1.10472,1.1048,1.1039,1.10391,2596,5165.9,-451318,-451231.2,27.74588679970152,43.08529910654868,41.28893792764651,NaN,NaN,50
1648839600,1.10391,1.10441,1.1039,1.10406,2504,4913.2,-448814,-450840.8,27.05118017913269,44.18950527645643,41.34353193505592,NaN,NaN,50
1648841400,1.10406,1.1048,1.10402,1.10479,2151,4695.95,-446663,-449387.4,25.73325456839101,49.340626933575535,42.01297355194591,NaN,NaN,50
1648843200,1.10479,1.10527,1.10467,1.10518,1259,4557.75,-445404,-448184.2,24.008976927962337,51.89510197275002,42.87737334994489,NaN,NaN,50
1648845000,1.10518,1.10525,1.10443,1.10494,1187,4397.95,-446591,-447758,22.53642179982784,50.21697911115085,43.56687590583529,NaN,NaN,50
1649019600,1.10494,1.10494,1.10386,1.10405,295,4225,-446886,-446871.6,21.93871725348276,44.473651135257626,44.251941191851095,NaN,NaN,50
1649021400,1.10405,1.10441,1.1038,1.10394,245,4017.3,-447131,-446535,21.46025611637774,43.806780290577876,44.61037072880079,NaN,NaN,50
1649023200,1.10394,1.10421,1.10382,1.104,1127,3861.75,-446004,-446403.2,21.015970774780214,44.29741418879137,45.0168013294934,NaN,NaN,50
1649025000,1.104,1.10442,1.10387,1.10435,701,3349.9,-445303,-446383,20.2063475530587,47.193822863424415,45.25639899448144,NaN,NaN,50
1649026800,1.10435,1.10454,1.10429,1.1044,514,3059.7,-444789,-446022.6,19.228694128292936,47.6129014517319,45.50612814403522,NaN,NaN,50
1649028600,1.1044,1.10458,1.1041,1.10458,1190,2827,-443599,-445365.2,18.633730475094822,49.176630077466676,46.04538264413561,NaN,NaN,50
1649030400,1.10458,1.10518,1.10444,1.10508,2626,2578.1,-440973,-444133.6,17.612971302752104,53.34280806993369,47.059690005366214,NaN,NaN,50
1649032200,1.10508,1.10539,1.10474,1.10494,2317,2295.8,-443290,-443590.8,17.001656623691154,52.056074902854036,47.75128706111611,NaN,NaN,50
1649034000,1.10494,1.10504,1.10437,1.10489,2115,2114,-445405,-443611.2,15.806263280383767,51.57755497983271,48.01893931145368,NaN,NaN,50
1649035800,1.10489,1.10545,1.10484,1.10491,2230,1962.25,-443175,-443288.4,15.321090267971286,51.76854192027494,48.63917094100555,NaN,NaN,50
1649037600,1.10491,1.10517,1.10466,1.1051,1753,1852,-441422,-442853,14.5441200048529,53.6392900652635,49.31415556877749,NaN,NaN,50
1649039400,1.1051,1.10518,1.10474,1.1049,1694,1743.8,-443116,-443281.6,13.839725055744664,51.38015886838625,49.45983642126396,NaN,NaN,50
1649041200,1.1049,1.10534,1.10478,1.10528,1055,1638.35,-442061,-443035.8,13.467033987303243,55.237688094437495,49.69859257281307,NaN,NaN,50
1649043000,1.10528,1.10528,1.10472,1.10479,1285,1577.1,-443346,-442624,12.993589541050865,49.75572718505433,49.665646006663316,NaN,NaN,50
1649044800,1.10479,1.10496,1.10461,1.1048,1405,1512.45,-441941,-442377.2,12.31437452178029,49.8650798501288,50.050748057725535,NaN,NaN,50
1649046600,1.1048,1.10492,1.10465,1.10479,1400,1452.65,-443341,-442761,11.68367486102904,49.748477505204235,50.475155001627414,NaN,NaN,50
1649048400,1.10479,1.10504,1.10474,1.10495,1875,1421.2,-441466,-442431,11.361399735703388,51.694776366788155,51.00353801434147,NaN,NaN,50
1649050200,1.10495,1.10522,1.10466,1.10513,2368,1432.05,-439098,-441838.4,11.44755648640907,53.85986829058016,51.47968411628118,NaN,NaN,50
1649052000,1.10513,1.1054,1.1038,1.10428,4254,1581.8,-443352,-441839.6,11.583308188765198,43.862105617307456,51.211770128108,NaN,NaN,50
1649053800,1.10428,1.10468,1.10362,1.10394,3876,1716.25,-447228,-442897,12.014705310701428,40.61449973653755,50.6001893894702,NaN,NaN,50
1649055600,1.10394,1.10428,1.10316,1.10328,6240,2013.5,-453468,-444922.4,13.118675284758158,35.1706737684469,49.302179796506856,NaN,NaN,50
1649057400,1.10328,1.10398,1.10274,1.10314,4738,2238.15,-458206,-448270.4,14.688689272580472,34.125774500580135,48.0214440534873,NaN,NaN,50
1649059200,1.10314,1.10378,1.10194,1.10371,7227,2543.15,-450979,-450646.6,16.969243174336725,41.717854424114925,47.317179728078884,NaN,NaN,50
1649061000,1.10371,1.10388,1.1021,1.10224,4263,2721.25,-455242,-453024.6,18.842554470810487,31.602275083815826,45.87673209690324,NaN,NaN,50
1649062800,1.10224,1.10322,1.102,1.10214,4591,2925.1,-459833,-455545.6,20.68150935121821,31.05069638024308,44.263261119401776,NaN,NaN,50
1649064600,1.10214,1.10231,1.10091,1.10098,4128,3072,-463961,-457644.2,23.273459910773482,25.492391205029648,42.41413485773346,NaN,NaN,50
1649066400,1.10098,1.10139,1.10064,1.10102,3808,3131.1,-460153,-458033.6,25.85316578363188,25.98440914576743,40.32461493282845,NaN,NaN,50
1649068200,1.10102,1.10104,1.10007,1.10013,3368,3183.65,-463521,-460542,28.577510791892557,22.43454115253283,38.37310164479119,NaN,NaN,50
1649070000,1.10013,1.10084,1.10007,1.10045,3510,3253.4,-460011,-461495.8,31.10725972813461,26.331500171228086,36.69213166772686,NaN,NaN,50
1649071800,1.10045,1.1007,1.09962,1.09969,4293,3356.55,-464304,-462390,33.69820025164405,23.333169630901978,34.80532396241956,NaN,NaN,50
1649073600,1.09969,1.1009,1.09958,1.10069,5684,3553.1,-458620,-461321.8,35.589054804450555,33.98486025167294,33.54032995419705,NaN,NaN,50
1649075400,1.10069,1.10084,1.09964,1.09992,4439,3690.35,-463059,-461903,37.344848317770875,30.473982863051162,31.869909566516405,NaN,NaN,50
1649077200,1.09992,1.10031,1.09812,1.09872,4425,3858.85,-467484,-462695.6,39.75816767808202,25.971055168588975,30.59197739160794,NaN,NaN,50
1649079000,1.09872,1.09936,1.09843,1.09924,5592,4074.2,-461892,-463071.8,41.99910708408522,30.74650442518916,29.887120583654482,NaN,NaN,50
1649080800,1.09924,1.09924,1.09817,1.09826,5633,4285.6,-467525,-463716,44.18672756041321,27.187059130475717,29.316862395227975,NaN,NaN,50
1649082600,1.09826,1.09986,1.09791,1.09946,6695,4550.35,-460830,-464158,44.771203595500026,36.830535560446286,29.510059613789842,NaN,NaN,50
1649084400,1.09946,1.09992,1.09905,1.09954,4422,4677.7,-456408,-462827.8,45.18244166482162,37.42553372954865,29.20346527846368,NaN,NaN,50
1649086200,1.09954,1.10013,1.09913,1.09932,3113,4714.95,-459521,-461235.2,45.09600398926338,36.40988138416295,29.546865728488477,NaN,NaN,50
1649088000,1.09932,1.09932,1.09806,1.0981,3188,4661.65,-462709,-461398.6,45.78769195030841,31.331955000066543,29.566955629904438,NaN,NaN,50
1649089800,1.0981,1.0981,1.09743,1.09747,2919,4613.8,-465628,-461019.2,46.781980046420834,29.076786743631203,29.822983882661696,NaN,NaN,50
1649091600,1.09747,1.09772,1.0967,1.0973,3144,4459,-468772,-462607.6,48.04978010468511,28.481068649251384,30.00131670433912,NaN,NaN,50
1649093400,1.0973,1.0973,1.09628,1.09639,3389,4391.55,-472161,-465758.2,49.401964154972774,25.472604210598945,30.218321208486696,NaN,NaN,50
1649095200,1.09639,1.09686,1.09606,1.0966,2539,4157.15,-469622,-467778.4,50.745989660328505,27.379001464014664,30.293142729400024,NaN,NaN,50
1649097000,1.0966,1.09729,1.09647,1.09713,2327,4060.35,-467295,-468695.6,51.11514507584267,32.09974209407561,30.919326476769566,NaN,NaN,50
1649098800,1.09713,1.09756,1.09692,1.09698,2267,3944.15,-469562,-469482.4,50.93306441314306,31.476109164174332,30.740129970519668,NaN,NaN,50
1649100600,1.09698,1.09741,1.09692,1.09697,2020,3838.75,-471582,-470044.4,50.763989512064846,31.432266532093124,30.808578804022666,NaN,NaN,50
1649102400,1.09697,1.09724,1.09693,1.09724,742,3685.45,-470840,-469780.2,50.606991389635084,34.10122233925358,31.38930503049871,NaN,NaN,50
1649104200,1.09724,1.09744,1.09706,1.09714,677,3550.9,-471517,-470159.2,50.01783469004172,33.57988159394992,31.59168911398162,NaN,NaN,50
1649106000,1.09714,1.09758,1.09714,1.09736,256,3388.2,-471261,-470952.4,49.1602697391006,35.90158313463972,32.214155114279045,NaN,NaN,50
1649107800,1.09736,1.0974,1.09724,1.09734,167,3181.9,-471428,-471325.6,48.36395942751241,35.77914162950617,32.13905554778332,NaN,NaN,50
1649109600,1.09734,1.09748,1.09711,1.09745,670,2931.2,-470758,-471160.8,47.76549171892962,37.05074889414831,32.11228520239759,NaN,NaN,50
1649111400,1.09745,1.09749,1.09718,1.09724,543,2736.4,-471301,-471253,47.18347034854899,35.60145669203537,32.054540581531334,NaN,NaN,50
1649113200,1.09724,1.09736,1.09712,1.09724,697,2550,-471301,-471209.8,46.715103651210796,35.601456692035356,32.35950498810053,NaN,NaN,50
1649115000,1.09724,1.09762,1.09724,1.0975,734,2307.1,-470567,-471071,45.553466918076964,39.026182237544816,33.070176094808645,NaN,NaN,50
1649116800,1.0975,1.09786,1.09704,1.09734,1786,2114.75,-472353,-471256,43.84961051610418,37.697581360640406,33.72849843133644,NaN,NaN,50
1649118600,1.09734,1.098,1.09728,1.09762,3199,1939.95,-469154,-470935.2,41.91587876908907,41.45387353203159,34.870017668581625,NaN,NaN,50
1649120400,1.09762,1.0977,1.09709,1.09718,1559,1796.8,-470713,-470817.6,40.45204647043436,37.615873787124045,35.60122283451801,NaN,NaN,50
1649122200,1.09718,1.09722,1.09676,1.09685,1782,1730.25,-472495,-471056.4,39.62332057039599,34.99867128418664,35.80828920524023,NaN,NaN,50
1649124000,1.09685,1.09732,1.09684,1.09712,1133,1627.5,-471362,-471215.4,38.5783764201761,38.75343340354055,36.328098079480675,NaN,NaN,50
1649125800,1.09712,1.09718,1.09654,1.09692,1152,1539.15,-472514,-471247.6,38.08037551402164,37.04634326012381,36.72910356005429,NaN,NaN,50
1649127600,1.09692,1.09714,1.09682,1.09692,1114,1437.65,-472514,-471919.6,37.61794610116392,37.04634326012381,36.93946934011645,NaN,NaN,50
1649129400,1.09692,1.09726,1.09683,1.09724,1082,1322.3,-471432,-472063.4,36.81920821262245,41.80334835922538,37.52685982335042,NaN,NaN,50
1649131200,1.09724,1.09727,1.09632,1.09632,1767,1283.7,-473199,-472204.2,36.878411556582414,33.87748842508444,37.382281629810755,NaN,NaN,50
1649133000,1.09632,1.09716,1.09623,1.09644,4119,1373.3,-469080,-471747.8,37.05876094313725,35.59281857094585,37.36897283991358,NaN,NaN,50
1649134800,1.09644,1.0968,1.09624,1.09678,1747,1347.3,-467333,-470711.6,37.22622823065247,40.31704848700168,37.60227995368883,NaN,NaN,50
1649136600,1.09678,1.09722,1.09667,1.0969,2077,1350.15,-465256,-469260,36.06522919191346,41.93584352665342,38.054736156161546,NaN,NaN,50
1649138400,1.0969,1.09719,1.0964,1.09658,3812,1503.65,-469068,-468787.2,35.46051837571734,38.90540855839596,38.290732718044445,NaN,NaN,50
1649140200,1.09658,1.09808,1.09648,1.09756,4666,1703.1,-464402,-467027.8,33.047001294162826,50.663759515393565,39.12198823789078,NaN,NaN,50
1649142000,1.09756,1.09886,1.09715,1.09842,7544,2067.5,-456858,-464583.4,32.05587759632352,58.25636711114494,40.5904729343554,NaN,NaN,50
1649143800,1.09842,1.0988,1.09794,1.09818,5673,2342.8,-462531,-463623,31.135548448329875,55.68105521728239,41.60670019758759,NaN,NaN,50
1649145600,1.09818,1.09851,1.09752,1.09774,4109,2514.75,-466640,-463899.8,29.429515011206437,51.21135098306183,42.57780571158315,NaN,NaN,50
1649147400,1.09774,1.09774,1.09622,1.09678,4812,2728.2,-471452,-464376.6,28.725039425389497,43.084919861984815,43.15539489571159,NaN,NaN,50
1649149200,1.09678,1.09847,1.0967,1.09818,3990,2892.85,-467462,-464988.6,26.949084289353582,54.4393433166174,44.27581703235994,NaN,NaN,50
1649151000,1.09818,1.09857,1.0975,1.09784,3583,3035.3,-471045,-467826,25.158961222891534,51.73975424435353,45.32534638837634,NaN,NaN,50
1649152800,1.09784,1.09784,1.09647,1.09666,4116,3151.8,-475161,-470352,24.717059648852754,43.64966248904357,45.79701204758491,NaN,NaN,50
1649154600,1.09666,1.09718,1.09563,1.09698,3984,3191.05,-471177,-471259.4,25.074464675697428,46.11051601831395,46.104666880376946,NaN,NaN,50
1649156400,1.09698,1.09776,1.09684,1.09733,3392,3282.7,-467785,-470526,24.574442282150976,48.7469200175951,47.16676913698485,NaN,NaN,50
1649158200,1.09733,1.09762,1.09629,1.09672,3609,3374.05,-471394,-471312.4,24.60161265267633,44.647248070725645,47.81351410125483,NaN,NaN,50
1649160000,1.09672,1.09718,1.0959,1.09613,3741,3504.45,-475135,-472130.4,24.949910826319105,41.051130310598104,47.865948517226,NaN,NaN,50
1649161800,1.09613,1.09658,1.09562,1.09643,3973,3645.5,-471162,-471330.6,25.4976131541407,43.54127291239424,47.98062204477892,NaN,NaN,50
1649163600,1.09643,1.09674,1.09588,1.09601,3807,3780.15,-474969,-472089,25.75356761415744,40.93423055944738,48.12553790199688,NaN,NaN,50
1649165400,1.09601,1.09758,1.09598,1.09694,5131,3982.6,-469838,-472499.6,24.783175105897385,48.313932140178935,47.957693089481545,NaN,NaN,50
1649167200,1.09694,1.09728,1.09358,1.09407,11028,4445.65,-480866,-474394,25.684662217389125,34.13862238462893,46.23499703758755,NaN,NaN,50
1649169000,1.09407,1.09458,1.09312,1.09383,8691,4674.25,-489557,-477278.4,26.77207720398636,33.259814344054774,44.633479832357,NaN,NaN,50
1649170800,1.09383,1.09416,1.09259,1.09267,5287,4851.25,-494844,-482014.8,28.055982856080945,29.329844472495495,43.07051508160226,NaN,NaN,50
1649172600,1.09267,1.09291,1.09192,1.09207,4075,4951.15,-498919,-486804.8,29.568826431063293,27.51861327585715,41.958636039736,NaN,NaN,50
1649174400,1.09207,1.09234,1.09136,1.09197,4007,4960.9,-502926,-493422.4,31.22070856702116,27.216939986682988,40.0141786590264,NaN,NaN,50
1649176200,1.09197,1.0921,1.09122,1.09143,2376,4846.4,-505302,-498309.6,32.81547529959189,25.585812276420526,38.146039947031184,NaN,NaN,50
1649178000,1.09143,1.09214,1.09122,1.09183,2322,4585.3,-502980,-500994.2,34.23586564600304,28.9810771917016,37.0982838543639,NaN,NaN,50
1649179800,1.09183,1.09188,1.09111,1.09132,2149,4409.1,-505129,-503051.2,35.60907383340049,27.27248839639455,35.75271045279823,NaN,NaN,50
1649181600,1.09132,1.09153,1.09084,1.09096,2003,4303.8,-507132,-504693.8,37.01960713920909,26.102653179141186,34.13526282148009,NaN,NaN,50
1649183400,1.09096,1.09104,1.0903,1.09046,2997,4213.05,-510129,-506134.4,38.58659645089887,24.528921912606364,32.698239524471575,NaN,NaN,50
1649185200,1.09046,1.09056,1.09,1.0903,2225,4124.8,-512354,-507544.8,40.176618122712036,24.029660256944325,31.482420234924877,NaN,NaN,50
1649187000,1.0903,1.09042,1.09005,1.0904,1715,4031.4,-510639,-509076.6,41.65306681796713,25.056373484888738,30.162070275817342,NaN,NaN,50
1649188800,1.0904,1.09062,1.0903,1.0905,934,3872.3,-509705,-509991.8,42.629168101143705,26.131474330082852,29.10473054514845,NaN,NaN,50
1649190600,1.0905,1.09064,1.09044,1.09055,585,3702.35,-509120,-510389.4,43.49463468884216,26.697696420943046,27.560713708060177,NaN,NaN,50
1649192400,1.09055,1.09064,1.09038,1.0906,219,3543.7,-508901,-510143.8,44.33634164265339,27.29784577221119,27.0720868071732,NaN,NaN,50
1649194200,1.0906,1.0907,1.09046,1.0907,294,3377.95,-508607,-509394.4,44.97905102171592,28.557675847013513,26.736219771670253,NaN,NaN,50
1649196000,1.0907,1.0907,1.09047,1.09062,809,3231.35,-509416,-509149.8,45.57585258798827,28.137601236853442,26.651059540552968,NaN,NaN,50
1649197800,1.09062,1.09082,1.09062,1.09075,757,3070.55,-508659,-508940.6,45.82091070793393,29.94105582077934,26.824091150904554,NaN,NaN,50
1649199600,1.09075,1.09082,1.09049,1.09055,586,2909.5,-509245,-508965.6,46.16457503679548,28.74583075820341,26.933297634584584,NaN,NaN,50
1649201400,1.09055,1.09075,1.09054,1.0906,783,2692.1,-508462,-508877.8,46.4836919135955,29.503491665011637,27.213131876626807,NaN,NaN,50
1649203200,1.0906,1.09064,1.09004,1.09008,1822,2231.8,-510284,-509213.2,47.21900747253454,26.363776553531054,27.026181831043193,NaN,NaN,50
1649205000,1.09008,1.09022,1.08942,1.08946,2870,1940.75,-513154,-509960.8,48.34188296452907,23.19440540882283,26.734890189073784,NaN,NaN,50
1649206800,1.08946,1.08956,1.08907,1.08943,3764,1864.6,-516918,-511612.6,49.59566444814502,23.050010839397373,26.516844307663515,NaN,NaN,50
1649208600,1.08943,1.08964,1.0891,1.08918,2933,1807.5,-519851,-513733.8,50.53175389077118,21.830369489508485,26.324090563156524,NaN,NaN,50
1649210400,1.08918,1.08959,1.08912,1.08952,2217,1718,-517634,-515568.2,51.40097980178119,27.452573599819146,26.568584373361865,NaN,NaN,50
1649212200,1.08952,1.09034,1.08936,1.08965,3647,1781.55,-513987,-516308.8,50.1964911117036,29.539295849811836,26.888793113713515,NaN,NaN,50
1649214000,1.08965,1.09002,1.08958,1.0897,2441,1787.5,-511546,-515987.2,49.07803732806013,30.368874160312814,27.19146453015851,NaN,NaN,50
1649215800,1.0897,1.0903,1.0896,1.09006,2435,1801.8,-509111,-514425.8,47.369461776716385,36.1938008598436,27.869757704365693,NaN,NaN,50
1649217600,1.09006,1.09016,1.08956,1.08964,2007,1802,-511118,-512679.2,45.83966027664068,32.75149361435729,28.2593039788047,NaN,NaN,50
1649219400,1.08964,1.0897,1.08932,1.0897,1680,1736.15,-509438,-511040,44.75854717075914,33.721280245103955,28.62813286438259,NaN,NaN,50
1649221200,1.0897,1.0901,1.08943,1.08952,2260,1737.9,-511698,-510582.2,42.79038682811513,32.22012136438232,28.919741444920366,NaN,NaN,50
1649223000,1.08952,1.08978,1.08834,1.08837,2474,1775.85,-514172,-511107.4,42.338402328466,24.66536889702587,28.542906664652264,NaN,NaN,50
1649224800,1.08837,1.08848,1.08745,1.08827,5936,2025.95,-520108,-513306.8,42.68932536017087,24.135419070593713,28.213591544108713,NaN,NaN,50
1649226600,1.08827,1.08886,1.08784,1.08882,4412,2217.3,-515696,-514222.4,42.25345339864966,32.70006050700083,28.441917889965083,NaN,NaN,50
1649228400,1.08882,1.09022,1.08839,1.08889,7549,2583.8,-508147,-513964.2,39.71971472006338,33.725561797937544,28.967759693136976,NaN,NaN,50
1649230200,1.08889,1.08976,1.08849,1.08954,7221,2930.15,-500926,-511809.8,37.366957375661826,42.488963724832196,30.345942429994786,NaN,NaN,50
1649232000,1.08954,1.09168,1.08912,1.09158,6465,3212.95,-494461,-507867.6,36.22131346567629,60.252742000554164,33.00328037007741,NaN,NaN,50
1649233800,1.09158,1.09272,1.09096,1.09234,6630,3506.6,-487831,-501412.2,35.90553664961389,64.63525120050407,36.06077192086282,NaN,NaN,50
1649235600,1.09234,1.09258,1.0907,1.09074,5662,3760.4,-493493,-496971.6,35.28659040871539,51.708993238992605,37.79337332366093,NaN,NaN,50
1649237400,1.09074,1.09188,1.09072,1.09126,4782,3960.35,-488711,-493084.4,34.71185461359535,54.86803702270731,39.60256912172489,NaN,NaN,50
1649239200,1.09126,1.09137,1.08993,1.08995,4334,4085.95,-493045,-491508.2,33.190485442317694,46.59797017402697,40.76179026556161,NaN,NaN,50
1649241000,1.08995,1.09124,1.08995,1.09122,4574,4171.15,-488471,-490310.2,31.777785497559876,53.8589348153695,42.02358554809917,NaN,NaN,50
1649242800,1.09122,1.0919,1.09046,1.09098,4957,4230.8,-493428,-491429.6,31.055184125990955,52.408720076907116,43.42767315256702,NaN,NaN,50
1649244600,1.09098,1.09178,1.09093,1.0917,5019,4335.1,-488409,-490412.8,30.384197138105527,56.217461029067,45.03454320856438,NaN,NaN,50
1649246400,1.0917,1.09318,1.0917,1.09274,6683,4558.4,-481726,-489015.8,30.823541909702744,61.0645875556124,47.094862222223675,NaN,NaN,50
1649248200,1.09274,1.09381,1.0926,1.09333,5611,4656.6,-476115,-485629.8,31.613465120193396,63.53123896315744,49.87099579837592,NaN,NaN,50
1649250000,1.09333,1.09373,1.09262,1.09278,5341,4801.6,-481456,-484226.8,32.34696524422042,59.73225656038991,52.41362704764708,NaN,NaN,50
1649251800,1.09278,1.09303,1.09126,1.09138,7043,5032,-488499,-483241,31.262627449148617,51.31993135560027,53.743617822547044,NaN,NaN,50
1649253600,1.09138,1.09168,1.09056,1.09166,6068,5235.05,-482431,-482045.4,29.51879008102269,52.753093053779175,55.10272719796429,NaN,NaN,50
1649255400,1.09166,1.0924,1.09128,1.09197,6995,5500.8,-475436,-480787.4,28.490833817987998,54.35531462585199,55.95032369089428,NaN,NaN,50
1649257200,1.09197,1.09226,1.0906,1.09098,5281,5651.85,-480717,-481707.8,26.85460324496755,48.67803348000085,55.12355879656905,NaN,NaN,50
1649259000,1.09098,1.09142,1.09028,1.09104,4847,5770.5,-475870,-480590.6,25.031182876297514,49.02553110151214,54.0085787894982,NaN,NaN,50
1649260800,1.09104,1.09157,1.09039,1.0906,4260,5686.7,-480130,-478916.8,23.478593085593616,46.53705457068095,53.63915459890451,NaN,NaN,50
1649262600,1.0906,1.09132,1.09043,1.09084,3127,5622.45,-477003,-477831.2,22.036902565654284,48.08497128315491,53.1546499032222,NaN,NaN,50
1649264400,1.09084,1.09107,1.0904,1.09048,2753,5382.65,-479756,-478695.2,20.66421044190265,45.936504730104055,53.10740237151341,NaN,NaN,50
1649266200,1.09048,1.09083,1.08997,1.09006,3579,5200.55,-483335,-479218.8,19.474260490190858,43.49482713475182,52.36710896575501,NaN,NaN,50
1649268000,1.09006,1.09276,1.08788,1.08838,18899,5822.25,-502234,-484491.6,20.137209046666406,35.39133840195977,51.15158170325877,NaN,NaN,50
1649269800,1.08838,1.09027,1.08818,1.08995,14373,6209.4,-487861,-486037.8,20.752804134822274,45.592868333240204,50.39268222498543,NaN,NaN,50
1649271600,1.08995,1.09064,1.08946,1.08952,6061,6229.35,-493922,-489421.6,20.86204989235524,43.5639913588335,49.142639639501226,NaN,NaN,50
1649273400,1.08952,1.09024,1.08918,1.09005,4225,6201.5,-489697,-491409.8,21.181993236159173,46.711619484234994,47.94123824814962,NaN,NaN,50
1649275200,1.09005,1.09022,1.08958,1.09006,1278,6048.7,-488419,-492426.6,21.479083483977107,46.77194159981648,47.01550146525152,NaN,NaN,50
1649277000,1.09006,1.09008,1.08947,1.08964,795,5859.75,-489214,-489822.6,21.848903302232152,44.493815967363396,46.52792179466316,NaN,NaN,50
1649278800,1.08964,1.0901,1.08933,1.0899,379,5630.85,-488835,-490017.4,22.31582718438834,46.239494831636456,46.06266477879582,NaN,NaN,50
1649280600,1.0899,1.0899,1.08973,1.08982,138,5386.8,-488973,-489027.6,22.749399360676232,45.762586545647565,45.44889848735265,NaN,NaN,50
1649282400,1.08982,1.08996,1.08946,1.08946,687,5087,-489660,-489020.2,23.408249613914496,43.58413733588156,45.0850487627727,NaN,NaN,50
1649284200,1.08946,1.08993,1.08946,1.08961,876,4850.25,-488784,-489093.2,24.020039134778596,44.76400287227481,44.78065388925574,NaN,NaN,50
1649286000,1.08961,1.08994,1.08956,1.08982,786,4622.5,-487998,-488850,24.567889010952598,46.45243545466146,44.77460966668292,NaN,NaN,50
1649287800,1.08982,1.0899,1.08954,1.08976,1234,4332.05,-489232,-488929.4,25.09906771788219,46.01960180019817,44.627083275043155,NaN,NaN,50
1649289600,1.08976,1.09073,1.08968,1.09012,3351,4196.2,-485881,-488311,23.983462202318726,49.08504871172615,44.85197927373044,NaN,NaN,50
1649291400,1.09012,1.09123,1.09,1.09118,3475,4020.2,-482406,-486860.2,22.372543251842792,56.85436236920699,45.80623179047724,NaN,NaN,50
1649293200,1.09118,1.09129,1.09052,1.0906,2633,3887.8,-485039,-486111.2,20.966217573082215,52.16391455107647,47.00427294398558,NaN,NaN,50
1649295000,1.0906,1.0913,1.09044,1.09108,2637,3777.3,-482402,-484992,19.52882638316543,55.44026986999641,47.70765876803959,NaN,NaN,50
1649296800,1.09108,1.09116,1.09048,1.09056,1673,3647.95,-484075,-483960.6,18.194105992528414,51.33802738069919,48.26294705531571,NaN,NaN,50
1649298600,1.09056,1.09118,1.09046,1.09118,1719,3577.55,-482356,-483255.6,16.954722772651184,55.560245571598436,48.894991775841675,NaN,NaN,50
1649300400,1.09118,1.09124,1.09062,1.09062,1797,3529.75,-484153,-483605,15.920866970565134,51.236028913858355,49.21385515541609,NaN,NaN,50
1649302200,1.09062,1.09108,1.09054,1.09072,1630,3432.3,-482523,-483101.8,14.791250123549407,51.955125143531546,49.74680581085668,NaN,NaN,50
1649304000,1.09072,1.0909,1.09061,1.09078,1378,2556.25,-481145,-482850.4,13.742320194177662,52.40859911981025,50.1874561171548,NaN,NaN,50
1649305800,1.09078,1.0916,1.09074,1.09144,1205,1897.85,-479940,-482023.4,14.12664825481584,57.19468382241765,51.00403449406696,NaN,NaN,50
1649307600,1.09144,1.09154,1.09098,1.09129,1841,1686.85,-481781,-481908.4,14.48352431112272,55.82070754150092,51.87807522303977,NaN,NaN,50
1649309400,1.09129,1.09204,1.09121,1.09188,2093,1580.25,-479688,-481015.4,15.60184318740566,59.90109599955834,52.95929616070288,NaN,NaN,50
1649311200,1.09188,1.09344,1.09126,1.09275,3994,1716.05,-475694,-479649.6,18.093170894377476,65.03005912314964,54.286269279880614,NaN,NaN,50
1649313000,1.09275,1.09279,1.09167,1.09171,4371,1894.85,-480065,-479433.6,20.40654662227988,55.83594818542065,54.98743687882507,NaN,NaN,50
1649314800,1.09171,1.0919,1.08952,1.0896,5398,2145.8,-485463,-480538.2,19.013708532811453,42.65841531112688,54.528391635925125,NaN,NaN,50
1649316600,1.0896,1.09021,1.08948,1.08978,4485,2363.15,-480978,-480377.6,17.76845786908286,43.87529877083266,53.60131566461268,NaN,NaN,50
1649318400,1.08978,1.09008,1.08791,1.0884,5357,2596.65,-486335,-481707,18.180852432882148,37.333857747920995,52.542025892958705,NaN,NaN,50
1649320200,1.0884,1.0885,1.08754,1.08782,3860,2745.85,-490195,-484607.2,18.856503618033337,34.97376372201026,51.080132596673984,NaN,NaN,50
1649322000,1.08782,1.08813,1.08646,1.08723,4934,2953.25,-495129,-487620,20.22914549299451,32.708612209908594,49.749460084474656,NaN,NaN,50
1649323800,1.08723,1.08975,1.08719,1.08922,4754,3129.25,-490375,-488602.4,19.640559826148028,45.524336639920314,49.032609446497645,NaN,NaN,50
1649325600,1.08922,1.08988,1.08918,1.08936,3123,3117.85,-487252,-489857.2,18.96551693275734,46.29919814985389,48.67997867764018,NaN,NaN,50
1649327400,1.08936,1.08966,1.08868,1.08944,3271,3107.65,-483981,-489386.4,18.738898715858163,46.76517466510351,48.30926792918103,NaN,NaN,50
1649329200,1.08944,1.09191,1.08908,1.08928,8840,3418,-492821,-489911.6,18.192414657758633,45.90719170228578,47.844881685072146,NaN,NaN,50
1649331000,1.08928,1.09218,1.08918,1.09112,10574,3814.85,-482247,-487335.2,17.86994467040774,55.92233573766899,47.75399967901867,NaN,NaN,50
1649332800,1.09112,1.09172,1.09095,1.09142,5282,3995.3,-476965,-484653.2,17.57050825358191,57.31014711601437,47.86038822005535,NaN,NaN,50
1649334600,1.09142,1.09268,1.09105,1.09136,5637,4191.2,-482602,-483723.2,17.953615350323535,56.92411552948297,47.6477467579071,NaN,NaN,50
1649336400,1.09136,1.09318,1.09072,1.0931,5505,4376.6,-477097,-482346.4,18.621650795929874,64.41083838976093,47.6035167055222,NaN,NaN,50
1649338200,1.0931,1.09386,1.09118,1.09143,7126,4651.4,-484223,-480626.8,19.640311719755537,54.60199174556745,47.515376959818404,NaN,NaN,50
1649340000,1.09143,1.09146,1.08981,1.09098,8866,5025.8,-493089,-482795.2,19.23177676283414,52.291161684050145,48.20343027217006,NaN,NaN,50
1649341800,1.09098,1.09237,1.09028,1.09113,8603,5395.7,-484486,-484299.4,19.42190624798771,53.00512103767955,48.8555604340877,NaN,NaN,50
1649343600,1.09113,1.09154,1.0901,1.09013,5839,5595.6,-490325,-485844,19.429995980439372,47.86272531375078,49.60762240307554,NaN,NaN,50
1649345400,1.09013,1.09062,1.08953,1.08986,4996,5740.75,-495321,-489488.8,18.909006416244306,46.54958267707572,50.43446661415164,NaN,NaN,50
1649347200,1.08986,1.09002,1.08822,1.08868,4143,5748.2,-499464,-492537,17.755571431300194,41.226167169182986,51.042863396956946,NaN,NaN,50
1649349000,1.08868,1.08877,1.08765,1.08772,3814,5720.35,-503278,-494574.8,17.09155709632007,37.47167196271891,50.46767306287114,NaN,NaN,50
1649350800,1.08772,1.08924,1.08767,1.08895,3570,5628.95,-499708,-497619.2,16.091767204069303,44.451853650104646,50.33571988431762,NaN,NaN,50
1649352600,1.08895,1.08895,1.08794,1.08833,2754,5542.4,-502462,-500046.6,15.163390875550725,41.91205037005702,49.98906814895715,NaN,NaN,50
1649354400,1.08833,1.08885,1.08818,1.08832,2581,5403.6,-505043,-501991,14.301327141926334,41.87049651613656,49.70073277851793,NaN,NaN,50
1649356200,1.08832,1.08846,1.0874,1.08803,3272,5374.2,-508315,-503761.2,14.144525004044292,40.61296246845596,48.60720611643129,NaN,NaN,50
1649358000,1.08803,1.08824,1.0868,1.08703,3216,5288.3,-511531,-505411.8,14.447973492070226,36.53783551237619,47.123469573314274,NaN,NaN,50
1649359800,1.08703,1.08734,1.08678,1.08722,2339,5167.55,-509192,-507308.6,14.744675535005673,37.81457809367141,45.75850261361345,NaN,NaN,50
1649361600,1.08722,1.08748,1.087,1.08736,1067,5064.75,-508125,-508441.2,14.859728740086739,38.791720259680375,43.92856560432198,NaN,NaN,50
1649363400,1.08736,1.0882,1.08735,1.08794,1331,4967.75,-506794,-508791.4,14.177492182716051,42.80165473032236,43.085684388947335,NaN,NaN,50
1649365200,1.08794,1.08814,1.08789,1.08795,51,4528.3,-506743,-508477,13.543986808014697,42.87114744746313,42.41282622919112,NaN,NaN,50
1649367000,1.08795,1.08806,1.08784,1.08792,125,4005.85,-506868,-507544.4,13.007058106882988,42.70352757041582,41.676998124386564,NaN,NaN,50
1649368800,1.08792,1.08825,1.08774,1.08802,965,3790,-505903,-506886.6,12.280378162747246,43.496574010877936,41.36513017418135,NaN,NaN,50
1649370600,1.08802,1.08803,1.08726,1.0875,983,3557.3,-506886,-506638.8,12.131256982510815,40.36766862605202,40.92356488482252,NaN,NaN,50
1649372400,1.0875,1.08755,1.08718,1.08728,832,3323.65,-507718,-506823.6,12.078820099117847,39.086608856634996,40.77073929106909,NaN,NaN,50
1649374200,1.08728,1.08735,1.08602,1.08645,1838,3059.25,-509556,-507386.2,13.126033837398388,34.62250485071769,40.567227354497575,NaN,NaN,50
1649376000,1.08645,1.08684,1.0858,1.08654,4529,2842.4,-505027,-507018,14.277197460202384,35.48296314417776,39.92659231835995,NaN,NaN,50
1649377800,1.08654,1.0872,1.08598,1.08622,4450,2634.75,-509477,-507732.8,14.821976233646359,33.78056697078469,39.345772075554784,NaN,NaN,50
1649379600,1.08622,1.08677,1.08587,1.08626,3313,2508.45,-506164,-507588.4,15.430153150584408,34.20550442559387,38.79827264051602,NaN,NaN,50
1649381400,1.08626,1.087,1.08604,1.08658,2817,2399.5,-503347,-506714.2,15.645483562962475,37.65244391325961,38.58680702943057,NaN,NaN,50
1649383200,1.08658,1.08684,1.08614,1.0863,2714,2328.05,-506061,-506015.2,15.845433231599253,35.88110119199483,38.53989743511762,NaN,NaN,50
1649385000,1.0863,1.0863,1.0857,1.0859,2279,2251.3,-508340,-506677.8,16.50224831445257,33.45943294863747,38.22881563904376,NaN,NaN,50
1649386800,1.0859,1.08592,1.08566,1.08574,1160,2130.8,-509500,-506682.4,17.154210677350687,32.514141245022145,37.78041713799674,NaN,NaN,50
1649388600,1.08574,1.08649,1.08573,1.08641,1182,2052.2,-508318,-507113.2,16.794155806781415,40.140540915744275,37.59033757981259,NaN,NaN,50
1649390400,1.08641,1.08641,1.08571,1.08576,1356,1990.95,-509674,-508378.6,16.485236884159907,35.90171819453779,37.09252120460364,NaN,NaN,50
1649392200,1.08576,1.08598,1.08548,1.08549,1308,1892.75,-510982,-509362.8,16.49692760223029,34.28227129867173,36.491002899479064,NaN,NaN,50
1649394000,1.08549,1.08635,1.08548,1.0862,2127,1838.3,-508855,-509465.8,15.871179568729197,41.72622857382841,36.36454965397552,NaN,NaN,50
1649395800,1.0862,1.08679,1.08577,1.08678,2649,1853.8,-506206,-508807,14.870794309578903,47.00696451863306,36.838785074874174,NaN,NaN,50
1649397600,1.08678,1.08694,1.0863,1.0865,3401,1970.5,-509607,-509064.8,14.163961982770552,44.89199109308148,37.25345523462035,NaN,NaN,50
1649399400,1.0865,1.08679,1.08586,1.08617,3734,2090.65,-513341,-509798.2,13.479105270126896,42.46686935024612,37.81376698458667,NaN,NaN,50
1649401200,1.08617,1.0865,1.08481,1.08525,6961,2436.15,-520302,-511662.2,14.13487761293131,36.54039409862004,37.889297767046834,NaN,NaN,50
1649403000,1.08525,1.08678,1.085,1.08674,3844,2622.1,-516458,-513182.8,14.291590515287131,48.96304104152178,38.9737602006709,NaN,NaN,50
1649404800,1.08674,1.08792,1.08654,1.08664,5243,2836,-521701,-516281.8,13.637846229088066,48.27994471331262,39.979077364079394,NaN,NaN,50
1649406600,1.08664,1.08698,1.08606,1.08668,3469,2960.3,-518232,-518006.8,12.876541161915323,48.588913794773994,40.76025378418756,NaN,NaN,50
1649408400,1.08668,1.08797,1.08644,1.08767,4199,3128.65,-514033,-518145.2,12.820868189233936,55.650533532841784,42.172356094248066,NaN,NaN,50
1649410200,1.08767,1.08775,1.08673,1.08691,3005,3187,-517038,-517492.4,12.769171857458364,49.97550768962417,43.35207571860426,NaN,NaN,50
1649412000,1.08691,1.08834,1.08632,1.0876,4306,3175.85,-512732,-516747.2,13.298138755058691,54.51100615165639,44.92328035479242,NaN,NaN,50
1649413800,1.0876,1.08918,1.08759,1.08862,3479,3127.3,-509253,-514257.6,14.493460677131775,60.24860837052173,46.35957088727652,NaN,NaN,50
1649415600,1.08862,1.08881,1.08638,1.08638,4207,3172,-513460,-513303.2,14.110127819665404,46.40568480995131,47.10985421694891,NaN,NaN,50
1649417400,1.08638,1.08654,1.0859,1.08634,3777,3220,-517237,-513944,13.253207935137215,46.20154207517357,47.96123070098476,NaN,NaN,50
1649419200,1.08634,1.0864,1.08544,1.0861,3676,3268.1,-520913,-514719,12.609305526845132,44.924566554944654,48.189683413921635,NaN,NaN,50
1649421000,1.0861,1.08664,1.08502,1.0853,4633,3385.8,-525546,-517281.8,12.405647084401412,40.86957757647788,47.75129863233912,NaN,NaN,50
1649422800,1.0853,1.08578,1.08388,1.08416,5183,3586.95,-530729,-521577,13.145949408637955,35.89718184160067,47.10881225723335,NaN,NaN,50
1649424600,1.08416,1.08476,1.08364,1.08402,6134,3834.55,-536863,-526257.6,14.00799881238825,35.32872001402379,46.598944447503186,NaN,NaN,50
1649426400,1.08402,1.08559,1.08389,1.08544,5129,4023.2,-531734,-529157,13.865223402154664,44.86564267180949,47.19360505987385,NaN,NaN,50
1649428200,1.08544,1.08818,1.08522,1.08726,7312,4323.4,-524422,-529858.8,14.11059453562871,54.19010550963279,47.566966807596074,NaN,NaN,50
1649430000,1.08726,1.08818,1.08716,1.08728,5491,4491.6,-518931,-528535.8,14.338439159568898,54.28160859502542,47.99565708486127,NaN,NaN,50
1649431800,1.08728,1.08768,1.08698,1.0874,3288,4523.55,-515643,-525518.6,14.376945847608633,54.8641595442177,48.44388892410725,NaN,NaN,50
1649433600,1.0874,1.08768,1.08681,1.0874,2751,4491.05,-515643,-521274.6,14.243863234519866,54.864159544217706,48.387719353491256,NaN,NaN,50
1649435400,1.0874,1.08756,1.08677,1.08722,2196,4414.15,-517839,-518495.6,14.078601480189487,53.67436891133686,48.65192372647073,NaN,NaN,50
1649437200,1.08722,1.08738,1.08654,1.08693,2838,4208,-520677,-517746.6,13.676347365460451,51.728032311254786,48.453139880727754,NaN,NaN,50
1649439000,1.08693,1.08758,1.08649,1.08718,2210,4126.3,-518467,-517653.8,13.488000356249682,53.300178465479405,47.95682345893902,NaN,NaN,50
1649440800,1.08718,1.08758,1.08696,1.08746,2181,3973.2,-516286,-517782.4,13.313106704839683,55.065330717931964,48.57536959522334,NaN,NaN,50
1649442600,1.08746,1.08854,1.08736,1.08836,2386,3919.05,-513900,-517433.8,14.015964371473574,60.26429712587843,49.579852098845116,NaN,NaN,50
1649444400,1.08836,1.0885,1.08764,1.0878,2158,3817,-516058,-517077.6,14.668617919062191,55.92822313460701,50.365827568821,NaN,NaN,50
1649446200,1.0878,1.08786,1.08751,1.08782,1535,3743.5,-514523,-515846.8,15.090471844592082,56.049848348982735,51.45013262399992,NaN,NaN,50
1649448000,1.08782,1.08784,1.08722,1.08743,958,3576.1,-515481,-515249.6,15.069732879212832,52.97948291484882,52.67029698637479,NaN,NaN,50
1649449800,1.08743,1.08791,1.08742,1.08762,774,3440.85,-514707,-514933.8,15.12530549471522,54.2931067101546,54.02489603609842,NaN,NaN,50
1649624400,1.08762,1.09183,1.08762,1.09062,496,3255.3,-514211,-514996,17.736326993013222,69.01324848041965,55.74972502242771,NaN,NaN,50
1649626200,1.09062,1.09126,1.09046,1.091,417,3087.3,-513794,-514543.2,20.160846955718508,70.31725964003815,56.90166460317096,NaN,NaN,50
1649628000,1.091,1.0914,1.09,1.09019,3812,3094.1,-517606,-515159.8,21.818743656425514,64.12279460787495,57.60460646123164,NaN,NaN,50
1649629800,1.09019,1.0902,1.0886,1.08917,2415,2983.2,-520021,-516067.8,21.7995255522099,57.279842229018314,57.77715522443168,NaN,NaN,50
1649631600,1.08917,1.0894,1.08852,1.08864,2466,2847.35,-522487,-517623.8,21.70111452766397,54.052063637831395,57.71914837397552,NaN,NaN,50
1649633400,1.08864,1.08902,1.08844,1.08844,1914,2636.35,-524401,-519661.8,21.524625482356964,52.84196794166578,57.659691161856166,NaN,NaN,50
1649635200,1.08844,1.08914,1.08832,1.08845,2528,2506.3,-521873,-521277.6,21.360742797429026,52.898747835664565,57.743313699314,NaN,NaN,50
1649637000,1.08845,1.08926,1.08804,1.08882,2560,2268.7,-519313,-521619,20.879725987964665,55.05503386474631,57.868660513547354,NaN,NaN,50
1649638800,1.08882,1.0895,1.0888,1.08936,2460,2117.15,-516853,-520985.4,20.642937046194636,58.07189856036679,58.08341535943555,NaN,NaN,50
1649640600,1.08936,1.08939,1.08852,1.08904,3105,2108,-519958,-520479.6,20.07500455038647,55.686475525104036,57.75642810223737,NaN,NaN,50
1649642400,1.08904,1.0891,1.0879,1.08798,3480,2144.45,-523438,-520287,18.823617549537772,48.56938401606693,57.230796736627376,NaN,NaN,50
1649644200,1.08798,1.08844,1.08752,1.08767,2372,2153.25,-525810,-521074.4,17.707063581384592,46.68999303128899,56.56223564250639,NaN,NaN,50
1649646000,1.08767,1.0886,1.08762,1.08818,2282,2125.45,-523528,-521917.4,16.487598230890825,50.110252215411926,56.35729059254662,NaN,NaN,50
1649647800,1.08818,1.08868,1.08796,1.08831,1977,2113.8,-521551,-522857,15.359245286155096,50.97370229937042,56.12019027749061,NaN,NaN,50
1649649600,1.08831,1.08842,1.088,1.08816,1361,2072.8,-522912,-523447.8,14.311488980329063,49.900543977223116,54.75499709869086,NaN,NaN,50
1649651400,1.08816,1.08878,1.08804,1.08852,1507,2028.85,-521405,-523041.2,13.794729004094226,52.48598861175689,53.48133488238505,NaN,NaN,50
1649653200,1.08852,1.08864,1.08814,1.08822,1868,2014.35,-523273,-522533.8,13.314880454733306,50.1627848206703,52.48419132615614,NaN,NaN,50
1649655000,1.08822,1.0893,1.08817,1.08926,2427,2058.95,-520846,-521997.4,13.667671619312374,57.23044172397301,52.48066271865291,NaN,NaN,50
1649656800,1.08926,1.08932,1.08766,1.08791,5868,2304.45,-526714,-523030,13.226710967151693,47.7618035240922,52.0313584248144,NaN,NaN,50
1649658600,1.08791,1.08829,1.0874,1.08824,4420,2486.75,-522294,-522906.4,12.45193850562967,49.94201510417055,51.82421893642187,NaN,NaN,50
1649660400,1.08824,1.09028,1.08776,1.09027,6291,2776.5,-516003,-521826,13.696719712987985,60.784620865932744,52.38749558144103,NaN,NaN,50
1649662200,1.09027,1.09138,1.08984,1.091,7656,3138.45,-508347,-518840.8,15.571864146516653,63.81953207110212,53.0135311676093,NaN,NaN,50
1649664000,1.091,1.09196,1.09057,1.09142,5154,3205.55,-503193,-515310.2,17.636473029619225,65.4750494706895,53.54232766120378,NaN,NaN,50
1649665800,1.09142,1.0915,1.09036,1.09073,3923,3280.95,-507116,-511390.6,19.258888442811944,60.571480974143626,53.89125662184946,NaN,NaN,50
1649667600,1.09073,1.09186,1.09037,1.09185,3559,3335.6,-503557,-507643.2,20.97880818689833,65.13574181113631,55.074567892925835,NaN,NaN,50
1649669400,1.09185,1.09282,1.09175,1.09253,3589,3419.35,-499968,-504436.2,23.084801400606043,67.58891985305405,56.567348380194765,NaN,NaN,50
1649671200,1.09253,1.09334,1.09214,1.09238,3806,3483.25,-503774,-503521.6,25.28217265955902,66.47772098150006,57.73645329205821,NaN,NaN,50
1649673000,1.09238,1.09238,1.09048,1.09126,4243,3567.4,-508017,-504486.4,25.23198686429375,58.71558692202181,58.289445050819026,NaN,NaN,50
1649674800,1.09126,1.09136,1.09,1.09005,3076,3598.2,-511093,-505281.8,24.687706880965337,51.69311870575994,58.41748610285737,NaN,NaN,50
1649676600,1.09005,1.09065,1.08978,1.09011,3557,3620.8,-507536,-506077.6,23.956623583818853,51.99968964515397,58.38275046238573,NaN,NaN,50
1649678400,1.09011,1.09039,1.08955,1.08984,4115,3652.55,-511651,-508414.2,23.037757538267527,50.44814463099093,58.40313330598006,NaN,NaN,50
1649680200,1.08984,1.0906,1.08923,1.09052,3828,3725.35,-507823,-509224,21.85018534862444,54.158000304205366,58.18367320456809,NaN,NaN,50
1649682000,1.09052,1.0906,1.08855,1.08862,3910,3806.75,-511733,-509967.2,20.499909787876575,44.20043788689588,57.92928994476836,NaN,NaN,50
1649683800,1.08862,1.08912,1.08791,1.08813,6705,4043.15,-518438,-511436.2,19.813437013536554,42.05302845393293,57.36579089832281,NaN,NaN,50
1649685600,1.08813,1.0894,1.08778,1.08847,5075,4228.85,-513363,-512601.6,18.881919391799997,44.08304383109986,56.17282111012046,NaN,NaN,50
1649687400,1.08847,1.08984,1.08842,1.08956,4667,4386.85,-508696,-512010.6,17.566073579580834,50.11639594186539,55.194025672317835,NaN,NaN,50
1649689200,1.08956,1.08996,1.08827,1.08853,4197,4503.3,-512893,-513024.6,16.495253978262433,45.15795828294923,53.74280487319353,NaN,NaN,50
1649691000,1.08853,1.08886,1.08736,1.08758,3806,4572.25,-516699,-514017.8,16.34902942110353,41.117227531495544,52.35321534157581,NaN,NaN,50
1649692800,1.08758,1.08814,1.08727,1.08814,2597,4408.7,-514102,-513150.6,16.291555148475297,44.28219133481336,50.86367602183845,NaN,NaN,50
1649694600,1.08814,1.0885,1.08758,1.0878,2460,4310.7,-516562,-513790.4,15.806445950394707,42.77875777712988,49.09152158784387,NaN,NaN,50
1649696400,1.0878,1.08866,1.08776,1.08783,2506,4121.45,-514056,-514862.4,15.164936118328828,42.96276742839092,47.411882048336075,NaN,NaN,50
1649698200,1.08783,1.08888,1.0878,1.08824,2297,3853.5,-511759,-514635.6,14.302890149062478,45.54030956819821,46.470790808777245,NaN,NaN,50
1649700000,1.08824,1.08912,1.08806,1.08882,2357,3713.65,-509402,-513176.2,13.350195092261686,49.04812186395174,46.2818624629338,NaN,NaN,50
1649701800,1.08882,1.08948,1.08873,1.08901,2712,3653.1,-506690,-511693.8,12.888783609459761,50.18019246923936,46.1518983789399,NaN,NaN,50
1649703600,1.08901,1.08908,1.08858,1.0886,2055,3577.9,-508745,-510130.4,12.260712384180291,47.71644421876163,45.956776920923524,NaN,NaN,50
1649705400,1.0886,1.08884,1.08818,1.08845,2070,3501.95,-510815,-509482.2,11.61167485231218,46.810913458069976,45.431985003342426,NaN,NaN,50
1649707200,1.08845,1.08854,1.08804,1.08808,1366,3379.95,-512181,-509566.6,11.186387913520125,44.56435409190369,45.45797901798584,NaN,NaN,50
1649709000,1.08808,1.08843,1.08802,1.08835,911,3213.35,-511270,-509940.2,10.817965006225618,46.579137664689036,45.78127253303985,NaN,NaN,50
1649710800,1.08835,1.08873,1.08832,1.08856,133,3066.2,-511137,-510829.6,10.066796086874891,48.15735445247877,46.0722947202812,NaN,NaN,50
1649712600,1.08856,1.08856,1.08821,1.0884,367,2906.7,-511504,-511381.4,9.491203346426355,47.017624865942125,45.85095392914382,NaN,NaN,50
1649714400,1.0884,1.08864,1.08826,1.08858,1011,2751.5,-510493,-511317,8.827617744034342,48.49445450112135,46.08927508758468,NaN,NaN,50
1649716200,1.08858,1.08863,1.08799,1.08805,615,2590.85,-511108,-511102.4,8.642742752119737,44.556271736515455,46.33492110222897,NaN,NaN,50
1649718000,1.08805,1.08856,1.08782,1.08804,1591,2474.9,-512699,-511388.2,8.735006092486104,44.48287015728433,46.349255303834035,NaN,NaN,50
1649719800,1.08804,1.08812,1.08769,1.08769,1442,2211.75,-514141,-511989,9.022906574673454,41.88223664885831,46.285218080386066,NaN,NaN,50
1649721600,1.08769,1.08874,1.08756,1.08804,3161,2116.05,-510980,-511884.2,8.586253033510102,45.32464694556969,46.453923760184544,NaN,NaN,50
1649723400,1.08804,1.08814,1.0871,1.08744,2666,2016,-513646,-512514.8,8.499927003139808,40.8569141478442,46.11939551587354,NaN,NaN,50
1649725200,1.08744,1.08746,1.08664,1.08681,2646,1938.45,-516292,-513551.6,9.062778418734709,36.75961479041686,45.24164501062106,NaN,NaN,50
1649727000,1.08681,1.08724,1.08674,1.08712,2571,1876.7,-513721,-513756,9.585426161787117,39.95075239359313,44.51097071950346,NaN,NaN,50
1649728800,1.08712,1.0872,1.08668,1.08718,2047,1849.2,-511674,-513262.6,10.1572861230304,40.57576512430261,44.00092221275639,NaN,NaN,50
1649730600,1.08718,1.08749,1.08706,1.08716,2161,1834.25,-513835,-513833.6,10.099243550290808,40.42472518651638,43.54476590764541,NaN,NaN,50
1649732400,1.08716,1.0877,1.08712,1.08735,1543,1786.1,-512292,-513562.8,9.640343306384255,42.610307979963494,43.40519118536398,NaN,NaN,50
1649734200,1.08735,1.08756,1.08722,1.08745,1782,1760.35,-510510,-512406.4,9.21422165132817,43.77934480959061,43.20520598142837,NaN,NaN,50
1649736000,1.08745,1.08824,1.08745,1.08816,1708,1727.9,-508802,-511422.6,9.500625184194485,51.355835288566794,43.4336688982918,NaN,NaN,50
1649737800,1.08816,1.08831,1.08793,1.08795,1733,1678.95,-510535,-511194.8,9.87658443775943,49.24208237613625,43.59255872044853,NaN,NaN,50
1649739600,1.08795,1.08808,1.0874,1.08752,2133,1682.85,-512668,-510961.4,9.189324937481459,45.144712609468705,43.353291442473335,NaN,NaN,50
1649741400,1.08752,1.0882,1.08701,1.08706,2368,1697.75,-515036,-511510.2,9.166842015747807,41.19564877015483,43.113246944876146,NaN,NaN,50
1649743200,1.08706,1.08724,1.08604,1.08637,4540,1856.45,-519576,-513323.4,10.422273125187239,36.09515609191637,42.514124511635565,NaN,NaN,50
1649745000,1.08637,1.08696,1.08602,1.08604,4326,2027.2,-523902,-516343.4,11.610714702201943,33.93138225148459,41.94620634039459,NaN,NaN,50
1649746800,1.08604,1.0864,1.08533,1.08604,7252,2383.15,-523902,-519016.8,13.437007390088947,33.93138225148459,41.132401719388504,NaN,NaN,50
1649748600,1.08604,1.08728,1.08588,1.08708,5150,2622.3,-518752,-520233.6,13.564715114340784,45.805624930962004,41.48588106103978,NaN,NaN,50
1649750400,1.08708,1.08714,1.08614,1.08644,4455,2794.5,-523207,-521867.8,13.683300858288918,40.9304667158185,41.78379905571132,NaN,NaN,50
1649752200,1.08644,1.08666,1.08553,1.08621,4198,2973.65,-527405,-523433.6,14.483685318205358,39.31119871274259,41.73811664993628,NaN,NaN,50
1649754000,1.08621,1.08726,1.08598,1.08674,3767,3082.45,-523638,-523380.8,14.265794194792875,44.73671932123453,42.03532766400286,NaN,NaN,50
1649755800,1.08674,1.0874,1.08642,1.08736,3125,3166.6,-520513,-522703,13.853658435522645,50.330705078380475,42.742897656278856,NaN,NaN,50
1649757600,1.08736,1.08738,1.0868,1.08729,2842,3150.65,-523355,-523623.6,13.470960944771718,49.71878286954543,43.250645862677565,NaN,NaN,50
1649759400,1.08729,1.08732,1.08656,1.08669,3205,3177.6,-526560,-524294.2,13.441073859608283,44.70197149782937,43.316547768980335,NaN,NaN,50
1649761200,1.08669,1.08686,1.08582,1.08612,2862,3188.4,-529422,-524697.6,14.29453623200056,40.51909266698946,42.54249472458195,NaN,NaN,50
1649763000,1.08612,1.08654,1.08546,1.08624,5011,3310.4,-524411,-524852.2,15.455793099771276,41.75475597188538,42.00768569570688,NaN,NaN,50
1649764800,1.08624,1.08649,1.08511,1.08547,4162,3416.15,-528573,-526464.2,16.869201953858713,36.51313249827277,41.3911442591929,NaN,NaN,50
1649766600,1.08547,1.0904,1.08547,1.0896,18837,4249.95,-509736,-523740.4,17.47793934702428,63.198365115657644,42.96276685530024,NaN,NaN,50
1649768400,1.0896,1.09032,1.08724,1.08771,12700,4807.8,-522436,-522915.6,18.04319549782088,52.35339458557899,44.12406960484757,NaN,NaN,50
1649770200,1.08771,1.08817,1.08688,1.08702,9413,5189.35,-531849,-523401,18.158878394461027,49.044486565939785,45.203577055880075,NaN,NaN,50
1649772000,1.08702,1.0886,1.08702,1.088,7160,5461.95,-524689,-523456.6,18.584814569549064,53.53623961925946,46.60392401072113,NaN,NaN,50
1649773800,1.088,1.08885,1.08724,1.08728,7006,5725.6,-531695,-524081,19.162359707760928,50.04577520501204,46.90679188743899,NaN,NaN,50
1649775600,1.08728,1.08754,1.08602,1.0862,7363,5987.1,-539058,-529945.4,18.341217722875868,45.27717795278803,47.21727126150824,NaN,NaN,50
1649777400,1.0862,1.0863,1.08514,1.08528,5341,6135.75,-544399,-534338,17.28623835357717,41.63754881305013,47.38343912581592,NaN,NaN,50
1649779200,1.08528,1.0865,1.08512,1.08543,5341,6175.8,-539058,-535779.8,16.122328358144394,42.44984127695562,47.22009069408171,NaN,NaN,50
1649781000,1.08543,1.08546,1.08322,1.08414,7912,6355.1,-546970,-540236,16.477840394595308,37.602745608717214,46.310950731962905,NaN,NaN,50
1649782800,1.08414,1.0845,1.08331,1.08368,5930,6289,-552900,-544477,16.80795871415687,36.02317057724207,45.332692711084086,NaN,NaN,50
1649784600,1.08368,1.0837,1.08276,1.08286,3838,6223.4,-556738,-548013,17.47423072420931,33.33497110982054,44.5207641119406,NaN,NaN,50
1649786400,1.08286,1.08312,1.08214,1.08264,3533,6177.3,-560271,-551187.4,18.472345681928772,32.63139876809154,43.95735740487647,NaN,NaN,50
1649788200,1.08264,1.0832,1.08257,1.08278,2924,6113.6,-557347,-554845.2,19.306265854609673,33.59194761955095,43.37429966542401,NaN,NaN,50
1649790000,1.08278,1.08338,1.08277,1.08308,3160,6083.25,-554187,-556288.6,19.862960122489444,35.70738851508774,43.31674652376794,NaN,NaN,50
1649791800,1.08308,1.08338,1.08289,1.08306,2213,6037.65,-556400,-556988.6,20.379890514092082,35.62591066681402,41.34728549170768,NaN,NaN,50
1649793600,1.08306,1.08312,1.08266,1.08286,1026,5946.85,-557426,-557126.2,21.034512896494498,34.77145600749613,40.09143273613033,NaN,NaN,50
1649795400,1.08286,1.08296,1.08264,1.08268,766,5824.9,-558192,-556710.4,21.658130682023728,33.98151798960794,39.01550640924948,NaN,NaN,50
1649797200,1.08268,1.08304,1.08266,1.08273,200,5691.8,-557992,-556839.4,22.113875115397324,34.4271500025919,37.65057143663038,NaN,NaN,50
1649799000,1.08273,1.08298,1.08266,1.08284,868,5484.65,-557124,-557426.8,22.53706637495852,35.45932121069107,36.608681865607444,NaN,NaN,50
1649800800,1.08284,1.08316,1.08262,1.08277,1325,5342.8,-558449,-557836.6,22.623143448654414,35.08088881503657,35.88037549862519,NaN,NaN,50
1649802600,1.08277,1.08288,1.08268,1.08284,764,4439.15,-557685,-557888.4,22.703072159943456,35.81854188149626,35.46473214637135,NaN,NaN,50
1649804400,1.08284,1.08288,1.08238,1.0825,825,3845.4,-558510,-557952,23.109068838230712,33.809085554724575,34.84753530906913,NaN,NaN,50
1649806200,1.0825,1.08278,1.08233,1.08261,899,3419.7,-557611,-557875.8,23.54138354711768,35.078082163531775,34.6672022058416,NaN,NaN,50
1649808000,1.08261,1.08292,1.08166,1.08212,2192,3171.3,-559803,-558411.6,24.62586766867443,32.12364363589111,34.38866456717368,NaN,NaN,50
1649809800,1.08212,1.08216,1.08115,1.08158,2762,2959.1,-562565,-559234.8,26.06897306899127,29.204403505519082,34.09362402400929,NaN,NaN,50
1649811600,1.08158,1.08248,1.08145,1.0821,2439,2712.9,-560126,-559723,26.75646146232461,35.30163384269184,34.28435510076645,NaN,NaN,50
1649813400,1.0821,1.08308,1.08186,1.083,2196,2555.65,-557930,-559607,26.299805422448628,44.25091139673218,35.04570965627939,NaN,NaN,50
1649815200,1.083,1.0836,1.08281,1.08322,3607,2468.95,-554323,-558949.4,25.055676617971894,46.20959519715441,35.79586727642701,NaN,NaN,50
1649817000,1.08322,1.08386,1.08314,1.08352,2332,2189.95,-551991,-557387,23.520464420120643,48.848756951806386,36.7403562967836,NaN,NaN,50
1649818800,1.08352,1.0841,1.08327,1.08399,2104,1998.65,-549887,-554851.4,21.92856284967903,52.75931443804427,38.02520332753704,NaN,NaN,50
1649820600,1.08399,1.084,1.08338,1.08374,1797,1896.6,-551684,-553163,20.450368534268957,50.54574124738322,39.208362131663854,NaN,NaN,50
1649822400,1.08374,1.0839,1.08316,1.08333,1383,1789.1,-553067,-552190.4,19.240832089400932,47.05865428768461,40.1106124377419,NaN,NaN,50
1649824200,1.08333,1.08346,1.08295,1.08336,1772,1731.5,-551295,-551584.8,18.43484908909306,47.34490114141027,40.959582432793276,NaN,NaN,50
1649826000,1.08336,1.08344,1.08295,1.08342,1666,1656.8,-549629,-551112.4,17.686436303092893,47.95104048818337,41.878878980875186,NaN,NaN,50
1649827800,1.08342,1.08441,1.08309,1.08437,2328,1662.55,-547301,-550595.2,17.379840439628683,56.49120337458035,43.35549765895262,NaN,NaN,50
1649829600,1.08437,1.0845,1.08258,1.08274,5577,1890.1,-552878,-550834,16.279468250877212,43.3486822357343,44.03689742188188,NaN,NaN,50
1649831400,1.08274,1.0832,1.08214,1.0822,5731,2138.35,-558609,-551942.4,15.598823854196583,40.02640915463791,44.390349349818045,NaN,NaN,50
1649833200,1.0822,1.08292,1.08152,1.08272,5512,2403.95,-553097,-552302.8,15.732223364980522,44.44210806993004,45.27023966653511,NaN,NaN,50
1649835000,1.08272,1.08402,1.08253,1.08382,4408,2580.95,-548689,-552114.8,14.871493157059469,52.42235558987521,46.92866481541769,NaN,NaN,50
1649836800,1.08382,1.0839,1.08272,1.08335,3416,2685.5,-552105,-553075.6,14.072243678275631,49.17236884284161,47.91943160114267,NaN,NaN,50
1649838600,1.08335,1.08382,1.08296,1.0837,3826,2838.6,-548279,-552155.8,13.330083447976355,51.57976108029916,48.442920864254596,NaN,NaN,50
1649840400,1.0837,1.0837,1.08252,1.08278,3331,2963.9,-551610,-550756,12.726086047808321,45.48174492359641,48.39093155900046,NaN,NaN,50
1649842200,1.08278,1.08353,1.08262,1.08349,3246,3081.25,-548364,-549809.4,12.165231319080863,50.35930167956558,48.498827610983255,NaN,NaN,50
1649844000,1.08349,1.08356,1.08261,1.08286,2817,3112.5,-551181,-550307.8,11.595872240667244,46.39305063478382,48.044094482178934,NaN,NaN,50
1649845800,1.08286,1.08293,1.08232,1.08271,2753,3112.05,-553934,-550673.6,11.499842419943558,45.47470579238758,47.68187766396496,NaN,NaN,50
1649847600,1.08271,1.08428,1.0826,1.0842,3993,3189.75,-549941,-551006,11.841522039656384,55.0030172777958,48.249332163258615,NaN,NaN,50
1649849400,1.0842,1.08479,1.08277,1.08308,5470,3353.45,-555411,-551766.2,12.692090968426958,48.186538379140934,48.3094491088108,NaN,NaN,50
1649851200,1.08308,1.08348,1.08202,1.08222,5287,3437.45,-560698,-554233,12.387954465768699,43.70740762135077,48.00633247546562,NaN,NaN,50
1649853000,1.08222,1.0832,1.08152,1.08181,7108,3676.25,-567806,-557558,11.532698828276171,41.716522506610744,46.95099812775351,NaN,NaN,50
1649854800,1.08181,1.08252,1.08099,1.08148,5918,3866.95,-573724,-561516,11.344688869770447,40.13200593530131,46.721235534865436,NaN,NaN,50
1649856600,1.08148,1.08274,1.08089,1.0817,6973,4125.75,-566751,-564878,10.884669387940606,41.721256203334875,46.8422960383438,NaN,NaN,50
1649858400,1.0817,1.08376,1.08146,1.08314,6422,4377.7,-560329,-565861.6,10.917185633815462,50.907486863537784,47.30410880931578,NaN,NaN,50
1649860200,1.08314,1.08488,1.08289,1.08475,5826,4580.4,-554503,-564622.6,11.927513358209067,58.73853472056566,47.755264461507956,NaN,NaN,50
1649862000,1.08475,1.08674,1.08451,1.08637,5624,4778.3,-548879,-560837.2,14.026101351499515,64.81959453740123,48.87292343969079,NaN,NaN,50
1649863800,1.08637,1.08736,1.0861,1.08716,5023,4913.05,-543856,-554863.6,16.277489337987493,67.3468895820887,49.99914690410433,NaN,NaN,50
1649865600,1.08716,1.08943,1.08716,1.08845,5441,4906.25,-538415,-549196.4,19.1697254681629,71.00925581725298,51.822540539365505,NaN,NaN,50
1649867400,1.08845,1.08892,1.08808,1.0882,4346,4837,-542761,-545682.8,21.855373303325774,69.38506081603457,53.18152333482759,NaN,NaN,50
1649869200,1.0882,1.08862,1.08747,1.08836,4151,4768.95,-538610,-542504.2,23.612330772948848,69.86020795347603,54.85774885759132,NaN,NaN,50
1649871000,1.08836,1.08856,1.08734,1.08749,3116,4704.35,-541726,-541073.6,25.08815519640556,64.04010453701123,56.183848767921575,NaN,NaN,50
1649872800,1.08749,1.08854,1.08716,1.08831,3262,4696.65,-538464,-539995.2,26.234905397860587,66.8438834688146,57.02962492442292,NaN,NaN,50
1649874600,1.08831,1.08874,1.0878,1.08857,2899,4650.3,-535565,-539425.2,27.40616049416738,67.70373183219358,58.42371017106954,NaN,NaN,50
1649876400,1.08857,1.08909,1.08841,1.08895,2614,4614.45,-532951,-537463.2,28.68033015488795,68.97030602868794,60.22820291445076,NaN,NaN,50
1649878200,1.08895,1.08895,1.08828,1.0883,1974,4550.85,-534925,-536726.2,29.67791670682175,64.3234215641514,61.842981418560804,NaN,NaN,50
1649880000,1.0883,1.08899,1.0883,1.08892,724,4446.2,-534201,-535221.2,30.62838526753366,66.63273731811006,63.73589080304715,NaN,NaN,50
1649881800,1.08892,1.0893,1.08886,1.0892,607,4338.9,-533594,-534247.2,31.701850048207618,67.65111861421423,65.58802383239568,NaN,NaN,50
1649883600,1.0892,1.08924,1.08841,1.08919,273,4152.9,-533867,-533907.6,31.988343332797843,67.57179874928991,66.77833182423511,NaN,NaN,50
1649885400,1.08919,1.08928,1.08897,1.08899,594,3909.1,-534461,-534209.6,32.284187887858764,65.90740575081009,67.29039404068115,NaN,NaN,50
1649887200,1.08899,1.08926,1.0888,1.08903,1241,3706.8,-533220,-533868.6,32.278279149040806,66.0873206718717,67.38094590742904,NaN,NaN,50
1649889000,1.08903,1.08904,1.08868,1.08897,1072,3405,-534292,-533886.8,32.07007318955993,65.52870302948843,67.25107543938616,NaN,NaN,50
1649890800,1.08897,1.08958,1.08892,1.08953,927,3155.45,-533365,-533841,32.35218652400606,68.22806788088101,67.05241915821674,NaN,NaN,50
1649892600,1.08953,1.08974,1.08933,1.08951,1263,2869.95,-534628,-533993.2,32.747551430320385,68.0231935096061,66.95514292204327,NaN,NaN,50
1649894400,1.08951,1.09,1.08901,1.08905,3009,2699.3,-537637,-534628.4,32.532069528012585,63.31409794388838,66.48756363564415,NaN,NaN,50
1649896200,1.08905,1.08905,1.08828,1.08846,2661,2541.05,-540298,-536044,31.156206288022613,57.78825042854168,66.04100262789633,NaN,NaN,50
1649898000,1.08846,1.08934,1.08828,1.08922,2769,2398.3,-537529,-536691.4,30.197590694236293,62.34698675626896,65.71979571985734,NaN,NaN,50
1649899800,1.08922,1.09089,1.08916,1.09063,3818,2338.05,-533711,-536760.6,30.65078564774138,69.02962293471275,65.81450222718014,NaN,NaN,50
1649901600,1.09063,1.0907,1.0902,1.09046,2742,2203.1,-536453,-537125.6,31.071609533138968,67.47471866876867,65.70767455861449,NaN,NaN,50
1649903400,1.09046,1.09084,1.09018,1.0902,1670,2069.3,-538123,-537222.8,31.568384206615864,65.06093918222618,65.76035438847696,NaN,NaN,50
1649905200,1.0902,1.09096,1.0902,1.09076,1917,1957.6,-536206,-536404.4,32.12322185277357,67.73793694215149,65.83929721876564,NaN,NaN,50
1649907000,1.09076,1.09086,1.0905,1.09074,1951,1899.35,-538157,-536530,32.63842823849143,67.53890743666484,65.83128213465497,NaN,NaN,50
1649908800,1.09074,1.09089,1.09035,1.09086,1774,1824.95,-536383,-537064.4,32.82099153073216,68.14371410731434,65.87213323165672,NaN,NaN,50
1649910600,1.09086,1.09129,1.09075,1.09124,1534,1756.7,-534849,-536743.6,33.35458710467381,70.0469042851679,66.16781169839656,NaN,NaN,50
1649912400,1.09124,1.09181,1.09118,1.09157,1656,1708.8,-533193,-535757.6,34.27310127483007,71.63191462384957,66.56385412353784,NaN,NaN,50
1649914200,1.09157,1.0918,1.09094,1.09103,2214,1720.8,-535407,-535597.8,34.63530604925925,65.52191130792801,66.56336900056924,NaN,NaN,50
1649916000,1.09103,1.09186,1.091,1.09152,3486,1858.9,-531921,-534350.6,35.02576035998965,68.1746534206123,66.55955368197861,NaN,NaN,50
1649917800,1.09152,1.09236,1.09133,1.09184,3517,2004.4,-528404,-532754.8,35.81961228727899,69.8083709821997,66.68706635859245,NaN,NaN,50
1649919600,1.09184,1.09198,1.09094,1.09102,5820,2281.75,-534224,-532629.8,35.741869808684996,61.14628536743269,66.53222260313132,NaN,NaN,50
1649921400,1.09102,1.09131,1.09034,1.09085,4200,2462.05,-538424,-533676,34.56751616297187,59.49798269891353,66.65434633672932,NaN,NaN,50
1649923200,1.09085,1.09124,1.09032,1.09044,3625,2581.25,-542049,-535004.4,33.442154719783304,55.60485026728695,66.17276515894488,NaN,NaN,50
1649925000,1.09044,1.09124,1.09031,1.09082,2822,2668.75,-539227,-536465.6,32.37850728558669,58.32655355600078,65.4082602033226,NaN,NaN,50
1649926800,1.09082,1.09142,1.09018,1.0914,2685,2756.65,-536542,-538093.2,31.62877330279238,62.14157413964233,65.027321308385,NaN,NaN,50
1649928600,1.0914,1.09177,1.09106,1.09138,3408,2863.9,-539950,-539238.4,31.372764358644545,61.93103517077526,64.80375673613851,NaN,NaN,50
1649930400,1.09138,1.09172,1.09096,1.09098,2225,2824.7,-542175,-539988.6,30.918303466414493,57.719074755727505,64.08812372282252,NaN,NaN,50
1649932200,1.09098,1.09099,1.09013,1.09058,2696,2826.45,-544871,-540553,28.935511931188795,53.780108172126226,63.105352346784045,NaN,NaN,50
1649934000,1.09058,1.0907,1.0902,1.09048,2312,2803.6,-547183,-542144.2,27.094348362764936,52.8098165387076,62.01007394902642,NaN,NaN,50
1649935800,1.09048,1.09177,1.0863,1.08654,13858,3305.6,-561041,-547044,28.528084138255412,29.911614727290953,59.143267552035205,NaN,NaN,50
1649937600,1.08654,1.08858,1.08652,1.08846,7966,3566.8,-553075,-549669,29.859410215496574,42.903834363774855,57.09126181917272,NaN,NaN,50
1649939400,1.08846,1.08906,1.08434,1.08476,18896,4428.1,-571971,-555628.2,32.0023817877698,30.984203336728058,54.62428267837272,NaN,NaN,50
1649941200,1.08476,1.0849,1.08168,1.08243,13311,4997.8,-585282,-563710.4,34.68027846979974,26.071965768024185,51.616947846044994,NaN,NaN,50
1649943000,1.08243,1.0828,1.07574,1.07706,15902,5695.35,-601184,-574510.6,37.964257328223624,18.70973151701577,47.96704502710329,NaN,NaN,50
1649944800,1.07706,1.07986,1.077,1.07957,10447,6129,-590737,-580449.8,41.013666268188665,28.826428312371547,45.65848380888463,NaN,NaN,50
1649946600,1.07957,1.07969,1.07688,1.07778,12065,6655.55,-602802,-590395.2,43.857005410173414,26.311583688356663,43.28802673670201,NaN,NaN,50
1649948400,1.07778,1.08176,1.07738,1.07963,15282,7336.85,-587520,-593505,44.735852856084826,32.833516424985646,41.661502890823336,NaN,NaN,50
1649950200,1.07963,1.08022,1.07832,1.07973,8180,7635.15,-579340,-592316.6,45.55192548443113,33.17779567286321,39.865163042027795,NaN,NaN,50
1649952000,1.07973,1.08316,1.0795,1.08242,9550,7938.35,-569790,-586037.8,44.26363826578586,41.81730418411786,38.41342947377604,NaN,NaN,50
1649953800,1.08242,1.08257,1.08132,1.08162,4272,7976.1,-574062,-582702.8,43.06737156275811,40.15455976793142,36.85796694500148,NaN,NaN,50
1649955600,1.08162,1.08194,1.0809,1.08156,3538,7862,-577600,-577662.4,42.109259840964164,40.0260140080395,35.594176891595204,NaN,NaN,50
1649957400,1.08156,1.0827,1.0815,1.08242,3290,7816.5,-574310,-575020.4,40.71622251121391,42.85005246974658,34.81345862713951,NaN,NaN,50
1649959200,1.08242,1.08298,1.08209,1.08258,3000,7785.25,-571310,-573414.4,39.237815192638905,43.38418822026301,34.14019946153633,NaN,NaN,50
1649961000,1.08258,1.08312,1.0824,1.08301,2168,7752.55,-569142,-573284.8,37.76865820725907,44.87531673189668,35.20903531900817,NaN,NaN,50
1649962800,1.08301,1.08348,1.0827,1.08279,2058,7721.2,-571200,-572712.4,36.14858700150149,44.23341767087891,35.304005555229885,NaN,NaN,50
1649964600,1.08279,1.0829,1.08238,1.08245,2159,7658.75,-573359,-571864.2,34.81456270209803,43.20485054364444,36.17690892715249,NaN,NaN,50
1649966400,1.08245,1.08314,1.08242,1.083,1023,7598.65,-572336,-571469.4,33.38972236199256,45.41598952717664,37.558624909949096,NaN,NaN,50
1649968200,1.083,1.08344,1.0827,1.08282,1130,7520.35,-573466,-571900.6,31.82879072530511,44.801252392729495,39.422304972500065,NaN,NaN,50
1649970000,1.08282,1.08307,1.08268,1.08288,174,7413.45,-573292,-572730.6,30.392478947986294,45.068164458851896,40.582428982962945,NaN,NaN,50
1649971800,1.08288,1.083,1.08272,1.08279,220,6731.55,-573512,-573193,29.05876086904739,44.718858787243065,41.89723434716912,NaN,NaN,50
1649973600,1.08279,1.0828,1.08243,1.08246,347,6350.6,-573859,-573293,28.033129311334065,43.390882370994355,42.651331914741164,NaN,NaN,50
1649975400,1.08246,1.08274,1.08222,1.08236,4114,5611.5,-577973,-574420.4,27.237009555094172,42.97441558311623,43.35109047975924,NaN,NaN,50
1649977200,1.08236,1.08258,1.08163,1.08164,4818,5186.85,-582791,-576285.4,26.92522632751958,39.99772073928904,43.22112023370004,NaN,NaN,50
1649979000,1.08164,1.08225,1.08146,1.08216,3230,4553.25,-579561,-577539.2,26.75611610729906,43.06503936050013,43.42901163316924,NaN,NaN,50
1649980800,1.08216,1.08223,1.08138,1.08142,1778,4119.8,-581339,-579104.6,26.65811639999091,39.93628234241606,43.42260222848184,NaN,NaN,50
1649982600,1.08142,1.08166,1.07984,1.08095,3353,3684.2,-584692,-581271.2,27.55347496514165,38.04566768701421,43.07943188685811,NaN,NaN,50
1649984400,1.08095,1.08142,1.08064,1.08132,2887,3064.45,-581805,-582037.6,28.384879347067336,40.436261990183304,42.86886572756669,NaN,NaN,50
1649986200,1.08132,1.08156,1.08119,1.08126,4165,2863.7,-585970,-582673.4,28.966612298562637,40.16560284944376,42.532457593105775,NaN,NaN,50
1649988000,1.08126,1.08138,1.08116,1.0813,3930,2582.7,-582040,-583169.2,29.52672834571523,40.45176619609389,42.26233963062113,NaN,NaN,50
1649989800,1.0813,1.08142,1.0797,1.0798,3950,2566.6,-585990,-584099.4,30.892233351913802,33.90353479833722,41.59795993452776,NaN,NaN,50
1649991600,1.0798,1.08085,1.07968,1.08006,6343,2706.85,-579647,-583090.4,32.17031008877267,35.8421997840163,40.9141178100163,NaN,NaN,50
1649993400,1.08006,1.0806,1.07996,1.08046,3848,2734.75,-575799,-581889.2,33.35709563014163,38.815490284290874,40.486563373699255,NaN,NaN,50
1649995200,1.08046,1.08059,1.08024,1.08027,2198,2694.65,-577997,-580294.6,34.459110775698505,37.916622498563136,39.97573894796434,NaN,NaN,50
1649997000,1.08027,1.08064,1.08026,1.08056,616,2617.05,-577381,-579362.8,35.39175437742422,40.19313913345716,39.6524732584082,NaN,NaN,50
1649998800,1.08056,1.08074,1.08044,1.08064,479,2538.1,-576902,-577545.2,36.06767947577389,40.837631410758604,39.47009818981994,NaN,NaN,50
1650000600,1.08064,1.08077,1.08045,1.08057,1124,2486.35,-578026,-577221,36.63536448490768,40.42711343441761,39.28814803634147,NaN,NaN,50
1650002400,1.08057,1.08066,1.08051,1.08056,897,2480.05,-578923,-577845.8,37.162500564817634,40.36468824334916,39.31436000091719,NaN,NaN,50
1650004200,1.08056,1.0808,1.08022,1.08026,916,2469.35,-579839,-578214.2,37.89593701247281,38.44667386306134,38.98447675110014,NaN,NaN,50
1650006000,1.08026,1.08085,1.08026,1.08084,1233,2522.3,-578606,-578459.2,38.45903752945463,43.98810504621564,39.2738926585144,NaN,NaN,50
1650007800,1.08084,1.08123,1.0807,1.08116,1445,2583.55,-577161,-578511,38.10752828549676,46.83208615254944,39.901493977481195,NaN,NaN,50
1650009600,1.08116,1.08171,1.08094,1.08154,1162,2624.3,-575999,-578105.6,36.80325815731594,50.073930225742046,40.589898851449675,NaN,NaN,50
1650011400,1.08154,1.08236,1.08137,1.08186,2445,2540.85,-573554,-577031.8,34.4787504321458,52.689983972316824,41.48449750308346,NaN,NaN,50
1650013200,1.08186,1.08198,1.08154,1.08188,1607,2380.3,-571947,-575453.4,32.32027897305925,52.856251750190644,42.37053218551895,NaN,NaN,50
1650015000,1.08188,1.08189,1.08132,1.0814,4362,2436.9,-576309,-574994,30.64815965464861,48.45487634677169,43.409913724692835,NaN,NaN,50
1650016800,1.0814,1.08174,1.08112,1.08145,8079,2751.95,-568230,-573207.8,29.390841738026634,48.93191663506568,44.344893499767785,NaN,NaN,50
1650018600,1.08145,1.08152,1.08072,1.08087,2670,2717.8,-570900,-572188,28.776532178414634,43.860976934886466,44.70528540338176,NaN,NaN,50
1650020400,1.08087,1.08088,1.08054,1.08072,1296,2638.25,-572196,-571916.4,28.440208203095533,42.63052446161003,45.04199268645653,NaN,NaN,50
1650022200,1.08072,1.08163,1.08058,1.08156,3219,2590.95,-568977,-571322.4,26.740174144532585,50.93203788597291,45.8090568830648,NaN,NaN,50
1650024000,1.08156,1.08198,1.08121,1.08183,2984,2543.65,-565993,-569259.2,25.04405078756582,53.27258461416146,46.697267826165,NaN,NaN,50
1650025800,1.08183,1.08184,1.08122,1.0813,1808,2436.55,-567801,-569173.4,23.46907909895382,48.39283897687309,47.266248222054685,NaN,NaN,50
1650027600,1.0813,1.08133,1.08065,1.08079,4505,2344.65,-572306,-569454.6,22.469796255655947,44.19747305509049,47.540018565750486,NaN,NaN,50
1650029400,1.08079,1.08136,1.08072,1.08124,1715,2238,-570591,-569133.6,21.488576895058056,48.444551979468216,48.25415271692241,NaN,NaN,50
1650031200,1.08124,1.08124,1.08072,1.08092,869,2171.55,-571460,-569630.2,20.57744463164573,45.776459877833425,48.38189234775225,NaN,NaN,50
1650033000,1.08092,1.08106,1.08066,1.08084,2259,2253.7,-573719,-571175.4,19.83287995918911,45.107607374308074,48.25871529216358,NaN,NaN,50
1650034800,1.08084,1.08094,1.08065,1.08071,443,2251.9,-574162,-572447.6,19.159380503182334,43.982974437934054,47.82364702160587,NaN,NaN,50
1650036600,1.08071,1.08107,1.08056,1.08086,423,2216.85,-573739,-572734.2,18.237908495461483,45.66628029585204,47.321953901858386,NaN,NaN,50
1650038400,1.08086,1.08107,1.08069,1.08098,597,2201.85,-573142,-573244.4,17.38225591686355,47.037435654278724,46.90632418072182,NaN,NaN,50
1650040200,1.08098,1.08098,1.08059,1.08062,510,2181.55,-573652,-573682.8,16.804727772517445,43.4915249025008,46.551799077559615,NaN,NaN,50
1650042000,1.08062,1.08072,1.08052,1.08062,640,2151.9,-573652,-573669.4,16.422964253851973,43.49152490250081,46.163199668090705,NaN,NaN,50
1650043800,1.08062,1.08118,1.08062,1.081,620,2110.65,-573032,-573443.4,15.580992025999999,48.2658495549973,46.477833426670045,NaN,NaN,50
1650045600,1.081,1.08106,1.08083,1.081,716,2088.35,-573032,-573302,14.79916067156602,48.2658495549973,46.88035664762628,NaN,NaN,50
1650047400,1.081,1.08115,1.08099,1.08102,652,1998.7,-572380,-573149.6,14.28929365231648,48.531284109184625,46.70887423499853,NaN,NaN,50
1650049200,1.08102,1.08104,1.08068,1.0807,433,1940,-572813,-572981.8,13.53115692561836,44.58929509541269,46.08863926937362,NaN,NaN,50
1650051000,1.0807,1.08101,1.0807,1.08093,386,1741.2,-572427,-572736.8,12.82717282225582,47.86699314208756,46.051078852603226,NaN,NaN,50
1650052800,1.08093,1.08122,1.0809,1.0811,263,1350.4,-572164,-572563.2,12.214231674746735,50.21128641506052,46.480636949743946,NaN,NaN,50
1650054600,1.0811,1.08156,1.08093,1.08149,584,1246.1,-571580,-572272.8,12.449123785444408,55.18955983963974,46.96242322547049,NaN,NaN,50
1650229200,1.08149,1.08149,1.08054,1.08076,124,1187.5,-571704,-572137.6,11.621071293864114,45.931829594838,46.97352106239938,NaN,NaN,50
1650231000,1.08076,1.08089,1.08072,1.08088,80,1030.55,-571624,-571899.8,10.85216540882527,47.49110748003172,47.14377106995107,NaN,NaN,50
1650232800,1.08088,1.08118,1.08032,1.08074,2461,1004.4,-574085,-572231.4,10.960039737414403,45.83049659016867,47.275736937967835,NaN,NaN,50
1650234600,1.08074,1.08218,1.0807,1.08204,2390,1033.5,-571695,-572137.6,11.387542399922843,59.86456426783528,48.28990007882378,NaN,NaN,50
1650236400,1.08204,1.08207,1.08152,1.08206,2931,954.8,-568764,-571574.4,11.784509157966394,60.03610523159169,49.21837647720327,NaN,NaN,50
1650238200,1.08206,1.08218,1.08128,1.0814,1560,947.05,-570324,-571298.4,11.5877233451825,52.119504139742254,49.83466070843481,NaN,NaN,50
1650240000,1.0814,1.0816,1.08045,1.08054,2258,1016.5,-572582,-571490,11.683016800400933,43.981221988861,49.86963907174625,NaN,NaN,50
1650241800,1.08054,1.0806,1.07936,1.08012,3301,1068.6,-575883,-571849.6,13.150031976118623,40.64343657711151,49.32518100189727,NaN,NaN,50
1650243600,1.08012,1.08101,1.07958,1.08092,4174,1255.15,-571709,-571852.4,13.734203942649073,48.63901431643539,49.35183562771427,NaN,NaN,50
1650245400,1.08092,1.08122,1.08054,1.0807,2760,1372,-574469,-572993.4,13.899951909569205,46.77308786665753,49.22625018181948,NaN,NaN,50
1650247200,1.0807,1.08095,1.07986,1.07994,1937,1439,-576406,-574209.8,14.843098757360165,40.93135760278777,48.964968932346274,NaN,NaN,50
1650249000,1.07994,1.08033,1.0796,1.0802,1725,1499.75,-574681,-574629.6,15.98657391810927,43.52977785858336,48.655167840667396,NaN,NaN,50
1650250800,1.0802,1.08028,1.07946,1.07968,1966,1566.05,-576647,-574782.4,17.19136052574352,39.76239610459818,47.90881853277723,NaN,NaN,50
1650252600,1.07968,1.07988,1.07908,1.0793,1766,1623.35,-578413,-576123.2,18.684290685011966,37.22683418636309,46.62576670040033,NaN,NaN,50
1650254400,1.0793,1.07968,1.07915,1.07928,1851,1680.1,-580264,-577282.2,20.07058297576124,37.09276715626141,45.99440509764486,NaN,NaN,50
1650256200,1.07928,1.07938,1.07894,1.07926,1214,1708.2,-581478,-578296.6,21.568444720406884,36.94946302895691,45.24143049399667,NaN,NaN,50
1650258000,1.07926,1.07944,1.07898,1.07912,1534,1763.25,-583012,-579962.8,22.81382486501433,35.90379800745309,44.53238059523126,NaN,NaN,50
1650259800,1.07912,1.07951,1.07886,1.07944,1762,1832.05,-581250,-580883.4,24.10168333310035,40.078035174492214,43.119057088563906,NaN,NaN,50
1650261600,1.07944,1.0798,1.07907,1.07951,1759,1906.85,-579491,-581099,24.56520085326837,40.9834577735217,41.758153698701754,NaN,NaN,50
1650263400,1.07951,1.08,1.07934,1.07938,1644,1959.85,-581135,-581273.2,24.51715262662157,39.781265654279636,40.87685094974015,NaN,NaN,50
1650265200,1.07938,1.08037,1.07936,1.07992,1847,2046,-579288,-580835.2,23.652043769444127,46.76656271716779,41.07580385890492,NaN,NaN,50
1650267000,1.07992,1.07992,1.07872,1.07914,2189,2151.45,-581477,-580528.2,23.77019084591368,39.617824319949285,41.002545840536186,NaN,NaN,50
1650268800,1.07914,1.07946,1.07832,1.07856,1713,2114.05,-583190,-580916.2,24.36107398755759,35.29714878751416,40.049555445613244,NaN,NaN,50
1650270600,1.07856,1.07932,1.07854,1.0792,1472,2068.15,-581718,-581361.6,24.909751190512644,42.72045317450132,39.76008153903066,NaN,NaN,50
1650272400,1.0792,1.07984,1.07918,1.07937,1314,1987.3,-580404,-581215.4,24.290283915994543,44.54058468149452,40.017883473224,NaN,NaN,50
1650274200,1.07937,1.07951,1.07897,1.07928,988,1958.7,-581392,-581636.2,24.01112037296613,43.748010764577636,40.03347153793788,NaN,NaN,50
1650276000,1.07928,1.07971,1.07904,1.0795,1487,1920.15,-579905,-581321.8,23.33657994075495,46.26513626186481,40.49795297774263,NaN,NaN,50
1650277800,1.0795,1.08015,1.0795,1.08008,1553,1832.75,-578352,-580354.2,21.86992338275439,52.32233666575908,41.57620315484235,NaN,NaN,50
1650279600,1.08008,1.08104,1.08006,1.08096,1797,1713.9,-576555,-579321.6,21.4497960588991,59.738007097939445,43.19372029353364,NaN,NaN,50
1650281400,1.08096,1.08138,1.08042,1.08095,2494,1700.6,-579049,-579050.6,21.479389318534622,59.62451585957347,44.81336692429196,NaN,NaN,50
1650283200,1.08095,1.08096,1.07992,1.08072,3159,1761.7,-582208,-579213.8,20.63883127115152,56.94486217291855,46.31630007896807,NaN,NaN,50
1650285000,1.08072,1.08146,1.08019,1.08051,2762,1813.55,-584970,-580226.8,20.48374167439669,54.5349306000346,47.34893546650681,NaN,NaN,50
1650286800,1.08051,1.08091,1.07968,1.08022,3579,1894.2,-588549,-582266.2,19.525085430856677,51.3058391330096,48.08624842075595,NaN,NaN,50
1650288600,1.08022,1.08109,1.07991,1.08008,5963,2104.05,-594512,-585857.6,18.869240405613525,49.773624620520366,48.799988346916,NaN,NaN,50
1650290400,1.08008,1.08048,1.07986,1.07998,3368,2179.9,-597880,-589623.8,18.177881936949287,48.655874547045194,48.93493919190724,NaN,NaN,50
1650292200,1.07998,1.08005,1.0791,1.07926,2696,2254,-600576,-593297.4,17.36222898507273,41.440093518225154,49.06510127749838,NaN,NaN,50
1650294000,1.07926,1.0798,1.07864,1.0787,2693,2311.95,-603269,-596957.2,17.183813190208166,36.86122624329454,49.1768210957684,NaN,NaN,50
1650295800,1.0787,1.07908,1.07831,1.07836,1828,2315.25,-605097,-600266.8,17.400855374785557,34.377588183613014,48.58090216784781,NaN,NaN,50
1650297600,1.07836,1.07868,1.07704,1.07729,2766,2365.6,-607863,-602937,18.78124950513257,27.986717428123626,47.39848307832131,NaN,NaN,50
1650299400,1.07729,1.07764,1.07699,1.07727,1888,2377.8,-609751,-605311.2,20.102341150386675,27.882378744414396,46.26522364830966,NaN,NaN,50
1650301200,1.07727,1.07792,1.07715,1.07788,1782,2374.55,-607969,-606789.8,20.840517330103474,35.75012266768614,45.51415124872546,NaN,NaN,50
1650303000,1.07788,1.07839,1.0778,1.07832,1571,2343.65,-606398,-607415.6,20.75615286057688,40.76962680633209,44.688957687337826,NaN,NaN,50
1650304800,1.07832,1.07858,1.07825,1.07842,1342,2325.1,-605056,-607407.4,20.38104088902093,41.880946608283466,43.41345336664811,NaN,NaN,50
1650306600,1.07842,1.07866,1.07827,1.07844,1666,2334.8,-603390,-606512.8,19.90483924154302,42.11487140745283,42.16276447721093,NaN,NaN,50
1650308400,1.07844,1.07844,1.0778,1.07792,1820,2360.1,-605210,-605604.6,20.013100554461573,37.8493317794546,40.79879802053494,NaN,NaN,50
1650310200,1.07792,1.07843,1.07785,1.07832,1569,2389.15,-603641,-604739,20.11362891645737,42.66032822196882,39.95061213638737,NaN,NaN,50
1650312000,1.07832,1.07838,1.07807,1.07826,785,2354.05,-604426,-604344.6,20.20697668116775,42.1334716272582,39.2954430288337,NaN,NaN,50
1650313800,1.07826,1.07841,1.0781,1.07816,407,2296.75,-604833,-604300,20.232341892640797,41.21976418177004,38.6844529974944,NaN,NaN,50
1650315600,1.07816,1.07816,1.07789,1.07801,45,2209.15,-604878,-604597.6,20.54299604608862,39.824655972113426,38.053651670713556,NaN,NaN,50
1650317400,1.07801,1.0782,1.07781,1.07782,411,2105,-605289,-604613.4,20.941011753971924,38.06713850850928,37.8127263128767,NaN,NaN,50
1650319200,1.07782,1.07881,1.07774,1.07838,1584,2026.25,-603705,-604626.2,20.02156568875015,45.67659609518847,38.44239558801198,NaN,NaN,50
1650321000,1.07838,1.07838,1.07804,1.07811,656,1920.95,-604361,-604613.2,19.167794342472792,42.9373668326555,39.05380834865787,NaN,NaN,50
1650322800,1.07811,1.07849,1.07776,1.0781,1405,1812.25,-605766,-604799.8,18.83981437460285,42.83490705747747,40.11439332218315,NaN,NaN,50
1650324600,1.0781,1.07818,1.07754,1.078,1408,1584.5,-607174,-605259,18.88006882080908,41.761706447607075,41.1057738724112,NaN,NaN,50
1650326400,1.078,1.07878,1.07762,1.07824,3579,1595.05,-603595,-604920.2,17.70339352087207,45.30361719632879,41.78816633874281,NaN,NaN,50
1650328200,1.07824,1.07833,1.0773,1.0779,2963,1608.4,-606558,-605490.8,17.137626206314888,41.45699810617083,41.8372642887313,NaN,NaN,50
1650330000,1.0779,1.07838,1.07755,1.07816,3244,1635.95,-603314,-605281.4,16.513796140635016,45.283020711231,42.08026958179897,NaN,NaN,50
1650331800,1.07816,1.07844,1.07764,1.07772,3276,1708.35,-606590,-605446.2,15.810870632142846,40.463538175103835,41.96231720805976,NaN,NaN,50
1650333600,1.07772,1.0778,1.07654,1.07656,2482,1694.15,-609072,-605825.8,16.756150588734496,31.073868059444294,41.4783555137733,NaN,NaN,50
1650335400,1.07656,1.07715,1.07612,1.07687,2569,1728.2,-606503,-606407.4,18.088653838737475,35.38888125591545,40.95896644476949,NaN,NaN,50
1650337200,1.07687,1.07721,1.07671,1.07694,1923,1735.25,-604580,-606011.8,19.194283269016662,36.35774962706886,40.5464148733274,NaN,NaN,50
1650339000,1.07694,1.07754,1.07678,1.07726,2201,1766.75,-602379,-605824.8,19.50894108186534,40.7330391531368,40.511648799853596,NaN,NaN,50
1650340800,1.07726,1.07817,1.07726,1.07766,1980,1798.65,-600399,-604586.6,18.626729069014413,45.753331806072,40.935125645136345,NaN,NaN,50
1650342600,1.07766,1.07777,1.07674,1.07722,2549,1842.8,-602948,-603361.8,18.508750792643156,41.58091411449749,41.186109616992645,NaN,NaN,50
1650344400,1.07722,1.07734,1.07666,1.07715,2108,1857.2,-605056,-603072.4,18.50130437812896,40.94124389347735,40.84787017401328,NaN,NaN,50
1650346200,1.07715,1.07774,1.07712,1.07745,2814,1919.45,-602242,-602604.8,17.776833292191625,44.85653493889585,40.98495361017331,NaN,NaN,50
1650348000,1.07745,1.07804,1.07674,1.07789,3825,2071.45,-598417,-601812.4,17.626912359174547,50.08339530043787,41.50270277038476,NaN,NaN,50
1650349800,1.07789,1.07878,1.07782,1.07828,3611,2231.65,-594806,-600693.8,16.433418544881214,54.225027700082435,42.39294000270443,NaN,NaN,50
1650351600,1.07828,1.07923,1.07816,1.07907,5668,2512.8,-589138,-597931.8,15.933007337930654,61.24043067564922,43.53128382265588,NaN,NaN,50
1650353400,1.07907,1.08028,1.07876,1.08021,4024,2693.45,-585114,-593943.4,16.61670373999033,68.69608316204338,45.47693275521827,NaN,NaN,50
1650355200,1.08021,1.08108,1.07976,1.08071,3853,2806.9,-581261,-589747.2,17.92803320407767,71.30336249640791,47.33552859701662,NaN,NaN,50
1650357000,1.08071,1.08144,1.07934,1.0811,5028,3025.5,-576233,-585310.4,18.499190572255767,73.17978415021656,49.672403309524675,NaN,NaN,50
1650358800,1.0811,1.08114,1.07938,1.0797,3621,3136.3,-579854,-582320,19.029550985563993,58.41378377672103,51.6252544321873,NaN,NaN,50
1650360600,1.0797,1.08065,1.07945,1.07984,2950,3213.4,-576904,-579873.2,19.522028512207353,59.29822660823641,53.333064814495934,NaN,NaN,50
1650362400,1.07984,1.07984,1.07885,1.07938,2917,3180.3,-579821,-578814.6,19.018154666953425,55.148064034937455,54.675230129343696,NaN,NaN,50
1650364200,1.07938,1.07943,1.07846,1.0794,2367,3150.5,-577454,-578053.2,17.991170865868163,55.29456503059728,55.715339120590876,NaN,NaN,50
1650366000,1.0794,1.07944,1.07851,1.07922,2750,3125.8,-580204,-578847.4,17.050608152384786,53.59775518174975,56.275655075996426,NaN,NaN,50
1650367800,1.07922,1.07974,1.07865,1.07958,3248,3124.4,-576956,-578267.8,16.573938001261354,56.47454870364249,57.339486118078206,NaN,NaN,50
1650369600,1.07958,1.08044,1.07891,1.07983,4922,3246.4,-572034,-577293.8,16.949964061579486,58.403191939782914,58.58676812138576,NaN,NaN,50
1650371400,1.07983,1.08008,1.07888,1.07941,5507,3393.3,-577541,-576837.8,17.24806710006437,54.06860474731477,59.24477310770139,NaN,NaN,50
1650373200,1.07941,1.07957,1.0786,1.07914,5464,3570.35,-583005,-577948,17.0430465921029,51.4262265585357,59.34068962613695,NaN,NaN,50
1650375000,1.07914,1.08084,1.07912,1.08059,8125,3866.55,-574880,-576883.2,18.160598962974603,62.12994488373467,59.905326567826386,NaN,NaN,50
1650376800,1.08059,1.08064,1.07921,1.08012,5996,4067.35,-580876,-577667.2,19.198326164498326,57.69217972781972,59.65188007155285,NaN,NaN,50
1650378600,1.08012,1.08014,1.07851,1.07856,7064,4293.1,-587940,-580848.4,19.02208165907244,45.95836253143264,58.02775716936636,NaN,NaN,50
1650380400,1.07856,1.07964,1.0782,1.07938,5389,4457.15,-582551,-581850.4,18.406127435668665,51.537903901242586,56.615938698283124,NaN,NaN,50
1650382200,1.07938,1.07952,1.07842,1.07896,3778,4505.35,-586329,-582515.2,17.834169942508016,48.76098864683312,54.87173901947002,NaN,NaN,50
1650384000,1.07896,1.07952,1.07838,1.07949,3229,4475.55,-583100,-584159.2,17.239568582667005,52.2568800528379,54.43196018204981,NaN,NaN,50
1650385800,1.07949,1.07983,1.07936,1.07966,2281,4409.05,-580819,-584147.8,17.094477342568652,53.35616227106502,54.007527015108984,NaN,NaN,50
1650387600,1.07966,1.08035,1.07966,1.07988,2541,4252.7,-578278,-582215.4,17.57836705231294,54.8063824886297,53.98312119037272,NaN,NaN,50
1650389400,1.07988,1.08002,1.07886,1.07889,2545,4178.75,-580823,-581869.8,16.747121833622618,47.629829389077415,53.4356400731213,NaN,NaN,50
1650391200,1.07889,1.07948,1.07824,1.07874,3226,4147.4,-584049,-581413.8,15.942122821759625,46.63345376433965,52.93818997187772,NaN,NaN,50
1650393000,1.07874,1.07928,1.07856,1.07904,2195,4005.75,-581854,-581164.6,15.194623739315412,48.934302236503534,52.39960093851066,NaN,NaN,50
1650394800,1.07904,1.0792,1.07848,1.07851,1528,3901.1,-583382,-581677.2,14.607683374128714,45.22464814190807,51.4582763815196,NaN,NaN,50
1650396600,1.07851,1.07898,1.0783,1.0789,2705,3888.85,-580677,-582157,14.308752387426368,48.32879342644883,51.0482898586006,NaN,NaN,50
1650398400,1.0789,1.07912,1.0785,1.07905,1582,3822.1,-579095,-581811.4,13.793857275108548,49.51385364868589,50.91169179361133,NaN,NaN,50
1650400200,1.07905,1.0792,1.07875,1.07886,555,3731.5,-579650,-580931.6,13.176668712990958,48.011795348599776,49.9032525411017,NaN,NaN,50
1650402000,1.07886,1.07888,1.07859,1.07886,432,3615.6,-579650,-580490.8,12.858838186584096,48.011795348599776,49.21179651401456,NaN,NaN,50
1650403800,1.07886,1.07911,1.07882,1.07903,4079,3657.15,-575571,-578928.6,12.13566338817065,49.59840123315201,49.471799278423084,NaN,NaN,50
1650405600,1.07903,1.07918,1.07874,1.07918,1626,3492.35,-573945,-577582.2,11.604678931458007,51.01883304347948,49.43472278858286,NaN,NaN,50
1650407400,1.07918,1.07929,1.07884,1.07904,1419,3287.95,-575364,-576836,10.894126756832886,49.6134429020734,49.49561237824288,NaN,NaN,50
1650409200,1.07904,1.07924,1.07878,1.07884,1503,3089.9,-576867,-576279.4,10.352312996247495,47.59634655301099,49.162717128255245,NaN,NaN,50
1650411000,1.07884,1.07954,1.07872,1.07942,1817,2774.5,-575050,-575359.4,9.988552318916422,53.5005073070747,49.173027487970224,NaN,NaN,50
1650412800,1.07942,1.07972,1.07876,1.07896,2760,2612.7,-577810,-575807.2,9.994992092139533,48.804083403577756,48.74429183903795,NaN,NaN,50
1650414600,1.07896,1.07991,1.07872,1.07964,2613,2390.15,-575197,-576057.6,10.352058165791744,55.081366179822396,49.276544466948316,NaN,NaN,50
1650416400,1.07964,1.08008,1.07841,1.0785,5170,2379.2,-580367,-577058.2,9.963854363083517,45.09805131570686,49.166872863474545,NaN,NaN,50
1650418200,1.0785,1.07984,1.0784,1.07971,4085,2394.55,-576282,-576941.2,9.580635468682265,54.520269378315746,49.56587051646113,NaN,NaN,50
1650420000,1.07971,1.08096,1.07926,1.08076,3802,2423.2,-572480,-576427.2,11.050813062123414,60.80622235829149,50.67884010334566,NaN,NaN,50
1650421800,1.08076,1.08086,1.08036,1.08073,3839,2501.1,-576319,-576129,12.415977970318764,60.54872375544224,51.551692269702336,NaN,NaN,50
1650423600,1.08073,1.08193,1.08062,1.08183,5382,2643.15,-570937,-575277,14.825627463727395,66.20059235682206,52.74360217742635,NaN,NaN,50
1650425400,1.08183,1.0823,1.0814,1.08188,4322,2732,-566615,-572526.6,17.365313268910697,66.43597101856848,54.05961472528126,NaN,NaN,50
1650427200,1.08188,1.08212,1.08148,1.08206,3612,2751.3,-563003,-569870.8,19.723592945152333,67.31833813906957,55.4386534960291,NaN,NaN,50
1650429000,1.08206,1.08224,1.0817,1.08202,2650,2774.05,-565653,-568505.4,22.015142527812394,66.89745936547263,56.67430050548057,NaN,NaN,50
1650430800,1.08202,1.08202,1.08131,1.08145,2581,2826.7,-568234,-566888.4,23.153230654091782,61.04088076472233,57.39016105699791,NaN,NaN,50
1650432600,1.08145,1.08194,1.08129,1.08166,2547,2818.8,-565687,-565838.4,24.160603178894704,62.34868757174262,58.299821390545716,NaN,NaN,50
1650434400,1.08166,1.08184,1.0808,1.08094,3848,2932.1,-569535,-566422.4,23.95018111423125,55.473030037837034,58.86244163946186,NaN,NaN,50
1650436200,1.08094,1.08144,1.08094,1.08134,3073,3058,-566462,-567114.2,23.754789197043753,58.228996974628764,59.20019090143001,NaN,NaN,50
1650438000,1.08134,1.08188,1.08071,1.08132,5122,3292.5,-571584,-568300.4,24.183985857282824,58.0355776512738,59.85958334769402,NaN,NaN,50
1650439800,1.08132,1.08188,1.08083,1.08092,3530,3265.05,-575114,-569676.4,24.58252561321911,54.160687477310745,59.79382058322891,NaN,NaN,50
1650441600,1.08092,1.08203,1.08057,1.08192,2891,3328.3,-572223,-570983.6,24.311054400066105,61.145177586743785,60.940043888302974,NaN,NaN,50
1650443400,1.08192,1.08414,1.0819,1.08398,4730,3493.85,-567493,-570575.2,26.19172052607433,70.96105876578434,62.11438598740784,NaN,NaN,50
1650445200,1.08398,1.08434,1.08296,1.08386,3695,3603.45,-571188,-571520.4,28.06867739092569,69.8539907703301,62.76065515969632,NaN,NaN,50
1650447000,1.08386,1.08672,1.08352,1.08542,8150,3920.1,-563038,-569811.2,30.90457960420192,75.25800985764721,63.81131845271096,NaN,NaN,50
1650448800,1.08542,1.08658,1.08513,1.08612,6318,4098,-556720,-566132.4,33.537917373672705,77.23043238976578,64.59916416934979,NaN,NaN,50
1650450600,1.08612,1.08652,1.08544,1.08588,3713,4153,-560433,-563774.4,35.98315958818129,75.02215934731467,65.2124633356888,NaN,NaN,50
1650452400,1.08588,1.08594,1.08398,1.08428,4497,4119.35,-564930,-563261.8,35.88265427308116,62.24431921817241,64.85003341276757,NaN,NaN,50
1650454200,1.08428,1.0847,1.08252,1.08268,4170,4123.6,-569100,-562844.2,34.10085920476235,52.59687051715301,63.82856278074474,NaN,NaN,50
1650456000,1.08268,1.08326,1.08261,1.0832,4589,4162.95,-564511,-563138.8,32.44633521275203,55.036057985201204,63.39964686792181,NaN,NaN,50
1650457800,1.0832,1.08329,1.08207,1.0829,5008,4221.4,-569519,-565698.6,30.354771110062185,53.33107100935248,62.75553139917965,NaN,NaN,50
1650459600,1.0829,1.0839,1.08219,1.08383,7226,4313.6,-562293,-566070.6,28.95587653369179,57.70534160296343,62.91498222526012,NaN,NaN,50
1650461400,1.08383,1.08438,1.08299,1.08418,6105,4402.75,-556188,-564322.2,28.054646797098837,59.253233890517315,62.98814200496644,NaN,NaN,50
1650463200,1.08418,1.08644,1.08416,1.08532,7550,4599.65,-548638,-560229.8,28.555525862335884,63.88894990241402,63.406240022905024,NaN,NaN,50
1650465000,1.08532,1.08659,1.0843,1.08646,6652,4799.75,-541986,-555724.8,29.100641170558294,67.83038373561533,64.38264689849821,NaN,NaN,50
1650466800,1.08646,1.08664,1.08529,1.08568,4088,4875.1,-546074,-551035.8,29.63487316341024,62.78123233414579,64.49950795188407,NaN,NaN,50
1650468600,1.08568,1.08609,1.08466,1.08547,3741,4934.8,-549815,-548540.2,29.37900090428568,61.45487711859968,63.82049497708516,NaN,NaN,50
1650470400,1.08547,1.086,1.08528,1.0856,2905,4887.65,-546910,-546684.6,29.14140523509859,61.99022252592499,63.258797245341945,NaN,NaN,50
1650472200,1.0856,1.08592,1.08408,1.08427,2957,4881.85,-549867,-546930.4,27.61076845872988,53.763199302252154,61.72345363424229,NaN,NaN,50
1650474000,1.08427,1.08494,1.084,1.08472,3512,4801.35,-546355,-547804.2,26.109925778233627,55.895966222841245,60.199563193747686,NaN,NaN,50
1650475800,1.08472,1.08525,1.08442,1.08518,2445,4747.1,-543910,-547371.4,24.99219702263527,58.02730495557662,58.98564502290925,NaN,NaN,50
1650477600,1.08518,1.08575,1.08498,1.08512,2509,4728,-546419,-546692.2,24.38294417396918,57.63606196756875,58.65648379072327,NaN,NaN,50
1650479400,1.08512,1.0852,1.08402,1.08415,3382,4660.6,-549801,-547270.4,22.804717187311216,51.58111854465203,58.583930078401785,NaN,NaN,50
1650481200,1.08415,1.08512,1.08407,1.085,2420,4596.85,-547381,-546773.2,21.339220699700252,55.9483832593406,58.64909616941174,NaN,NaN,50
1650483000,1.085,1.08545,1.08459,1.08538,1789,4278.8,-545592,-546620.6,20.301391852583393,57.78172976079646,58.967000365943456,NaN,NaN,50
1650484800,1.08538,1.08546,1.08491,1.08493,825,4004.15,-546417,-547122,19.34773114021066,54.86948936893586,58.76443949208433,NaN,NaN,50
1650486600,1.08493,1.08554,1.08478,1.0855,986,3867.8,-545431,-546924.4,18.304249466001362,57.77269046594616,58.65868639032925,NaN,NaN,50
1650488400,1.0855,1.08555,1.08444,1.08506,577,3671.8,-546008,-546165.8,17.0699818642781,54.83999618670752,58.01233255349308,NaN,NaN,50
1650490200,1.08506,1.08518,1.08501,1.08518,105,3468.55,-545903,-545870.2,15.923876234106494,55.50340950632561,57.13183439425809,NaN,NaN,50
1650492000,1.08518,1.08555,1.0846,1.08472,1400,3309.1,-547303,-546212.4,15.36482277635092,52.329889065775205,56.385309875088765,NaN,NaN,50
1650493800,1.08472,1.08542,1.08471,1.0853,1551,3136.25,-545752,-546079.4,14.845701708435028,55.76427893183704,55.978838576034285,NaN,NaN,50
1650495600,1.0853,1.08549,1.08505,1.08518,1002,2825.05,-546754,-546344,14.255934680607304,54.883267933502,55.4711989622898,NaN,NaN,50
1650497400,1.08518,1.08522,1.0847,1.08496,1322,2585.9,-548076,-546757.6,14.17452375774921,53.22310184297364,55.43262057234133,NaN,NaN,50
1650499200,1.08496,1.08508,1.084,1.08415,2617,2339.25,-550693,-547715.6,14.910762973909295,47.523236361535844,54.83456843939094,NaN,NaN,50
1650501000,1.08415,1.08426,1.08312,1.0836,4077,2210.5,-554770,-549209,16.406000371854248,44.071890672515906,53.83775313345804,NaN,NaN,50
1650502800,1.0836,1.08438,1.0835,1.08403,3415,2176.85,-551355,-550329.6,17.58467812007401,47.29464810557961,53.099080714744524,NaN,NaN,50
1650504600,1.08403,1.08414,1.08348,1.08378,2817,2130.65,-554172,-551813.2,18.697687174525747,45.64772671092509,52.67526701233546,NaN,NaN,50
1650506400,1.08378,1.08378,1.08298,1.08322,1844,2077.6,-556016,-553401.2,20.181132769925807,42.110341633484545,51.686835467631454,NaN,NaN,50
1650508200,1.08322,1.08334,1.0824,1.08261,2542,2056.85,-558558,-554974.2,22.014089021388745,38.601277139714654,50.31680313755418,NaN,NaN,50
1650510000,1.08261,1.08306,1.08237,1.08288,1970,1979.75,-556588,-555337.8,23.738685921240137,40.94692967888553,49.32233458826488,NaN,NaN,50
1650511800,1.08288,1.08319,1.08253,1.08304,2224,1968.7,-554364,-555939.6,25.063426091423175,42.35241515498719,48.22088635176781,NaN,NaN,50
1650513600,1.08304,1.08356,1.08298,1.08328,2278,1957.15,-552086,-555522.4,25.5300143909214,44.486721230419555,47.48136671203296,NaN,NaN,50
1650515400,1.08328,1.08346,1.08291,1.08324,1983,1887.2,-554069,-555133,26.03693516527238,44.193048932467626,46.67348381390024,NaN,NaN,50
1650517200,1.08324,1.08485,1.08318,1.08463,3899,1961.15,-550170,-553455.4,24.198117825823537,55.24856543367138,46.8819606973214,NaN,NaN,50
1650519000,1.08463,1.0852,1.08441,1.08469,2789,2011.15,-547381,-551614,22.892940174108396,55.656920292000855,46.874292223047384,NaN,NaN,50
1650520800,1.08469,1.08602,1.08462,1.08579,3904,2165.1,-543477,-549436.6,22.590068817511664,62.42619396468246,47.41307265384599,NaN,NaN,50
1650522600,1.08579,1.09036,1.0857,1.09022,10071,2619.35,-533406,-545700.6,24.83863717067115,77.39353389413398,49.13953208607173,NaN,NaN,50
1650524400,1.09022,1.09158,1.0888,1.09138,7569,2968.95,-525837,-540054.2,27.30864704488315,79.67648779565909,51.436192902794815,NaN,NaN,50
1650526200,1.09138,1.09364,1.09075,1.09273,7328,3330.1,-518509,-533722,30.108784158081615,81.95980455944331,54.14247246614678,NaN,NaN,50
1650528000,1.09273,1.09285,1.09132,1.09134,5810,3550.6,-524319,-529109.6,32.70891147748019,72.88065101070549,55.97004410222719,NaN,NaN,50
1650529800,1.09134,1.09302,1.09113,1.09212,4993,3722.7,-519326,-524279.4,34.90506411475618,74.5822089361174,58.036792832598074,NaN,NaN,50
1650531600,1.09212,1.09253,1.09148,1.09168,3868,3866,-523194,-522237,36.94434870651245,71.84379254549948,60.160610754884864,NaN,NaN,50
1650533400,1.09168,1.09205,1.09082,1.0914,3725,3986.15,-526919,-522453.4,38.03426201526242,70.08039265941275,62.40911900629187,NaN,NaN,50
1650535200,1.0914,1.09217,1.09116,1.09146,3250,4017.8,-523669,-523485.4,39.09172969526221,70.24890913017029,64.50211753852649,NaN,NaN,50
1650537000,1.09146,1.09167,1.09,1.09005,4290,4028.45,-527959,-524213.4,38.746000548041124,61.48481767867181,65.86871771878968,NaN,NaN,50
1650538800,1.09005,1.09013,1.08767,1.08833,6172,4166.3,-534131,-527174.4,36.42772717315781,52.8268484842373,66.46444109406238,NaN,NaN,50
1650540600,1.08833,1.0886,1.08745,1.08798,4967,4273.8,-539098,-530355.2,34.11759069708863,51.24549796638384,66.96818745362782,NaN,NaN,50
1650542400,1.08798,1.08878,1.08792,1.08836,4076,4385.4,-535022,-531975.8,32.09540974494591,52.89422159831697,66.80002003681679,NaN,NaN,50
1650544200,1.08836,1.08934,1.08758,1.08912,4825,4499.55,-530197,-533281.4,30.599255951579273,56.092295873344405,66.83111829262705,NaN,NaN,50
1650546000,1.08912,1.08962,1.08834,1.08938,7037,4752.9,-523160,-532321.6,29.39804263903018,57.16374196818958,66.45522886430612,NaN,NaN,50
1650547800,1.08938,1.08962,1.08706,1.0872,6075,4945.45,-529235,-531342.4,27.34847594182026,46.842392265024486,64.27300446222688,NaN,NaN,50
1650549600,1.0872,1.0876,1.08624,1.08702,6697,5166.4,-535932,-530709.2,26.017988841922644,46.10221065901023,61.8748418096091,NaN,NaN,50
1650551400,1.08702,1.08736,1.08412,1.08428,6151,5374.8,-542083,-532121.4,25.979243199148744,36.617039165038875,58.63607285286592,NaN,NaN,50
1650553200,1.08428,1.0859,1.08424,1.08572,5217,5440.7,-536866,-533455.2,25.943265102287267,43.22785900642457,56.518016281131565,NaN,NaN,50
1650555000,1.08572,1.08598,1.08368,1.0842,6631,5632.8,-543497,-537522.6,26.193245027006135,38.645892408944505,53.95113652919065,NaN,NaN,50
1650556800,1.0842,1.08458,1.08331,1.08356,4262,5650.7,-547759,-541227.4,26.609308480668076,36.873641176019355,51.453268574227785,NaN,NaN,50
1650558600,1.08356,1.08502,1.0834,1.08435,3671,5330.7,-544088,-542858.6,26.57457354442881,40.500786626952724,49.340439571909215,NaN,NaN,50
1650560400,1.08435,1.08564,1.08375,1.0854,5027,5203.6,-539061,-542254.2,25.970611467929984,45.02233723342958,47.538541579284875,NaN,NaN,50
1650562200,1.0854,1.08585,1.08484,1.08497,5790,5126.7,-544851,-543851.2,25.21890362403088,43.56234266960747,46.258364792923146,NaN,NaN,50
1650564000,1.08497,1.08513,1.08406,1.08406,4977,5085.05,-549828,-545117.4,25.022098566429225,40.564383574742415,45.382474442244934,NaN,NaN,50
1650565800,1.08406,1.08488,1.08378,1.08385,4041,5037.45,-553869,-546339.4,25.011509279152417,39.88226963164677,44.570815275478004,NaN,NaN,50
1650567600,1.08385,1.08422,1.08329,1.08364,3216,5004.85,-557085,-548938.8,25.2986454959051,39.17288417897921,43.590719745525305,NaN,NaN,50
1650569400,1.08364,1.08402,1.08306,1.08386,2501,4943.65,-554584,-552043.4,25.703221547169044,40.369511324941264,42.467663706353655,NaN,NaN,50
1650571200,1.08386,1.08422,1.0836,1.08403,1550,4858.65,-553034,-553680,25.846433135794157,41.329992144556236,41.33668157609412,NaN,NaN,50
1650573000,1.08403,1.08408,1.08311,1.08316,1174,4702.85,-554208,-554556,26.297154606719364,37.96019486058098,40.702238904348164,NaN,NaN,50
1650574800,1.08316,1.08391,1.08316,1.08352,275,4408,-553933,-554568.8,26.7156816868642,40.13528521467507,40.2760299440385,NaN,NaN,50
1650576600,1.08352,1.08388,1.08348,1.0837,2333,4276.3,-551600,-553471.8,27.104313975570122,41.244486066556135,40.60656186557545,NaN,NaN,50
1650578400,1.0837,1.0837,1.0833,1.08348,1163,4130.65,-552763,-553107.6,27.598241202299224,40.262567213527014,40.394755308939914,NaN,NaN,50
1650580200,1.08348,1.084,1.08328,1.08396,1286,3953.7,-551477,-552796.2,27.607284108847015,43.4271813205534,40.7362759454834,NaN,NaN,50
1650582000,1.08396,1.08404,1.08344,1.08354,1165,3660.1,-552642,-552483,27.554566853627303,41.3624062997221,41.05690202574788,NaN,NaN,50
1650583800,1.08354,1.08372,1.08336,1.0835,1831,3447.9,-554473,-552591,27.579910274862314,41.1616821648628,41.10410884988431,NaN,NaN,50
1650585600,1.0835,1.08418,1.08326,1.08384,2647,3245.4,-551826,-552636.2,26.86391062704744,43.66422588718049,41.00710089658081,NaN,NaN,50
1650587400,1.08384,1.0843,1.0832,1.08374,3153,3095.5,-554979,-553079.4,26.01235463342976,43.083807358963554,40.972919802963396,NaN,NaN,50
1650589200,1.08374,1.08467,1.0836,1.08432,3417,3005.5,-551562,-553096.4,24.657146229738057,47.44719763178666,41.46454937846655,NaN,NaN,50
1650591000,1.08432,1.08455,1.08363,1.08407,3144,2831.15,-554706,-553509.2,23.398738426310047,45.816741509464094,41.888440226882075,NaN,NaN,50
1650592800,1.08407,1.08422,1.0839,1.08404,2020,2719.05,-556726,-553959.8,22.23021689455547,45.61417655177064,42.34853253922432,NaN,NaN,50
1650594600,1.08404,1.08446,1.08348,1.08407,2305,2650.75,-554421,-554478.8,21.734918087291906,45.871896250505145,42.741560033907454,NaN,NaN,50
1650596400,1.08407,1.08413,1.08309,1.0839,3730,2585.9,-558151,-555113.2,21.76853807994097,44.58263771221608,42.97389186016888,NaN,NaN,50
1650598200,1.0839,1.08421,1.08385,1.08414,1777,2385.25,-556374,-556075.6,21.64524411584724,46.853621344175174,43.60913660899703,NaN,NaN,50
1650600000,1.08414,1.08506,1.08408,1.08449,2438,2258.3,-553936,-555921.6,20.111732088470696,50.06724605877414,44.31856238357553,NaN,NaN,50
1650601800,1.08449,1.08469,1.08414,1.08456,1945,2153.5,-551991,-554974.6,18.687756634478188,50.70919731177869,44.99461318680572,NaN,NaN,50
1650603600,1.08456,1.08516,1.0842,1.08423,2275,2106.45,-554266,-554943.6,18.06055886518245,47.602178093372885,45.51887110679471,NaN,NaN,50
1650605400,1.08423,1.0848,1.0839,1.0846,2689,2115.85,-551577,-553628.8,16.985149986209777,51.211666528639114,46.074905764515115,NaN,NaN,50
1650607200,1.0846,1.08517,1.08416,1.08426,5052,2290.95,-556629,-553679.8,16.519956226660398,47.94336012392393,46.54497389481525,NaN,NaN,50
1650609000,1.08426,1.08473,1.0825,1.08264,5098,2487.15,-561727,-555238,16.731365542350197,36.11627775665712,46.1845878656577,NaN,NaN,50
1650610800,1.08264,1.08288,1.08042,1.0811,8258,2886.3,-569985,-558836.8,18.46825755878135,28.834305257292755,45.12530782066572,NaN,NaN,50
1650612600,1.0811,1.08168,1.0803,1.08065,5706,3054.95,-575691,-563121.8,20.150016741867155,27.113960510589038,43.98460447435325,NaN,NaN,50
1650614400,1.08065,1.08116,1.07907,1.07932,6131,3303.35,-581822,-569170.8,22.34554307052485,22.78671509353164,42.22314143590646,NaN,NaN,50
1650616200,1.07932,1.08018,1.07904,1.07982,5197,3498.9,-576625,-573170,24.39829154769246,27.472925397565916,40.91286885648516,NaN,NaN,50
1650618000,1.07982,1.08088,1.07924,1.08052,4657,3673.5,-571968,-575218.2,25.317930791409744,33.553114594332214,40.05136443095385,NaN,NaN,50
1650619800,1.08052,1.08059,1.07974,1.08056,4022,3783.05,-567946,-574810.4,26.17188151771865,33.89415311907176,39.195811350137184,NaN,NaN,50
1650621600,1.08056,1.08064,1.07993,1.08042,3132,3807.3,-571078,-573887.8,26.891143387620637,33.25089557708938,38.386401197628125,NaN,NaN,50
1650623400,1.08042,1.08159,1.08024,1.08159,3374,3818.35,-567704,-571064.2,26.26196632171489,42.98874798408982,38.11033881476489,NaN,NaN,50
1650625200,1.08159,1.08253,1.08144,1.08216,3549,3824.95,-564155,-568570.2,24.628790742426325,47.042168102500185,37.89426181788817,NaN,NaN,50
1650627000,1.08216,1.0825,1.08183,1.08215,3023,3818.9,-567178,-567612.2,23.112270561658374,46.97906144123392,37.627823541420696,NaN,NaN,50
1650628800,1.08215,1.08234,1.08152,1.0818,4583,3947.05,-571761,-568375.2,22.017383483295262,44.717947419922425,37.421807064745664,NaN,NaN,50
1650630600,1.0818,1.08232,1.0815,1.08192,4563,4059.95,-567198,-567599.2,21.02141730695111,45.68322012817486,37.026918036141076,NaN,NaN,50
1650632400,1.08192,1.0845,1.08186,1.08262,7416,4244.25,-559782,-566014.8,21.024557000170244,51.052297435844046,37.24898498699251,NaN,NaN,50
1650634200,1.08262,1.08262,1.08024,1.08059,10432,4677,-570214,-567226.6,19.552889689107896,39.00968379304682,37.45565684673464,NaN,NaN,50
1650636000,1.08059,1.08169,1.07988,1.08,7836,4946.9,-578050,-569401,18.476138130105717,36.32753970067107,37.990887878404514,NaN,NaN,50
1650637800,1.08,1.08004,1.07756,1.07762,8693,5284.3,-586743,-572397.4,18.9803102492923,27.972469349094695,38.05220993829778,NaN,NaN,50
1650639600,1.07762,1.0786,1.07706,1.07852,8251,5583.1,-578492,-574656.2,19.70735206445631,34.14097098496535,38.86322821625732,NaN,NaN,50
1650641400,1.07852,1.07922,1.07813,1.0789,5348,5716.05,-573144,-577328.6,19.819434259682193,36.60946099196098,39.51583790157125,NaN,NaN,50
1650643200,1.0789,1.0792,1.07763,1.0778,3259,5626.4,-576403,-578566.4,20.206547883850426,32.779359476783924,39.46056967888923,NaN,NaN,50
1650645000,1.0778,1.07857,1.0778,1.07794,3313,5537.15,-573090,-577574.4,20.566010534863782,33.72964967657103,39.44881943299632,NaN,NaN,50
1650646800,1.07794,1.0787,1.07784,1.07862,2377,5243.1,-570713,-574368.4,20.766051665952226,38.29270440606582,39.808948635066066,NaN,NaN,50
1650648600,1.07862,1.07952,1.0786,1.07878,3402,5127.9,-567311,-572132.2,20.139377020343783,39.35087743240837,39.54910073851739,NaN,NaN,50
1650650400,1.07878,1.07954,1.07864,1.07926,3604,5001.55,-563707,-570244.8,19.538139533678294,42.53458145275562,39.227130263535635,NaN,NaN,50
1650652200,1.07926,1.07951,1.07848,1.07862,3598,4921.6,-567305,-568425.2,19.108411128423715,39.553227682297525,38.69671356646875,NaN,NaN,50
1650654000,1.07862,1.07952,1.07862,1.07944,3605,4869,-563700,-566547.2,18.698265038437427,44.88374783375357,38.70855645317097,NaN,NaN,50
1650655800,1.07944,1.08004,1.07905,1.07932,3016,4818.7,-566716,-565747.8,17.740257963319266,44.26850941167049,38.60750568770637,NaN,NaN,50
1650657600,1.07932,1.08006,1.0791,1.08001,1756,4749.9,-564960,-565277.6,16.828543297356326,48.62890310659953,38.43440609276034,NaN,NaN,50
1650659400,1.08001,1.08024,1.07967,1.07974,1137,4638.05,-566097,-565755.6,15.773961141549206,47.07676274729443,39.010626018063746,NaN,NaN,50
1650834000,1.07974,1.08108,1.07974,1.08081,689,4495.05,-565408,-565376.2,15.391741606318748,53.421668076558625,40.231635187769996,NaN,NaN,50
1650835800,1.08081,1.08086,1.08025,1.0806,222,4355,-565630,-565762.2,15.036823466461893,52.101440867093714,41.95513315334135,NaN,NaN,50
1650837600,1.0806,1.08158,1.07998,1.08006,3565,4304.1,-569195,-566258,15.401062955322816,48.764171709074816,42.99964749077775,NaN,NaN,50
1650839400,1.08006,1.08072,1.07962,1.08066,2490,4200.45,-566705,-566607,15.265889135956437,52.41158452285784,44.128370600127525,NaN,NaN,50
1650841200,1.08066,1.08113,1.08042,1.08101,1768,3918.05,-564937,-566375,15.53189242070993,54.44868995569949,45.67617992005006,NaN,NaN,50
1650843000,1.08101,1.08123,1.08074,1.08096,1948,3493.85,-566885,-566670.4,15.873639798725542,54.09245576136202,47.130666068963706,NaN,NaN,50
1650844800,1.08096,1.08122,1.08002,1.08055,4063,3305.2,-570948,-567734,15.222813771266816,51.13791669745019,48.048181232634015,NaN,NaN,50
1650846600,1.08055,1.08104,1.08005,1.08021,3457,3043.4,-574405,-568776,14.618475317197998,48.759478695108456,48.72022417996974,NaN,NaN,50
1650848400,1.08021,1.08046,1.07964,1.07989,4017,2831.7,-578422,-571119.4,13.619368017413198,46.56435913926708,49.00806544329198,NaN,NaN,50
1650850200,1.07989,1.07998,1.07838,1.07872,4829,2805.75,-583251,-574782.2,14.015007491381375,39.553042404630666,49.00805220917293,NaN,NaN,50
1650852000,1.07872,1.0789,1.07805,1.07818,3426,2814.1,-586677,-578740.6,14.670882463609097,36.79897680100003,48.430568563976244,NaN,NaN,50
1650853800,1.07818,1.07844,1.07774,1.07814,3566,2826.75,-590243,-582599.6,15.543845352127022,36.595705798634526,47.8825111630451,NaN,NaN,50
1650855600,1.07814,1.07882,1.07802,1.07882,2407,2828.25,-587836,-585285.8,15.813174058935639,42.41880226273084,47.4389325313402,NaN,NaN,50
1650857400,1.07882,1.07886,1.07814,1.07814,1879,2752.1,-589715,-587544.4,16.005957669990806,38.600959040509615,46.83351798085557,NaN,NaN,50
1650859200,1.07814,1.07855,1.07814,1.0784,1622,2653,-588093,-588512.8,16.184971023113462,40.79510942423,45.931620934260664,NaN,NaN,50
1650861000,1.0784,1.07842,1.07722,1.07742,2460,2596.1,-590553,-589288,17.23643212783383,35.62710634495912,44.7548827541082,NaN,NaN,50
1650862800,1.07742,1.07765,1.07722,1.07749,2296,2530.65,-588257,-588890.8,18.212788867931312,36.24835109426575,43.86089556733612,NaN,NaN,50
1650864600,1.07749,1.07789,1.07684,1.07758,3470,2553.35,-584787,-588281,19.454551427000943,37.08900150666111,42.766425351893496,NaN,NaN,50
1650866400,1.07758,1.07779,1.07218,1.07242,10984,3014.75,-595771,-589492.2,22.782588978156678,20.444043998737143,40.33752206925333,NaN,NaN,50
1650868200,1.07242,1.073,1.07069,1.07146,10380,3476.9,-606151,-593103.8,26.212461822231376,18.757425019467135,37.81359130197512,NaN,NaN,50
1650870000,1.07146,1.07366,1.07136,1.07328,11808,4032.85,-594343,-593861.8,28.633536943989146,30.46895815014068,36.33723712002445,NaN,NaN,50
1650871800,1.07328,1.07412,1.07288,1.07385,6668,4355.15,-587675,-593745.4,30.368390618819674,33.69283668918007,35.26104840531527,NaN,NaN,50
1650873600,1.07385,1.07524,1.07337,1.07493,7013,4527.55,-580662,-592920.4,30.829206932556097,39.42389542640374,34.75101528296789,NaN,NaN,50
1650875400,1.07493,1.07546,1.0738,1.0745,5783,4692.2,-586445,-591055.2,31.044173540592627,38.01506246888219,34.64115957327157,NaN,NaN,50
1650877200,1.0745,1.07492,1.07358,1.07418,5041,4855.85,-591486,-588122.2,31.35213123040535,36.95664093973447,34.652421297466894,NaN,NaN,50
1650879000,1.07418,1.07465,1.07302,1.07308,4524,4984.65,-596010,-588455.6,31.91112715746285,33.50345515601609,34.43154625156557,NaN,NaN,50
1650880800,1.07308,1.07367,1.0724,1.07292,4620,5012.5,-600630,-591046.6,32.71631498397542,33.02015323754695,33.76021417833815,NaN,NaN,50
1650882600,1.07292,1.07354,1.07198,1.07242,4773,5078.3,-605403,-595994.8,33.650036411724216,31.491338881783932,33.252384167000606,NaN,NaN,50
1650884400,1.07242,1.07476,1.072,1.07364,7775,5266.2,-597628,-598231.4,33.210991210354464,38.92211485913996,33.11859884092274,NaN,NaN,50
1650886200,1.07364,1.07525,1.07318,1.07496,9237,5486.6,-588391,-597612.4,32.33466177193946,45.77519024524921,33.84346197665775,NaN,NaN,50
1650888000,1.07496,1.07584,1.07418,1.0744,11081,5869.35,-599472,-598304.8,30.980560844241474,43.543061411820155,34.36451271362593,NaN,NaN,50
1650889800,1.0744,1.07464,1.07322,1.07429,7756,6078.85,-607228,-599624.4,30.334371371315843,43.09849105008927,34.79376196672794,NaN,NaN,50
1650891600,1.07429,1.07438,1.07251,1.07257,6371,6277.05,-613599,-601263.6,30.141050608952042,36.77577317902245,35.96031405103403,NaN,NaN,50
1650893400,1.07257,1.07296,1.07156,1.07227,10466,6706.4,-624065,-606551,30.453175435379265,35.78954942125027,37.17689436544712,NaN,NaN,50
1650895200,1.07227,1.0729,1.07094,1.07149,9843,7117.45,-633908,-615654.4,31.03609178960643,33.289872870515566,37.37838827404532,NaN,NaN,50
1650897000,1.07149,1.072,1.0697,1.07072,9550,7471.95,-643458,-624451.6,32.09872609859171,30.98888493982389,37.18524886337702,NaN,NaN,50
1650898800,1.07072,1.07166,1.0704,1.07084,7677,7741,-635781,-630162.2,33.085457956935194,31.780269202260413,36.63927556165249,NaN,NaN,50
1650900600,1.07084,1.07092,1.06988,1.0703,6864,7910.7,-642645,-635971.4,34.21290848237227,30.107119616947713,36.07442250080003,NaN,NaN,50
1650902400,1.0703,1.07185,1.06968,1.0711,5279,7625.45,-637366,-638631.6,34.24686315028674,35.52292945068265,35.97201453729633,NaN,NaN,50
1650904200,1.0711,1.07189,1.07092,1.07153,4481,7330.5,-632885,-638427,34.236128853713524,38.29078634439508,36.313966765037684,NaN,NaN,50
1650906000,1.07153,1.07186,1.07088,1.0716,4063,6943.25,-628822,-635499.8,34.2483269108246,38.75172851136197,36.723364998881614,NaN,NaN,50
1650907800,1.0716,1.07186,1.07122,1.07132,3269,6773.3,-632091,-634761.8,34.25965367814203,37.5436973374532,37.15567631714371,NaN,NaN,50
1650909600,1.07132,1.07166,1.07098,1.0715,3899,6617.6,-628192,-631871.2,34.4188158882061,38.863136511776666,37.15146357804633,NaN,NaN,50
1650911400,1.0715,1.0719,1.07096,1.07096,3368,6496.85,-631560,-630710,34.2445180326226,36.380100941117036,36.480385770608315,NaN,NaN,50
1650913200,1.07096,1.07178,1.07048,1.07172,3125,6401.05,-628435,-629820,34.40543840019236,41.99704063403164,36.369955715051994,NaN,NaN,50
1650915000,1.07172,1.07184,1.0713,1.07137,2555,6302.6,-630990,-630253.6,34.468447634086544,40.23525649807262,36.16543896133652,NaN,NaN,50
1650916800,1.07137,1.07151,1.07094,1.07128,1139,6128.55,-632129,-630261.2,34.777342800836124,39.77321198208983,36.37954173298419,NaN,NaN,50
1650918600,1.07128,1.07132,1.07098,1.07111,554,5917.6,-632683,-631159.4,35.0641740271036,38.865327745928994,36.599240184746954,NaN,NaN,50
1650920400,1.07111,1.07134,1.07111,1.07134,119,5534.8,-632564,-631360.2,35.29603672727596,40.833132411687274,37.13804443768779,NaN,NaN,50
1650922200,1.07134,1.07136,1.07124,1.07127,235,5084.7,-632799,-632233,35.474472105881496,40.40684333061538,37.81075575131575,NaN,NaN,50
1650924000,1.07127,1.0714,1.07106,1.07122,1096,4585.45,-633895,-632814,35.79525664617572,40.08493711232277,38.403946316320216,NaN,NaN,50
1650925800,1.07122,1.0715,1.07098,1.07132,1225,4258.9,-632670,-632922.2,35.8886145035501,41.09566987344259,39.1888427632127,NaN,NaN,50
1650927600,1.07132,1.07134,1.07072,1.07077,1521,4016.4,-634191,-633223.8,36.21869520784175,37.362454111106466,39.3202373818144,NaN,NaN,50
1650929400,1.07077,1.07146,1.0707,1.07126,1696,3577.9,-632495,-633210,36.262032962968696,42.38411453555035,39.61261796689691,NaN,NaN,50
1650931200,1.07126,1.07249,1.07116,1.07248,3811,3276.3,-628684,-632387,34.39559894270213,52.5780223728337,40.60021038557347,NaN,NaN,50
1650933000,1.07248,1.07316,1.07226,1.07304,4340,3015.8,-624344,-630476.8,32.160888852982275,56.39199491009138,41.946517355047625,NaN,NaN,50
1650934800,1.07304,1.07338,1.07206,1.07238,3883,2826.1,-628227,-629588.2,30.36804805374887,51.16871824125522,42.82548747858181,NaN,NaN,50
1650936600,1.07238,1.07318,1.0723,1.0725,4013,2683.55,-624214,-627592.8,28.703267311603557,52.03855906885592,43.9439487734203,NaN,NaN,50
1650938400,1.0725,1.07308,1.0724,1.07304,3027,2570.95,-621187,-625331.2,27.15739947961148,55.84984146285126,44.933434546907414,NaN,NaN,50
1650940200,1.07304,1.07317,1.07252,1.07298,3285,2511.15,-624472,-624488.8,25.85745838080799,55.323784274486414,46.011186530936975,NaN,NaN,50
1650942000,1.07298,1.0737,1.07296,1.07368,3800,2498,-620672,-623754.4,25.395714280406473,60.051418331406865,47.45962984160248,NaN,NaN,50
1650943800,1.07368,1.07387,1.07312,1.0732,3356,2502.35,-624028,-622914.6,25.186224130919882,55.69888732608922,48.66202695447107,NaN,NaN,50
1650945600,1.0732,1.07334,1.07288,1.07294,2313,2423.05,-626341,-623340,24.51293802765437,53.439464580946904,49.56247925227532,NaN,NaN,50
1650947400,1.07294,1.07309,1.07264,1.07281,1610,2335.15,-627951,-624692.8,23.42750325551702,52.29715523480981,50.41178724543207,NaN,NaN,50
1650949200,1.07281,1.07286,1.07225,1.07253,1529,2255.35,-629480,-625694.4,21.781699943099557,49.82666677413262,51.10762507841849,NaN,NaN,50
1650951000,1.07253,1.07338,1.07246,1.07316,2615,2258.35,-626865,-626933,21.00885333039928,54.97988533570996,52.09935475429472,NaN,NaN,50
1650952800,1.07316,1.07346,1.07074,1.07148,6061,2504.45,-632926,-628712.6,21.000571477177683,42.456912627289725,52.463244648307814,NaN,NaN,50
1650954600,1.07148,1.07159,1.07005,1.07038,5630,2758.25,-638556,-631155.6,21.6163542526398,36.581560283248294,52.048776487429095,NaN,NaN,50
1650956400,1.07038,1.07112,1.06824,1.06914,9602,3232.4,-648158,-635197,23.38274541529505,31.319933693345618,50.53034158175137,NaN,NaN,50
1650958200,1.06914,1.06988,1.06754,1.06762,7418,3591.55,-655576,-640416.2,25.36811039649872,26.322069836635563,48.382489790790245,NaN,NaN,50
1650960000,1.06762,1.06922,1.06726,1.06898,6320,3852.75,-649256,-644894.4,27.341899131097335,36.141030055523736,47.309083491809425,NaN,NaN,50
1650961800,1.06898,1.06922,1.06784,1.0681,5180,4050.5,-654436,-649196.4,29.174702956081767,33.069956912797764,45.95418333780527,NaN,NaN,50
1650963600,1.0681,1.06954,1.06807,1.0695,4877,4218.3,-649559,-651397,30.361142420193993,41.575716027502985,44.934602949566106,NaN,NaN,50
1650965400,1.0695,1.0697,1.06845,1.06866,3939,4330.45,-653498,-652465,31.20492695218392,38.42075631330182,43.727243809481486,NaN,NaN,50
1650967200,1.06866,1.0691,1.0679,1.06892,3532,4316.5,-649966,-651343,32.33534235325625,39.93996831574605,42.29071166550572,NaN,NaN,50
1650969000,1.06892,1.06974,1.06862,1.06897,3438,4271.4,-646528,-650797.4,32.3849355239639,40.2452759172019,41.18688227915662,NaN,NaN,50
1650970800,1.06897,1.0694,1.06816,1.06862,4304,4292.45,-650832,-650076.6,32.75937234566685,38.75996240835206,40.13834640968556,NaN,NaN,50
1650972600,1.06862,1.06871,1.06692,1.0671,4139,4298.75,-654971,-651159,33.8473910637799,33.05446423148713,38.7638684808768,NaN,NaN,50
1650974400,1.0671,1.06772,1.06704,1.06744,4284,4361.6,-650687,-650596.8,34.85769415917059,35.34701426177949,37.729607587137295,NaN,NaN,50
1650976200,1.06744,1.06839,1.06701,1.06791,6093,4502,-644594,-649522.4,34.798897915681955,38.483150427886905,36.551269379435645,NaN,NaN,50
1650978000,1.06791,1.06832,1.06638,1.06816,5977,4610.85,-638617,-647940.2,35.15505728771174,40.1462733712171,36.3862237182876,NaN,NaN,50
1650979800,1.06816,1.06854,1.06725,1.06747,6417,4763.9,-645034,-646780.6,35.16883052367995,37.16018980248701,36.42755439823322,NaN,NaN,50
1650981600,1.06747,1.06776,1.06628,1.06766,5888,4942.65,-639146,-643615.6,35.78650014136265,38.51633338392173,36.941582947560086,NaN,NaN,50
1650983400,1.06766,1.06766,1.06418,1.06503,11225,5423.4,-650371,-643552.4,37.29889029792464,29.14140227304604,37.14296383587513,NaN,NaN,50
1650985200,1.06503,1.06635,1.06472,1.06614,6370,5665.45,-644001,-643433.8,38.70325258616077,36.19966793892005,37.14715225611773,NaN,NaN,50
1650987000,1.06614,1.06635,1.06552,1.06592,4090,5739.2,-648091,-645328.6,40.00730328238004,35.44603903933832,37.316872408013474,NaN,NaN,50
1650988800,1.06592,1.0665,1.06562,1.06646,3919,5632.1,-644172,-645156.2,40.989002211530384,38.81321898119902,37.11955119042034,NaN,NaN,50
1650990600,1.06646,1.06648,1.06538,1.06592,3417,5521.45,-647589,-646844.8,42.012990212962954,36.74891956860705,37.00013428008499,NaN,NaN,50
1650992400,1.06592,1.06617,1.06518,1.06552,2967,5189.7,-650556,-646881.8,43.05839693834789,35.253225404415716,36.66536692927569,NaN,NaN,50
1650994200,1.06552,1.0657,1.06458,1.06468,2207,4929.15,-652763,-648634.2,44.29968118060991,32.28183062110425,36.09654940812585,NaN,NaN,50
1650996000,1.06468,1.06512,1.06438,1.06508,2496,4737.95,-650267,-649069.4,45.538241545476495,35.0876159945978,35.834238950000554,NaN,NaN,50
1650997800,1.06508,1.06508,1.06406,1.06448,2886,4623.25,-653153,-650865.6,46.82476133918976,32.886500447469004,35.8222415368564,NaN,NaN,50
1650999600,1.06448,1.06477,1.06395,1.064,2586,4508.7,-655739,-652495.6,48.066508264507576,31.200251302679604,35.52604418263498,NaN,NaN,50
1651001400,1.064,1.06451,1.06383,1.0644,2569,4440.2,-653170,-653018.4,49.27278474985998,34.22685878857183,35.22202335125534,NaN,NaN,50
1651003200,1.0644,1.06441,1.06376,1.06394,1584,4342.8,-654754,-653416.6,50.42521649023527,32.4584620243221,34.67289396933426,NaN,NaN,50
1651005000,1.06394,1.064,1.06358,1.06368,926,4217.2,-655680,-654499.2,51.58062258610141,31.468786424259847,34.266365156603754,NaN,NaN,50
1651006800,1.06368,1.06396,1.06356,1.0638,426,4023.3,-655254,-654919.4,52.66331261652297,32.491875736538006,33.8360467532192,NaN,NaN,50
1651008600,1.0638,1.064,1.0638,1.06392,208,3826.75,-655046,-654780.8,53.564079177330115,33.560042727734185,34.151663928554065,NaN,NaN,50
1651010400,1.06392,1.0643,1.06352,1.06386,2178,3721.45,-657224,-655591.6,53.61862817897498,33.27652788201861,33.94286821020396,NaN,NaN,50
1651012200,1.06386,1.06459,1.06383,1.06448,1316,3482.6,-655908,-655822.4,52.958259470423286,39.01023351701201,34.1974535300378,NaN,NaN,50
1651014000,1.06448,1.06473,1.06438,1.0647,1587,3263.1,-654321,-655550.6,52.01046757746164,40.94932066486924,34.35003222172852,NaN,NaN,50
1651015800,1.0647,1.0648,1.06424,1.06428,1840,3034.25,-656161,-655732,51.27581810765821,38.4368584739856,34.47059928639842,NaN,NaN,50
1651017600,1.06428,1.06468,1.0638,1.06396,2544,2867.05,-658705,-656463.8,51.02051361140013,36.59458123457576,34.56641041712414,NaN,NaN,50
1651019400,1.06396,1.06436,1.06349,1.06436,2745,2443.05,-655960,-656211,51.05312981187616,40.437612319710425,35.148966252738866,NaN,NaN,50
1651021200,1.06436,1.06451,1.06385,1.06404,3099,2279.5,-659059,-656841.2,50.691141121021154,38.43082257617424,35.38776672285147,NaN,NaN,50
1651023000,1.06404,1.0647,1.0636,1.06469,4564,2303.2,-654495,-656876,50.59073589527745,44.46015330182906,36.21445621244862,NaN,NaN,50
1651024800,1.06469,1.06536,1.06456,1.06473,3536,2284.05,-650959,-655835.6,48.91936648430323,44.818276401662025,37.187172290947366,NaN,NaN,50
1651026600,1.06473,1.06487,1.06342,1.06347,3004,2263.4,-653963,-654887.2,48.49002718326575,36.77435285265474,37.36913615266757,NaN,NaN,50
1651028400,1.06347,1.06426,1.06338,1.06408,3502,2290.15,-650461,-653787.4,48.124349629988245,42.184408475914914,38.06384661349563,NaN,NaN,50
1651030200,1.06408,1.06441,1.06392,1.06408,2052,2282.4,-650461,-652067.8,47.460761925899185,42.184408475914914,38.829248188613846,NaN,NaN,50
1651032000,1.06408,1.0642,1.06378,1.06417,2021,2258.65,-648440,-650856.8,46.97923964953105,43.01870948554542,39.58116488497152,NaN,NaN,50
1651033800,1.06417,1.06504,1.06417,1.06498,2145,2221.6,-646295,-649924,44.86271056066739,50.01043466179811,40.7561928802618,NaN,NaN,50
1651035600,1.06498,1.06542,1.06474,1.06536,2486,2216.6,-643809,-647893.2,42.269911527452045,52.92848959443269,42.15990443114852,NaN,NaN,50
1651037400,1.06536,1.06548,1.06476,1.06506,2755,2225.9,-646564,-647113.8,39.764847668110626,50.42589743101961,42.97530899643478,NaN,NaN,50
1651039200,1.06506,1.06518,1.06212,1.06241,8505,2571.95,-655069,-648035.4,39.912941664986974,34.781516165101465,42.53475153216566,NaN,NaN,50
1651041000,1.06241,1.06323,1.06163,1.06207,7444,2897.85,-662513,-650850,40.338894556478785,33.3518254678213,42.1715348888682,NaN,NaN,50
1651042800,1.06207,1.06288,1.05883,1.05884,10048,3378.95,-672561,-656103.2,41.891720952036266,23.47835973705834,41.23466192475981,NaN,NaN,50
1651044600,1.05884,1.06245,1.05882,1.0624,7900,3763.55,-664661,-660273.6,43.336746267033796,43.37536071095705,41.44450109556315,NaN,NaN,50
1651046400,1.0624,1.0625,1.06112,1.06128,5535,3931.4,-670196,-665000,44.607286512887356,39.86354308006704,41.54683827441262,NaN,NaN,50
1651048200,1.06128,1.06148,1.05856,1.05886,6410,4186.1,-676606,-669307.4,46.49063003104143,33.5439993540969,40.767112992431755,NaN,NaN,50
1651050000,1.05886,1.06162,1.0586,1.06136,7610,4487.25,-668996,-670604,48.059896645796364,43.50746087737586,40.673483312125605,NaN,NaN,50
1651051800,1.06136,1.06209,1.0606,1.06132,4564,4623.45,-673560,-670803.8,48.90974829111258,43.39535613906062,41.14641211829745,NaN,NaN,50
1651053600,1.06132,1.06228,1.06056,1.06228,4701,4731.3,-668859,-671643.4,49.45323904535155,46.929691594357884,41.48536091247195,NaN,NaN,50
1651055400,1.06228,1.06228,1.06036,1.06104,6133,4900.7,-674992,-672602.6,50.031806610754316,43.17938087224244,41.55643036935248,NaN,NaN,50
1651057200,1.06104,1.0611,1.05927,1.05934,5301,5010.8,-680293,-673340,50.94056798656379,38.622460792321434,41.242412605550776,NaN,NaN,50
1651059000,1.05934,1.0595,1.05807,1.05846,6136,5089.4,-686429,-676826.6,52.121891027166576,36.47647754203756,40.27570138271073,NaN,NaN,50
1651060800,1.05846,1.0586,1.05715,1.05738,7813,5303.25,-694242,-680963,53.43905631233643,33.981028675166314,38.922311317048845,NaN,NaN,50
1651062600,1.05738,1.0574,1.05451,1.05553,8329,5569.5,-702571,-687705.4,55.13858635371985,30.173103380428344,37.475683170578044,NaN,NaN,50
1651064400,1.05553,1.05612,1.05334,1.0539,7166,5752.7,-709737,-694654.4,56.87542843133902,27.273169663193457,36.93937270615604,NaN,NaN,50
1651066200,1.0539,1.05568,1.05388,1.05482,10263,6163.25,-699474,-698490.6,58.488210360556806,31.28728726250162,36.79190569149034,NaN,NaN,50
1651068000,1.05482,1.0554,1.05344,1.05344,8990,6511.7,-708464,-702897.6,60.04570824328441,28.726063675045637,37.166741687060856,NaN,NaN,50
1651069800,1.05344,1.05396,1.05148,1.05148,9751,6892,-718215,-707692.2,61.72249327986331,25.52949868729739,35.892037256799455,NaN,NaN,50
1651071600,1.05148,1.05454,1.05146,1.05428,8607,7198.05,-709608,-709099.6,62.629272669907756,36.4150065046838,35.64571321570066,NaN,NaN,50
1651073400,1.05428,1.05543,1.05427,1.05454,5558,7338.2,-704050,-707962.2,62.52742472024916,37.33105153777446,35.91621694310619,NaN,NaN,50
1651075200,1.05454,1.0566,1.05454,1.05634,4117,7118.8,-699933,-708054,61.3174714717245,43.40945988416426,35.9092168721625,NaN,NaN,50
1651077000,1.05634,1.05713,1.05602,1.05632,3429,6918.05,-703362,-707033.6,59.72470174335278,43.35913760825553,35.90662983424785,NaN,NaN,50
1651078800,1.05632,1.057,1.05584,1.05689,4343,6632.8,-699019,-703194.4,58.31642089509374,45.30517712956356,35.79059308676255,NaN,NaN,50
1651080600,1.05689,1.05724,1.05646,1.05704,2851,6380.35,-696168,-700506.4,56.78090022071333,45.832602306560545,35.980108903499556,NaN,NaN,50
1651082400,1.05704,1.05724,1.05599,1.05613,3079,6257.55,-699247,-699545.8,55.561947313563934,43.11622447193547,36.30109202347199,NaN,NaN,50
1651084200,1.05613,1.05661,1.05559,1.05608,3673,6120.7,-702920,-700143.2,54.603693128638284,42.96554666218906,36.76459696062567,NaN,NaN,50
1651086000,1.05608,1.05622,1.0555,1.05552,3257,5903.05,-706177,-700706.2,53.75387058598449,41.227742491423086,37.28221937607258,NaN,NaN,50
1651087800,1.05552,1.05588,1.05536,1.05584,3143,5832,-703034,-701509.2,53.03002670795107,42.65506525110634,38.17378808112101,NaN,NaN,50
1651089600,1.05584,1.05604,1.05575,1.05602,1266,5660.25,-701768,-702629.2,52.16037047684926,43.48646427032087,39.33188055305868,NaN,NaN,50
1651091400,1.05602,1.05609,1.0556,1.05586,804,5393.8,-702572,-703294.2,51.43338895098301,42.891193257735786,40.160730981289696,NaN,NaN,50
1651093200,1.05586,1.0563,1.05539,1.05569,428,5150.15,-703000,-703310.2,50.758334676964346,42.22974973758416,41.12527998575673,NaN,NaN,50
1651095000,1.05569,1.05577,1.05526,1.05557,694,4878.05,-703694,-702813.6,50.2094304986482,41.740423507248245,42.28320318718179,NaN,NaN,50
1651096800,1.05557,1.05578,1.05518,1.05532,2112,4593,-705806,-703368,49.74978591577404,40.682792462478595,42.58804504130999,NaN,NaN,50
1651098600,1.05532,1.05536,1.05501,1.05511,722,4212.65,-706528,-704320,49.43300598045659,39.77118096171714,42.762340000163036,NaN,NaN,50
1651100400,1.05511,1.05539,1.05496,1.05498,967,3902.7,-707495,-705304.6,49.17245872858943,39.1858027822199,42.46065020716701,NaN,NaN,50
1651102200,1.05498,1.05564,1.05496,1.05544,1093,3444.2,-706402,-705985,48.46947708915441,42.41557743305562,42.39325305179558,NaN,NaN,50
1651104000,1.05544,1.05544,1.05465,1.05468,2305,3109.95,-708707,-706987.6,48.05862063619585,38.75356859748613,41.92528101379006,NaN,NaN,50
1651105800,1.05468,1.05494,1.05308,1.05384,3704,2807.6,-712411,-708308.6,48.63210514923857,35.142188613996666,41.16168003574978,NaN,NaN,50
1651107600,1.05384,1.05536,1.05384,1.05438,4194,2586.95,-708217,-708646.4,48.46217252774551,39.072899946263924,40.87287114105896,NaN,NaN,50
1651109400,1.05438,1.05479,1.05351,1.0547,3410,2479.55,-704807,-708108.8,48.49868833963394,41.341614558465075,40.756875990792956,NaN,NaN,50
1651111200,1.0547,1.05476,1.05336,1.05344,2653,2406.35,-707460,-708320.4,48.62071535397119,35.70404366942836,40.362326074936185,NaN,NaN,50
1651113000,1.05344,1.05432,1.05326,1.05368,2703,2370.05,-704757,-707530.4,48.794708532212255,37.45361704792173,39.990794060423006,NaN,NaN,50
1651114800,1.05368,1.05408,1.05154,1.05298,8531,2579.45,-713288,-707705.8,49.795799969922086,34.50447677804358,39.34922352526034,NaN,NaN,50
1651116600,1.05298,1.05314,1.05091,1.05092,5615,2717.65,-718903,-709843,50.95524221802407,27.61354828028111,38.257963169727866,NaN,NaN,50
1651118400,1.05092,1.0516,1.05088,1.05109,2735,2700.45,-716168,-712115.2,52.04258718824849,28.875914535980314,37.304117798184734,NaN,NaN,50
1651120200,1.05109,1.05269,1.05099,1.05176,2961,2664.85,-713207,-713264.6,51.30285165677546,33.777580343866774,36.73534328651463,NaN,NaN,50
1651122000,1.05176,1.05196,1.05008,1.05012,3747,2689.35,-716954,-715704,51.10331128215726,28.58463873378679,35.87118944875092,NaN,NaN,50
1651123800,1.05012,1.0526,1.04814,1.05123,10381,3051.25,-706573,-714361,51.69680679224338,35.78098955541816,35.58617577687242,NaN,NaN,50
1651125600,1.05123,1.05224,1.05066,1.05154,8737,3424.8,-697836,-710147.6,52.247909765894775,37.67002894243513,35.477906216887796,NaN,NaN,50
1651127400,1.05154,1.05309,1.05108,1.05247,8951,3832.15,-688885,-704691,51.65349871287594,43.07946868420964,35.52532702054165,NaN,NaN,50
1651129200,1.05247,1.05434,1.05152,1.05325,12529,4437.2,-676356,-697320.8,49.730794828038114,47.21703954462231,36.12986065962281,NaN,NaN,50
1651131000,1.05325,1.0565,1.05314,1.0555,10975,4951.25,-665381,-687006.2,46.183008926494054,56.94044937748698,37.68687928558641,NaN,NaN,50
1651132800,1.0555,1.05562,1.0528,1.05435,6822,5186.75,-672203,-680132.2,43.11281742511533,51.69839071928241,38.58870005508772,NaN,NaN,50
1651134600,1.05435,1.05438,1.05148,1.0516,5111,5406.2,-677314,-676027.8,41.091322108879176,41.790557494164005,38.620767407637636,NaN,NaN,50
1651136400,1.0516,1.05345,1.05138,1.05326,5811,5648.4,-671503,-672551.4,39.27319169820645,48.23912631434727,39.516130453703276,NaN,NaN,50
1651138200,1.05326,1.05388,1.05167,1.05203,7088,5948.15,-678591,-672998.4,37.230150997953494,44.32114320126923,40.00666803608524,NaN,NaN,50
1651140000,1.05203,1.05298,1.051,1.05157,5529,6109.35,-684120,-676746.2,35.762002226897685,42.91725518014762,40.60758077909268,NaN,NaN,50
1651141800,1.05157,1.05185,1.04966,1.04974,5927,6220.5,-690047,-680315,35.15151864657226,37.789049615707256,41.33440230305168,NaN,NaN,50
1651143600,1.04974,1.05098,1.04927,1.05046,6110,6316.3,-683937,-681639.6,34.78288892879801,40.78694875915741,42.18519046185005,NaN,NaN,50
1651145400,1.05046,1.0507,1.04863,1.04905,6550,6473.3,-690487,-685436.4,34.75630887198705,37.02418471326971,42.41709077395026,NaN,NaN,50
1651147200,1.04905,1.04998,1.04713,1.04858,8685,6774.9,-699172,-689552.6,35.37558396158746,35.83736363641708,42.935142552709564,NaN,NaN,50
1651149000,1.04858,1.05244,1.04818,1.04858,15176,7398.55,-699172,-692563,33.949413604705484,35.83736363641708,42.939169272780916,NaN,NaN,50
1651150800,1.04858,1.0513,1.04816,1.05036,9390,7441.5,-689782,-692510,32.6354288882029,43.75627262994825,43.37390096474614,NaN,NaN,50
1651152600,1.05036,1.05142,1.04964,1.05086,8656,7593.55,-681126,-691947.8,31.325235121711092,45.7805631422809,43.566836283179796,NaN,NaN,50
1651154400,1.05086,1.05188,1.04983,1.05076,9780,7945.8,-690906,-692031.6,29.756728369477674,45.428402442096406,43.439076490142234,NaN,NaN,50
1651156200,1.05076,1.05202,1.04815,1.05153,13295,8462.5,-677611,-687719.4,29.238708500308725,48.70065620962231,42.850519835294755,NaN,NaN,50
1651158000,1.05153,1.05314,1.05117,1.0521,10002,8775.25,-667609,-681406.8,27.9328531695089,51.04101029822469,42.80356409093349,NaN,NaN,50
1651159800,1.0521,1.05238,1.0497,1.04999,6533,8582.85,-674142,-678278.8,27.46806405498321,43.186638667266784,42.90328417472655,NaN,NaN,50
1651161600,1.04999,1.05069,1.04936,1.04985,4912,8391.6,-679054,-677864.4,27.196161097674683,42.716936518396004,42.508842046444315,NaN,NaN,50
1651163400,1.04985,1.05154,1.04966,1.05127,4687,8178.4,-674367,-674556.6,26.315197483841207,48.799571205274326,42.828729761016106,NaN,NaN,50
1651165200,1.05127,1.05158,1.05069,1.05079,4994,7801.65,-679361,-674906.6,25.46768168957633,46.983437320411596,43.11917134246353,NaN,NaN,50
1651167000,1.05079,1.0509,1.04972,1.04995,3808,7443.3,-683169,-678018.6,25.20489153484232,43.90408409212837,43.55595951935076,NaN,NaN,50
1651168800,1.04995,1.05101,1.04978,1.05082,2506,7227.5,-680663,-679322.8,24.870683041340815,47.72554061062539,44.051573223027034,NaN,NaN,50
1651170600,1.05082,1.05106,1.05014,1.05046,2426,7093.25,-683089,-680129.8,24.516876412604322,46.31940067734387,44.71551722046091,NaN,NaN,50
1651172400,1.05046,1.05108,1.05037,1.05064,2294,6917.4,-680795,-681415.4,24.169751063748816,47.15772844567875,45.52411470683675,NaN,NaN,50
1651174200,1.05064,1.051,1.05034,1.05098,2536,6689.8,-678259,-681195,23.867470416003368,48.784726695496545,46.44892635391385,NaN,NaN,50
1651176000,1.05098,1.05101,1.05034,1.05044,1311,6478.9,-679570,-680475.2,23.576050174844777,46.34410945625821,46.63377184150742,NaN,NaN,50
1651177800,1.05044,1.05066,1.04985,1.0499,814,6223.25,-680384,-680419.4,23.66067724198189,43.97489024347469,46.5047952058784,NaN,NaN,50
1651179600,1.0499,1.05034,1.04974,1.04992,229,5929.2,-680155,-679832.6,23.818625399039746,44.088896762537885,46.409116228767076,NaN,NaN,50
1651181400,1.04992,1.0501,1.04983,1.05001,323,5617.85,-679832,-679640,23.965291544879186,44.63488137306178,46.118703740441326,NaN,NaN,50
1651183200,1.05001,1.0502,1.0498,1.04996,1886,5277.9,-681718,-680331.8,23.963638279319227,44.37561932627501,45.64260438530206,NaN,NaN,50
1651185000,1.04996,1.05011,1.04914,1.04971,1080,4573.1,-682798,-680977.4,24.49594030935827,43.029794545898426,45.63140123377575,NaN,NaN,50
1651186800,1.04971,1.04999,1.04951,1.0499,1190,4163.1,-681608,-681222.2,24.9902207658231,44.409675369195476,45.75231115168999,NaN,NaN,50
1651188600,1.0499,1.05036,1.04986,1.05031,1091,3784.85,-680517,-681294.6,24.88550100037721,47.37195446842816,45.65033852762955,NaN,NaN,50
1651190400,1.05031,1.05163,1.05022,1.05129,3029,3447.3,-677488,-680825.8,23.18549203535766,53.720089767675155,46.13152798814838,NaN,NaN,50
1651192200,1.05129,1.05174,1.05066,1.05158,1886,2876.85,-675602,-679602.6,21.57216372644925,55.433244371485515,46.955039436673886,NaN,NaN,50
1651194000,1.05158,1.05298,1.05151,1.05296,3215,2537.5,-672387,-677520.4,21.26860449107125,62.53953528412737,48.0131819133526,NaN,NaN,50
1651195800,1.05296,1.05298,1.05182,1.05191,3113,2366.5,-675500,-676298.8,20.98672805822025,55.31264759011385,48.65555669283617,NaN,NaN,50
1651197600,1.05191,1.05232,1.05136,1.05148,2556,2248.7,-678056,-675806.6,20.15934267402544,52.63040997319797,49.0464625162304,NaN,NaN,50
1651199400,1.05148,1.0517,1.05051,1.05106,2719,2150.3,-680775,-676464,18.973066676226356,50.076126753294275,49.138705377501665,NaN,NaN,50
1651201200,1.05106,1.05155,1.05068,1.05118,2324,2016.8,-678451,-677033.8,17.871524678270063,50.81067412153575,49.45774571073577,NaN,NaN,50
1651203000,1.05118,1.05196,1.05093,1.05134,3066,1979.7,-675385,-677633.4,16.800833132953343,51.82838900480311,50.018709907973516,NaN,NaN,50
1651204800,1.05134,1.05154,1.05088,1.05144,1956,1952.2,-673429,-677219.2,15.747144978053912,52.49000341380004,50.61878895449224,NaN,NaN,50
1651206600,1.05144,1.05209,1.0512,1.05166,1600,1910.9,-671829,-675973.8,15.380813541463864,53.98727005720068,51.28681671764502,NaN,NaN,50
1651208400,1.05166,1.05339,1.05166,1.05304,3950,1993.7,-667879,-673394.6,16.20345072526345,62.063558633873306,52.55024095390204,NaN,NaN,50
1651210200,1.05304,1.05421,1.0529,1.05372,3481,2040.95,-664398,-670584,17.542219673308917,65.29598104547932,54.14068284672929,NaN,NaN,50
1651212000,1.05372,1.05488,1.05312,1.0546,6528,2301.8,-657870,-667081,19.195769163916772,68.97962014615877,55.89567890222667,NaN,NaN,50
1651213800,1.0546,1.05482,1.05394,1.05438,5116,2516.9,-662986,-664992.4,20.731207976624063,67.06313333388673,57.30219167833085,NaN,NaN,50
1651215600,1.05438,1.05591,1.0536,1.05572,6699,2840.4,-656287,-661884,22.76208839990913,72.1403677667745,58.61792582112366,NaN,NaN,50
1651217400,1.05572,1.05788,1.05569,1.0562,7094,3178.95,-649193,-658146.8,25.437832066763573,73.70407182137059,59.92298492468688,NaN,NaN,50
1651219200,1.0562,1.05752,1.0558,1.0575,5236,3346.45,-643957,-654058.6,27.92245118598555,77.40329912639045,60.98468234199139,NaN,NaN,50
1651221000,1.0575,1.0593,1.05657,1.05692,6873,3636.1,-650830,-652650.6,30.757054266056905,72.50273340498835,62.212545614482416,NaN,NaN,50
1651222800,1.05692,1.05762,1.05658,1.05712,5615,3857.35,-645215,-649096.4,33.38918569755173,73.13437451461229,63.677114510297734,NaN,NaN,50
1651224600,1.05712,1.05804,1.05686,1.0578,4659,4035.75,-640556,-645950.2,35.9451690644956,75.21871332708288,65.47301355128263,NaN,NaN,50
1651226400,1.0578,1.05782,1.05615,1.05729,4736,4121.1,-645292,-645170,37.34107994367569,70.78316530307026,66.89962006424939,NaN,NaN,50
1651228200,1.05729,1.05746,1.0563,1.05646,4165,4235.05,-649457,-646270,38.637282902914336,64.15290869201743,67.77994289905041,NaN,NaN,50
1651230000,1.05646,1.05793,1.05546,1.0574,6161,4382.35,-643296,-644763.2,38.731312536482896,67.82833971197795,68.87553834892026,NaN,NaN,50
1651231800,1.0574,1.05762,1.05398,1.05445,7099,4581.65,-650395,-645799.2,37.22558138246112,50.37291907811835,68.61737042184295,NaN,NaN,50
1651233600,1.05445,1.05472,1.05286,1.05298,6139,4760.8,-656534,-648994.8,34.86145946819517,44.260471217927154,67.34572132070393,NaN,NaN,50
1651235400,1.05298,1.05388,1.05096,1.05314,11491,5199.4,-645043,-648945,33.367310605415526,45.04216205162204,65.89901996399985,NaN,NaN,50
1651237200,1.05314,1.05416,1.05227,1.0526,8565,5511.45,-653608,-649775.2,31.761728548456876,42.857630397041184,64.03316355334859,NaN,NaN,50
1651239000,1.0526,1.0537,1.05222,1.05339,7797,5748,-645811,-650278.2,30.303472908076618,46.91399662791249,62.593939502921856,NaN,NaN,50
1651240800,1.05339,1.05388,1.05224,1.05244,6426,5971.5,-652237,-650646.6,28.79433313834331,42.96426575814257,60.509932216591004,NaN,NaN,50
1651242600,1.05244,1.05594,1.05185,1.05467,12079,6495.45,-640158,-647371.4,27.592884188430762,52.97298346852221,59.02914019138755,NaN,NaN,50
1651244400,1.05467,1.05543,1.0533,1.0535,9687,6782.3,-649845,-648331.8,26.477253020654828,48.19445518505167,56.94279419557763,NaN,NaN,50
1651246200,1.0535,1.05463,1.05328,1.05404,5634,6889.95,-644211,-646452.4,25.423901693564932,50.41756129686188,55.36528190214003,NaN,NaN,50
1651248000,1.05404,1.05486,1.05326,1.05419,3971,6762.1,-640240,-645338.2,24.61128153401586,51.04598769863989,53.78753998671343,NaN,NaN,50
1651249800,1.05419,1.05498,1.05392,1.05494,3283,6670.45,-636957,-642282.2,23.94593442259996,54.17349251250083,52.284309928529,NaN,NaN,50
1651251600,1.05494,1.05764,1.05488,1.05732,3643,6517.65,-633314,-640913.4,24.886524992414586,62.38574876078874,51.684494461223174,NaN,NaN,50
1651253400,1.05732,1.05788,1.05697,1.05726,3357,6330.8,-636671,-638278.6,25.86960661739476,62.08369637178286,51.53669358120642,NaN,NaN,50
1651255200,1.05726,1.05748,1.05651,1.05702,3487,6243.35,-640158,-637468,26.30729117214096,60.81530165878075,51.03576229169233,NaN,NaN,50
1651257000,1.05702,1.05732,1.05637,1.057,3914,6095.4,-644072,-638234.4,26.567737195164696,60.70400103181707,51.77369671695653,NaN,NaN,50
1651258800,1.057,1.057,1.05544,1.0556,4775,6053.4,-648847,-640612.4,25.88398205906583,53.34436974150747,52.42254661149798,NaN,NaN,50
1651260600,1.0556,1.05575,1.05454,1.05488,5146,6077.75,-653993,-644748.2,24.46236845921053,49.987827281850265,52.77580841365714,NaN,NaN,50
1651262400,1.05488,1.05522,1.05422,1.05506,2001,5941,-651992,-647812.4,22.87891867662839,50.82094888114515,53.344616876807414,NaN,NaN,50
1651264200,1.05506,1.05506,1.0542,1.05453,1290,5797.25,-653282,-650437.2,21.391501702916727,48.271136399921815,53.44155543195093,NaN,NaN,50
1651438800,1.05453,1.05627,1.05421,1.05441,118,5495.1,-653400,-652302.8,20.934577455587874,47.68774195197978,53.77894658865359,NaN,NaN,50
1651440600,1.05441,1.05476,1.05441,1.05464,98,5145.05,-653302,-653193.8,20.510290654496796,48.960976455225975,53.49237465913244,NaN,NaN,50
1651442400,1.05464,1.05526,1.0537,1.05371,2559,4966.05,-655861,-653567.4,19.438764559244373,44.26911120297892,53.21199294612724,NaN,NaN,50
1651444200,1.05371,1.05468,1.0537,1.05434,2566,4519.8,-653295,-653828,18.443776042224265,47.91066364754037,53.03292882831856,NaN,NaN,50
1651446000,1.05434,1.05493,1.054,1.05424,2840,4233.55,-656135,-654398.6,17.739803409549086,47.38143548393935,52.771175098697086,NaN,NaN,50
1651447800,1.05424,1.05462,1.05345,1.0535,2849,3986.15,-658984,-655515.4,16.53019193102216,43.547941427273685,52.012207164038,NaN,NaN,50
1651449600,1.0535,1.05532,1.05348,1.05468,4457,3887.7,-654527,-655760.4,16.040769418015906,50.434483251009596,51.15854534191093,NaN,NaN,50
1651451400,1.05468,1.05468,1.05267,1.05294,5288,3548.15,-659815,-656551.2,14.98938287271558,42.2498613983088,49.741842843805635,NaN,NaN,50
1651453200,1.05294,1.05336,1.05236,1.05274,3718,3249.7,-663533,-658598.8,14.292879845032076,41.41785986144902,48.35631128685337,NaN,NaN,50
1651455000,1.05274,1.05291,1.05216,1.05245,3350,3135.5,-666883,-660748.4,13.827791838184359,40.182237824229986,46.89047105774,NaN,NaN,50
1651456800,1.05245,1.05268,1.0518,1.05261,2355,3054.7,-664528,-661857.2,13.721675635243576,41.224085092157175,46.024736439929264,NaN,NaN,50
1651458600,1.05261,1.05277,1.0521,1.0521,2103,2995.7,-666631,-664278,13.51770241906816,38.89845254432848,45.23263824439199,NaN,NaN,50
1651460400,1.0521,1.05262,1.05174,1.05182,2708,2948.95,-669339,-666182.8,13.669355048007862,37.64286980934963,44.291346882120884,NaN,NaN,50
1651462200,1.05182,1.05276,1.0518,1.05242,2289,2895.55,-667050,-666886.2,13.628929185560414,41.96576936286539,43.84096352233114,NaN,NaN,50
1651464000,1.05242,1.05246,1.05182,1.05182,2034,2822.9,-669084,-667326.4,13.591390884716356,39.050364961491546,43.22400802301054,NaN,NaN,50
1651465800,1.05182,1.052,1.05169,1.05186,1961,2725.25,-667123,-667845.4,13.699819286464818,39.35285245217471,42.53771345136402,NaN,NaN,50
1651467600,1.05186,1.05198,1.05162,1.05172,1890,2581,-669013,-668321.8,13.880601053305316,38.63022202888247,42.13493565321427,NaN,NaN,50
1651469400,1.05172,1.05214,1.05105,1.05135,2583,2452.85,-671596,-668773.2,14.669636420561455,36.711548432985325,41.334998852174635,NaN,NaN,50
1651471200,1.05135,1.05234,1.05102,1.05216,3537,2529.65,-668059,-668975,15.065483224496148,43.34555452490667,41.04672164081516,NaN,NaN,50
1651473000,1.05216,1.05518,1.05185,1.05486,5183,2724.3,-662876,-667733.4,15.688196502147319,58.835183319449385,42.138667490256275,NaN,NaN,50
1651474800,1.05486,1.05685,1.05422,1.05466,7841,3110.45,-670717,-668452.2,17.29074769986792,57.57937069137547,42.64901659313955,NaN,NaN,50
1651476600,1.05466,1.05504,1.05319,1.05324,4805,3345.8,-675522,-669754,17.682813917558292,49.500664786423556,43.16693112086203,NaN,NaN,50
1651478400,1.05324,1.05362,1.05256,1.05297,6060,3520.85,-681582,-671751.2,17.448887704400516,48.11823006853731,43.64552899279691,NaN,NaN,50
1651480200,1.05297,1.0536,1.0526,1.0529,4644,3624.75,-686226,-675384.6,17.231670506468294,47.74593357213686,44.18579297479026,NaN,NaN,50
1651482000,1.0529,1.0533,1.0522,1.05271,3468,3656.15,-689694,-680748.2,16.639276741508226,46.689983772388096,44.576214309092464,NaN,NaN,50
1651483800,1.05271,1.05276,1.05188,1.0527,2800,3653.7,-692494,-685103.6,15.781371799942487,46.63152931629983,45.12857693566185,NaN,NaN,50
1651485600,1.0527,1.05288,1.052,1.05222,2415,3551.6,-694909,-688981,15.091866756986347,43.797102787618975,45.568165005538226,NaN,NaN,50
1651487400,1.05222,1.05293,1.052,1.05264,2640,3419.2,-692269,-691118.4,14.498591844961982,46.841829434495274,45.916455010654644,NaN,NaN,50
1651489200,1.05264,1.05279,1.05166,1.05273,2888,3377.7,-689381,-691749.4,13.575427507583546,47.498188958574865,46.519871010446316,NaN,NaN,50
1651491000,1.05273,1.05276,1.05137,1.05168,4069,3413.65,-693450,-692500.6,12.80460613281447,41.11925029882716,46.6460422852072,NaN,NaN,50
1651492800,1.05168,1.053,1.05163,1.05298,4028,3497.3,-689422,-691886.2,11.961549197201528,50.06147925708466,47.46256065865021,NaN,NaN,50
1651494600,1.05298,1.0533,1.05084,1.05106,4395,3611.9,-693817,-691667.8,11.86876094022232,40.32161448537252,47.720422519535006,NaN,NaN,50
1651496400,1.05106,1.0519,1.05028,1.05058,5315,3742.25,-699132,-693040.4,12.29959806576674,38.314653881199696,47.36107247355594,NaN,NaN,50
1651498200,1.05058,1.0528,1.05054,1.05242,7461,4000.85,-691671,-693498.4,11.663995772273616,48.8290770882021,46.64635059989541,NaN,NaN,50
1651500000,1.05242,1.05353,1.0515,1.05339,8914,4344.85,-682757,-691359.8,11.304354448874022,53.343992463736114,46.34382358363546,NaN,NaN,50
1651501800,1.05339,1.05418,1.05222,1.05226,6414,4567.5,-689171,-691309.6,11.537967180199752,48.027692485454686,46.238611276423406,NaN,NaN,50
1651503600,1.05226,1.05238,1.0504,1.05068,4894,4717.7,-694065,-691359.2,11.34398746970031,41.760751639628786,45.78450567435851,NaN,NaN,50
1651505400,1.05068,1.05216,1.05051,1.05216,3787,4777.9,-690278,-689588.4,11.163863452807968,48.53505579985822,45.84087154776717,NaN,NaN,50
1651507200,1.05216,1.0526,1.05205,1.05246,2881,4745.1,-687397,-688733.6,10.575652107733772,49.80948240125652,46.06369287840063,NaN,NaN,50
1651509000,1.05246,1.05264,1.05022,1.05092,3957,4683.8,-691354,-690453,11.382993387982479,43.811859483189174,45.8622878903213,NaN,NaN,50
1651510800,1.05092,1.05109,1.05016,1.05064,3862,4484.85,-695216,-691662,12.170866518848387,42.80269890569519,45.79125904161246,NaN,NaN,50
1651512600,1.05064,1.05074,1.04928,1.04933,2870,4388.1,-698086,-692466.2,13.443213698448398,38.3517581265084,45.18482537675625,NaN,NaN,50
1651514400,1.04933,1.04986,1.04904,1.04982,3167,4243.45,-694919,-693394.4,14.764010801172464,40.83026295214105,44.708544947725265,NaN,NaN,50
1651516200,1.04982,1.04997,1.04918,1.04921,3186,4170.55,-698105,-695536,15.862631925832702,38.742071334927076,44.53874645030383,NaN,NaN,50
1651518000,1.04921,1.05105,1.04916,1.05068,3289,4161.6,-694816,-696228.4,15.716722308384835,45.91996934768103,44.242924313917854,NaN,NaN,50
1651519800,1.05068,1.05116,1.05016,1.05043,4354,4239.3,-699170,-697019.2,15.470895357879622,44.9552026744438,44.57389489885151,NaN,NaN,50
1651521600,1.05043,1.05068,1.05017,1.05036,1730,4205.05,-700900,-697582,15.242627475267637,44.672193382555754,45.028004863234095,NaN,NaN,50
1651523400,1.05036,1.05083,1.05027,1.05076,794,4112.75,-700106,-698619.4,14.862148433070827,46.735689604588245,44.8784771858331,NaN,NaN,50
1651525200,1.05076,1.05076,1.05029,1.05071,90,3972.85,-700196,-699037.6,14.508846465316644,46.502220930990994,44.38977921920844,NaN,NaN,50
1651527000,1.05071,1.05082,1.05042,1.05064,211,3779.95,-700407,-700155.8,14.104986408895298,46.154598607425115,44.255986799349195,NaN,NaN,50
1651528800,1.05064,1.05138,1.05058,1.05132,1404,3648.75,-699003,-700122.4,13.152739111553096,50.060103256453104,44.84879762912235,NaN,NaN,50
1651530600,1.05132,1.05132,1.05088,1.05102,739,3465.95,-699742,-699890.8,12.268509478306767,48.39245957735933,44.838612184658146,NaN,NaN,50
1651532400,1.05102,1.0511,1.05058,1.05076,811,3240.75,-700553,-699980.2,11.711900434789625,46.93321332431651,44.633164393448155,NaN,NaN,50
1651534200,1.05076,1.05096,1.05072,1.05096,572,2896.3,-699981,-699937.2,11.195049180095138,48.22651436387332,44.94849688492559,NaN,NaN,50
1651536000,1.05096,1.05142,1.05086,1.05102,2206,2560.9,-697775,-699410.8,10.708379936654248,48.630982240863446,45.36480283743761,NaN,NaN,50
1651537800,1.05102,1.05259,1.051,1.05253,2919,2386.15,-694856,-698581.4,11.543646707348907,57.6069566586621,46.74017416116288,NaN,NaN,50
1651539600,1.05253,1.05268,1.05162,1.05172,2535,2268.2,-697391,-698111.2,12.40445545330612,52.32513804950995,47.56123666811779,NaN,NaN,50
1651541400,1.05172,1.05235,1.05151,1.05224,2125,2185.1,-695266,-697053.8,13.028694219440176,55.16703926933201,48.73444866343243,NaN,NaN,50
1651543200,1.05224,1.05259,1.05217,1.05247,2135,2147.8,-693131,-695683.8,13.859130670267895,56.404885040305125,49.48337121290558,NaN,NaN,50
1651545000,1.05247,1.05247,1.051,1.05136,1980,2048.95,-695111,-695151,12.943276843625068,49.32657039779252,49.795611764573344,NaN,NaN,50
1651546800,1.05136,1.05176,1.0508,1.05172,1906,1951.15,-693205,-694820.8,12.187904550528629,51.45435483420549,50.28005186826262,NaN,NaN,50
1651548600,1.05172,1.05196,1.05139,1.05186,1014,1858.35,-692191,-693780.8,11.40428936470045,52.29330635588309,50.67702449335511,NaN,NaN,50
1651550400,1.05186,1.05186,1.05142,1.05152,947,1747.35,-693138,-693355.2,10.676646692145711,50.03194712304559,50.92914779278759,NaN,NaN,50
1651552200,1.05152,1.05242,1.05018,1.05018,3985,1787.3,-697123,-694153.6,11.28155355709354,42.27308605928729,50.651896896492026,NaN,NaN,50
1651554000,1.05018,1.05108,1.04998,1.05083,2854,1765.55,-694269,-693985.2,12.03825180365458,46.59914122388663,50.40468532273728,NaN,NaN,50
1651555800,1.05083,1.05096,1.04978,1.05074,2450,1670.35,-696719,-694688,12.936689519050418,46.0841742723582,50.23980780095148,NaN,NaN,50
1651557600,1.05074,1.05086,1.0498,1.05015,4274,1797.55,-700993,-696448.4,13.77095311191798,42.7489782072411,49.94093386401753,NaN,NaN,50
1651559400,1.05015,1.05125,1.04964,1.04978,4868,2001.25,-705861,-698993,13.89126350658549,40.75690562114043,49.40739038239375,NaN,NaN,50
1651561200,1.04978,1.05176,1.04946,1.05162,7577,2375.6,-698284,-699225.2,13.229295702794678,52.58894970319961,49.69010234398919,NaN,NaN,50
1651563000,1.05162,1.0528,1.05143,1.05188,5857,2657.9,-692427,-698856.8,13.230727387080115,53.98737497388596,49.431560795076614,NaN,NaN,50
1651564800,1.05188,1.05259,1.05143,1.0515,3869,2781.15,-696296,-698772.2,13.232056808202305,51.59219250909341,49.37920754218971,NaN,NaN,50
1651566600,1.0515,1.05168,1.05001,1.05001,4741,2981.25,-701037,-698781,13.062874865553889,43.45186040958194,48.54240905220757,NaN,NaN,50
1651568400,1.05001,1.05046,1.04922,1.04976,5339,3207.65,-706376,-698884,13.626091004634116,42.24738916129124,47.53115934656372,NaN,NaN,50
1651570200,1.04976,1.05142,1.04962,1.05136,4018,3379.95,-702358,-699698.8,13.034960942035411,51.5112801805635,47.687210045333075,NaN,NaN,50
1651572000,1.05136,1.05232,1.05101,1.05158,4282,3483.75,-698076,-700828.6,12.588628079612393,52.63628644952773,47.77163373214181,NaN,NaN,50
1651573800,1.05158,1.05158,1.05018,1.05041,3842,3529.9,-701918,-701953,11.987812136547568,46.46233612367651,47.355135858412766,NaN,NaN,50
1651575600,1.05041,1.05158,1.04991,1.05142,3790,3592.65,-698128,-701371.2,11.667540452121706,51.72625378683378,47.47615776296907,NaN,NaN,50
1651577400,1.05142,1.05421,1.05138,1.05378,6596,3816.2,-691532,-698402.4,12.348149002477744,61.30095501443995,48.83529125976569,NaN,NaN,50
1651579200,1.05378,1.05615,1.05371,1.05603,8226,4120.75,-683306,-694592,13.965013856039251,67.84840198805495,50.353095600063455,NaN,NaN,50
1651581000,1.05603,1.05776,1.05589,1.05678,6829,4363.2,-676477,-690272.2,16.094388922656886,69.68930562775101,52.03917641116294,NaN,NaN,50
1651582800,1.05678,1.05724,1.05585,1.05606,6344,4585.1,-682821,-686452.8,18.034642141453403,65.79459981068534,53.68529223998039,NaN,NaN,50
1651584600,1.05606,1.05666,1.05486,1.05558,8275,4948.15,-691096,-685046.4,18.939240647523995,63.256508944289045,55.29240676306244,NaN,NaN,50
1651586400,1.05558,1.05588,1.05422,1.05576,6712,5236.4,-684384,-683616.8,19.24221996159921,63.82014617892547,56.09463508275714,NaN,NaN,50
1651588200,1.05576,1.05648,1.05353,1.05383,6419,5358.1,-690803,-685116.2,18.97271735110939,54.21679920566603,56.11102252788429,NaN,NaN,50
1651590000,1.05383,1.05483,1.05338,1.05399,5758,5503.3,-685045,-686829.8,18.603325323618552,54.82370708166456,56.341844997353654,NaN,NaN,50
1651591800,1.05399,1.05404,1.05316,1.0532,4070,5584.3,-689115,-688088.6,18.078994262511358,51.21380472532061,56.896269591334985,NaN,NaN,50
1651593600,1.0532,1.05323,1.05116,1.05175,4723,5606.75,-693838,-688637,17.407667019756914,45.31583381447949,57.11544420941986,NaN,NaN,50
1651595400,1.05175,1.0523,1.05122,1.05158,4104,5568.55,-697942,-691348.6,16.7842917229135,44.66635984726408,56.6265213284699,NaN,NaN,50
1651597200,1.05158,1.05406,1.05144,1.0529,4653,5422.35,-693289,-691845.8,16.165872265805763,50.58814472314155,56.480225490870886,NaN,NaN,50
1651599000,1.0529,1.05325,1.05241,1.05293,3033,5281.15,-690256,-692888,15.591625627062866,50.71723408853077,56.78414677407476,NaN,NaN,50
1651600800,1.05293,1.05306,1.05172,1.05206,2907,5233.05,-693163,-693697.6,14.551016952160767,46.89132626298742,56.43879480808574,NaN,NaN,50
1651602600,1.05206,1.05261,1.05126,1.05256,3652,5178.6,-689511,-692832.2,13.763592265068256,49.26031055837497,55.57874877550967,NaN,NaN,50
1651604400,1.05256,1.0528,1.05194,1.0521,3374,5080.35,-692885,-691820.8,12.887168018199521,47.17541195871247,54.10210663055664,NaN,NaN,50
1651606200,1.0521,1.0526,1.05189,1.05252,2812,5020.05,-690073,-691177.6,12.112294776827175,49.28594554088131,52.64472376720881,NaN,NaN,50
1651608000,1.05252,1.05268,1.05218,1.05236,1080,4859.95,-691153,-691357,11.323907091245525,48.491116534529745,51.40876067605484,NaN,NaN,50
1651609800,1.05236,1.0524,1.05194,1.05202,538,4694.75,-691691,-691062.6,10.801133776015938,46.76521058035735,50.23081079291686,NaN,NaN,50
1651611600,1.05202,1.05218,1.05202,1.05208,96,4510.05,-691595,-691479.4,10.315701411874178,47.122878316897186,49.03814880277198,NaN,NaN,50
1651613400,1.05208,1.0525,1.05208,1.0525,315,4196,-691280,-691158.4,9.61815807365297,49.67192209186273,48.71351472321461,NaN,NaN,50
1651615200,1.0525,1.05282,1.05218,1.05238,1122,3840.8,-692402,-691624.2,9.290399309099161,48.945912175521684,48.29367222991869,NaN,NaN,50
1651617000,1.05238,1.05252,1.05225,1.05246,1033,3551,-691369,-691667.4,8.986051884870625,49.47609048976109,48.16954978452158,NaN,NaN,50
1651618800,1.05246,1.05262,1.05204,1.05204,677,3267.65,-692046,-691738.4,8.454785348938842,46.732290242564176,48.27072524367049,NaN,NaN,50
1651620600,1.05204,1.05262,1.05195,1.05251,800,2893.9,-691246,-691668.6,7.852176885355569,50.0693039236271,48.65664982055356,NaN,NaN,50
1651622400,1.05251,1.05341,1.05202,1.05212,1596,2638.1,-692842,-691981,8.182972541511537,47.41493922340561,48.42999228485814,NaN,NaN,50
1651624200,1.05212,1.05287,1.05212,1.0525,1337,2384,-691505,-691801.6,8.490139936513506,50.18598838065837,48.39204616286725,NaN,NaN,50
1651626000,1.0525,1.05264,1.05185,1.05263,1178,2155,-690327,-691593.2,8.397019001373748,51.13468422563731,48.69514316019939,NaN,NaN,50
1651627800,1.05263,1.05334,1.05246,1.05294,1893,2046.15,-688434,-690870.8,9.080898867529964,53.4131467125447,48.99177431406866,NaN,NaN,50
1651629600,1.05294,1.05308,1.05239,1.05266,1701,1895.05,-690135,-690648.6,9.611785625314702,51.09571638328455,49.27179605868095,NaN,NaN,50
1651631400,1.05266,1.05272,1.05196,1.05201,1429,1761.3,-691564,-690393,9.475738942382813,46.095829640250656,49.04393063720733,NaN,NaN,50
1651633200,1.05201,1.05238,1.05167,1.05183,1191,1588.2,-692755,-690643,8.949065412733049,44.78878977536423,48.77947872583837,NaN,NaN,50
1651635000,1.05183,1.05184,1.05142,1.05163,1279,1500.5,-694034,-691384.4,8.495776119229074,43.31902431169135,48.533322563790804,NaN,NaN,50
1651636800,1.05163,1.05204,1.0515,1.0517,1148,1412.55,-692886,-692274.8,7.982872050492147,44.01154054174802,48.311084151280134,NaN,NaN,50
1651638600,1.0517,1.05194,1.05162,1.05168,736,1266.75,-693622,-692972.2,7.506603986665001,43.84670674678004,47.89499734091709,NaN,NaN,50
1651640400,1.05168,1.05185,1.05124,1.05126,1175,1156.8,-694797,-693618.8,7.438175126443005,40.42288627103818,47.286209776311125,NaN,NaN,50
1651642200,1.05126,1.05161,1.05113,1.05126,1592,1095.8,-694797,-694027.2,7.532330562995855,40.42288627103818,46.63955233211663,NaN,NaN,50
1651644000,1.05126,1.05238,1.05061,1.05176,3825,1233.05,-690972,-693414.8,7.5431938082712895,46.22088043303726,46.603023060007565,NaN,NaN,50
1651645800,1.05176,1.0519,1.05078,1.05138,3381,1375.2,-694353,-693708.2,7.553281107455621,42.81090683018176,46.084566124761466,NaN,NaN,50
1651647600,1.05138,1.05286,1.05078,1.05124,6011,1670.95,-700364,-695056.6,8.745441654103514,41.59341377615886,45.66874287852956,NaN,NaN,50
1651649400,1.05124,1.05268,1.0511,1.05244,4280,1869.2,-696084,-695314,9.852447875990844,53.737814839521256,45.92244476844833,NaN,NaN,50
1651651200,1.05244,1.05284,1.05172,1.05248,4538,2040,-691546,-694663.8,11.061711999129798,54.08056231752267,46.13286463215443,NaN,NaN,50
1651653000,1.05248,1.05346,1.05208,1.05222,3690,2172.85,-695236,-695516.6,12.82622113590452,51.41414113517122,45.990078519484896,NaN,NaN,50
1651654800,1.05222,1.0531,1.05148,1.0531,3463,2312.15,-691773,-695000.6,13.365338685436553,58.81555627328825,46.54149565448516,NaN,NaN,50
1651656600,1.0531,1.05338,1.05215,1.05238,3207,2432.5,-694980,-693923.8,14.172520812114644,51.85519673525109,46.95287901841376,NaN,NaN,50
1651658400,1.05238,1.05302,1.05212,1.05273,2701,2487.75,-692279,-693162.8,14.867006738421926,54.66388778723153,47.65824316211857,NaN,NaN,50
1651660200,1.05273,1.05314,1.05214,1.05298,2460,2543.9,-689819,-692817.4,15.652872913313548,56.61099940839592,48.60766995474033,NaN,NaN,50
1651662000,1.05298,1.05365,1.05262,1.05343,2568,2613.4,-687251,-691220.4,16.944459316037204,59.94567208959029,49.74582220815763,NaN,NaN,50
1651663800,1.05343,1.05362,1.05232,1.05307,3676,2702.55,-690927,-691051.2,17.542128546594533,56.22293996617069,50.62983886668553,NaN,NaN,50
1651665600,1.05307,1.05426,1.05255,1.0541,5317,2883.35,-685610,-689177.2,18.771493617467556,63.254171567661125,52.260644959301466,NaN,NaN,50
1651667400,1.0541,1.05555,1.0537,1.05534,5722,3098,-679888,-686699,20.916519787471163,69.58718700589756,54.34380929750568,NaN,NaN,50
1651669200,1.05534,1.05558,1.05462,1.05522,4446,3260.75,-684334,-685602,22.927944492818135,68.35933901823847,55.92512776787719,NaN,NaN,50
1651671000,1.05522,1.05522,1.0532,1.05326,5842,3488.9,-690176,-686187,22.509457958287886,52.16810664986859,56.59349918356911,NaN,NaN,50
1651672800,1.05326,1.05407,1.05246,1.05376,6772,3770.1,-683404,-684682.4,21.22162882189003,55.09037500898534,57.5575678430567,NaN,NaN,50
1651674600,1.05376,1.05509,1.05312,1.05464,6936,4080.1,-676468,-682854,20.96499082334928,59.751103968638105,57.98708849513648,NaN,NaN,50
1651676400,1.05464,1.05643,1.05437,1.05601,4500,4246.35,-671968,-681270,21.685758084264695,65.71629957135293,58.81821258469578,NaN,NaN,50
1651678200,1.05601,1.05602,1.05368,1.05405,4558,4394.65,-676526,-679708.4,21.579012441805837,53.49988522988768,58.96719430574696,NaN,NaN,50
1651680000,1.05405,1.05448,1.05342,1.05428,4308,4418.8,-672218,-676116.8,21.200486050104065,54.567209808847274,58.663740986858315,NaN,NaN,50
1651681800,1.05428,1.05492,1.0538,1.05492,3236,4411.55,-668982,-673232.4,21.183833389251568,57.49108813112366,59.06630465799207,NaN,NaN,50
1651683600,1.05492,1.05529,1.05396,1.05407,3629,4292.45,-672611,-672461,21.440803470148474,52.64521106431054,58.9221134634977,NaN,NaN,50
1651685400,1.05407,1.05465,1.05341,1.05445,3818,4269.35,-668793,-671826,21.04022766145244,54.49196609665962,58.77075394123083,NaN,NaN,50
1651687200,1.05445,1.05733,1.05348,1.05543,26519,5368.4,-642274,-664975.6,22.312102250580974,58.939292238511726,58.69886966615378,NaN,NaN,50
1651689000,1.05543,1.06268,1.05106,1.06178,35484,6958.1,-606790,-651890,25.11023489236149,75.58722670146332,60.08203300438901,NaN,NaN,50
1651690800,1.06178,1.06222,1.05823,1.06071,32885,8429.2,-639675,-646028.6,27.708500916871966,70.40704737637972,60.59295270501177,NaN,NaN,50
1651692600,1.06071,1.06179,1.05907,1.0609,19344,9236.05,-620331,-635572.6,30.121176511060266,70.789858501214,60.67885781182008,NaN,NaN,50
1651694400,1.0609,1.06312,1.06051,1.06272,5636,9382.8,-614695,-624753,32.645136189276656,74.22885990878692,61.09810930400211,NaN,NaN,50
1651696200,1.06272,1.06275,1.06205,1.06206,1161,9317.85,-615856,-619469.4,34.988813033334736,70.96594380932609,62.44081195824908,NaN,NaN,50
1651698000,1.06206,1.06258,1.06206,1.06242,121,9195.5,-615735,-621258.4,37.165084388531525,71.69676715044457,63.626982825496164,NaN,NaN,50
1651699800,1.06242,1.06252,1.06234,1.06248,103,9016.85,-615632,-616449.8,39.18590778978569,71.82406365745516,64.48933708898309,NaN,NaN,50
1651701600,1.06248,1.0625,1.0615,1.06156,2063,8854.15,-617695,-615922.6,40.11067862132246,66.85860879498807,64.57093060495703,NaN,NaN,50
1651703400,1.06156,1.0616,1.06048,1.06059,1663,8651.2,-619358,-616855.2,39.93409677500515,61.992344245244595,65.17753482033967,NaN,NaN,50
1651705200,1.06059,1.06078,1.06044,1.06052,1891,8523.45,-621249,-617933.8,39.730729093781335,61.64365564063396,65.68299523689585,NaN,NaN,50
1651707000,1.06052,1.0623,1.0604,1.06206,2144,8338.55,-619105,-618607.8,40.17502785624957,66.15404314821077,66.30177773811637,NaN,NaN,50
1651708800,1.06206,1.06277,1.06112,1.06118,4834,8241.65,-623939,-620269.2,40.76060226054281,61.68990733058962,66.94782747142202,NaN,NaN,50
1651710600,1.06118,1.0618,1.06042,1.06139,3403,8065,-620536,-620837.4,40.59365958690982,62.342960419191144,67.50861278017426,NaN,NaN,50
1651712400,1.06139,1.06324,1.06106,1.06314,4154,8047.7,-616382,-620242.2,41.00754195937443,67.33942236421785,68.10862207486755,NaN,NaN,50
1651714200,1.06314,1.0642,1.06202,1.06258,5665,8103.05,-622047,-620401.8,41.71725591236109,64.39497983246224,67.30917586993891,NaN,NaN,50
1651716000,1.06258,1.06287,1.06142,1.06163,3159,8045.6,-625206,-621622,41.793000850066136,59.63144555408038,66.53949002548896,NaN,NaN,50
1651717800,1.06163,1.06302,1.0616,1.06232,2285,7998.05,-622921,-621418.4,41.92201260802206,61.83946025604778,65.90017586511995,NaN,NaN,50
1651719600,1.06232,1.06259,1.06194,1.06226,1825,7907.85,-624746,-622260.4,42.0418092404097,61.52432827003503,64.99270931949481,NaN,NaN,50
1651721400,1.06226,1.06284,1.06151,1.06178,2499,7841.9,-627245,-624433,41.685794512492784,58.93678336250695,64.13348357329343,NaN,NaN,50
1651723200,1.06178,1.0618,1.06098,1.06102,2929,6662.4,-630174,-626058.4,40.79699707996657,54.99306426916712,62.94036193891647,NaN,NaN,50
1651725000,1.06102,1.0618,1.06099,1.06124,2467,5011.55,-627707,-626558.6,39.9716851783351,55.912722778854636,61.803837590445006,NaN,NaN,50
1651726800,1.06124,1.06194,1.06062,1.06162,3060,3520.3,-624647,-626903.8,38.79794683322135,57.52709871702666,61.1373011563049,NaN,NaN,50
1651728600,1.06162,1.0617,1.06085,1.06122,2877,2696.95,-627524,-627459.4,37.70804694133002,55.23432331575985,60.65458537562743,NaN,NaN,50
1651730400,1.06122,1.06176,1.0601,1.06031,6595,2744.9,-634119,-628834.2,35.86660799035686,50.320700615484355,59.84580287383102,NaN,NaN,50
1651732200,1.06031,1.06056,1.05938,1.05948,5524,2963.05,-639643,-630728,33.44863572144406,46.27699696721368,58.42601386090265,NaN,NaN,50
1651734000,1.05948,1.06068,1.05848,1.05854,6955,3304.75,-646598,-634506.2,31.69172506356682,42.146272248828154,57.03003992649112,NaN,NaN,50
1651735800,1.05854,1.06014,1.05847,1.0598,5715,3585.35,-640883,-637753.4,30.06859602090485,48.74990798561033,56.05910760980679,NaN,NaN,50
1651737600,1.0598,1.05984,1.05834,1.05886,5893,3776.85,-646776,-641603.8,28.67525988000807,44.65482985299266,54.438779573290695,NaN,NaN,50
1651739400,1.05886,1.06006,1.05816,1.06003,5503,3968.85,-641273,-643034.6,27.13722563327271,50.255919121457005,53.428846665361746,NaN,NaN,50
1651741200,1.06003,1.06031,1.0595,1.05966,4096,4079.1,-645369,-644179.8,25.429981765952984,48.58149978318058,52.639564824583196,NaN,NaN,50
1651743000,1.05966,1.06014,1.05922,1.05978,3929,4168.35,-641440,-643148.2,24.13587168085178,49.17297413113224,51.73481581566066,NaN,NaN,50
1651744800,1.05978,1.06078,1.05953,1.06028,3243,4088.8,-638197,-642611,22.609779729535415,51.66772503392258,51.030772727366916,NaN,NaN,50
1651746600,1.06028,1.06038,1.05868,1.05978,3400,4088.65,-641597,-641575.2,21.66654378869089,49.07374643564854,50.32627008973417,NaN,NaN,50
1651748400,1.05978,1.06036,1.05532,1.0559,11157,4438.8,-652754,-643871.4,22.960110818910653,34.56970275870556,48.86745855327263,NaN,NaN,50
1651750200,1.0559,1.05691,1.05456,1.05479,9311,4621.1,-662065,-647210.6,24.486047142745885,31.684583172814058,47.13687715284116,NaN,NaN,50
1651752000,1.05479,1.05738,1.05477,1.05654,7621,4844.2,-654444,-649811.4,25.40946728634231,40.16339285591311,45.8966124484759,NaN,NaN,50
1651753800,1.05654,1.05685,1.0549,1.05534,9170,5188.45,-663614,-654894.8,26.266928848253272,36.791373587388065,44.579258896449346,NaN,NaN,50
1651755600,1.05534,1.05659,1.05472,1.05604,7342,5464.3,-656272,-657829.8,27.156222420943216,39.95813472981866,43.8390756189018,NaN,NaN,50
1651757400,1.05604,1.05622,1.05422,1.05564,8132,5745.95,-664404,-660159.8,28.23865373962701,38.76303709730857,43.302364199622865,NaN,NaN,50
1651759200,1.05564,1.05568,1.05363,1.05488,10803,6139.65,-675207,-662788.2,29.529508723218207,36.52762353399369,42.90103214856326,NaN,NaN,50
1651761000,1.05488,1.05548,1.05292,1.0533,11007,6566.65,-686214,-669142.2,31.04437249100555,32.350739008676754,41.72966293592515,NaN,NaN,50
1651762800,1.0533,1.05332,1.05034,1.0505,9751,6901.2,-695965,-675612.4,33.30945101865623,26.555502087335725,40.4368538098068,NaN,NaN,50
1651764600,1.0505,1.05194,1.05036,1.05068,6050,7059.85,-689915,-682341,35.41273822290329,27.455191245147873,38.80823039007043,NaN,NaN,50
1651766400,1.05068,1.05094,1.04927,1.0509,7085,7084.35,-682830,-686026.2,37.64983463383739,28.60633029169233,37.38143256924984,NaN,NaN,50
1651768200,1.0509,1.05152,1.05056,1.0511,6356,7125.95,-676474,-686279.6,39.040484596972256,29.69847005629525,35.99039656390433,NaN,NaN,50
1651770000,1.0511,1.05286,1.05072,1.0509,7660,7161.2,-684134,-685863.6,38.923841683630044,29.217142270651607,34.38678350938498,NaN,NaN,50
1651771800,1.0509,1.05154,1.05034,1.0504,6475,7199.2,-690609,-684792.4,38.98050586688156,27.99556542711362,32.881199151632494,NaN,NaN,50
1651773600,1.0504,1.05172,1.05022,1.05086,5525,7180.8,-685084,-683826.2,38.84873943015133,30.859658248844156,32.616195972356685,NaN,NaN,50
1651775400,1.05086,1.0521,1.05065,1.05162,5227,7167,-679857,-683231.6,38.331519943015884,35.42951254532986,32.883690927536385,NaN,NaN,50
1651777200,1.05162,1.05389,1.05162,1.05364,5630,7243.7,-674227,-682782.2,36.25526055033123,45.702029948993484,33.279307862756404,NaN,NaN,50
1651779000,1.05364,1.0551,1.05323,1.05506,8038,7449.15,-666189,-679193.2,33.86237674060866,51.53863278141923,34.332683519472916,NaN,NaN,50
1651780800,1.05506,1.05508,1.05434,1.05442,1975,7385.75,-668164,-674704.2,31.640413203009132,48.98300116922074,34.97731683657306,NaN,NaN,50
1651782600,1.05442,1.05444,1.0538,1.05396,1011,7266.3,-669175,-671522.4,29.578962157516877,47.172427802402645,35.57798760122264,NaN,NaN,50
1651784400,1.05396,1.05447,1.0539,1.05438,58,6711.35,-669117,-669374.4,27.641174030256217,49.0251192535724,36.470665866906835,NaN,NaN,50
1651786200,1.05438,1.05438,1.05407,1.05414,186,6255.1,-669303,-668389.6,25.841799340657033,47.989417857358376,37.58771435609838,NaN,NaN,50
1651788000,1.05414,1.05459,1.05392,1.05426,2035,5975.8,-667268,-668605.4,24.006955643088798,48.57440978796659,39.16049347757201,NaN,NaN,50
1651789800,1.05426,1.05503,1.05415,1.05502,1307,5582.65,-665961,-668164.8,22.689999664755675,52.23839806133208,40.930722535870885,NaN,NaN,50
1651791600,1.05502,1.05503,1.05357,1.05392,2020,5316.55,-667981,-667926,21.2105606281668,47.01692774041498,42.245765210779645,NaN,NaN,50
1651793400,1.05392,1.05434,1.05363,1.05396,1849,5002.4,-666132,-667329,19.836795808477127,47.22351115269774,43.49755386052268,NaN,NaN,50
1651795200,1.05396,1.0551,1.05335,1.05436,3476,4636.05,-662656,-665999.6,18.992444865378914,49.35027883059628,44.935635043375875,NaN,NaN,50
1651797000,1.05436,1.05464,1.05381,1.0541,3795,4275.45,-666451,-665836.2,18.20840470393057,47.99638040145889,46.36426468440053,NaN,NaN,50
1651798800,1.0541,1.05456,1.05248,1.05324,6243,4100.05,-672694,-667182.8,17.61523235536587,43.72349603426215,47.28311024050181,NaN,NaN,50
1651800600,1.05324,1.0535,1.05157,1.0526,7058,4150.45,-679752,-669537,17.765420761434054,40.81168376107061,47.667551041626155,NaN,NaN,50
1651802400,1.0526,1.05304,1.05195,1.05263,3615,3976.95,-676137,-671538,17.90488142421166,41.00999753112772,47.332405868921455,NaN,NaN,50
1651804200,1.05263,1.05342,1.05234,1.05286,3020,3810.15,-673117,-673630.2,17.605880273895515,42.59794307522257,46.6937851756217,NaN,NaN,50
1651806000,1.05286,1.05374,1.05266,1.05352,2063,3530.3,-671054,-674550.8,16.97515463667561,47.00635122459428,46.55259589386266,NaN,NaN,50
1651807800,1.05352,1.05396,1.05326,1.0533,1780,3295.55,-672834,-674578.8,16.147224401290046,45.74521092261707,46.450651831020835,NaN,NaN,50
1651809600,1.0533,1.05349,1.05258,1.05278,1399,3089.25,-674233,-673475,16.013899071514444,42.82087192577624,46.00749130760682,NaN,NaN,50
1651811400,1.05278,1.05346,1.05265,1.05326,1097,2882.75,-673136,-672874.8,15.890096979579956,46.237399467944755,45.88234713693442,NaN,NaN,50
1651813200,1.05326,1.05342,1.05275,1.05339,1716,2687.05,-671420,-672535.4,15.775137894212218,47.15829635929248,45.78119617774342,NaN,NaN,50
1651815000,1.05339,1.0534,1.05214,1.05228,2420,2406.15,-673840,-673092.6,16.251947068807173,40.74132375749907,44.95997658461249,NaN,NaN,50
1651816800,1.05228,1.05255,1.05089,1.05094,4779,2546.35,-678619,-674249.6,17.65729735740897,34.617361039254035,44.07429324881527,NaN,NaN,50
1651818600,1.05094,1.05198,1.04829,1.04862,6885,2840.05,-685504,-676503.8,20.244613910861755,27.03926432728538,42.63256133271439,NaN,NaN,50
1651820400,1.04862,1.0512,1.04828,1.05068,11699,3422.1,-673805,-676637.6,22.650940961158657,39.668431715492545,41.9410008244927,NaN,NaN,50
1651822200,1.05068,1.0544,1.04956,1.05214,11643,3994.95,-662162,-674786,21.746784944213474,46.70902847791308,41.84904711566799,NaN,NaN,50
1651824000,1.05214,1.05552,1.05126,1.05505,14512,4618.8,-647650,-669548,20.24287872916735,57.38391414401037,42.8247912663643,NaN,NaN,50
1651825800,1.05505,1.05813,1.0543,1.05576,12562,5181.55,-635088,-660841.8,20.236735072215,59.51478014292825,44.16072672221127,NaN,NaN,50
1651827600,1.05576,1.05658,1.05514,1.05572,7680,5464.55,-642768,-652294.6,20.2310302479021,59.334777771374,45.469639596514575,NaN,NaN,50
1651829400,1.05572,1.05758,1.0557,1.05711,6787,5711.45,-635981,-644729.8,20.682648804577592,63.469518502372566,46.96046641273957,NaN,NaN,50
1651831200,1.05711,1.05912,1.05689,1.05908,5069,5791.1,-630912,-638479.8,21.717318076027343,68.3770551578757,48.48694526511682,NaN,NaN,50
1651833000,1.05908,1.0599,1.05831,1.05888,4172,5809.95,-635084,-635966.6,22.95652768479846,67.38728452336954,50.03280766517057,NaN,NaN,50
1651834800,1.05888,1.05911,1.05802,1.05823,4001,5697.85,-639085,-636766,23.87369987543951,64.13785837847368,51.555449554648966,NaN,NaN,50
1651836600,1.05823,1.0591,1.05599,1.05658,4491,5569.5,-643576,-636927.6,23.265129954690895,56.66785559238116,52.300482134965854,NaN,NaN,50
1651838400,1.05658,1.05754,1.05598,1.05727,5932,5685.35,-637644,-637260.2,22.693454177365094,58.827410835335115,53.13399031182604,NaN,NaN,50
1651840200,1.05727,1.05972,1.05475,1.05536,20890,6578.85,-658534,-642784.6,23.117642978335034,51.2180811634928,53.88233012653988,NaN,NaN,50
1651842000,1.05536,1.05844,1.05534,1.0582,14287,7190.05,-644247,-644617.2,23.5115325792357,59.58840585277516,55.66597618464852,NaN,NaN,50
1651843800,1.0582,1.0596,1.05631,1.05734,16220,7912.05,-660467,-648893.6,24.329618993382514,56.430755183458956,57.765368388660924,NaN,NaN,50
1651845600,1.05734,1.05878,1.05674,1.05768,15355,8609.85,-645112,-649200.8,25.0892706636617,57.3920532542994,59.03134135571855,NaN,NaN,50
1651847400,1.05768,1.05844,1.05572,1.05818,12656,9187.8,-632456,-648163.2,24.994707653545806,58.830613979395245,59.897168891538705,NaN,NaN,50
1651849200,1.05818,1.05952,1.05766,1.05921,8860,9545,-623596,-641175.6,25.37759660647555,61.6993810615606,60.20541652850658,NaN,NaN,50
1651851000,1.05921,1.05934,1.05706,1.0571,7140,9781,-630736,-638473.4,25.27527780433281,53.47830860711875,59.77423999023448,NaN,NaN,50
1651852800,1.0571,1.05804,1.05664,1.05748,6287,9856.4,-624449,-631269.8,24.863815694267057,54.650256567171226,59.439631332791414,NaN,NaN,50
1651854600,1.05748,1.05772,1.05678,1.05692,6523,9838.3,-630972,-628441.8,24.481743734920293,52.54933811526961,58.65961844799835,NaN,NaN,50
1651856400,1.05692,1.05749,1.05644,1.05678,5234,9515.05,-636206,-629191.8,23.849781507663067,52.011022381998586,57.490616106864266,NaN,NaN,50
1651858200,1.05678,1.05694,1.05503,1.05504,5950,9230.4,-642156,-632903.8,22.216928584493473,45.73957422690719,55.94435108568838,NaN,NaN,50
1651860000,1.05504,1.05585,1.05496,1.05551,3940,8701.8,-638216,-634399.8,20.65219384980809,47.57829949192196,54.76152545093469,NaN,NaN,50
1651861800,1.05551,1.05552,1.05437,1.05474,4467,8297.05,-642683,-638046.6,19.56708097155997,44.894183531267586,53.92054887514087,NaN,NaN,50
1651863600,1.05474,1.05484,1.05363,1.05433,3562,8091.15,-646245,-641101.2,19.04640977544594,43.48738010269209,52.82483239423779,NaN,NaN,50
1651865400,1.05433,1.05564,1.05425,1.05474,5463,8024.95,-640782,-642016.4,17.941797862944913,45.332223203195035,52.40441396850223,NaN,NaN,50
1651867200,1.05474,1.05484,1.05408,1.05408,1309,7836.95,-642091,-642003.4,17.03602638753339,42.9041696657658,51.21268281228728,NaN,NaN,50
1651869000,1.05408,1.05488,1.05404,1.05458,1285,7692.6,-640806,-642521.4,16.19495287465126,45.29468490212782,50.41724922076362,NaN,NaN,50
1652043600,1.05458,1.05458,1.0542,1.05434,30,7494.05,-640836,-642152,15.413956041260715,44.335149028108454,49.48461320460712,NaN,NaN,50
1652045400,1.05434,1.05434,1.05385,1.05406,199,7279.45,-641035,-641110,14.978799430543758,43.18571110481483,48.3671201421371,NaN,NaN,50
1652047200,1.05406,1.05437,1.05358,1.05396,1604,7063.05,-642639,-641481.4,14.79743496871449,42.75933297255838,47.01425956435123,NaN,NaN,50
1652049000,1.05396,1.0541,1.05368,1.05378,1292,6083.15,-643931,-641849.4,14.6290251113016,41.95634383215539,46.19126208042528,NaN,NaN,50
1652050800,1.05378,1.0539,1.05309,1.05334,1400,5438.8,-645331,-642754.4,14.973964298072397,39.97989639366034,45.14337921088879,NaN,NaN,50
1652052600,1.05334,1.0539,1.05308,1.05322,1395,4697.55,-646726,-643932.4,15.302669759742962,39.4342956240808,44.206590461518154,NaN,NaN,50
1652054400,1.05322,1.05354,1.05255,1.05314,2539,4056.75,-649265,-645578.4,16.050045729503562,39.05167672329073,43.28092291446759,NaN,NaN,50
1652056200,1.05314,1.05314,1.05182,1.05194,3111,3579.5,-652376,-647525.8,17.287371898571273,33.76023797175617,42.425256039099665,NaN,NaN,50
1652058000,1.05194,1.05264,1.05136,1.0516,3911,3332.05,-656287,-649997,18.74573215916717,32.419859123845754,41.34251029852279,NaN,NaN,50
1652059800,1.0516,1.05268,1.0514,1.05242,3161,3133.1,-653126,-651556,20.040400599736238,38.737255593167866,40.90272973151567,NaN,NaN,50
1652061600,1.05242,1.05243,1.05148,1.0518,2833,2960.4,-655959,-653402.6,21.242592723121803,35.99725330688764,40.3677206746725,NaN,NaN,50
1652063400,1.0518,1.05206,1.05066,1.05068,2649,2766.7,-658608,-655271.2,22.926081039560977,31.64302596828901,39.38992087217921,NaN,NaN,50
1652065200,1.05068,1.0513,1.0505,1.05088,2874,2648.7,-655734,-655942.8,24.590826542974735,33.19696713620681,38.696549262925,NaN,NaN,50
1652067000,1.05088,1.0513,1.05028,1.05102,1900,2446.2,-653834,-655452.2,26.277720289445046,34.32248190745072,37.91282047759091,NaN,NaN,50
1652068800,1.05102,1.05164,1.05058,1.0516,1751,2336.75,-652083,-655243.6,27.234272600767014,38.91424631164501,37.52561314070067,NaN,NaN,50
1652070600,1.0516,1.05166,1.05088,1.05125,1754,2201.1,-653837,-654819.2,28.086224714839986,37.22302939630166,37.0997073043783,NaN,NaN,50
1652072400,1.05125,1.05125,1.0503,1.05066,2089,2127.45,-655926,-654282.8,29.32047646770357,34.50101038103294,36.509827119269346,NaN,NaN,50
1652074200,1.05066,1.05115,1.05036,1.05076,2956,2002.1,-652970,-653730,30.466567381076903,35.36376670430167,36.03892875299408,NaN,NaN,50
1652076000,1.05076,1.05144,1.05052,1.05102,4253,2149.3,-648717,-652706.6,30.95106372619692,37.66286949542026,35.87342683169122,NaN,NaN,50
1652077800,1.05102,1.05118,1.04952,1.05029,3659,2268,-652376,-652765.2,32.170684657621734,34.00552379189655,35.48565741510663,NaN,NaN,50
1652079600,1.05029,1.05213,1.04978,1.0517,7136,2623.3,-645240,-651045.8,31.723131159459722,45.09573093185641,35.917375572861324,NaN,NaN,50
1652081400,1.0517,1.05295,1.05058,1.05118,6740,2950.35,-651980,-650256.6,30.21065459452492,42.27425135336286,36.52551938583323,NaN,NaN,50
1652083200,1.05118,1.05202,1.05076,1.05162,4520,3096.15,-647460,-649154.6,28.806212069942603,45.387864525054965,37.4518054859196,NaN,NaN,50
1652085000,1.05162,1.05163,1.05013,1.05074,4008,3231.95,-651468,-649704.8,28.128410686599974,40.663781477882836,37.589414477684954,NaN,NaN,50
1652086800,1.05074,1.05178,1.05046,1.05087,3902,3357.05,-647566,-648742.8,27.290061436139823,41.63030091372536,37.991775021030506,NaN,NaN,50
1652088600,1.05087,1.05304,1.05074,1.05281,3774,3476,-643792,-648453.2,25.6791645941002,53.740134012494636,39.57013988133091,NaN,NaN,50
1652090400,1.05281,1.05454,1.05262,1.0534,4617,3579.9,-639175,-645892.2,25.467989396662766,56.6834667425951,41.24774699607293,NaN,NaN,50
1652092200,1.0534,1.055,1.05328,1.0545,5023,3675.5,-634152,-643230.6,25.595864906037235,61.5902996130654,43.1954482607597,NaN,NaN,50
1652094000,1.0545,1.05452,1.05325,1.05391,5055,3732.7,-639207,-640778.4,25.677290365352956,57.80780708223708,44.54498831580198,NaN,NaN,50
1652095800,1.05391,1.05526,1.05384,1.0547,4771,3813.2,-634436,-638152.4,26.267470469371617,61.24027300858098,46.26050571667908,NaN,NaN,50
1652097600,1.0547,1.05736,1.05448,1.0564,9013,4122.2,-625423,-634478.6,27.905812359384708,67.38851824675295,48.60961342137337,NaN,NaN,50
1652099400,1.0564,1.05727,1.05572,1.05624,6933,4336.4,-632356,-633114.8,29.427129828682574,66.32220410694072,50.82093037870474,NaN,NaN,50
1652101200,1.05624,1.05634,1.05384,1.05429,6156,4500.5,-638512,-633986.8,28.77767094894394,54.91694963815722,52.053364674614514,NaN,NaN,50
1652103000,1.05429,1.05492,1.05306,1.05324,9196,4865.3,-647708,-635687,27.49063968986726,49.93717832681798,53.19133999853748,NaN,NaN,50
1652104800,1.05324,1.05346,1.05218,1.05277,5666,5061.05,-653374,-639474.6,25.598088465965535,47.84576561577604,53.387771047388874,NaN,NaN,50
1652106600,1.05277,1.05304,1.05172,1.05278,5447,5245.7,-647927,-643975.4,24.039668925725838,47.89576625804239,53.789307826294554,NaN,NaN,50
1652108400,1.05278,1.05354,1.0527,1.0533,4516,5367.05,-643411,-646186.4,22.441288495424853,50.550586849288564,54.15807370659696,NaN,NaN,50
1652110200,1.0533,1.05632,1.0532,1.0557,5932,5515.85,-637479,-645979.8,22.635650348338505,60.54315467592174,55.578028935028314,NaN,NaN,50
1652112000,1.0557,1.05926,1.05548,1.059,7593,5682.85,-629886,-642415.4,23.959753570650573,69.63056368767768,57.57804770459632,NaN,NaN,50
1652113800,1.059,1.05924,1.05735,1.05735,5347,5767.25,-635233,-638787.2,25.189277991368925,61.94810191347388,58.164331126094844,NaN,NaN,50
1652115600,1.05735,1.05753,1.05606,1.05679,3930,5606.95,-639163,-637034.4,25.340952697189085,59.546795088822165,58.368854579396775,NaN,NaN,50
1652117400,1.05679,1.05702,1.05526,1.05584,4471,5493.5,-643634,-637079,24.922204044629787,55.60873000478867,57.941599607377,NaN,NaN,50
1652119200,1.05584,1.05668,1.05523,1.05532,4405,5487.75,-648039,-639191,24.512210407673447,53.52220813217965,57.635485396658616,NaN,NaN,50
1652121000,1.05532,1.05669,1.05507,1.0566,4258,5500.25,-643781,-641970,24.011995666094215,57.72691053514948,57.38453093427065,NaN,NaN,50
1652122800,1.0566,1.05756,1.0559,1.0561,5492,5579.75,-649273,-644778,23.995079279125402,55.61054046897667,56.54324680728663,NaN,NaN,50
1652124600,1.0561,1.05642,1.0556,1.05584,4211,5601.6,-653484,-647642.2,23.73682551705753,54.49179210546218,55.69821737860959,NaN,NaN,50
1652126400,1.05584,1.05624,1.05572,1.05575,1322,5436.85,-654806,-649876.6,23.49701845228022,54.08617578848865,55.63887638934756,NaN,NaN,50
1652128200,1.05575,1.05614,1.05574,1.05602,683,5219.85,-654123,-651093.4,23.27434046355843,55.16441011130727,56.01225008823965,NaN,NaN,50
1652130000,1.05602,1.05658,1.05544,1.05582,918,5013,-655041,-653345.4,23.3396976460347,54.14998740868416,56.462551644875944,NaN,NaN,50
1652131800,1.05582,1.05593,1.05548,1.05578,513,4800.1,-655554,-654601.6,23.40038645833409,53.93636033217854,56.89402265017138,NaN,NaN,50
1652133600,1.05578,1.05588,1.05526,1.05559,1789,4438.9,-657343,-655373.4,23.217249773171943,52.86941844981103,57.05965347878013,NaN,NaN,50
1652135400,1.05559,1.05585,1.05548,1.0557,1026,4143.55,-656317,-655675.6,23.04719427980709,53.44361704598751,56.55254364807053,NaN,NaN,50
1652137200,1.0557,1.05604,1.05568,1.05592,1228,3897.15,-655089,-655868.8,23.03816737070485,54.63404753181815,55.481363922652,NaN,NaN,50
1652139000,1.05592,1.05692,1.05584,1.05634,1976,3536.15,-653113,-655483.2,23.668899621963035,56.89981449785594,55.120771964393576,NaN,NaN,50
1652140800,1.05634,1.05647,1.05532,1.05606,5805,3543.1,-658918,-656156,23.606638560653806,54.93016243667621,54.791012489240295,NaN,NaN,50
1652142600,1.05606,1.05653,1.05561,1.05588,4560,3498.75,-663478,-657383,23.59556201205755,53.644569187143794,54.65071528797994,NaN,NaN,50
1652144400,1.05588,1.05691,1.05551,1.05636,5448,3545.35,-658030,-657725.6,23.88407480257157,56.563985844657374,54.8679851245855,NaN,NaN,50
1652146200,1.05636,1.0568,1.05594,1.05623,4822,3489.85,-662852,-659278.2,24.1519795366203,55.54371106489555,54.71204230528165,NaN,NaN,50
1652148000,1.05623,1.05779,1.05598,1.05768,5183,3369.35,-657669,-660189.4,25.13327468763707,63.46050020142614,55.27275371474233,NaN,NaN,50
1652149800,1.05768,1.05799,1.05698,1.05728,4362,3320.1,-662031,-660812,26.177169582134894,60.27184869947355,55.68561490002885,NaN,NaN,50
1652151600,1.05728,1.05747,1.05695,1.05711,2776,3262.4,-664807,-661077.8,27.098503733665698,58.91691764521484,56.030667889795005,NaN,NaN,50
1652153400,1.05711,1.05798,1.05697,1.05788,1684,3123.05,-663123,-662096.4,28.30611518844738,62.976713021221286,56.588689526217436,NaN,NaN,50
1652155200,1.05788,1.0581,1.05744,1.05744,1465,2976.05,-664588,-662443.6,29.507819673919585,59.36652839562592,56.961299596713275,NaN,NaN,50
1652157000,1.05744,1.0581,1.05738,1.05758,1580,2842.15,-663008,-663511.4,30.512749807808916,60.149318307932944,57.405082309267165,NaN,NaN,50
1652158800,1.05758,1.05806,1.05737,1.05792,2831,2709.1,-660177,-663140.6,31.426238069877144,62.06086236217894,58.06161401729344,NaN,NaN,50
1652160600,1.05792,1.05854,1.05762,1.05767,3239,2660.5,-663416,-662862.4,32.639637569567434,59.78983842766791,58.514915544556324,NaN,NaN,50
1652162400,1.05767,1.05792,1.05664,1.05665,4610,2824.9,-668026,-663843,32.01244602194651,51.50805445436926,58.29163032473854,NaN,NaN,50
1652164200,1.05665,1.0568,1.05594,1.05606,4942,3037.85,-672968,-665519,30.431222637283696,47.416723755298165,57.61426670027013,NaN,NaN,50
1652166000,1.05606,1.05676,1.0551,1.05632,7398,3361.85,-665570,-666031.4,28.551455765771816,49.32689784697734,57.21403351529164,NaN,NaN,50
1652167800,1.05632,1.05785,1.0557,1.05572,7313,3701.85,-672883,-668572.6,27.341505648130127,45.24244435493478,56.61388174156242,NaN,NaN,50
1652169600,1.05572,1.0571,1.05542,1.05588,4990,3861.9,-667893,-669468,25.898204775738638,46.51430980994207,55.89604773908276,NaN,NaN,50
1652171400,1.05588,1.05756,1.05588,1.05724,4916,4056.4,-662977,-668458.2,24.997532156981357,55.89239554669711,55.92095377349715,NaN,NaN,50
1652173200,1.05724,1.05758,1.05586,1.05612,3910,4190.5,-666887,-667242,24.16119329670674,48.37059487179977,54.84310339280955,NaN,NaN,50
1652175000,1.05612,1.05637,1.05371,1.05394,4844,4333.9,-671731,-668474.2,23.624652395519586,37.72783745356059,53.232816875244346,NaN,NaN,50
1652176800,1.05394,1.05492,1.05356,1.05439,3778,4232.55,-667953,-667488.2,23.242345655668583,40.63164897992091,51.92672625629478,NaN,NaN,50
1652178600,1.05439,1.05536,1.05386,1.05534,3571,4183.1,-664382,-666786,22.39788192410749,46.32232603211877,50.7371271856446,NaN,NaN,50
1652180400,1.05534,1.05626,1.05468,1.05608,3642,4092.8,-660740,-666338.6,20.88309107765781,50.31724029208555,50.09074946396315,NaN,NaN,50
1652182200,1.05608,1.05667,1.05501,1.05533,4280,4065.7,-665020,-665965.2,19.847779521103355,46.53694382369926,49.1184370008036,NaN,NaN,50
1652184000,1.05533,1.05598,1.05484,1.0557,4370,4025.05,-660650,-663749,18.712010974880776,48.58900452857304,48.15616144126032,NaN,NaN,50
1652185800,1.0557,1.05614,1.05484,1.05518,5360,4074.95,-666010,-663360.4,17.813341924398525,45.92130479581768,47.16555189612816,NaN,NaN,50
1652187600,1.05518,1.05752,1.05506,1.05584,5788,4225.55,-660222,-662528.4,18.147838720111622,49.696362621029465,47.036145336603894,NaN,NaN,50
1652189400,1.05584,1.05617,1.05414,1.05438,7965,4539.6,-668187,-664017.8,17.485069643326465,42.610291418406824,46.692828741111654,NaN,NaN,50
1652191200,1.05438,1.05536,1.05351,1.05401,10547,4993.7,-678734,-666760.6,16.280044114993746,41.01423203899026,46.09906689768401,NaN,NaN,50
1652193000,1.05401,1.05484,1.05276,1.0541,9659,5397.65,-669075,-668445.6,15.709969152784991,41.587379926193464,45.837990867059624,NaN,NaN,50
1652194800,1.0541,1.05453,1.05252,1.05372,7663,5639.25,-676738,-670591.2,15.374665241208211,39.82771251150436,45.360376774314076,NaN,NaN,50
1652196600,1.05372,1.05466,1.05292,1.0531,5871,5770.85,-682609,-675068.6,14.928600718094632,37.07156339952119,44.01603162094437,NaN,NaN,50
1652198400,1.0531,1.05445,1.05264,1.05414,6229,5851.8,-676380,-676707.2,14.760465693478839,44.064093723108336,43.708424396037834,NaN,NaN,50
1652200200,1.05414,1.05468,1.05338,1.05338,5079,5858.65,-681459,-677252.2,14.343423175942377,40.52062586912119,43.90790928286359,NaN,NaN,50
1652202000,1.05338,1.05376,1.05264,1.0532,4897,5733.6,-686356,-680708.4,14.613663922784045,39.70621099437011,43.84180656960996,NaN,NaN,50
1652203800,1.0532,1.05416,1.05285,1.05376,4235,5579.7,-682121,-681785,14.395775377484924,43.51020444621673,43.64094074204553,NaN,NaN,50
1652205600,1.05376,1.054,1.0532,1.05324,3210,5490.7,-685331,-682329.4,14.193450299707166,40.92801631963512,42.970281886870495,NaN,NaN,50
1652207400,1.05324,1.05352,1.05276,1.05308,3382,5414,-688713,-684796,14.423711303799738,40.13868164337683,42.51326315970461,NaN,NaN,50
1652209200,1.05308,1.05388,1.05306,1.05336,3427,5389.85,-685286,-685561.4,14.175324800300263,42.23812658073647,42.05962902057343,NaN,NaN,50
1652211000,1.05336,1.05358,1.05284,1.05356,2567,5276,-682719,-684834,14.167309996286074,43.75550832676372,41.90492927278387,NaN,NaN,50
1652212800,1.05356,1.05358,1.05276,1.05306,909,5132.55,-683628,-685135.4,14.242862481605318,40.86527625476398,41.27413738947918,NaN,NaN,50
1652214600,1.05306,1.05314,1.05277,1.05299,848,4996.4,-684476,-684964.4,14.313018360830329,40.462314873237176,41.12071049339564,NaN,NaN,50
1652216400,1.05299,1.05328,1.05286,1.05293,131,4820.85,-684607,-684143.2,14.158342433384657,40.097340434647435,41.05521823594258,NaN,NaN,50
1652218200,1.05293,1.05322,1.05284,1.05306,1722,4692.95,-682885,-683663,14.040393974078064,41.33211852548925,41.036985278749434,NaN,NaN,50
1652220000,1.05306,1.05339,1.05296,1.05338,773,4513.1,-682112,-683541.6,13.640708908026895,44.37180697140829,41.36156345445686,NaN,NaN,50
1652221800,1.05338,1.05354,1.05328,1.05332,796,4284.9,-682908,-683397.6,13.012624787352618,43.91239558764538,41.85019432503715,NaN,NaN,50
1652223600,1.05332,1.05348,1.05318,1.05345,827,4036.85,-682081,-682918.6,12.587502519582824,45.235429893712436,41.933861194366024,NaN,NaN,50
1652225400,1.05345,1.05347,1.05288,1.0529,1386,3707.9,-683467,-682690.6,12.656772429745672,40.84554684900714,41.95706983578644,NaN,NaN,50
1652227200,1.0529,1.0534,1.0527,1.05328,2618,3311.45,-680849,-682283.4,12.987917588037881,44.82926486160966,42.323002254874986,NaN,NaN,50
1652229000,1.05328,1.05369,1.05312,1.05314,2712,2964.1,-683561,-682573.2,12.711054175113848,43.66261636973973,42.33388882084091,NaN,NaN,50
1652230800,1.05314,1.05329,1.05258,1.0531,2434,2702.65,-685995,-683190.6,13.25056509021996,43.31576688499689,42.50444243265247,NaN,NaN,50
1652232600,1.0531,1.05348,1.05257,1.05337,2678,2543,-683317,-683437.8,13.369880180245126,46.41034004888514,42.95241803304592,NaN,NaN,50
1652234400,1.05337,1.05378,1.05321,1.05344,2464,2354.75,-680853,-682915,12.90409012924964,47.21491893524703,43.307903201225244,NaN,NaN,50
1652236200,1.05344,1.05351,1.05292,1.05347,2262,2213.9,-678591,-682463.4,12.924951146534235,47.578170673040944,43.58095051167361,NaN,NaN,50
1652238000,1.05347,1.05385,1.05326,1.05378,1335,2035.8,-677256,-681202.4,12.303808549869899,51.30712487073294,44.32679684138569,NaN,NaN,50
1652239800,1.05378,1.05392,1.05327,1.05369,1306,1889.35,-678562,-679715.8,11.598526203570774,50.190865643497595,45.021693324975715,NaN,NaN,50
1652241600,1.05369,1.05384,1.05339,1.05368,1622,1809.95,-680184,-679089.2,10.943621167721586,50.06054143387081,45.73335053920596,NaN,NaN,50
1652243400,1.05368,1.05434,1.05351,1.05413,1538,1717.75,-678646,-678647.8,10.90367359690834,55.642249572355816,46.755502756839284,NaN,NaN,50
1652245200,1.05413,1.05464,1.05401,1.05458,1401,1616.45,-677245,-678378.6,11.34531698607029,60.40784449508721,47.900934008530626,NaN,NaN,50
1652247000,1.05458,1.05502,1.05394,1.0546,1664,1571.3,-675581,-678043.6,12.303685327567147,60.61039410547347,49.09364818837549,NaN,NaN,50
1652248800,1.0546,1.05494,1.05372,1.05444,3219,1686.8,-678800,-678091.2,12.70729446624846,58.05173662474358,50.009098669163436,NaN,NaN,50
1652250600,1.05444,1.0548,1.05398,1.05415,2980,1793.4,-681780,-678410.4,13.082074380738245,53.63241982602506,50.922446738950434,NaN,NaN,50
1652252400,1.05415,1.0561,1.05415,1.05526,4631,2018.4,-677149,-678111,15.025198338347916,64.70721132710449,52.34230005791435,NaN,NaN,50
1652254200,1.05526,1.05583,1.05484,1.05524,4137,2139.15,-681286,-678919.2,16.829527727556897,64.40870236325652,53.824163343165544,NaN,NaN,50
1652256000,1.05524,1.05633,1.05495,1.05578,5980,2399.5,-675306,-678864.2,18.966765939782253,68.6182061636535,55.63148043449816,NaN,NaN,50
1652257800,1.05578,1.05746,1.05518,1.05678,5935,2656.45,-669371,-676978.4,21.744567620638815,74.60758757510459,57.64556954351383,NaN,NaN,50
1652259600,1.05678,1.05758,1.0559,1.0563,5050,2867.6,-674421,-675506.6,24.394079381235585,67.90795790898486,59.12364375592368,NaN,NaN,50
1652261400,1.0563,1.05644,1.05571,1.05634,2947,2945.65,-671474,-674371.6,26.420901511785853,68.16451422925525,60.59409686708184,NaN,NaN,50
1652263200,1.05634,1.05676,1.05555,1.05564,3110,2970.25,-674584,-673031.2,28.521565934950864,59.23931132705973,61.160681613962325,NaN,NaN,50
1652265000,1.05564,1.05574,1.05451,1.05462,2154,2942.35,-676738,-673317.6,28.414385777336815,49.14212247783829,61.085771387843806,NaN,NaN,50
1652266800,1.05462,1.05554,1.05433,1.05552,4048,3023.05,-672690,-673981.4,28.012631633337502,56.2310934220757,61.526525101287014,NaN,NaN,50
1652268600,1.05552,1.0557,1.05446,1.0545,4653,3121.8,-677343,-674565.8,27.81000018354366,48.055642777621365,60.98462461594884,NaN,NaN,50
1652270400,1.0545,1.05564,1.05447,1.05492,5022,3249.7,-672321,-674735.2,27.62184240873509,51.20174797500939,60.32704629308614,NaN,NaN,50
1652272200,1.05492,1.05495,1.0502,1.0521,27637,4518.45,-699958,-679810,28.221655391512137,35.60758959724207,58.541131685355325,NaN,NaN,50
1652274000,1.0521,1.05647,1.05179,1.05591,17260,5314.7,-682698,-681002,27.24518338682432,55.38024145363246,58.35031060170453,NaN,NaN,50
1652275800,1.05591,1.05772,1.05492,1.05606,16652,6082,-666046,-679673.2,25.335009098888246,55.95368514980738,58.51611526768898,NaN,NaN,50
1652277600,1.05606,1.05704,1.05509,1.05663,13429,6672.35,-652617,-674728,23.561275831519033,58.15448604199693,58.048063461609864,NaN,NaN,50
1652279400,1.05663,1.05684,1.05444,1.05483,13124,7251.65,-665741,-673412,22.403669911845377,49.70793802034716,56.998008865687765,NaN,NaN,50
1652281200,1.05483,1.05552,1.05388,1.05487,10389,7701.05,-655352,-664490.8,21.726183916924295,49.882143052250726,55.65971864344471,NaN,NaN,50
1652283000,1.05487,1.0555,1.05326,1.05374,7623,7999,-662975,-660546.2,21.512730918415183,45.126630861694984,53.55393602105831,NaN,NaN,50
1652284800,1.05374,1.05456,1.05308,1.05316,6071,8141.6,-669046,-661146.2,21.43331140500546,42.86763243975154,51.7653413446845,NaN,NaN,50
1652286600,1.05316,1.05434,1.05288,1.05308,5686,8276.9,-674732,-665569.2,21.495466056483274,42.5512285618375,49.93582093986895,NaN,NaN,50
1652288400,1.05308,1.05354,1.05232,1.05244,6355,8363.1,-681087,-668638.4,21.926288946200923,40.00718268282503,48.56209746528076,NaN,NaN,50
1652290200,1.05244,1.0527,1.0515,1.05176,4405,8376.5,-685492,-674666.4,22.822540454331225,37.44549581008516,47.72662413186982,NaN,NaN,50
1652292000,1.05176,1.05329,1.05174,1.05298,6539,8404.45,-678953,-677862,22.99068287019406,44.33243008054272,46.876719607474605,NaN,NaN,50
1652293800,1.05298,1.05358,1.05266,1.05312,6636,8439.5,-672317,-678516.2,22.831144975138237,45.07965864965168,46.66414931261962,NaN,NaN,50
1652295600,1.05312,1.05317,1.05185,1.05261,4900,8432,-677217,-679013.2,23.22639067069198,42.824533396167666,46.065776842702356,NaN,NaN,50
1652297400,1.05261,1.0527,1.05139,1.05156,4493,8509.3,-681710,-679137.8,23.87716830691651,38.54885227636171,46.27586703406805,NaN,NaN,50
1652299200,1.05156,1.0516,1.05099,1.05114,1480,8427.8,-683190,-678677.4,24.720065634771423,36.9592780152746,44.96008393132821,NaN,NaN,50
1652301000,1.05114,1.05142,1.05102,1.05136,879,8364.05,-682311,-679349,25.502756010636702,38.392330911421695,43.70570148572923,NaN,NaN,50
1652302800,1.05136,1.0517,1.05122,1.0516,319,8177.6,-681992,-681284,25.856085767916575,39.99484856758224,42.40858452327103,NaN,NaN,50
1652304600,1.0516,1.05172,1.05148,1.05153,300,7959.95,-682292,-682299,26.15663908101779,39.67072570018024,41.69164078611625,NaN,NaN,50
1652306400,1.05153,1.05162,1.05122,1.05127,728,7745.25,-683020,-682561,26.634206670213818,38.425119299004194,40.873281946598645,NaN,NaN,50
1652308200,1.05127,1.05181,1.05127,1.05173,2096,6468.2,-680924,-682107.8,26.789955290785333,41.90087652043114,40.642870922222656,NaN,NaN,50
1652310000,1.05173,1.05184,1.05128,1.05128,1139,5662.15,-682063,-682058.2,26.887383850449737,39.548968255223016,40.40582348047062,NaN,NaN,50
1652311800,1.05128,1.0516,1.05106,1.05119,1158,4887.45,-683221,-682304,27.177643994167738,39.076548396756756,40.15763204010771,NaN,NaN,50
1652313600,1.05119,1.05183,1.05076,1.05172,3797,4405.85,-679424,-681730.4,27.713898503632496,43.36679421377147,40.39760429231817,NaN,NaN,50
1652315400,1.05172,1.05288,1.05154,1.05242,4191,3959.2,-675233,-680173,26.582876685853414,48.52286529140421,41.18884496955524,NaN,NaN,50
1652317200,1.05242,1.05258,1.05192,1.0524,3237,3601.6,-678470,-679682.2,25.532642140772836,48.38731641401554,41.47847970766044,NaN,NaN,50
1652319000,1.0524,1.0529,1.05214,1.05232,3773,3409.1,-682243,-679718.2,24.106159976178375,47.8119681812654,41.67364467420428,NaN,NaN,50
1652320800,1.05232,1.05294,1.05216,1.05273,2160,3213.55,-680083,-679090.6,22.724684992615856,51.02595280981793,42.25946034660787,NaN,NaN,50
1652322600,1.05273,1.05279,1.05126,1.05159,3764,3117.45,-683847,-679975.2,22.493207924006967,43.081416888632404,42.58321496177006,NaN,NaN,50
1652324400,1.05159,1.0524,1.05147,1.05234,2330,2916.2,-681517,-681232,22.278264931727282,48.73635654456757,43.42443485671955,NaN,NaN,50
1652326200,1.05234,1.05268,1.05216,1.05224,2000,2795.95,-683517,-682241.4,21.627890545084774,48.050870567625374,44.11433054644839,NaN,NaN,50
1652328000,1.05224,1.05256,1.05172,1.0518,1683,2553.15,-685200,-682832.8,21.53284707111529,45.048507022841896,44.475306150395504,NaN,NaN,50
1652329800,1.0518,1.05254,1.05169,1.05178,1418,2292.25,-686618,-684139.8,21.478686159638,44.911141383217945,44.849621556326774,NaN,NaN,50
1652331600,1.05178,1.05208,1.0509,1.05116,2507,2172.6,-689125,-685195.4,22.249941917470366,40.76164153560514,45.016516001798266,NaN,NaN,50
1652333400,1.05116,1.05122,1.04996,1.05014,3121,2104,-692246,-687341.2,23.72485903569233,35.02777729596734,44.52558034290799,NaN,NaN,50
1652335200,1.05014,1.05094,1.04904,1.05055,7308,2395.4,-684938,-687625.4,25.673056921547943,38.75701817775976,44.469012480232045,NaN,NaN,50
1652337000,1.05055,1.05151,1.05026,1.05036,6166,2659.75,-691104,-688806.2,26.549431595966094,37.67774340949879,44.36909783828505,NaN,NaN,50
1652338800,1.05036,1.0505,1.04432,1.04636,19519,3619.75,-710623,-693607.2,29.546320672176336,23.095998760693973,42.92118387735094,NaN,NaN,50
1652340600,1.04636,1.04796,1.04495,1.04596,10363,4122.9,-720986,-699979.4,32.32914624294299,22.171912641529445,41.03897297378847,NaN,NaN,50
1652342400,1.04596,1.04652,1.04462,1.04538,7741,4473.55,-728727,-707275.6,34.98238797851693,20.868111001824943,39.07331544434628,NaN,NaN,50
1652344200,1.04538,1.04592,1.04404,1.04406,5567,4647.1,-734294,-717146.8,37.56606161938097,18.239364606710836,36.960986617592376,NaN,NaN,50
1652346000,1.04406,1.04462,1.0423,1.0434,7703,4975.3,-741997,-727325.4,40.27613115693556,17.080779538663293,34.536331383938474,NaN,NaN,50
1652347800,1.0434,1.0434,1.04221,1.04272,5286,5181.7,-747283,-734657.4,42.80720833304685,15.956182640630061,32.598814651938305,NaN,NaN,50
1652349600,1.04272,1.04414,1.04266,1.04408,5049,5244.3,-742234,-738907,44.2947528575853,26.394155701593007,31.00294316315441,NaN,NaN,50
1652351400,1.04408,1.04411,1.04284,1.04366,4179,5243.7,-746413,-742444.2,45.67604420179958,25.34718344237666,29.381251225636642,NaN,NaN,50
1652353200,1.04366,1.04438,1.04194,1.04224,5088,5336.25,-751501,-745885.6,47.18827633625664,22.14834428577879,27.745525315846415,NaN,NaN,50
1652355000,1.04224,1.04229,1.03888,1.03996,8058,5550.5,-759559,-749398,49.17149841859264,18.180911826280536,25.836223204636607,NaN,NaN,50
1652356800,1.03996,1.04238,1.0395,1.04194,7147,5799.85,-752412,-750423.8,50.91702399849132,29.920996302754588,25.061891402290136,NaN,NaN,50
1652358600,1.04194,1.04382,1.04107,1.04152,11285,6175.9,-763697,-754716.4,51.087799361298536,28.97136646930467,24.62929062895709,NaN,NaN,50
1652360400,1.04152,1.04258,1.04143,1.04163,8312,6475,-755385,-756510.8,51.24637648390523,29.60155348850887,23.97532886543917,NaN,NaN,50
1652362200,1.04163,1.04166,1.03966,1.03992,12040,6977,-767425,-759695.6,51.870148789367654,25.773350315245608,23.125015072992515,NaN,NaN,50
1652364000,1.03992,1.04158,1.03836,1.04019,9860,7385.85,-757565,-759296.8,52.739621462915096,27.370500888541486,23.430336653553052,NaN,NaN,50
1652365800,1.04019,1.04172,1.0397,1.04122,8554,7742.65,-749011,-758616.6,53.41061331741164,33.269377640720435,24.223012724923837,NaN,NaN,50
1652367600,1.04122,1.0425,1.04084,1.041,6760,7955.3,-755771,-757031.4,53.277736303643486,32.6592335613406,25.06523576488924,NaN,NaN,50
1652369400,1.041,1.04113,1.03716,1.03749,5962,8097.35,-761733,-758301,54.0162435791932,24.833914894824076,25.536275071183045,NaN,NaN,50
1652371200,1.03749,1.03891,1.03666,1.03887,7426,8103.25,-754307,-755677.4,54.793374849424694,31.757161182448968,26.584588045739164,NaN,NaN,50
1652373000,1.03887,1.03909,1.03546,1.03579,7334,8161.65,-761641,-756492.6,55.72387865355354,26.000986235239097,27.302074016782665,NaN,NaN,50
1652374800,1.03579,1.03746,1.03538,1.03683,6528,7512.1,-755113,-757713,56.601583515262945,30.57675952885411,27.600831433015603,NaN,NaN,50
1652376600,1.03683,1.03698,1.03604,1.03685,3295,7158.7,-751818,-756922.4,57.41659517256454,30.66555053531468,27.98071479679689,NaN,NaN,50
1652378400,1.03685,1.03752,1.03655,1.0372,3820,6962.65,-747998,-754175.4,57.63968235155667,32.29744433525798,28.70565051461683,NaN,NaN,50
1652380200,1.0372,1.03729,1.03653,1.03703,3182,6843.4,-751180,-753550,57.85182559351681,31.90465254621195,29.685917708897644,NaN,NaN,50
1652382000,1.03703,1.0377,1.03678,1.03714,3202,6618.35,-747978,-750817.4,57.617224258406615,32.47688849323629,29.868481436789192,NaN,NaN,50
1652383800,1.03714,1.03772,1.03708,1.03732,3487,6528.4,-744491,-748693,57.37760344420343,33.46223818988874,30.18925798825948,NaN,NaN,50
1652385600,1.03732,1.03797,1.03727,1.03794,649,6308.4,-743842,-747097.8,56.8700958866568,36.879007274675885,30.70907611584284,NaN,NaN,50
1652387400,1.03794,1.03829,1.03764,1.0381,688,6133.85,-743154,-746129,56.02931064473143,37.767144646448294,31.56577571092875,NaN,NaN,50
1652389200,1.0381,1.03825,1.03762,1.03822,234,5891.15,-742920,-744477,55.25764731122944,38.46644584366962,32.358343207723614,NaN,NaN,50
1652391000,1.03822,1.03832,1.03803,1.0381,671,5521.8,-743591,-743599.6,54.451492712471946,38.00652050242811,32.69671055498845,NaN,NaN,50
1652392800,1.0381,1.03838,1.038,1.03824,1201,5224.5,-742390,-743179.4,53.62156686480299,38.92402283146712,33.144195502854636,NaN,NaN,50
1652394600,1.03824,1.03826,1.0378,1.03782,790,4699.75,-743180,-743047,52.96368063398435,37.147789260622865,34.023757957554544,NaN,NaN,50
1652396400,1.03782,1.03817,1.03776,1.03779,798,4324.05,-743978,-743211.8,52.376262591770896,37.017847077175105,34.39952123574927,NaN,NaN,50
1652398200,1.03779,1.03844,1.03779,1.03784,1237,3783.9,-742741,-743176,51.40477006510454,37.41080853942766,35.214508543191315,NaN,NaN,50
1652400000,1.03784,1.03809,1.03732,1.03798,2695,3425.65,-740046,-742467,50.81627510851139,38.56660063791372,35.785211479552714,NaN,NaN,50
1652401800,1.03798,1.03841,1.0377,1.03808,3695,3182.7,-736351,-741259.2,49.75898343003737,39.42703131603417,36.411031535318386,NaN,NaN,50
1652403600,1.03808,1.03896,1.03774,1.03812,3475,3018.45,-732876,-739198.4,47.95494351397243,39.79029544093974,36.94623518572423,NaN,NaN,50
1652405400,1.03812,1.03832,1.03744,1.0378,3866,2913.65,-736742,-737751.2,46.535171263492344,37.835429458291124,37.369862108015596,NaN,NaN,50
1652407200,1.0378,1.03879,1.03773,1.03866,2873,2686,-733869,-735976.8,44.53987089624638,45.57429100808316,38.30539085907609,NaN,NaN,50
1652409000,1.03866,1.03918,1.03852,1.03898,2564,2447.5,-731305,-734228.6,42.16167070053195,48.16031587340182,39.3552535507556,NaN,NaN,50
1652410800,1.03898,1.0398,1.03878,1.03956,2348,2238.5,-728957,-732749.8,39.19058779777389,52.56013426748515,40.475334050241976,NaN,NaN,50
1652412600,1.03956,1.03978,1.03909,1.03912,2070,2177.25,-731027,-732380,36.43172510235569,49.151953995433395,41.28853471802662,NaN,NaN,50
1652414400,1.03912,1.03946,1.03889,1.03938,2070,2089.75,-728957,-730823,34.11614288261823,51.166999495810416,42.19571712175097,NaN,NaN,50
1652416200,1.03938,1.03976,1.03905,1.03972,1491,2005.2,-727466,-729542.4,31.78658641597716,53.74824356441376,43.320125911892795,NaN,NaN,50
1652418000,1.03972,1.03986,1.03946,1.03972,1425,1916.35,-727466,-728774.6,29.754858460718214,53.74824356441376,44.37899882138898,NaN,NaN,50
1652419800,1.03972,1.04017,1.03947,1.03957,2226,1853.3,-729692,-728921.6,28.273559170449346,52.33286732613011,45.463647254639504,NaN,NaN,50
1652421600,1.03957,1.04016,1.03852,1.03878,4714,2056.55,-734406,-729597.4,26.873763758405183,45.53226480269505,46.0718199493195,NaN,NaN,50
1652423400,1.03878,1.0406,1.03868,1.03928,5365,2290.4,-729041,-729614.2,24.99261976939909,49.96408661166176,46.96848266876479,NaN,NaN,50
1652425200,1.03928,1.0413,1.03838,1.0411,8994,2728.4,-720047,-728130.4,23.985646743911566,62.06396440533035,48.64686579500884,NaN,NaN,50
1652427000,1.0411,1.04198,1.03982,1.04158,7406,3065.15,-712641,-725165.4,23.727266937083932,64.50209207564774,50.43794156355267,NaN,NaN,50
1652428800,1.04158,1.04195,1.0405,1.04091,4074,3208.8,-716715,-722570,23.487342830743984,58.81952869689563,51.79717251040666,NaN,NaN,50
1652430600,1.04091,1.04091,1.03989,1.0408,3372,3337.9,-720087,-719706.2,22.408279866294674,57.917372156768465,53.231596988869335,NaN,NaN,50
1652432400,1.0408,1.04089,1.0384,1.03882,3461,3471.05,-723548,-718607.6,21.816176167980018,44.644014647949476,53.16514867743121,NaN,NaN,50
1652434200,1.03882,1.03918,1.03724,1.03745,4218,3620.1,-727766,-720151.4,22.175770967464594,38.13217649386753,52.44885300746448,NaN,NaN,50
1652436000,1.03745,1.03856,1.03707,1.03856,3479,3659.3,-724287,-722480.6,22.629134866160115,45.11714063397232,51.9172106050707,NaN,NaN,50
1652437800,1.03856,1.03892,1.03777,1.03882,3294,3639.25,-720993,-723336.2,22.59519380159672,46.63690210223643,51.73756404127092,NaN,NaN,50
1652439600,1.03882,1.03984,1.03858,1.03882,3103,3620.65,-720993,-723517.4,21.516524666777574,46.63690210223643,51.41398565601564,NaN,NaN,50
1652441400,1.03882,1.03938,1.0382,1.03828,3624,3608.55,-724617,-723731.2,20.849766065057853,43.72071280318919,50.697733458785315,NaN,NaN,50
1652443200,1.03828,1.03926,1.03744,1.03762,4125,3671.15,-728742,-723926.4,20.8479426783034,40.39596389459561,49.74399919665545,NaN,NaN,50
1652445000,1.03762,1.0384,1.03734,1.03778,4223,3754.1,-724519,-723972.8,20.92402953764029,41.55626396683815,48.97424181384888,NaN,NaN,50
1652446800,1.03778,1.03794,1.03492,1.03582,5348,3904.1,-729867,-725747.6,22.46637216930642,33.0648194257525,48.08371000121012,NaN,NaN,50
1652448600,1.03582,1.0377,1.03579,1.03645,7610,4181.1,-722257,-726000.4,23.89854747013926,37.48650657950929,47.1924542846278,NaN,NaN,50
1652450400,1.03645,1.03888,1.03644,1.03818,9940,4574.6,-712317,-723540.4,23.906700517810528,47.70297493399833,46.166669322389794,NaN,NaN,50
1652452200,1.03818,1.03968,1.03778,1.03943,6528,4826.45,-705789,-718949.8,23.14726342793477,53.60314055685649,45.38817278533328,NaN,NaN,50
1652454000,1.03943,1.0416,1.03917,1.0415,5150,5012.7,-700639,-714173.8,22.025329367096326,61.374639315700556,45.57068068667649,NaN,NaN,50
1652455800,1.0415,1.0416,1.04049,1.04116,3625,5082.65,-704264,-709053.2,20.98353345346063,59.60852888263985,45.6914775956673,NaN,NaN,50
1652457600,1.04116,1.04154,1.04076,1.04084,2721,4983,-706985,-705998.8,20.016151533656053,57.919226475281576,46.639707011905315,NaN,NaN,50
1652459400,1.04084,1.04154,1.04058,1.04088,2586,4844.05,-704399,-704415.2,18.956985245126138,58.0791541895235,48.064491133023594,NaN,NaN,50
1652461200,1.04088,1.0416,1.04084,1.04094,2287,4508.7,-702112,-703679.8,18.02405791772508,58.334946744264705,49.00862014090162,NaN,NaN,50
1652463000,1.04094,1.04113,1.03974,1.03988,2239,4250.35,-704351,-704422.2,17.28759158088759,52.26721313835493,49.41078521491009,NaN,NaN,50
1652464800,1.03988,1.0402,1.03937,1.03983,2536,4173.45,-706887,-704946.8,16.89695815076998,51.99249509679339,49.79332757166416,NaN,NaN,50
1652466600,1.03983,1.04055,1.0397,1.04048,2943,4152,-703944,-704338.6,16.187980285584885,55.2829717035683,50.61920320740552,NaN,NaN,50
1652468400,1.04048,1.04086,1.03987,1.03998,1171,4037.5,-705115,-704481.8,15.226240649488654,52.31268730545582,51.47039773675267,NaN,NaN,50
1652470200,1.03998,1.04053,1.03964,1.04016,1707,3911.95,-703408,-704741,14.546867965463155,53.28575525828217,52.30821854328439,NaN,NaN,50
1652472000,1.04016,1.04036,1.03998,1.04034,688,3772.4,-702720,-704414.8,13.916021901725193,54.290218727355956,53.82431849339893,NaN,NaN,50
1652473800,1.04034,1.04092,1.04018,1.04072,1053,3660.35,-701667,-703370.8,13.117115441311231,56.42062104883237,55.176755241207715,NaN,NaN,50
1652648400,1.04072,1.04072,1.03968,1.04008,270,3518.7,-701937,-702969.4,12.508598660181674,52.02289603941789,55.485321034451964,NaN,NaN,50
1652650200,1.04008,1.04034,1.0398,1.03982,213,3348.15,-702150,-702376.4,11.943547363418515,50.30736020760629,55.24990815236267,NaN,NaN,50
1652652000,1.03982,1.04146,1.03982,1.04086,2276,3255.7,-699874,-701669.6,11.930233079020754,56.488318460351216,54.900885234123436,NaN,NaN,50
1652653800,1.04086,1.0409,1.04,1.04053,2305,3159.8,-702179,-701561.4,11.917869814937118,54.18523341840741,54.51350698667826,NaN,NaN,50
1652655600,1.04053,1.04056,1.04002,1.04026,1114,2948.1,-703293,-701886.6,11.906389641145172,52.306181199144866,54.11257518123993,NaN,NaN,50
1652657400,1.04026,1.04051,1.03975,1.0398,1888,2662,-705181,-702535.4,11.536810871307823,49.177216962789714,53.476722522187515,NaN,NaN,50
1652659200,1.0398,1.04056,1.03977,1.04032,2164,2273.2,-703017,-702708.8,11.252836626392531,52.62712503340516,53.06902097141183,NaN,NaN,50
1652661000,1.04032,1.04111,1.04014,1.04102,2125,2053.05,-700892,-702912.4,11.618065286664924,56.871313767764356,53.39788530208393,NaN,NaN,50
1652662800,1.04102,1.04174,1.04064,1.04124,2900,1940.55,-697992,-702075,12.585320543250978,58.14062184242611,53.837037212486266,NaN,NaN,50
1652664600,1.04124,1.04134,1.04002,1.04053,3692,1943.9,-701684,-701753.2,12.587147173435866,52.74544002722957,53.655784949890645,NaN,NaN,50
1652666400,1.04053,1.04053,1.0394,1.03986,6224,2119.05,-707908,-702298.6,11.80497458858319,48.20001285537942,53.362022489170904,NaN,NaN,50
1652668200,1.03986,1.04038,1.03946,1.04026,3972,2188.35,-703936,-702482.4,11.078671474077133,50.91939097646904,53.1929964690414,NaN,NaN,50
1652670000,1.04026,1.04029,1.03892,1.03958,3342,2241.1,-707278,-703759.6,10.821021689179613,46.45458926088833,52.633308650008,NaN,NaN,50
1652671800,1.03958,1.03982,1.03916,1.03966,1753,2216.8,-705525,-705266.2,10.581775460346202,47.042902882939416,51.9634716381585,NaN,NaN,50
1652673600,1.03966,1.0399,1.03934,1.0398,1350,2157.5,-704175,-705764.4,10.243210484560237,48.11722030347835,51.6844947998771,NaN,NaN,50
1652675400,1.0398,1.04001,1.03972,1.03997,1112,2065.95,-703063,-704795.4,9.762797713872299,49.45802711221268,51.62382815020613,NaN,NaN,50
1652677200,1.03997,1.04074,1.03994,1.04034,1786,2096.7,-701277,-704263.6,9.817308603480242,52.34466296960675,51.3278527580101,NaN,NaN,50
1652679000,1.04034,1.04079,1.04008,1.04012,1261,2074.4,-702538,-703315.6,9.931244976197275,50.49786877294455,51.06446956904847,NaN,NaN,50
1652680800,1.04012,1.04064,1.03956,1.04054,3209,2200.45,-699329,-702076.4,9.242185628126965,53.84574311638385,51.174438277422674,NaN,NaN,50
1652682600,1.04054,1.04096,1.0395,1.04037,2920,2293.8,-702249,-701691.2,9.044539962862826,52.30381911839367,51.39776700282296,NaN,NaN,50
1652684400,1.04037,1.04252,1.0403,1.04218,4370,2498.8,-697879,-700654.4,10.50316347114846,64.09343774682378,52.21678933949572,NaN,NaN,50
1652686200,1.04218,1.04261,1.04076,1.04088,4672,2721.75,-702551,-700909.2,11.9333890964169,53.80621677202677,51.997853839800186,NaN,NaN,50
1652688000,1.04088,1.0427,1.04064,1.04252,4311,2823.5,-698240,-700049.6,13.064328506964419,62.075838885749455,52.27894077146613,NaN,NaN,50
1652689800,1.04252,1.04344,1.04189,1.0433,3728,2894.65,-694512,-699086.2,14.74975808671741,65.26115773325456,53.17292060761076,NaN,NaN,50
1652691600,1.0433,1.04358,1.04196,1.04229,2937,2985.8,-697449,-698126.2,16.425517636873906,58.41886715513018,53.90283877187868,NaN,NaN,50
1652693400,1.04229,1.04242,1.04151,1.04158,2078,2995.3,-699527,-698455.8,17.210609839837936,54.123005345987345,54.131668369701416,NaN,NaN,50
1652695200,1.04158,1.04277,1.04154,1.04255,2719,3023.05,-696808,-697307.2,18.257937580887585,58.60194468717634,54.999336614436274,NaN,NaN,50
1652697000,1.04255,1.04382,1.04228,1.04357,2517,3042.65,-694291,-696517.4,20.0359382709946,62.723220893575835,56.11935932948173,NaN,NaN,50
1652698800,1.04357,1.0438,1.04252,1.04272,3189,3057.1,-697480,-697111,21.686938911808255,57.57900296148195,56.795200947910566,NaN,NaN,50
1652700600,1.04272,1.04278,1.04175,1.04188,3019,3023.45,-700499,-697721,21.958187789628543,52.95671411552414,57.04510716243281,NaN,NaN,50
1652702400,1.04188,1.04266,1.04128,1.04242,3427,2883.6,-697072,-697230,21.53752643913952,55.43356571036624,57.265743072487055,NaN,NaN,50
1652704200,1.04242,1.04346,1.04224,1.04235,4805,2925.25,-701877,-698243.8,21.87177884501754,55.029098149548375,57.58940231367304,NaN,NaN,50
1652706000,1.04235,1.04334,1.04224,1.04228,3723,2944.3,-705600,-700505.6,22.182156079047136,54.600067083413265,57.64328259703229,NaN,NaN,50
1652707800,1.04228,1.04274,1.04022,1.04044,5895,3151.4,-711495,-703308.6,21.082514800400368,44.72851779269873,57.10218964519693,NaN,NaN,50
1652709600,1.04044,1.04221,1.04002,1.0422,5577,3362.75,-705918,-704392.4,20.242020084015603,53.406133635043446,56.33881078006977,NaN,NaN,50
1652711400,1.0422,1.04224,1.03894,1.0403,6294,3621.85,-712212,-707420.4,20.344117751731638,45.16275333430623,55.7214205345183,NaN,NaN,50
1652713200,1.0403,1.04068,1.03977,1.04046,3947,3729.9,-708265,-708698,20.43892272889653,45.91976716774107,54.56741541180342,NaN,NaN,50
1652715000,1.04046,1.042,1.03998,1.04197,3780,3855.85,-704485,-708475,19.120166501175923,52.57384315289281,53.661178656063285,NaN,NaN,50
1652716800,1.04197,1.04224,1.04157,1.04197,2199,3805.35,-704485,-707073,17.837048055199286,52.57384315289281,53.243676941617764,NaN,NaN,50
1652718600,1.04197,1.04282,1.04195,1.04252,2126,3765.65,-702359,-706361.2,17.168284559190788,54.917080828502115,53.30039661894024,NaN,NaN,50
1652720400,1.04252,1.0428,1.04178,1.04218,1791,3636.7,-704150,-704748.8,16.37035728233542,53.16823485490291,52.912274488063574,NaN,NaN,50
1652722200,1.04218,1.04262,1.04198,1.04254,2257,3515.95,-701893,-703474.4,15.629424810969716,54.809211149016775,52.34698807773792,NaN,NaN,50
1652724000,1.04254,1.04268,1.04215,1.04262,1955,3398.15,-699938,-702565,15.003596301158224,55.1850115493879,52.17598869115977,NaN,NaN,50
1652725800,1.04262,1.04419,1.04262,1.04372,2754,3349.45,-697184,-701104.8,15.757126015511833,60.09843936135682,52.686111923004965,NaN,NaN,50
1652727600,1.04372,1.04432,1.04362,1.04362,2172,3311.2,-699356,-700504.2,16.553942089319847,59.46020571354761,52.973729066089355,NaN,NaN,50
1652729400,1.04362,1.04368,1.04306,1.04324,2289,3321.75,-701645,-700003.2,16.585842080803168,56.98372135212281,53.113345009130384,NaN,NaN,50
1652731200,1.04324,1.04327,1.043,1.04316,657,3218.65,-702302,-700085,16.540824009469326,56.45066962585061,53.24553090501877,NaN,NaN,50
1652733000,1.04316,1.04354,1.0431,1.04343,492,3117.4,-701810,-700459.4,16.748070728384395,57.882653121836086,54.18511199995716,NaN,NaN,50
1652734800,1.04343,1.04358,1.04326,1.04358,147,2965.3,-701663,-701355.2,16.97834959890995,58.69523817866849,54.56290518164466,NaN,NaN,50
1652736600,1.04358,1.04373,1.04355,1.04361,182,2823.45,-701481,-701780.2,17.340045957251316,58.86616950363333,55.54172062231088,NaN,NaN,50
1652738400,1.04361,1.04387,1.04286,1.04312,2401,2772.15,-703882,-702227.6,16.685727240163693,54.87195418652908,56.18116255222431,NaN,NaN,50
1652740200,1.04312,1.04362,1.04298,1.04361,1914,2627.6,-701968,-702160.8,16.078145574296613,57.94499328712279,56.56481613324074,NaN,NaN,50
1652742000,1.04361,1.04372,1.04354,1.04371,1166,2499.75,-700802,-701959.2,15.63683389352985,58.565114102093716,56.99276405818366,NaN,NaN,50
1652743800,1.04371,1.044,1.04359,1.04392,1301,2270.05,-699501,-701526.8,15.571167546688855,59.90227096392316,57.34884906785659,NaN,NaN,50
1652745600,1.04392,1.04486,1.04389,1.04472,2833,2132.85,-696668,-700564.2,16.425666515633967,64.5903337466637,58.164713274410914,NaN,NaN,50
1652747400,1.04472,1.04544,1.04465,1.04472,2450,1940.65,-696668,-699121.4,17.728511550305875,64.59033374666372,58.86336488852856,NaN,NaN,50
1652749200,1.04472,1.04472,1.0435,1.04368,2496,1868.1,-699164,-698560.6,17.268021015847566,54.91099527140173,58.84379229724383,NaN,NaN,50
1652751000,1.04368,1.04498,1.04354,1.0449,3734,1865.8,-695430,-697486.2,17.097475013016194,62.088316626864135,58.985926387637214,NaN,NaN,50
1652752800,1.0449,1.04502,1.04373,1.04437,1844,1848.05,-697274,-697040.8,16.9796991020627,57.78496052031064,58.86626601669171,NaN,NaN,50
1652754600,1.04437,1.04448,1.04372,1.0438,1258,1804.65,-698532,-697413.6,16.85554112928808,53.490965769756585,58.616783475094124,NaN,NaN,50
1652756400,1.0438,1.0439,1.0432,1.04379,1267,1778.45,-699799,-698039.8,15.988742152621537,53.41597157468824,58.40001932858252,NaN,NaN,50
1652758200,1.04379,1.0443,1.04332,1.04402,1487,1739.95,-698312,-697869.4,15.662381772607903,54.97937565783309,58.19264236686803,NaN,NaN,50
1652760000,1.04402,1.0444,1.04359,1.04404,960,1690.2,-697352,-698253.8,15.476882497462569,55.12042458343951,57.937298538637386,NaN,NaN,50
1652761800,1.04404,1.04439,1.04376,1.04408,862,1595.6,-696490,-698097,15.304633170541898,55.421240579462385,57.69123218691089,NaN,NaN,50
1652763600,1.04408,1.04474,1.04404,1.04436,1300,1552,-695190,-697428.6,15.580137839116123,57.565390367514766,57.883620485552726,NaN,NaN,50
1652765400,1.04436,1.04518,1.04406,1.04473,1787,1526.9,-693403,-696149.4,16.33662342728711,60.28384867056221,58.050681584369826,NaN,NaN,50
1652767200,1.04473,1.04576,1.04464,1.0455,4344,1711.25,-689059,-694298.8,17.617036444066205,65.27015538830496,58.529613104813485,NaN,NaN,50
1652769000,1.0455,1.04646,1.0454,1.0458,3922,1882.75,-685137,-691855.8,19.39146092250475,67.00809407459178,59.037171898432675,NaN,NaN,50
1652770800,1.0458,1.04748,1.04542,1.04612,4793,2115.05,-680344,-688626.6,21.711724950343132,68.80150051187748,59.33796952451937,NaN,NaN,50
1652772600,1.04612,1.04648,1.04517,1.04638,3588,2285.35,-676756,-684939.8,23.41708109421949,70.21805233755413,59.73994942386869,NaN,NaN,50
1652774400,1.04638,1.04838,1.04564,1.04806,6175,2474.05,-670581,-680375.4,25.984383266576906,77.36849356775147,61.34405644503652,NaN,NaN,50
1652776200,1.04806,1.04922,1.04742,1.04903,4849,2620.8,-665732,-675710,28.68051096467905,80.30824909021275,62.64548019241857,NaN,NaN,50
1652778000,1.04903,1.04921,1.0475,1.04778,3551,2740.05,-669283,-672539.2,31.184058112916762,68.04233490060275,63.37814979101086,NaN,NaN,50
1652779800,1.04778,1.04821,1.0469,1.04752,3007,2825.35,-672290,-670928.4,32.55206554335249,65.79143018833943,64.25675439233821,NaN,NaN,50
1652781600,1.04752,1.05206,1.04752,1.05182,6847,3026.05,-665443,-668665.8,35.103483888325975,78.47425299302797,66.04663163650534,NaN,NaN,50
1652783400,1.05182,1.05276,1.05063,1.05158,5864,3196.75,-671307,-668811,37.62233125273237,76.76359272198961,67.60264714108794,NaN,NaN,50
1652785200,1.05158,1.05348,1.05144,1.05322,4943,3319.1,-666364,-668937.4,40.105547959092824,79.97583493727755,69.37803359493351,NaN,NaN,50
1652787000,1.05322,1.05558,1.05297,1.05394,6760,3470.4,-659604,-667001.6,42.75922809982248,81.20432212226993,71.21968227656262,NaN,NaN,50
1652788800,1.05394,1.05474,1.05312,1.0536,4605,3608.45,-664209,-665385.4,45.223359659071455,78.74744306145553,72.73268604041554,NaN,NaN,50
1652790600,1.0536,1.05496,1.05275,1.0543,6903,3890.7,-657306,-663758,47.07108222076578,80.08348989185266,74.14694612765058,NaN,NaN,50
1652792400,1.0543,1.0544,1.0527,1.0533,4516,4053.15,-661822,-661861,48.72527406603464,73.02119167775179,74.70059157689677,NaN,NaN,50
1652794200,1.0533,1.054,1.05254,1.054,4288,4193.2,-657534,-660095,50.05386558583722,74.70292123772029,75.25022208854882,NaN,NaN,50
1652796000,1.054,1.05431,1.05269,1.05376,5438,4417.1,-662972,-660768.6,51.3677824852157,73.02223591611597,75.55170318885156,NaN,NaN,50
1652797800,1.05376,1.05453,1.05255,1.05346,6915,4719.75,-669887,-661904.2,52.64553826463474,70.87568695101152,75.59867708981281,NaN,NaN,50
1652799600,1.05346,1.05383,1.05278,1.05348,3522,4830.85,-666365,-663716,53.832025774095285,70.93702347893745,75.13928636918322,NaN,NaN,50
1652801400,1.05348,1.05438,1.05315,1.05326,2398,4861.4,-668763,-665104.2,55.08548853664548,69.21034343157861,74.34657882213794,NaN,NaN,50
1652803200,1.05326,1.05511,1.05301,1.05456,2844,4786.4,-665919,-666781.2,56.43315870328334,73.33992155782937,74.72497786908271,NaN,NaN,50
1652805000,1.05456,1.05462,1.05378,1.05432,2378,4709.2,-668297,-667846.2,57.684566715161345,71.43505397058567,75.12809385352885,NaN,NaN,50
1652806800,1.05432,1.05506,1.0539,1.05442,2761,4607.6,-665536,-666976,58.95657456178217,71.76413203558138,74.64879949942552,NaN,NaN,50
1652808600,1.05442,1.05528,1.05425,1.05462,2360,4546.2,-663176,-666338.2,60.19172793048693,72.44778657229503,74.3405276315902,NaN,NaN,50
1652810400,1.05462,1.0555,1.05254,1.0533,18858,5180.35,-682034,-668992.4,58.75492563667677,61.81059249179507,73.04301031405573,NaN,NaN,50
1652812200,1.0533,1.0547,1.05214,1.05432,10131,5444.45,-671903,-670189.2,56.9288905845244,65.96866340990779,71.95474897745844,NaN,NaN,50
1652814000,1.05432,1.05452,1.05376,1.05411,3885,5461.15,-675788,-671687.4,55.23328660752578,64.41366206673037,70.9309074778352,NaN,NaN,50
1652815800,1.05411,1.05502,1.05396,1.05459,2883,5454.95,-672905,-673161.2,53.976263833566364,66.36524910550506,69.95103313595324,NaN,NaN,50
1652817600,1.05459,1.05492,1.05426,1.0544,1113,5168.25,-674018,-675329.6,52.80902840060405,64.84922378237161,69.36732114342608,NaN,NaN,50
1652819400,1.0544,1.05538,1.0544,1.05536,1087,4929.4,-672931,-673509,52.020407372052546,68.735387498341,68.94106873347042,NaN,NaN,50
1652821200,1.05536,1.05536,1.0548,1.05506,730,4718.75,-673661,-673860.6,51.28811641696901,66.26971177291009,68.45874558038429,NaN,NaN,50
1652823000,1.05506,1.05518,1.05492,1.05504,878,4424.65,-674539,-673610.8,50.60813195867715,66.09947749027481,68.11758776176023,NaN,NaN,50
1652824800,1.05504,1.0551,1.05478,1.05481,835,4236.15,-675374,-674104.6,49.72787083389162,64.06144457104901,67.62647498262535,NaN,NaN,50
1652826600,1.05481,1.05528,1.05475,1.05495,1601,3971.05,-673773,-674055.6,49.055544704053816,64.77342566713838,67.30955228516534,NaN,NaN,50
1652828400,1.05495,1.05506,1.0546,1.0547,885,3789.5,-674658,-674401,48.14375382145063,62.39624095164219,66.52786081329482,NaN,NaN,50
1652830200,1.0547,1.05496,1.05457,1.05487,1412,3645.7,-673246,-674318,47.2373157951693,63.38041757855092,65.9525296424352,NaN,NaN,50
1652832000,1.05487,1.05639,1.05482,1.05593,3629,3555.25,-669617,-673333.6,47.50055417965596,68.85415039714837,65.74467381111855,NaN,NaN,50
1652833800,1.05593,1.05633,1.05548,1.05551,2264,3322.7,-671881,-672635,47.74498982239356,64.72580722469897,65.19310385771884,NaN,NaN,50
1652835600,1.05551,1.05574,1.05481,1.05497,2345,3263.85,-674226,-672725.6,46.72985511397205,59.76426804554177,65.0469378258436,NaN,NaN,50
1652837400,1.05497,1.055,1.05362,1.05394,4225,3355.2,-678451,-673484.2,44.06475389956768,51.634032276942754,64.02303560206039,NaN,NaN,50
1652839200,1.05394,1.05404,1.0533,1.05392,1810,3303.5,-680261,-674887.2,41.20159490886623,51.48756475278245,63.09974293677839,NaN,NaN,50
1652841000,1.05392,1.05409,1.05316,1.05354,1992,3284.2,-682253,-677414.4,38.37301486113876,48.66305577404631,61.83530055595991,NaN,NaN,50
1652842800,1.05354,1.05366,1.05244,1.05263,2033,3247.8,-684286,-679895.4,36.333896450939214,42.631690369797205,60.248333883633165,NaN,NaN,50
1652844600,1.05263,1.0533,1.0526,1.05324,2475,3253.55,-681811,-681412.4,34.44042935575392,47.3430383876555,58.72030894715563,NaN,NaN,50
1652846400,1.05324,1.05356,1.05291,1.05296,1979,2409.6,-683790,-682480.2,32.329334191766954,45.4960682289694,57.23647726544558,NaN,NaN,50
1652848200,1.05296,1.05338,1.05286,1.05294,1543,1980.2,-685333,-683494.6,30.431739389515194,45.35994478858946,55.755082072468056,NaN,NaN,50
1652850000,1.05294,1.05407,1.05292,1.0535,2215,1896.7,-683118,-683667.6,28.757665558823533,49.88161451497813,54.74223706846299,NaN,NaN,50
1652851800,1.0535,1.05406,1.05313,1.05392,2503,1877.7,-680615,-682933.4,27.203168430324126,53.02162870399555,53.90282299966707,NaN,NaN,50
1652853600,1.05392,1.05398,1.05275,1.05284,5230,2083.55,-685845,-683740.2,25.30715600987114,45.18255922976389,52.6732743052472,NaN,NaN,50
1652855400,1.05284,1.05288,1.05168,1.0521,3604,2209.4,-689449,-684872,24.811406978567007,40.738229729711925,51.05597517318727,NaN,NaN,50
1652857200,1.0521,1.05232,1.05134,1.05156,4748,2410.3,-694197,-686644.8,24.686294741752643,37.81510431137417,48.838900452774816,NaN,NaN,50
1652859000,1.05156,1.05244,1.05138,1.05164,3981,2565.45,-690216,-688064.4,24.382150262133308,38.518934022303924,46.96698093831803,NaN,NaN,50
1652860800,1.05164,1.05208,1.05073,1.05115,3898,2718.6,-694114,-690764.2,24.730095253621236,35.84298616460521,45.258317946822565,NaN,NaN,50
1652862600,1.05115,1.05136,1.04944,1.05078,4412,2859.15,-698526,-693300.4,26.021500728992454,33.92638686839862,43.99348613192655,NaN,NaN,50
1652864400,1.05078,1.05204,1.0506,1.05149,3401,2984.95,-695125,-694435.6,26.219908642853056,40.50110785268582,43.20873921049108,NaN,NaN,50
1652866200,1.05149,1.05244,1.05131,1.05237,2813,3055,-692312,-694058.6,25.865833737080084,47.477114064935705,43.12402908841175,NaN,NaN,50
1652868000,1.05237,1.05292,1.05223,1.05242,3007,3023.9,-689305,-693876.4,24.928135306843053,47.851236720496885,43.496853827747444,NaN,NaN,50
1652869800,1.05242,1.05268,1.05151,1.05186,3134,3067.4,-692439,-693541.4,24.693060939093627,44.06536812340433,43.26273452315807,NaN,NaN,50
1652871600,1.05186,1.05225,1.0512,1.05124,3566,3128.45,-696005,-693037.2,24.727503234348376,40.26689660114107,42.889222264027474,NaN,NaN,50
1652873400,1.05124,1.05152,1.05045,1.05106,4128,3123.6,-700133,-694038.8,25.32204265582292,39.21013906467288,42.449950426604865,NaN,NaN,50
1652875200,1.05106,1.05264,1.05105,1.0521,4172,3241.7,-695961,-694768.6,24.498284678826014,47.743380330004086,42.29721941339243,NaN,NaN,50
1652877000,1.0521,1.05262,1.05147,1.05216,4123,3348.25,-691838,-695275.2,23.73336655732889,48.19519003388561,41.952473794098864,NaN,NaN,50
1652878800,1.05216,1.0527,1.05163,1.05186,4112,3452.2,-695950,-695977.4,22.926766340212325,46.05126076355462,42.01452390365535,NaN,NaN,50
1652880600,1.05186,1.0542,1.05179,1.05181,7873,3722.1,-703823,-697541,21.951272409743964,45.68648336662478,42.367970592006266,NaN,NaN,50
1652882400,1.05181,1.05244,1.05048,1.05056,6234,3934.85,-710057,-699525.8,20.920741304597225,37.65594535040101,42.35660209479389,NaN,NaN,50
1652884200,1.05056,1.05142,1.04945,1.05102,6980,4206.7,-703077,-700949,20.724439197934448,41.716060167533186,42.58496824802455,NaN,NaN,50
1652886000,1.05102,1.05142,1.04888,1.04994,5848,4388.35,-708925,-704366.4,20.917506203874915,35.818163106439954,42.58319517244132,NaN,NaN,50
1652887800,1.04994,1.05152,1.04902,1.04914,6282,4577.3,-715207,-708217.8,20.9910965680996,32.18790481208286,42.45901788270449,NaN,NaN,50
1652889600,1.04914,1.04944,1.04825,1.04898,4611,4546.35,-719818,-711416.8,21.563521997401185,31.5002617614725,41.816100304760674,NaN,NaN,50
1652891400,1.04898,1.04984,1.04865,1.04872,3673,4549.8,-723491,-714103.6,21.651395771719788,30.365036098030487,40.59380902141031,NaN,NaN,50
1652893200,1.04872,1.04885,1.04757,1.04826,3546,4489.7,-727037,-718895.6,22.410235194905653,28.413982023978605,39.20543368594472,NaN,NaN,50
1652895000,1.04826,1.04827,1.0476,1.04779,2434,4412.35,-729471,-723004.8,23.11487180214967,26.5377590051379,37.95346160606855,NaN,NaN,50
1652896800,1.04779,1.04854,1.0477,1.04822,2336,4334.25,-727135,-725390.4,23.444325971554978,31.025193580491276,37.293339961736415,NaN,NaN,50
1652898600,1.04822,1.0485,1.0473,1.0474,2594,4243.35,-729729,-727372.6,24.018701270684563,27.56696997660164,36.461685026874186,NaN,NaN,50
1652900400,1.0474,1.04756,1.04661,1.04661,2435,4195.05,-732164,-729107.2,24.983171898088433,24.70938927395096,34.816399951441824,NaN,NaN,50
1652902200,1.04661,1.04747,1.04648,1.04662,2864,4197.6,-729300,-729559.8,25.957119132752617,24.815630878980713,33.146431440377185,NaN,NaN,50
1652904000,1.04662,1.04664,1.04611,1.04628,1378,4116.15,-730678,-729801.2,27.085430741438444,23.596460862537583,31.542517161733112,NaN,NaN,50
1652905800,1.04628,1.0467,1.04618,1.04626,1436,4031.25,-732114,-730797,28.043634927986904,23.523250585590517,29.959429105944952,NaN,NaN,50
1652907600,1.04626,1.04671,1.04616,1.04657,352,3870.55,-731762,-731203.6,28.946840876139778,27.28891971945383,29.218927275163004,NaN,NaN,50
1652909400,1.04657,1.04666,1.04625,1.04628,1021,3715.2,-732783,-731327.4,29.785532113710307,25.999204610576072,28.09629473538035,NaN,NaN,50
1652911200,1.04628,1.04709,1.04628,1.047,1822,3597.7,-730961,-731659.6,29.829573354482797,34.301226731958494,27.987942137203106,NaN,NaN,50
1652913000,1.047,1.04752,1.04682,1.04746,2083,3495.7,-728878,-731299.6,29.190592320466724,39.00907781661256,28.475168780383797,NaN,NaN,50
1652914800,1.04746,1.04752,1.04706,1.04717,917,3335.95,-729795,-730835.8,28.597252788880372,37.19930074195853,28.88224299327566,NaN,NaN,50
1652916600,1.04717,1.04748,1.04701,1.0473,2209,3052.75,-727586,-730000.6,28.101378909057757,38.57503438740816,29.46867144251692,NaN,NaN,50
1652918400,1.0473,1.04835,1.04682,1.04834,3936,2937.85,-723650,-728174,26.298872713206826,48.32730346190517,30.89105154522596,NaN,NaN,50
1652920200,1.04834,1.05006,1.04822,1.04884,5378,2857.75,-718272,-725636.2,26.02587047351993,52.252260584901734,32.727801658066234,NaN,NaN,50
1652922000,1.04884,1.04912,1.04836,1.04842,3732,2751.95,-722004,-724261.4,25.77236839381067,48.89270503773682,34.00405247644091,NaN,NaN,50
1652923800,1.04842,1.0488,1.04788,1.04868,4571,2666.4,-717433,-721789,24.887410338146264,50.99329361136439,35.677361307495396,NaN,NaN,50
1652925600,1.04868,1.04916,1.04832,1.04864,2826,2577.15,-720259,-720323.6,24.41570769800885,50.648392103362866,37.53014722388196,NaN,NaN,50
1652927400,1.04864,1.05012,1.04854,1.04968,3584,2572.7,-716675,-718928.6,24.793522316294812,58.506532596907235,39.93664020373386,NaN,NaN,50
1652929200,1.04968,1.05069,1.04957,1.04987,3374,2564.1,-713301,-717934.4,25.556279672364717,59.76692746913901,42.52024496134824,NaN,NaN,50
1652931000,1.04987,1.0503,1.04962,1.05004,2195,2552.15,-711106,-715754.8,26.26455436014391,60.91102023256606,45.190799936132215,NaN,NaN,50
1652932800,1.05004,1.0507,1.04982,1.05041,2355,2553.1,-708751,-714018.4,27.210727624369497,63.353589912081056,47.766847807034154,NaN,NaN,50
1652934600,1.05041,1.05043,1.0496,1.04963,1707,2508.75,-710458,-712058.2,27.733088097661867,55.48263750275005,49.8728072993323,NaN,NaN,50
1652936400,1.04963,1.05022,1.04938,1.04941,1693,2471.65,-712151,-711153.4,27.86193285780156,53.46502127227141,51.24164976649751,NaN,NaN,50
1652938200,1.04941,1.04959,1.0486,1.04866,3441,2500.5,-715592,-711611.6,26.834323560252233,47.16778212705712,51.8244143601007,NaN,NaN,50
1652940000,1.04866,1.0494,1.04816,1.04822,3565,2609.85,-719157,-713221.8,25.31234833342107,43.90092452005338,52.303101772821755,NaN,NaN,50
1652941800,1.04822,1.04845,1.04755,1.04789,3043,2690.2,-722200,-715911.6,23.823225825140582,41.57516565752369,52.517396863544285,NaN,NaN,50
1652943600,1.04789,1.04796,1.04652,1.04734,6134,2979.3,-728334,-719486.8,23.442770610329656,37.965146312095655,51.77724278141504,NaN,NaN,50
1652945400,1.04734,1.04948,1.04731,1.04925,6333,3244.9,-722001,-721456.8,22.04891964858458,53.17192451786272,51.842933062340826,NaN,NaN,50
1652947200,1.04925,1.04994,1.04799,1.0496,5425,3425.05,-716576,-721653.6,21.153296158605507,55.33270411968014,52.30293299676534,NaN,NaN,50
1652949000,1.0496,1.0509,1.04922,1.04962,5198,3580.8,-711378,-720097.8,21.06812431295598,55.45918037564563,52.62192490849973,NaN,NaN,50
1652950800,1.04962,1.0502,1.0487,1.04918,4829,3776.4,-716207,-718899.2,20.44820789174338,51.97258897262029,52.71651039916096,NaN,NaN,50
1652952600,1.04918,1.04998,1.04877,1.04998,4046,3868.25,-712161,-715664.6,19.872571214903108,57.236654383022085,52.62580481245488,NaN,NaN,50
1652954400,1.04998,1.05088,1.0496,1.05047,3961,3869.5,-708200,-712904.4,20.041738259808785,60.11988437030122,52.65101601968075,NaN,NaN,50
1652956200,1.05047,1.0535,1.05012,1.05283,5535,3877.35,-702665,-710122.2,21.64649528271693,70.45282936670053,53.33257381497607,NaN,NaN,50
1652958000,1.05283,1.05393,1.05168,1.05244,5590,3970.25,-708255,-709497.6,23.317475846553677,67.3473714647881,53.617843925883726,NaN,NaN,50
1652959800,1.05244,1.05291,1.05132,1.05178,6648,4074.1,-714903,-709236.8,24.473453632955884,62.33948547976844,54.107618781385035,NaN,NaN,50
1652961600,1.05178,1.05297,1.05164,1.05222,5318,4198.7,-709585,-708721.6,25.57628093188248,64.24813383678011,54.87784110742137,NaN,NaN,50
1652963400,1.05222,1.05454,1.0521,1.05379,9836,4511.3,-699749,-707031.4,27.291179211023774,70.07579119903983,56.51412746970585,NaN,NaN,50
1652965200,1.05379,1.05614,1.05366,1.0545,7568,4721,-692181,-704934.6,29.424234206235223,72.2766133815986,58.54096238838764,NaN,NaN,50
1652967000,1.0545,1.05714,1.05421,1.05584,11579,5190.2,-680602,-699404,31.685809020884896,75.88187621282857,60.99144171376656,NaN,NaN,50
1652968800,1.05584,1.05816,1.05576,1.05706,9951,5570,-670651,-690553.6,34.04039958860746,78.60931525264624,63.89459663809161,NaN,NaN,50
1652970600,1.05706,1.05934,1.05523,1.05908,14575,6213.4,-656076,-679851.8,36.48539631460046,82.19883385595514,65.9679473050982,NaN,NaN,50
1652972400,1.05908,1.05917,1.05756,1.0591,11179,6687.7,-644897,-668881.4,38.75575041730824,82.23062798339238,67.88922758107766,NaN,NaN,50
1652974200,1.0591,1.05988,1.05836,1.05867,6284,6829.85,-651181,-660681.4,41.015103664828274,78.96507559244613,69.56822009656341,NaN,NaN,50
1652976000,1.05867,1.05926,1.05796,1.0591,4753,6889.25,-646428,-653846.6,42.63972051022743,79.82777887860232,71.55787651841926,NaN,NaN,50
1652977800,1.0591,1.05956,1.05868,1.05934,3505,6912.35,-642923,-648301,44.22713474399173,80.31309575652301,73.20619375938362,NaN,NaN,50
1652979600,1.05934,1.05985,1.05864,1.05878,3955,6803.4,-646878,-646461.4,45.77829283840123,75.73455363695126,74.32152727843005,NaN,NaN,50
1652981400,1.05878,1.06072,1.05865,1.06048,4027,6688.1,-642851,-646052.2,47.43837125093293,79.54655385282553,74.97107902743899,NaN,NaN,50
1652983200,1.06048,1.06065,1.05957,1.0599,4187,6626.2,-647038,-645223.6,48.97987263399809,75.20566237892315,75.53238552130577,NaN,NaN,50
1652985000,1.0599,1.06045,1.05971,1.05981,3361,6534.35,-650399,-646017.8,50.41126677541573,74.52604444761204,76.40285401900887,NaN,NaN,50
1652986800,1.05981,1.06018,1.05846,1.05851,3650,6475.4,-654049,-648243,50.05655505864276,65.34091972771816,76.48091015407589,NaN,NaN,50
1652988600,1.05851,1.0592,1.05834,1.05912,2532,6399.7,-651517,-649170.8,49.57950444399963,67.37293144584328,76.28784874313328,NaN,NaN,50
1652990400,1.05912,1.05912,1.05832,1.05838,902,6246.75,-652419,-651084.4,49.110466289984736,62.57969160087406,75.59521147308153,NaN,NaN,50
1652992200,1.05838,1.0585,1.05812,1.05842,690,6004.5,-651729,-652022.6,48.40243911409482,62.73402826950942,74.65607947713018,NaN,NaN,50
1652994000,1.05842,1.05862,1.05826,1.05846,188,5734.4,-651541,-652251,47.81857369757757,62.89881952813653,73.53390121109375,NaN,NaN,50
1652995800,1.05846,1.0588,1.05835,1.05848,203,5412.15,-651338,-651708.8,47.39015891440832,62.98695105005073,72.16162386781487,NaN,NaN,50
1652997600,1.05848,1.05873,1.05828,1.05862,1181,5205.3,-650157,-651436.8,46.88056324453996,63.63808893642602,70.83358536446013,NaN,NaN,50
1652999400,1.05862,1.05862,1.058,1.0581,1634,4795.2,-651791,-651311.2,45.952767452005546,59.45437561660212,69.43996393761414,NaN,NaN,50
1653001200,1.0581,1.05837,1.05796,1.05822,1078,4470.7,-650713,-651108,45.02494081529648,60.10617368171737,68.03127785212236,NaN,NaN,50
1653003000,1.05822,1.05833,1.05782,1.05794,2018,3992.65,-652731,-651346,43.921532497045916,57.77244021264883,66.42123102755991,NaN,NaN,50
1653004800,1.05794,1.05838,1.05756,1.05778,2045,3597.35,-654776,-652033.6,42.44839186584999,56.42426991183814,65.04192504719468,NaN,NaN,50
1653006600,1.05778,1.05792,1.05683,1.05762,2998,3018.5,-657774,-653557,39.95488407420634,55.041036934231414,63.29153098158082,NaN,NaN,50
1653008400,1.05762,1.05812,1.05686,1.05779,3856,2652.35,-653918,-653982.4,37.87947763603748,56.26775505352922,61.93882331548126,NaN,NaN,50
1653010200,1.05779,1.05815,1.05706,1.05734,3417,2509,-657335,-655306.8,35.989455906441066,52.20701115552704,60.3446066517609,NaN,NaN,50
1653012000,1.05734,1.05736,1.05548,1.05621,3172,2429.95,-660507,-656862,34.5822795340406,43.68193128417236,58.797536048650485,NaN,NaN,50
1653013800,1.05621,1.05644,1.0559,1.05598,2134,2361.4,-662641,-658435,33.27561575966874,42.17243388891977,56.99750050887024,NaN,NaN,50
1653015600,1.05598,1.05634,1.05591,1.05601,1409,2234.1,-661232,-659126.6,32.06228511203773,42.45177865844621,55.55979244155397,NaN,NaN,50
1653017400,1.05601,1.05672,1.05601,1.05662,2079,2136.7,-659153,-660173.6,30.358255104016184,47.956844469075904,54.50427931295157,NaN,NaN,50
1653019200,1.05662,1.05748,1.05625,1.05738,2589,2056.8,-656564,-660019.4,28.610117888481522,53.87680044441322,53.85984937839991,NaN,NaN,50
1653021000,1.05738,1.05746,1.05702,1.05738,1552,1966.35,-656564,-659230.8,26.98684761691362,53.87680044441322,53.20912433514008,NaN,NaN,50
1653022800,1.05738,1.05814,1.05712,1.05755,2250,1896.35,-654314,-657565.4,26.279768010220423,55.198852895245984,52.606321760770086,NaN,NaN,50
1653024600,1.05755,1.05937,1.05755,1.05909,4039,1971.7,-650275,-655374,26.737976444367412,64.98901831838145,53.00165338232575,NaN,NaN,50
1653026400,1.05909,1.05922,1.05814,1.05825,4413,2147.25,-654688,-654481,27.16345570464676,57.595778444377885,52.8223394368015,NaN,NaN,50
1653028200,1.05825,1.05917,1.05765,1.05782,2698,2247.65,-657386,-654645.4,26.800195861486593,54.19684486785958,52.566939769316555,NaN,NaN,50
1653030000,1.05782,1.0581,1.05652,1.05708,5004,2488.45,-662390,-655810.6,25.0174228893775,48.853694627322064,52.026184391851125,NaN,NaN,50
1653031800,1.05708,1.0583,1.05666,1.05766,4931,2724.85,-657459,-656439.6,23.576736509092072,52.782890975726325,51.86488825195791,NaN,NaN,50
1653033600,1.05766,1.05779,1.05547,1.05663,5259,2928.75,-662718,-658928.2,22.775073416024064,46.02139005943269,51.13300503809387,NaN,NaN,50
1653035400,1.05663,1.05812,1.05654,1.05774,4114,3052.75,-658604,-659711.4,21.65583912547933,53.007689193214205,51.19019632650009,NaN,NaN,50
1653037200,1.05774,1.0589,1.05723,1.0586,3450,3171.35,-655154,-659265,20.41434632687439,57.58780430304149,52.18347297070503,NaN,NaN,50
1653039000,1.0586,1.05931,1.05808,1.05914,2464,3193.65,-652690,-657325,19.64946908747362,60.21021765201615,53.47188609664048,NaN,NaN,50
1653040800,1.05914,1.05994,1.0585,1.05963,3538,3268.3,-649152,-655663.6,19.49278454253924,62.47741903219183,54.90228898047946,NaN,NaN,50
1653042600,1.05963,1.05972,1.0584,1.05889,2880,3262.4,-652032,-653526.4,19.225981236732295,57.178674959634556,55.56099115837651,NaN,NaN,50
1653044400,1.05889,1.0589,1.05752,1.05776,3250,3232.1,-655282,-652862,17.981756735196267,50.18005510614042,55.296937919928446,NaN,NaN,50
1653046200,1.05776,1.05808,1.05664,1.05666,3882,3255.35,-659164,-653664,17.403664985752556,44.47344717291172,54.62526982910691,NaN,NaN,50
1653048000,1.05666,1.058,1.05661,1.05768,3919,3292.7,-655245,-654175,16.893897778710286,50.13616297876668,54.263649120786965,NaN,NaN,50
1653049800,1.05768,1.058,1.05612,1.05642,4129,3392.45,-659374,-656219.4,16.86146383564908,44.1468278624122,52.77492123107487,NaN,NaN,50
1653051600,1.05642,1.05712,1.05608,1.05614,3710,3507.5,-663084,-658429.8,16.86722540622434,42.91979188397846,51.726636476760625,NaN,NaN,50
1653053400,1.05614,1.05662,1.05558,1.05627,7112,3759.15,-655972,-658567.8,17.316715697565638,43.702174902722675,50.97701719353656,NaN,NaN,50
1653055200,1.05627,1.05651,1.05401,1.0559,7744,4016.9,-663716,-659478.2,18.842857356799904,41.94017001179173,50.483194006712964,NaN,NaN,50
1653057000,1.0559,1.05658,1.05525,1.05566,5983,4238.45,-669699,-662369,20.164827031898074,40.79131308929669,49.626652729110845,NaN,NaN,50
1653058800,1.05566,1.05579,1.05452,1.05461,4640,4357.95,-674339,-665362,21.82815491300691,36.12849597452832,48.92001743733197,NaN,NaN,50
1653060600,1.05461,1.05641,1.05461,1.05584,3768,4344.4,-670571,-666859.4,22.534650431218974,44.17828287516964,48.289345557471634,NaN,NaN,50
1653062400,1.05584,1.05602,1.05396,1.05528,3249,4286.2,-673820,-670429,23.602968730333146,41.60721530850591,47.14787491500481,NaN,NaN,50
1653064200,1.05528,1.0558,1.05483,1.0549,3118,4307.2,-676938,-673073.4,24.59497857951059,39.90988866910678,45.69785141622557,NaN,NaN,50
1653066000,1.0549,1.05546,1.05454,1.05475,3326,4223.3,-680264,-675186.4,25.703243356516026,39.22958496361144,44.0372918398984,NaN,NaN,50
1653067800,1.05475,1.0554,1.05444,1.05449,3642,4158.85,-683906,-677099.8,26.797899133350967,38.01982500441337,42.668802557382605,NaN,NaN,50
1653069600,1.05449,1.05484,1.05329,1.05338,3392,4065.5,-687298,-680445.2,28.48625803903223,33.29868490130397,41.46299039989429,NaN,NaN,50
1653071400,1.05338,1.05485,1.0533,1.05458,2627,3991.15,-684671,-682615.4,30.03799316366247,41.72371708695411,41.26658110804017,NaN,NaN,50
1653073200,1.05458,1.05542,1.0544,1.0554,2530,3945.15,-682141,-683656,30.578957193624273,46.679880065910794,41.01970375712189,NaN,NaN,50
1653075000,1.0554,1.05596,1.0551,1.05572,1771,3910.5,-680370,-683677.2,30.306447110135874,48.51986481900619,41.332063539735756,NaN,NaN,50
1653076800,1.05572,1.05675,1.05528,1.05608,916,3779.4,-679454,-682786.8,29.053111846132225,50.58577894953406,41.879634044418296,NaN,NaN,50
1653078600,1.05608,1.05643,1.05522,1.05554,1087,3689.75,-680541,-681435.4,27.9451025401002,47.506150185467796,42.15134656461437,NaN,NaN,50
1653253200,1.05554,1.05648,1.05554,1.05635,63,3530.4,-680478,-680596.8,26.85158016440291,52.20634749407019,42.88464495620569,NaN,NaN,50
1653255000,1.05635,1.05638,1.05586,1.05621,53,3338.95,-680531,-680274.8,25.836166529826855,51.35053167497311,43.63887485518257,NaN,NaN,50
1653256800,1.05621,1.05753,1.05602,1.05716,1329,3209.45,-679202,-680041.2,24.49906499904365,56.55500732921256,45.09791138051717,NaN,NaN,50
1653258600,1.05716,1.05772,1.05708,1.05765,746,3040.3,-678456,-679841.6,23.45821925018614,58.991843261082714,46.156022836653804,NaN,NaN,50
1653260400,1.05765,1.05781,1.05715,1.05752,1706,2940.1,-680162,-679765.8,22.589517588240913,58.061365995702076,47.331319314310676,NaN,NaN,50
1653262200,1.05752,1.05764,1.0569,1.0569,1813,2675.15,-681975,-680065.2,21.437096266350466,53.71021910804485,48.31705720280626,NaN,NaN,50
1653264000,1.0569,1.05838,1.05682,1.05838,2949,2435.4,-679026,-679764.2,21.180590749977934,61.187487391125984,49.88547880477158,NaN,NaN,50
1653265800,1.05838,1.05908,1.05807,1.0583,3427,2307.6,-682453,-680414.4,21.58998183091158,60.61749536375297,51.49959811615298,NaN,NaN,50
1653267600,1.0583,1.05908,1.05797,1.05907,3190,2235.1,-679263,-680575.8,21.81879565556949,64.08536701653432,53.69864683866943,NaN,NaN,50
1653269400,1.05907,1.05907,1.05832,1.05881,2768,2185.1,-682031,-680949.6,22.03126563560898,62.09699530648667,55.15388099720747,NaN,NaN,50
1653271200,1.05881,1.05928,1.05865,1.05912,2078,2126.55,-679953,-680545.2,22.43844013762912,63.54917092126626,56.358830344018585,NaN,NaN,50
1653273000,1.05912,1.05948,1.05872,1.05884,1129,2027.1,-681082,-680956.4,23.01541331251748,61.26596136218017,57.26926581138815,NaN,NaN,50
1653274800,1.05884,1.05938,1.05862,1.05862,1425,1932.05,-682507,-680967.2,23.361699973572712,59.45837824117088,57.90302290364792,NaN,NaN,50
1653276600,1.05862,1.05936,1.05847,1.05926,1077,1803.8,-681430,-681400.6,23.392930630151028,62.88864440590363,59.00177249082191,NaN,NaN,50
1653278400,1.05926,1.05949,1.05905,1.05918,791,1673.75,-682221,-681438.6,23.578761864780095,62.18041329105619,59.71420576203519,NaN,NaN,50
1653280200,1.05918,1.05948,1.05898,1.05906,649,1574.85,-682870,-682022,23.603420014457434,61.069442434012565,60.40841367339516,NaN,NaN,50
1653282000,1.05906,1.05927,1.05886,1.05903,1153,1506,-684023,-682610.2,23.365667017506585,60.777085348723126,60.70999067478876,NaN,NaN,50
1653283800,1.05903,1.0614,1.05901,1.05994,4062,1620.55,-679961,-682101,25.19584922962984,66.0814330525959,61.21638994561114,NaN,NaN,50
1653285600,1.05994,1.06079,1.0595,1.05992,4719,1810.7,-684680,-682751,26.895304140887156,65.87059112923832,61.77419174086373,NaN,NaN,50
1653287400,1.05992,1.06097,1.0599,1.0606,3568,1934.75,-681112,-682529.2,28.597599805914825,69.44072251543957,62.897799127106204,NaN,NaN,50
1653289200,1.0606,1.06107,1.05952,1.06052,5318,2197.5,-686430,-683241.2,29.40380105893756,68.5324473665824,63.422439125353094,NaN,NaN,50
1653291000,1.06052,1.0609,1.05926,1.06008,4535,2421.6,-690965,-684629.6,29.649445814934193,63.604791114328556,63.63581739325135,NaN,NaN,50
1653292800,1.06008,1.06358,1.06006,1.06276,10824,2896.35,-680141,-684665.6,31.59713353734911,75.26895169111562,64.43464487000716,NaN,NaN,50
1653294600,1.06276,1.06489,1.06161,1.06461,5910,3154.55,-674231,-682575.8,33.89422352703943,80.02740123541331,65.71538815064478,NaN,NaN,50
1653296400,1.06461,1.06816,1.0645,1.06711,8708,3504.65,-665523,-679458,36.80156503148978,84.3965477047114,67.20448649231943,NaN,NaN,50
1653298200,1.06711,1.06876,1.06684,1.06784,5309,3679.45,-660214,-674214.8,39.60249724732766,85.40083415563788,68.92840597756641,NaN,NaN,50
1653300000,1.06784,1.06815,1.06688,1.06718,3655,3714.75,-663869,-668795.6,42.20336287631997,80.36458321450738,70.42170633280473,NaN,NaN,50
1653301800,1.06718,1.06766,1.06634,1.0676,3335,3710.15,-660534,-664874.2,43.92643464468488,81.12731016061718,71.72446817242714,NaN,NaN,50
1653303600,1.0676,1.06812,1.06716,1.06721,3111,3706.2,-663645,-662757,45.64204464373253,78.09379954616607,72.8611386192207,NaN,NaN,50
1653305400,1.06721,1.06732,1.06541,1.06564,4114,3773.5,-667759,-663204.2,45.2613897255075,67.20025762926034,73.29905399030983,NaN,NaN,50
1653307200,1.06564,1.06604,1.06516,1.06548,4973,3918.25,-672732,-665707.8,44.66049762058955,66.1869761394612,73.68547476107683,NaN,NaN,50
1653309000,1.06548,1.06584,1.06474,1.06488,4330,4078.3,-677062,-668346.4,43.68459275039443,62.38792067942935,73.4216524487078,NaN,NaN,50
1653310800,1.06488,1.06586,1.0648,1.06522,3620,4188.05,-673442,-670928,42.789178454136675,63.66081012287434,73.26381094825322,NaN,NaN,50
1653312600,1.06522,1.06678,1.06445,1.06662,5795,4423.95,-667647,-671728.4,42.43861198512498,68.40265873088728,73.18966353507093,NaN,NaN,50
1653314400,1.06662,1.06742,1.06544,1.06699,6233,4696.05,-661414,-670459.4,42.41593795518258,69.53413218239974,73.26121245048645,NaN,NaN,50
1653316200,1.06699,1.06786,1.06613,1.06685,7154,5021.3,-668568,-669626.6,42.593755759799464,68.5341055377711,73.6133063378752,NaN,NaN,50
1653318000,1.06685,1.06915,1.06646,1.06809,5563,5241.8,-663005,-666815.2,43.27776508683531,72.3298992799453,73.4033740227916,NaN,NaN,50
1653319800,1.06809,1.0686,1.06692,1.06696,3687,5223.05,-666692,-665465.2,43.91291660479716,64.67340925832518,72.30666031014245,NaN,NaN,50
1653321600,1.06696,1.06719,1.06656,1.06707,2186,5096.4,-664506,-664837,44.057833142138804,65.06113053469538,70.92555908371274,NaN,NaN,50
1653323400,1.06707,1.0681,1.06666,1.06772,2092,5022.6,-662414,-665037,44.5794866356703,67.34206094672122,69.63564671164725,NaN,NaN,50
1653325200,1.06772,1.06776,1.06716,1.0677,1902,4851.8,-664316,-664186.6,45.06387916537812,67.19669842602354,68.69508351246985,NaN,NaN,50
1653327000,1.0677,1.06884,1.0677,1.06844,1938,4721.95,-662378,-664061.2,45.93493043076978,69.79467902981844,67.88560986026994,NaN,NaN,50
1653328800,1.06844,1.06857,1.06798,1.06824,2360,4298.75,-664738,-663670.4,46.74376374863348,68.22205076391228,67.1804849472518,NaN,NaN,50
1653330600,1.06824,1.06975,1.06821,1.06932,2338,4120.15,-662400,-663249.2,47.901423536701756,71.90361701582319,67.51643918914915,NaN,NaN,50
1653332400,1.06932,1.06942,1.06836,1.06858,1718,3770.65,-664118,-663590,48.976393339908014,66.2408907946882,67.52029023595108,NaN,NaN,50
1653334200,1.06858,1.06916,1.06855,1.06868,1395,3574.95,-662723,-663271.4,49.9745795857424,66.62342437737993,67.82282621437612,NaN,NaN,50
1653336000,1.06868,1.06926,1.06853,1.06908,689,3426.65,-662034,-663202.6,50.9382532768073,68.17676803546883,68.1453946367043,NaN,NaN,50
1653337800,1.06908,1.06938,1.06884,1.06912,685,3294.15,-661349,-662524.8,51.87914445520367,68.3354704357979,68.14059547276933,NaN,NaN,50
1653339600,1.06912,1.06934,1.06858,1.06916,586,3167.9,-660763,-662197.4,52.28923875296325,68.50461994719208,68.06705888454022,NaN,NaN,50
1653341400,1.06916,1.06922,1.06898,1.069,131,2968.75,-660894,-661552.6,52.670040600882864,66.96369394052509,67.95488662759406,NaN,NaN,50
1653343200,1.069,1.06944,1.06794,1.06825,1507,2795.45,-662401,-661488.2,51.27828752476747,60.13531692387373,67.08384503073181,NaN,NaN,50
1653345000,1.06825,1.06853,1.0682,1.06835,624,2610.15,-661777,-661436.8,49.985945382660326,60.71059387417502,66.8007867890068,NaN,NaN,50
1653346800,1.06835,1.0685,1.06809,1.06838,750,2466.65,-661027,-661372.4,48.60838181939315,60.892920451970966,66.50305749738364,NaN,NaN,50
1653348600,1.06838,1.06897,1.06811,1.06838,1030,2228.4,-661027,-661425.2,47.72065453571329,60.89292045197096,66.04240460490148,NaN,NaN,50
1653350400,1.06838,1.06862,1.06726,1.0673,2043,2018.9,-663070,-661860.4,45.59814384796282,51.0096872215904,64.88618951887054,NaN,NaN,50
1653352200,1.0673,1.06776,1.06671,1.06693,1609,1741.65,-664679,-662316,42.91004847665253,48.1277128399847,63.33854907673956,NaN,NaN,50
1653354000,1.06693,1.06753,1.06681,1.06723,1669,1546.95,-663010,-662562.6,40.41395991757867,50.566441830671785,62.07743415293667,NaN,NaN,50
1653355800,1.06723,1.06738,1.06665,1.06676,2051,1465.15,-665061,-663369.4,37.88095922021965,46.85022448254627,60.287906114845455,NaN,NaN,50
1653357600,1.06676,1.06677,1.0661,1.06632,1535,1432.6,-666596,-664483.2,35.523390443848605,43.61839877026758,58.67201382738684,NaN,NaN,50
1653359400,1.06632,1.06674,1.06628,1.06644,1351,1395.55,-665245,-664918.2,33.33421943721835,44.73803219257781,57.1087715284724,NaN,NaN,50
1653361200,1.06644,1.06715,1.06644,1.06678,1002,1350.55,-664243,-664831,31.165981906506673,47.89520596564011,55.66008852348464,NaN,NaN,50
1653363000,1.06678,1.06738,1.06678,1.06727,634,1285.35,-663609,-664950.8,29.452578165635945,52.13901308447313,54.503198712675726,NaN,NaN,50
1653364800,1.06727,1.06734,1.06674,1.06682,900,1212.35,-664509,-664840.4,27.799998224412896,48.252179013744765,53.056595788858054,NaN,NaN,50
1653366600,1.06682,1.06716,1.06628,1.06635,898,1140.35,-665407,-664602.6,26.050903555649757,44.51923945170571,51.4534204682281,NaN,NaN,50
1653368400,1.06635,1.06672,1.06625,1.06656,1168,1112.85,-664239,-664401.4,24.470398054941963,46.51041423221717,50.48021313310978,NaN,NaN,50
1653370200,1.06656,1.06689,1.06624,1.06681,1955,1140.85,-662284,-664009.6,22.727081890796125,48.86332190890801,49.63397942130499,NaN,NaN,50
1653372000,1.06681,1.06742,1.06657,1.06686,2501,1231.45,-659783,-663244.4,21.891614983697654,49.34326257119028,48.80900385839209,NaN,NaN,50
1653373800,1.06686,1.06936,1.06682,1.06842,5339,1464.15,-654444,-661231.4,23.048589734123862,61.48804793752983,48.851512964503435,NaN,NaN,50
1653375600,1.06842,1.07326,1.06842,1.07236,13345,2102.1,-641099,-656369.8,25.87863411745103,76.68897988033778,50.68574815441393,NaN,NaN,50
1653377400,1.07236,1.07362,1.07194,1.0731,7526,2471.85,-633573,-650236.6,28.607775676092878,78.41242964663122,52.84894221203154,NaN,NaN,50
1653379200,1.0731,1.07339,1.07054,1.07124,6245,2708.75,-639818,-645743.4,29.53395212227451,65.33683745039532,53.90397047058321,NaN,NaN,50
1653381000,1.07124,1.07179,1.07009,1.07048,6522,3003.65,-646340,-643054.8,29.935490490644074,60.87033592813656,54.90540700241109,NaN,NaN,50
1653382800,1.07048,1.07194,1.07044,1.07144,3564,3144.35,-642776,-640721.2,30.38252362663175,64.19953923627148,56.37548846426851,NaN,NaN,50
1653384600,1.07144,1.07148,1.07052,1.07114,3297,3257.7,-646073,-641716,30.797625824334595,62.412474421552254,57.637948623480966,NaN,NaN,50
1653386400,1.07114,1.07198,1.07105,1.0716,2754,3293.25,-643319,-643665.2,31.44879070432675,64.06426936603087,58.79288172350888,NaN,NaN,50
1653388200,1.0716,1.07171,1.07048,1.07095,2981,3361.85,-646300,-644961.6,31.385902449266688,60.048621292507505,59.357853738368476,NaN,NaN,50
1653390000,1.07095,1.07108,1.07021,1.07093,2256,3391.2,-648556,-645404.8,31.020195813249657,59.92415750105025,60.19156648746173,NaN,NaN,50
1653391800,1.07093,1.0728,1.07088,1.07147,6150,3596.15,-642406,-645330.8,31.65167092237205,62.20216603365639,61.45463267188678,NaN,NaN,50
1653393600,1.07147,1.07231,1.0696,1.06962,5192,3779,-647598,-645635.8,30.951902809524938,51.41873992338992,61.805227364113414,NaN,NaN,50
1653395400,1.06962,1.07184,1.06957,1.07076,5006,3961.75,-642592,-645490.4,30.273926421552428,56.43113517218518,62.34578545434749,NaN,NaN,50
1653397200,1.07076,1.0715,1.07042,1.07079,5268,4175.05,-637324,-643695.2,29.64437691843509,56.55815918871209,62.86113521274191,NaN,NaN,50
1653399000,1.07079,1.07392,1.07057,1.07344,10883,4687.5,-626441,-639272.2,30.36440526861156,65.99049424787144,63.18273852062345,NaN,NaN,50
1653400800,1.07344,1.07472,1.07206,1.0742,9578,5121.4,-616863,-634163.6,31.362191769379137,68.12784053487017,62.57122856737577,NaN,NaN,50
1653402600,1.0742,1.07465,1.07211,1.07266,8742,5513.6,-625605,-629765,32.288707805806176,59.911530864656925,61.24973579723475,NaN,NaN,50
1653404400,1.07266,1.07332,1.07219,1.07322,6108,5760.6,-619497,-625146,33.14904412534557,61.71946324974855,60.99135192575998,NaN,NaN,50
1653406200,1.07322,1.0744,1.07292,1.07433,6004,5963.05,-613493,-620379.8,34.40200030833393,65.08104435275195,61.292116813232504,NaN,NaN,50
1653408000,1.07433,1.07487,1.07384,1.0739,4126,6044.3,-617619,-618615.4,35.744387385117726,62.78106256505858,61.19079705100301,NaN,NaN,50
1653409800,1.0739,1.074,1.07287,1.0731,3564,5955.55,-621183,-619479.4,35.88071644812735,58.62967227631768,60.920596897771965,NaN,NaN,50
1653411600,1.0731,1.07368,1.07264,1.0734,3459,5461.25,-617724,-617903.2,35.75901527482932,59.70570243456055,60.60927068838123,NaN,NaN,50
1653413400,1.0734,1.07374,1.07266,1.0732,3458,5257.85,-621182,-618240.2,35.67912733049155,58.611217842466,60.50659901337826,NaN,NaN,50
1653415200,1.0732,1.0733,1.07238,1.07282,3429,5117.05,-624611,-620463.8,35.276113747329426,56.49226584485093,60.26146389507831,NaN,NaN,50
1653417000,1.07282,1.07292,1.07222,1.07248,3117,4946.8,-627728,-622485.6,34.71047534382238,54.590582913446404,59.717779386491884,NaN,NaN,50
1653418800,1.07248,1.07372,1.07244,1.07306,2831,4910.15,-624897,-623228.4,34.70350068930044,57.23523739096291,60.13324349131853,NaN,NaN,50
1653420600,1.07306,1.07388,1.07295,1.07304,2990,4894.8,-627887,-625261,34.79538437560923,57.11171806209662,60.18185655488363,NaN,NaN,50
1653422400,1.07304,1.0736,1.07304,1.07354,881,4801.15,-627006,-626425.8,34.88070494146739,59.46680510867127,60.389616977737866,NaN,NaN,50
1653424200,1.07354,1.07384,1.07338,1.07359,583,4681.25,-626423,-626788.2,35.12151929957192,59.70509364451404,59.940659791783766,NaN,NaN,50
1653426000,1.07359,1.07362,1.0728,1.07347,592,4598.05,-627015,-626645.6,34.51333150092945,58.81147887666356,59.27520538762615,NaN,NaN,50
1653427800,1.07347,1.07374,1.07318,1.07335,385,4309.8,-627400,-627146.2,34.04516092009969,57.878565340858806,59.12999356449772,NaN,NaN,50
1653429600,1.07335,1.07356,1.07326,1.07347,578,4079.1,-626822,-626933.2,33.61043109504349,58.58603975738446,58.90617760075742,NaN,NaN,50
1653431400,1.07347,1.0739,1.07324,1.07382,946,3876.1,-625876,-626707.2,33.500472801309485,60.661420307171284,58.59049016893022,NaN,NaN,50
1653433200,1.07382,1.07388,1.07324,1.07324,767,3651.05,-626643,-626751.2,33.39836867141363,55.68166686714652,58.08339047622222,NaN,NaN,50
1653435000,1.07324,1.07347,1.07321,1.07328,720,3142.9,-625923,-626532.8,33.248775121959625,55.950235653308056,57.89200214600725,NaN,NaN,50
1653436800,1.07328,1.07369,1.07237,1.07252,1670,2747.5,-627593,-626571.4,31.71228245968288,49.777932385196834,57.18287571390984,NaN,NaN,50
1653438600,1.07252,1.0726,1.07182,1.0723,2094,2415.1,-629687,-627144.4,29.52665254686843,48.12295746068352,56.433714258068235,NaN,NaN,50
1653440400,1.0723,1.07236,1.07122,1.07136,3088,2264.1,-632775,-628524.2,28.063792140944972,41.737769872311745,55.379821688601155,NaN,NaN,50
1653442200,1.07136,1.07182,1.07108,1.07123,2528,2090.3,-635303,-630256.2,26.865418306026783,40.92894940935265,54.403990724023025,NaN,NaN,50
1653444000,1.07123,1.07204,1.07101,1.07112,3660,2067,-638963,-632864.2,25.434603475714013,40.2187416952086,53.188526745754864,NaN,NaN,50
1653445800,1.07112,1.07112,1.07033,1.07065,2359,2006.75,-641322,-635610,24.888099122044274,37.24494051602619,51.76947120674983,NaN,NaN,50
1653447600,1.07065,1.07111,1.07047,1.07098,1454,1906.5,-639868,-637646.2,24.38063079363666,40.56775685876024,50.419539188899044,NaN,NaN,50
1653449400,1.07098,1.07151,1.07096,1.07138,1424,1804.8,-638444,-638780,23.284928678156973,44.41000129988397,49.32703259285404,NaN,NaN,50
1653451200,1.07138,1.07143,1.07072,1.07099,1194,1693.05,-639638,-639647,22.564843730047308,41.58700802140192,48.09671324604964,NaN,NaN,50
1653453000,1.07099,1.0711,1.07052,1.07056,1064,1590.4,-640702,-639994.8,22.140788975708045,38.66841236712969,46.72455946221184,NaN,NaN,50
1653454800,1.07056,1.07087,1.07051,1.07069,1194,1508.55,-639508,-639632,21.759647946688716,40.038499931806314,45.39973518895626,NaN,NaN,50
1653456600,1.07069,1.07092,1.07024,1.07082,1845,1451.3,-637663,-639191,21.750756065435635,41.44713010628321,44.02728588889282,NaN,NaN,50
1653458400,1.07082,1.07082,1.06915,1.06956,3413,1577.9,-641076,-639717.4,22.870657519250777,33.285280387769035,42.427543997508714,NaN,NaN,50
1653460200,1.06956,1.07064,1.06932,1.06977,4714,1784.45,-636362,-639062.2,23.91056601207912,35.56281062575242,40.97129935268331,NaN,NaN,50
1653462000,1.06977,1.06998,1.06818,1.06902,6662,2087.95,-643024,-639526.6,25.754171522480974,31.435312198435696,39.66111219648609,NaN,NaN,50
1653463800,1.06902,1.0695,1.06825,1.06843,5067,2322.05,-648091,-641243.2,27.466090924996983,28.621125069421893,38.26812416853882,NaN,NaN,50
1653465600,1.06843,1.06864,1.06667,1.06734,6302,2608.25,-654393,-644589.2,29.917601417492428,24.294051222529518,37.02214426498295,NaN,NaN,50
1653467400,1.06734,1.0679,1.06678,1.067,4199,2770.9,-658592,-648092.4,32.19400401766677,23.11988295502161,35.75006808967358,NaN,NaN,50
1653469200,1.067,1.06752,1.06623,1.06692,4129,2939,-662721,-653364.2,34.548895832069874,22.84016179177148,34.50874095371379,NaN,NaN,50
1653471000,1.06692,1.06794,1.06662,1.06758,3700,3088,-659021,-656563.6,35.936669237567706,30.329247918102325,34.01476291100494,NaN,NaN,50
1653472800,1.06758,1.06778,1.06666,1.06705,3450,3177,-662471,-659439.6,37.225315971244264,27.98063372694193,33.115682687303625,NaN,NaN,50
1653474600,1.06705,1.0671,1.06557,1.06656,2955,3220.05,-665426,-661646.2,38.97850981368632,25.977746881326,31.799093085978058,NaN,NaN,50
1653476400,1.06656,1.06689,1.06588,1.0661,3948,3263.05,-669374,-663802.6,40.60647552452538,24.224661681743513,30.55892549028817,NaN,NaN,50
1653478200,1.0661,1.0674,1.06542,1.06597,6648,3469.05,-676022,-666462.8,41.14584311072171,23.737133177299043,29.492405548157414,NaN,NaN,50
1653480000,1.06597,1.0665,1.06421,1.06424,5605,3566.3,-681627,-670984,42.30195049891422,18.423402233080367,27.948469998248413,NaN,NaN,50
1653481800,1.06424,1.06654,1.06424,1.0651,5725,3734.6,-675902,-673670.2,43.30512621656351,27.153462459733277,26.927493737780562,NaN,NaN,50
1653483600,1.0651,1.06653,1.06478,1.06648,4108,3867.3,-671794,-674943.8,44.23664652580928,38.52270916603543,27.301595793371018,NaN,NaN,50
1653485400,1.06648,1.06725,1.06612,1.06675,5593,4075.75,-666201,-674309.2,43.81085080578333,40.47999868098159,27.652823511601678,NaN,NaN,50
1653487200,1.06675,1.06848,1.0659,1.06836,6366,4334.35,-659835,-671071.8,41.68352507717051,50.583253234439326,29.02053358560193,NaN,NaN,50
1653489000,1.06836,1.06872,1.06742,1.06782,6907,4626.5,-666742,-668094.8,39.41869879043352,47.661023885721555,30.380526358194768,NaN,NaN,50
1653490800,1.06782,1.06824,1.06729,1.06772,4051,4769.35,-670793,-667073,37.446241474007856,47.11816514563468,32.010820209845136,NaN,NaN,50
1653492600,1.06772,1.06776,1.06566,1.06569,3252,4839.7,-674045,-667523.2,36.97047558265792,37.724628058434746,33.05401628866036,NaN,NaN,50
1653494400,1.06569,1.06626,1.06546,1.06616,2481,4793.1,-671564,-668595.8,36.66540115258981,40.673630034096526,34.327835448826434,NaN,NaN,50
1653496200,1.06616,1.06641,1.06537,1.06547,1877,4651.25,-673441,-671317,36.17504657857677,37.84059098824254,34.86435995383645,NaN,NaN,50
1653498000,1.06547,1.06654,1.06518,1.06638,2660,4451.15,-670781,-672124.8,35.8648211535045,43.4362917824091,35.96833552922696,NaN,NaN,50
1653499800,1.06638,1.06755,1.0663,1.06718,2387,4317.15,-668394,-671645,34.23848249822976,47.87848944683495,37.53267428390617,NaN,NaN,50
1653501600,1.06718,1.06901,1.06618,1.06759,17212,4862.65,-651182,-667072.4,32.320919147451725,50.043837094032554,39.37690109906968,NaN,NaN,50
1653503400,1.06759,1.06899,1.06741,1.06882,6415,4973.45,-644767,-661713,30.54032460744355,55.95548318823618,41.67821181413661,NaN,NaN,50
1653505200,1.06882,1.06946,1.06851,1.06868,3207,4927.35,-647974,-656619.6,29.30597421836549,55.15543658110115,44.30192855328095,NaN,NaN,50
1653507000,1.06868,1.06902,1.06763,1.06772,2910,4887.85,-650884,-652640.2,27.243435910941788,49.888029661619186,45.92582621055852,NaN,NaN,50
1653508800,1.06772,1.06778,1.06738,1.06758,1170,4773.85,-652054,-649372.2,25.507001895771825,49.15083709385071,46.684978205402466,NaN,NaN,50
1653510600,1.06758,1.06811,1.06758,1.06798,1787,4715.45,-650267,-649189.2,23.80970441686521,51.36227372747579,47.462283565866336,NaN,NaN,50
1653512400,1.06798,1.06856,1.06772,1.06824,4942,4765.15,-645325,-649300.8,22.67275229731542,52.79921157817959,47.62056630470493,NaN,NaN,50
1653514200,1.06824,1.06826,1.06809,1.0681,482,4456.85,-645807,-648867.4,21.61701104344776,51.90989932090034,47.924057407217695,NaN,NaN,50
1653516000,1.0681,1.06944,1.06798,1.06906,2926,4322.9,-642881,-647266.8,21.688410306635976,57.229718055624275,48.646311186502665,NaN,NaN,50
1653517800,1.06906,1.0696,1.06874,1.06902,899,4081.6,-643780,-645612,21.880793055810006,56.94704411287767,50.019340904677165,NaN,NaN,50
1653519600,1.06902,1.06948,1.06896,1.06918,981,3925.25,-642799,-644118.4,22.059434180043034,57.84399424865834,51.24579549143158,NaN,NaN,50
1653521400,1.06918,1.0692,1.06852,1.0687,866,3688.9,-643665,-643786.4,21.622797270237708,54.19612314102279,52.41404778805874,NaN,NaN,50
1653523200,1.0687,1.06945,1.06854,1.06938,2350,3488.1,-641315,-642888,21.456560788862262,58.21626034990762,53.46975982859435,NaN,NaN,50
1653525000,1.06938,1.07066,1.0693,1.07044,3690,3327.25,-637625,-641836.8,22.29349802721521,63.58207288708578,54.59144436004083,NaN,NaN,50
1653526800,1.07044,1.07058,1.06996,1.07014,2027,3226.05,-639652,-641011.2,23.070654034257235,61.187166172588455,55.38739643708055,NaN,NaN,50
1653528600,1.07014,1.0702,1.06874,1.0688,2987,3212.8,-642639,-640979.2,22.19973910090149,51.80151137199449,55.090684164491854,NaN,NaN,50
1653530400,1.0688,1.06994,1.0688,1.06958,2351,3206.3,-640288,-640303.8,21.391032377071152,56.029556118193895,55.153121274284196,NaN,NaN,50
1653532200,1.06958,1.07022,1.06956,1.06974,1591,3192,-638697,-639780.2,20.911669311043624,56.865431766899285,55.65150713894706,NaN,NaN,50
1653534000,1.06974,1.0698,1.06882,1.0694,1838,3150.9,-640535,-640362.2,19.579620855347653,54.49471941760227,56.03321301921503,NaN,NaN,50
1653535800,1.0694,1.07026,1.0692,1.07016,1457,3104.4,-639078,-640247.4,18.814541562504285,58.64500387606512,56.55340802982855,NaN,NaN,50
1653537600,1.07016,1.07026,1.06907,1.06934,1467,2317.15,-640545,-639828.6,17.947381584653616,53.02564263585912,56.56958167680566,NaN,NaN,50
1653539400,1.06934,1.06945,1.06806,1.06826,1761,2084.45,-642306,-640232.2,17.288183296758273,46.681212149022954,56.19610402167155,NaN,NaN,50
1653541200,1.06826,1.06838,1.06782,1.06821,1912,2019.7,-644218,-641336.4,16.908259661190712,46.404392618588176,55.42286649045469,NaN,NaN,50
1653543000,1.06821,1.06828,1.06672,1.06676,2492,1998.8,-646710,-642571.4,17.495491709839367,39.15326895325745,54.15188255048181,NaN,NaN,50
1653544800,1.06676,1.06798,1.0663,1.0665,3311,2105.85,-650021,-644760,18.3504818135227,38.006453350956576,52.73491534350312,NaN,NaN,50
1653546600,1.0665,1.06794,1.06626,1.06755,3665,2199.75,-646356,-645922.2,19.17414941504939,45.01131459425431,52.078857590162514,NaN,NaN,50
1653548400,1.06755,1.06926,1.06753,1.06856,4655,2185.4,-641701,-645801.2,18.329901889259506,50.77328077165819,51.547216191716124,NaN,NaN,50
1653550200,1.06856,1.0696,1.06826,1.06889,4039,2363.25,-637662,-644490,17.193965623592675,52.52373656657148,50.757335025965105,NaN,NaN,50
1653552000,1.06889,1.06908,1.06777,1.06817,3306,2382.25,-640968,-643341.6,16.602674780883877,48.47369379126875,49.84922985587083,NaN,NaN,50
1653553800,1.06817,1.06866,1.06778,1.06825,2907,2482.65,-638061,-640949.6,16.053618998368567,48.94476487919568,49.64517653495663,NaN,NaN,50
1653555600,1.06825,1.0686,1.06794,1.06849,1844,2525.8,-636217,-638921.8,15.543781486032918,50.40950907514818,49.24374460331051,NaN,NaN,50
1653557400,1.06849,1.07162,1.06848,1.07134,3486,2656.8,-632731,-637127.8,16.430854541334476,63.72029175174577,49.73337745937097,NaN,NaN,50
1653559200,1.07134,1.07188,1.07086,1.07134,3700,2724.3,-632731,-636141.6,17.411182600804878,63.72029175174577,50.392346911809796,NaN,NaN,50
1653561000,1.07134,1.0723,1.07077,1.07196,3075,2693.55,-629656,-633879.2,18.572368497684423,66.02134944922759,50.919228738464255,NaN,NaN,50
1653562800,1.07196,1.07196,1.07082,1.07083,3641,2774.25,-633297,-632926.4,19.650612544786856,58.71224980846017,51.32541496507861,NaN,NaN,50
1653564600,1.07083,1.07118,1.07022,1.07056,4163,2833.05,-637460,-633175,19.917531413710996,57.086029693360004,52.068616218245545,NaN,NaN,50
1653566400,1.07056,1.07086,1.06891,1.06984,4032,2917.1,-641492,-634927.2,18.815683237151543,52.879792456966236,52.53114477812969,NaN,NaN,50
1653568200,1.06984,1.07044,1.06936,1.06984,5603,3117.7,-641492,-636679.4,17.792538501774903,52.87979245696624,53.51161074268032,NaN,NaN,50
1653570000,1.06984,1.07062,1.06924,1.06986,3736,3212.6,-637756,-638299.4,17.004995655399327,52.991378097383006,54.5819625102822,NaN,NaN,50
1653571800,1.06986,1.072,1.06983,1.07166,5770,3428.25,-631986,-638037.2,17.368279316710918,61.76681563775013,55.77878401338904,NaN,NaN,50
1653573600,1.07166,1.07223,1.071,1.07166,4366,3573.2,-631986,-636942.4,17.865080639521395,61.76681563775013,56.564036503824184,NaN,NaN,50
1653575400,1.07166,1.0718,1.07048,1.07174,6395,3804.9,-625591,-633762.2,17.747228157337005,62.131199934315184,57.250283887234446,NaN,NaN,50
1653577200,1.07174,1.07291,1.07124,1.07288,5185,3968.55,-620406,-629545,18.41807357376279,66.96310072184191,58.57095581084682,NaN,NaN,50
1653579000,1.07288,1.07294,1.07199,1.07255,2813,3984.6,-623219,-626637.6,19.06067659084319,64.40141614436016,59.67500232978713,NaN,NaN,50
1653580800,1.07255,1.07295,1.07146,1.07182,2534,3945.75,-625753,-625391,19.04669617330481,59.022425890844495,60.29021067376544,NaN,NaN,50
1653582600,1.07182,1.07198,1.07053,1.07058,2752,3900.1,-628505,-624694.8,18.0782904936912,51.19972887602889,59.39588475407138,NaN,NaN,50
1653584400,1.07058,1.0714,1.0702,1.07096,3083,3821.5,-625422,-624661,16.868400354095307,53.24483406938511,58.64763777675991,NaN,NaN,50
1653586200,1.07096,1.07166,1.07086,1.07144,1765,3707.8,-623657,-625311.2,15.983605181709311,55.7664972231319,57.91514833203878,NaN,NaN,50
1653588000,1.07144,1.07218,1.07132,1.07201,1508,3617.9,-622149,-625097.2,15.624996839269139,58.620540691112346,57.90859768079965,NaN,NaN,50
1653589800,1.07201,1.07222,1.07177,1.072,1442,3544.65,-623591,-624664.8,15.327554826427134,58.549166730350635,58.013107469156125,NaN,NaN,50
1653591600,1.072,1.07259,1.07176,1.072,1873,3546.1,-623591,-623682,15.384949914893694,58.549166730350635,58.41806277439787,NaN,NaN,50
1653593400,1.072,1.07254,1.07196,1.07239,1510,3447.3,-622081,-623013.8,15.43824535418407,60.712759290697534,58.977560405378675,NaN,NaN,50
1653595200,1.07239,1.07306,1.07234,1.07298,987,3311.65,-621094,-622501.2,15.962009595189567,63.79183794082382,59.74902182276731,NaN,NaN,50
1653597000,1.07298,1.07317,1.07276,1.07302,729,3194.35,-620365,-622144.4,16.546090673786225,63.99784892067451,59.9083813429762,NaN,NaN,50
1653598800,1.07302,1.07302,1.07248,1.07298,2252,3124.9,-622617,-621949.6,16.677770829590568,63.608103502952225,60.03990190477634,NaN,NaN,50
1653600600,1.07298,1.0732,1.07298,1.07308,671,2950.3,-621946,-621620.6,16.9811515371854,64.19516288808398,60.18732783004554,NaN,NaN,50
1653602400,1.07308,1.07318,1.07276,1.07302,974,2797.4,-622920,-621788.4,16.92352363136955,63.53292785714885,59.94231548256747,NaN,NaN,50
1653604200,1.07302,1.07319,1.07281,1.07297,582,2546.35,-623502,-622270,16.88150468244526,62.950140680100965,59.8386529494061,NaN,NaN,50
1653606000,1.07297,1.07348,1.07294,1.07308,846,2401.85,-622656,-622728.2,17.18046324702672,63.7382158605961,60.17549509010264,NaN,NaN,50
1653607800,1.07308,1.07342,1.07303,1.07326,662,2146.45,-621994,-622603.6,17.458067628423787,65.04834275786399,61.16468179594801,NaN,NaN,50
1653609600,1.07326,1.07398,1.07312,1.0736,1768,2016.55,-620226,-622259.6,18.34966918088263,67.4412353663095,62.17871046001403,NaN,NaN,50
1653611400,1.0736,1.07404,1.07306,1.07401,1801,1786.85,-618425,-621360.6,19.17758490816584,70.09964219496936,63.202506529431,NaN,NaN,50
1653613200,1.07401,1.07404,1.07342,1.07386,1964,1625.8,-620389,-620738,19.946363797785963,67.91484892046404,63.866385688670405,NaN,NaN,50
1653615000,1.07386,1.07652,1.0737,1.07626,4402,1705.25,-615987,-619404.2,22.578882030131016,79.1252390369555,65.33610513914218,NaN,NaN,50
1653616800,1.07626,1.0763,1.07512,1.07518,2550,1706.05,-618537,-618712.8,25.02336324587999,67.66761191216162,65.98742265212869,NaN,NaN,50
1653618600,1.07518,1.0758,1.07518,1.07556,1477,1642.3,-617060,-618079.6,27.293238660504045,69.34937020039226,66.60432343139259,NaN,NaN,50
1653620400,1.07556,1.07626,1.07553,1.07595,1561,1566.2,-615499,-617494.4,29.652689949630812,71.0156758452938,67.12031185314045,NaN,NaN,50
1653622200,1.07595,1.07597,1.07539,1.07559,1284,1542.15,-616783,-616773.2,31.545392918330112,67.374565684396,67.36150590769198,NaN,NaN,50
1653624000,1.07559,1.07583,1.07542,1.07576,1031,1518.3,-615752,-616726.2,33.30290281783661,68.20363003229306,67.6897578026449,NaN,NaN,50
1653625800,1.07576,1.07584,1.07536,1.07548,892,1490.8,-616644,-616347.6,34.7923551942875,65.26201257775217,67.76596135190691,NaN,NaN,50
1653627600,1.07548,1.07568,1.07526,1.07548,1085,1451.4,-616644,-616264.4,35.92854180700158,65.26201257775217,67.88946740337857,NaN,NaN,50
1653629400,1.07548,1.07571,1.07438,1.07505,1918,1471.8,-618562,-616877,35.09721278404402,60.606398507841675,67.72205724821721,NaN,NaN,50
1653631200,1.07505,1.07555,1.07454,1.07498,3143,1579.6,-621705,-617861.4,34.325264405583425,59.85779562318371,67.44488437411631,NaN,NaN,50
1653633000,1.07498,1.07498,1.07383,1.07397,3152,1700.75,-624857,-619682.4,32.35776376911862,50.21925463003485,66.3856637935571,NaN,NaN,50
1653634800,1.07397,1.0755,1.07378,1.07443,4682,1822.25,-620175,-620388.6,31.196674127681707,53.8631014954603,65.41579708849643,NaN,NaN,50
1653636600,1.07443,1.07507,1.07332,1.07358,3370,1957.2,-623545,-621768.8,29.39717137006316,47.01485201741218,63.766883504385206,NaN,NaN,50
1653638400,1.07358,1.07434,1.0726,1.07351,4125,2114.75,-627670,-623590.4,27.836740356868283,46.49062738865921,62.23658196639915,NaN,NaN,50
1653640200,1.07351,1.07382,1.07258,1.07305,3512,2261.25,-631182,-625485.8,26.41293208937417,43.09040445057424,59.66266521022906,NaN,NaN,50
1653642000,1.07305,1.07315,1.0723,1.0723,2839,2360.9,-634021,-627318.6,25.448231286415197,38.186520453548624,57.55687296318528,NaN,NaN,50
1653643800,1.0723,1.07255,1.07156,1.07158,3065,2481.05,-637086,-630700.8,25.38557384602904,34.16660134020296,55.04381804460032,NaN,NaN,50
1653645600,1.07158,1.07172,1.07072,1.07163,3524,2568.85,-633562,-632704.2,26.085369629484134,34.68084621055053,52.44847307069009,NaN,NaN,50
1653647400,1.07163,1.07176,1.06969,1.06986,2984,2628,-636546,-634479.4,27.460532556546983,26.722981543518102,49.544788489198815,NaN,NaN,50
1653649200,1.06986,1.07146,1.06978,1.07076,3928,2726.2,-632618,-634766.6,28.7374695602482,34.90245588715328,47.166133193117396,NaN,NaN,50
1653651000,1.07076,1.0719,1.0704,1.07074,3909,2701.55,-636527,-635267.8,29.175447851114978,34.809467833444046,44.99095142566682,NaN,NaN,50
1653652800,1.07074,1.07267,1.07072,1.07254,3410,2744.55,-633117,-634474,28.4307275064912,48.188495877261566,43.771414518488925,NaN,NaN,50
1653654600,1.07254,1.0728,1.07094,1.07154,6145,2977.95,-639262,-635614,27.558795486473294,42.91864616441299,42.50800363681544,NaN,NaN,50
1653656400,1.07154,1.07226,1.07096,1.07216,3605,3080.15,-635657,-635436.2,26.74914432502809,46.80299657809114,41.5755179907374,NaN,NaN,50
1653658200,1.07216,1.07496,1.07181,1.07446,5462,3289.05,-630195,-634951.6,26.49195700187813,58.17384579461007,42.143703073921344,NaN,NaN,50
1653660000,1.07446,1.07505,1.07294,1.07305,4707,3472.85,-634902,-634626.6,26.319092999510733,50.97970389133105,41.93774610219782,NaN,NaN,50
1653661800,1.07305,1.07403,1.071,1.07112,6859,3771.2,-641761,-636355.4,24.65242223038218,43.11928554536136,41.65949135419419,NaN,NaN,50
1653663600,1.07112,1.07145,1.07016,1.07114,6128,4023.35,-635633,-635629.6,23.744425188635997,43.21699219363009,41.425660268834974,NaN,NaN,50
1653665400,1.07114,1.07126,1.07014,1.07076,2982,4076.55,-638615,-636221.2,22.91613675120649,41.749588668335115,41.32988771296075,NaN,NaN,50
1653667200,1.07076,1.07109,1.0705,1.07105,2081,4023.45,-636534,-637489,22.14701177359338,43.33098160632551,41.69734922387339,NaN,NaN,50
1653669000,1.07105,1.07166,1.0704,1.07102,1999,3965.8,-638533,-638215.2,20.85290224108623,43.20032368648995,42.34261510575102,NaN,NaN,50
1653670800,1.07102,1.07112,1.07062,1.07086,1550,3809.2,-640083,-637879.6,19.651229103758162,42.46487816805185,42.89861738842969,NaN,NaN,50
1653672600,1.07086,1.07212,1.07085,1.07177,2118,3746.6,-637965,-638346,18.913755755509296,47.89771167426342,44.411098112054354,NaN,NaN,50
1653674400,1.07177,1.07242,1.07162,1.07214,1945,3637.6,-636020,-637827,18.48690571392198,49.96642315745131,45.48709577421851,NaN,NaN,50
1653676200,1.07214,1.07326,1.07213,1.07322,1776,3550.8,-634244,-637369,18.75730206392493,55.51820220642033,46.96629108657396,NaN,NaN,50
1653678000,1.07322,1.07342,1.07284,1.07294,1530,3485.35,-635774,-636817.2,19.12786310446883,53.849900899348555,47.37067715958017,NaN,NaN,50
1653679800,1.07294,1.07339,1.07286,1.07338,1301,3397.15,-634473,-635695.2,19.471955499259593,56.08321086809075,48.311003209842866,NaN,NaN,50
1653681600,1.07338,1.07338,1.07277,1.07306,620,3251.95,-635093,-635120.8,19.668900370802866,54.03518701447449,48.82758824101311,NaN,NaN,50
1653683400,1.07306,1.07336,1.07301,1.07334,705,3138,-634388,-634794.4,19.851777751521624,55.5642568637128,48.6411890316633,NaN,NaN,50
1653858000,1.07334,1.07375,1.07287,1.07322,256,2954.4,-634644,-634874.4,20.382959446064195,54.72404670089599,48.90864208948937,NaN,NaN,50
1653859800,1.07322,1.07346,1.07322,1.07336,859,2801.9,-633785,-634476.6,20.87619959099658,55.56819328255408,49.79784978500313,NaN,NaN,50
1653861600,1.07336,1.07364,1.07323,1.07344,469,2654.85,-633316,-634245.2,21.50897075888905,56.07220002999592,50.71607891617212,NaN,NaN,50
1653863400,1.07344,1.07347,1.07293,1.07307,434,2369.3,-633750,-633976.6,21.56874733108773,53.07360781703941,51.52493742679385,NaN,NaN,50
1653865200,1.07307,1.07316,1.07262,1.07264,565,2217.3,-634315,-633962,21.103377698894818,49.74422383075634,51.98302615711034,NaN,NaN,50
1653867000,1.07264,1.07318,1.07264,1.07296,1113,1999.85,-633202,-633673.6,20.696272298938403,52.14988504876972,52.62228054013032,NaN,NaN,50
1653868800,1.07296,1.07346,1.07283,1.07322,1348,1831.9,-631854,-633287.4,20.67197349821665,54.073507400836675,53.45146834247209,NaN,NaN,50
1653870600,1.07322,1.07348,1.07292,1.07302,1735,1575.7,-633589,-633342,20.674912467503166,52.33075705310162,53.76811444096053,NaN,NaN,50
1653872400,1.07302,1.07354,1.07268,1.07349,1426,1340.6,-632163,-633024.6,20.205484170683288,55.92567401228084,54.1937752163055,NaN,NaN,50
1653874200,1.07349,1.0753,1.07334,1.07485,2127,1297.85,-630036,-632168.8,21.621898530975173,64.31241924024923,54.821933575864705,NaN,NaN,50
1653876000,1.07485,1.0756,1.07466,1.07556,1566,1272.1,-628470,-631222.4,23.162045875176158,67.76138060554544,55.815610697735906,NaN,NaN,50
1653877800,1.07556,1.07556,1.07428,1.07452,1387,1241.5,-629857,-630823,23.908583141973892,58.79761296424141,56.00949656174667,NaN,NaN,50
1653879600,1.07452,1.07475,1.07384,1.07394,1356,1231.8,-631213,-630347.8,23.867545913396402,54.470030979640434,56.040556844972805,NaN,NaN,50
1653881400,1.07394,1.07464,1.07376,1.07447,1163,1184.05,-630050,-629925.2,23.698700906632165,57.545041388970716,56.1820414539198,NaN,NaN,50
1653883200,1.07447,1.07478,1.07423,1.07465,1074,1140.5,-628976,-629713.2,23.69446691196914,58.56847913398373,56.456643770568924,NaN,NaN,50
1653885000,1.07465,1.07602,1.07462,1.07576,1526,1128,-627450,-629509.2,24.814382695051783,64.28598753118101,57.079343359756606,NaN,NaN,50
1653886800,1.07576,1.07608,1.07554,1.07555,1200,1111.5,-628650,-629267.8,25.900306657779677,62.52793825526763,57.54046751870458,NaN,NaN,50
1653888600,1.07555,1.07601,1.07512,1.07535,1654,1129.15,-630304,-629086,26.167144858459796,60.821971355108374,58.09392205713808,NaN,NaN,50
1653890400,1.07535,1.07656,1.07523,1.0762,3023,1249.3,-627281,-628532.2,26.89069626947574,65.1711677440614,59.19584662237416,NaN,NaN,50
1653892200,1.0762,1.07702,1.07513,1.07538,3563,1392.2,-630844,-628905.8,27.920048513587652,58.43213169258583,59.64457852550389,NaN,NaN,50
1653894000,1.07538,1.07584,1.07446,1.07526,4607,1609.75,-635451,-630506,27.768553581997345,57.49516176098636,59.88898240837172,NaN,NaN,50
1653895800,1.07526,1.076,1.07404,1.07428,3014,1717.5,-638465,-632469,27.008249038268982,50.38894138989112,59.75028128957097,NaN,NaN,50
1653897600,1.07428,1.0753,1.07403,1.0742,3619,1875,-642084,-634825,26.287485703828377,49.84731756680513,59.31611297203698,NaN,NaN,50
1653899400,1.0742,1.07638,1.0742,1.07634,2868,1996.7,-639216,-637212,26.62897218689241,61.70527628735663,59.1298884754018,NaN,NaN,50
1653901200,1.07634,1.07704,1.07612,1.07669,3269,2131.9,-635947,-638232.6,27.442344596835035,63.23627298798261,58.806666502718734,NaN,NaN,50
1653903000,1.07669,1.07696,1.07624,1.07658,2198,2186.15,-638145,-638771.4,28.19761897749604,62.392017931242364,59.063409714647385,NaN,NaN,50
1653904800,1.07658,1.0766,1.07568,1.0761,1893,2213.4,-640038,-639086,28.009378691566166,58.708668899452874,59.366169566062545,NaN,NaN,50
1653906600,1.0761,1.07753,1.07596,1.0775,2963,2274.8,-637075,-638084.2,28.573416634794896,65.1677012578578,59.91064527098306,NaN,NaN,50
1653908400,1.0775,1.07806,1.07708,1.07708,2913,2349.15,-639988,-638238.6,29.456920200694853,62.03271731567407,60.15809085538951,NaN,NaN,50
1653910200,1.07708,1.0776,1.07646,1.07668,2291,2357.35,-642279,-639505,29.370469229121664,59.115942374224204,59.78880191560688,NaN,NaN,50
1653912000,1.07668,1.07711,1.07565,1.07571,3208,2439.45,-645487,-640973.4,28.259821111770478,52.65072811165629,59.08328690534893,NaN,NaN,50
1653913800,1.07571,1.07596,1.07483,1.07526,2611,2500.65,-648098,-642585.4,26.340429701535324,49.922979966443684,58.3047875204443,NaN,NaN,50
1653915600,1.07526,1.0763,1.07506,1.07628,2253,2545.5,-645845,-644339.4,24.88572061569851,55.545005226215075,57.617204483455275,NaN,NaN,50
1653917400,1.07628,1.07718,1.07619,1.07713,1872,2580.95,-643973,-645136.4,24.30562829611218,59.61401244112434,57.70162453692232,NaN,NaN,50
1653919200,1.07713,1.07754,1.07662,1.07705,2504,2652.45,-646477,-645976,24.053084955741493,59.066036525922826,57.81382987727492,NaN,NaN,50
1653921000,1.07705,1.07824,1.07672,1.07813,3605,2756.4,-642872,-645453,24.33666708078639,63.89151944185141,58.77829973812921,NaN,NaN,50
1653922800,1.07813,1.07838,1.07752,1.07826,3000,2846.4,-639872,-643807.8,24.69940559531944,64.4350000803239,59.820277060523416,NaN,NaN,50
1653924600,1.07826,1.07835,1.07761,1.07796,1431,2835.25,-641303,-642899.4,25.036234215957272,62.11167134084744,59.8493052786299,NaN,NaN,50
1653926400,1.07796,1.0782,1.07781,1.07816,1528,2760.5,-639775,-642059.8,25.349003649406686,63.06773797866771,59.83726706367884,NaN,NaN,50
1653928200,1.07816,1.07866,1.07808,1.07864,1215,2643.1,-638560,-640476.4,26.010096581563218,65.32897125938847,60.0470494442607,NaN,NaN,50
1653930000,1.07864,1.0787,1.07824,1.07836,800,2452.75,-639360,-639774,26.655907824709875,62.909303086108935,60.34709474330755,NaN,NaN,50
1653931800,1.07836,1.07864,1.07833,1.07842,413,2322.7,-638947,-639589,27.25558969334606,63.22364089860748,60.20823328907539,NaN,NaN,50
1653933600,1.07842,1.07848,1.07822,1.07836,661,2174.8,-639608,-639250,27.606560255950196,62.651833068032886,60.2524558428153,NaN,NaN,50
1653935400,1.07836,1.07836,1.07806,1.07834,425,2052.65,-640033,-639301.6,27.62706148418337,62.44908342722781,60.49053734660127,NaN,NaN,50
1653937200,1.07834,1.07838,1.07772,1.07806,1074,1942.9,-641107,-639811,27.016426010934126,59.5438824661969,60.98290551478275,NaN,NaN,50
1653939000,1.07806,1.07814,1.07783,1.07792,611,1863.55,-641718,-640282.6,26.44940735720268,58.08876863533927,61.56617613398958,NaN,NaN,50
1653940800,1.07792,1.07826,1.07782,1.07796,881,1812.95,-640837,-640660.6,26.081496087003448,58.40155910531745,61.77021569678261,NaN,NaN,50
1653942600,1.07796,1.07811,1.07783,1.078,373,1683.45,-640464,-640831.8,25.739864193247016,58.733230674600314,61.70730271345946,NaN,NaN,50
1653944400,1.078,1.078,1.07775,1.07788,71,1541.35,-640535,-640932.2,25.24263538311981,57.25828684958625,61.57817773657829,NaN,NaN,50
1653946200,1.07788,1.07792,1.07774,1.0778,220,1437.8,-640755,-640861.8,24.757261821288612,56.24422842498275,61.03194266394481,NaN,NaN,50
1653948000,1.0778,1.07798,1.07754,1.07775,542,1304.5,-641297,-640777.6,23.827152141652785,55.5816749165593,60.39956229510448,NaN,NaN,50
1653949800,1.07775,1.07775,1.07737,1.0775,675,1207.7,-641972,-641004.6,22.569918330575263,52.26639481399093,59.696328257471876,NaN,NaN,50
1653951600,1.0775,1.07756,1.07724,1.07726,873,1138.7,-642845,-641480.8,21.106385038758756,49.23055241081242,58.70795785976793,NaN,NaN,50
1653953400,1.07726,1.07742,1.07704,1.07731,1154,1102.8,-641691,-641712,19.892990293065235,49.883652192399516,57.604720783554434,NaN,NaN,50
1653955200,1.07731,1.07747,1.07559,1.07562,2582,1106.7,-644273,-642415.6,20.96911446150718,33.974886169349546,55.53797671807162,NaN,NaN,50
1653957000,1.07562,1.07563,1.0743,1.07458,4705,1161.7,-648978,-643951.8,23.062791620685033,28.047043616786922,53.025362626513,NaN,NaN,50
1653958800,1.07458,1.0747,1.07342,1.07441,3651,1194.25,-652629,-646083.2,25.530855420925004,27.21127173789081,50.49389396007428,NaN,NaN,50
1653960600,1.07441,1.07516,1.07375,1.07506,4078,1326.6,-648551,-647224.4,26.959327871119214,35.166444608828286,48.545134044474324,NaN,NaN,50
1653962400,1.07506,1.0758,1.07453,1.07481,2615,1380.95,-651166,-649119.4,27.214526016398644,33.643453408892725,46.69510339752402,NaN,NaN,50
1653964200,1.07481,1.07514,1.07421,1.07514,1692,1404.8,-649474,-650159.6,27.71236357951439,37.491719535554466,45.22388560468226,NaN,NaN,50
1653966000,1.07514,1.07538,1.07456,1.07456,1904,1460,-651378,-650639.6,27.784229216479613,33.78335179185076,43.46544222514893,NaN,NaN,50
1653967800,1.07456,1.07526,1.07444,1.07514,1528,1515.75,-649850,-650083.8,27.960239101930444,40.15776117500576,42.13862297517788,NaN,NaN,50
1653969600,1.07514,1.07526,1.07446,1.07477,1410,1553.2,-651260,-650625.6,28.123676852706215,37.66667658547047,40.739222242026756,NaN,NaN,50
1653971400,1.07477,1.07479,1.07438,1.07446,908,1577.35,-652168,-650826,28.35676820700373,35.670178411985376,39.26964724109837,NaN,NaN,50
1653973200,1.07446,1.0753,1.07446,1.07502,938,1570.55,-651230,-651177.2,27.627472931155122,41.68349562333365,38.276920148725104,NaN,NaN,50
1653975000,1.07502,1.07554,1.07449,1.07458,1552,1617.6,-652782,-651458,26.540223394177538,38.628184787348154,37.302762289679194,NaN,NaN,50
1653976800,1.07458,1.07516,1.07388,1.07423,3082,1727.65,-655864,-652660.8,26.265082198806816,36.34601416344013,36.3824381291526,NaN,NaN,50
1653978600,1.07423,1.07444,1.07278,1.07339,4123,1915.15,-659987,-654406.2,27.03476093201565,31.53119321485228,35.071548202184935,NaN,NaN,50
1653980400,1.07339,1.07484,1.07336,1.07434,5147,2168.95,-654840,-654940.6,27.08606736021472,41.043466004206785,35.5764467618176,NaN,NaN,50
1653982200,1.07434,1.07471,1.07346,1.07368,3752,2345.55,-658592,-656413,27.13370904354243,37.178961601631435,36.228726617877925,NaN,NaN,50
1653984000,1.07368,1.0746,1.07348,1.07412,4018,2519.35,-654574,-656771.4,27.17794774948959,41.15673435843901,37.224831090774224,NaN,NaN,50
1653985800,1.07412,1.07442,1.07252,1.07276,3634,2667.3,-658208,-657240.2,28.090367735414752,33.992239824839245,37.14095932048929,NaN,NaN,50
1653987600,1.07276,1.07388,1.07212,1.07326,5844,2915.85,-652364,-655715.6,29.239696585253327,38.248314537161406,37.46987797250848,NaN,NaN,50
1653989400,1.07326,1.07387,1.0722,1.07242,3630,3039.65,-655994,-655946.4,30.306930517246293,34.25253984257269,37.23850799443836,NaN,NaN,50
1653991200,1.07242,1.07304,1.07186,1.07275,3579,3089.5,-652415,-654711,31.55678052499144,37.035480346625384,37.47080289120798,NaN,NaN,50
1653993000,1.07275,1.07346,1.0689,1.06962,8996,3304.05,-661411,-656078.4,34.12800811463172,25.8563640153356,36.44927452266011,NaN,NaN,50
1653994800,1.06962,1.07102,1.06894,1.06994,6874,3465.2,-654537,-655344.2,36.51557659072627,28.241181235426993,35.776024854799864,NaN,NaN,50
1653996600,1.06994,1.07136,1.06982,1.07134,4033,3462.95,-650504,-654972.2,38.15829730548903,37.6847906821696,35.9199257312416,NaN,NaN,50
1653998400,1.07134,1.0716,1.07022,1.07062,5723,3618.35,-656227,-655018.8,39.282680979563835,35.124649694983475,35.45143673635944,NaN,NaN,50
1654000200,1.07062,1.07064,1.068,1.06818,6297,3848.6,-662524,-657040.6,41.18152871599225,28.14619220118911,34.70272298020522,NaN,NaN,50
1654002000,1.06818,1.0713,1.0679,1.07108,6108,4058.8,-656416,-656041.6,42.0356462278443,42.713855229164785,35.15756877061413,NaN,NaN,50
1654003800,1.07108,1.0719,1.0702,1.07127,7422,4353.5,-648994,-654933,42.06444063996177,43.52176250774589,36.014038005820815,NaN,NaN,50
1654005600,1.07127,1.0713,1.0689,1.07034,8511,4708.55,-657505,-656333.2,42.66754465004404,40.51020993286516,35.97594828643927,NaN,NaN,50
1654007400,1.07034,1.07362,1.07018,1.07118,12094,5267.85,-645411,-654170,40.94590083751185,44.26182070143868,36.48186679356836,NaN,NaN,50
1654009200,1.07118,1.073,1.07104,1.07236,9071,5674.5,-636340,-648933.2,39.34723158301768,49.11628746978215,37.050406301521434,NaN,NaN,50
1654011000,1.07236,1.07372,1.07192,1.07312,5111,5852.45,-631229,-643895.8,37.26172811087393,52.01503382456646,38.33774873007338,NaN,NaN,50
1654012800,1.07312,1.07382,1.07239,1.07251,3988,5897.75,-635217,-641140.4,35.24254935430339,49.57393295020143,39.14672147386195,NaN,NaN,50
1654014600,1.07251,1.07336,1.07235,1.07313,3124,5847.8,-632093,-636058,33.396877037769926,52.037720166604814,40.41709149700711,NaN,NaN,50
1654016400,1.07313,1.07342,1.07256,1.07312,2556,5718.25,-634649,-633905.6,31.626590858700137,51.993594534729766,41.485528224728846,NaN,NaN,50
1654018200,1.07312,1.0739,1.07305,1.07379,2047,5633,-632602,-633158,29.528234724590916,54.76143456891157,43.550176121412846,NaN,NaN,50
1654020000,1.07379,1.07398,1.07304,1.07368,2527,5558.45,-635129,-633938,27.503759562102253,54.20883009292043,45.40500818266237,NaN,NaN,50
1654021800,1.07368,1.07468,1.07324,1.07367,3078,5530.65,-638207,-634536,26.099948161711822,54.15532775397008,46.58147511636241,NaN,NaN,50
1654023600,1.07367,1.07368,1.0732,1.07352,2701,5373.5,-640908,-636299,24.754305621529703,53.30546188720451,47.88010455866391,NaN,NaN,50
1654025400,1.07352,1.07404,1.07326,1.07352,2363,5310.15,-640908,-637550.8,23.838028768335814,53.30546188720451,49.67719525052216,NaN,NaN,50
1654027200,1.07352,1.07366,1.07322,1.07343,1097,5186.05,-642005,-639431.4,22.939362183155808,52.729644651710075,50.39260878070396,NaN,NaN,50
1654029000,1.07343,1.07358,1.07298,1.07322,664,4769.45,-642669,-640939.4,21.809065642607997,51.336173719080726,50.95078101008502,NaN,NaN,50
1654030800,1.07322,1.07349,1.07322,1.07334,3433,4597.4,-639236,-641145.2,20.759504569242175,52.11490929999982,51.779688107737506,NaN,NaN,50
1654032600,1.07334,1.07344,1.07322,1.0733,242,4407.85,-639478,-640859.2,19.784912143973905,51.8172485699073,52.31936152691383,NaN,NaN,50
1654034400,1.0733,1.0736,1.07322,1.07346,1012,4172.3,-638466,-640370.8,19.079392076073116,52.97426577254743,52.59493140568278,NaN,NaN,50
1654036200,1.07346,1.0738,1.07346,1.07368,682,3891.55,-637784,-639526.6,18.674566628489757,54.58898425934073,52.77878500816666,NaN,NaN,50
1654038000,1.07368,1.07372,1.07324,1.07342,470,3609.65,-638254,-638643.6,17.94184011126741,52.30325241534082,52.97373639853375,NaN,NaN,50
1654039800,1.07342,1.07378,1.07328,1.07342,902,3283.65,-638254,-638447.2,17.34499918761795,52.30325241534082,52.99270298772918,NaN,NaN,50
1654041600,1.07342,1.07348,1.07276,1.0731,1725,2944.35,-639979,-638547.4,16.25503649851811,49.35350862681124,52.80412542287787,NaN,NaN,50
1654043400,1.0731,1.07342,1.07266,1.0728,1764,2427.85,-641743,-639202.8,15.393866613770019,46.69474593520832,52.22793337761335,NaN,NaN,50
1654045200,1.0728,1.07286,1.07217,1.07226,1679,2058.25,-643422,-640330.4,15.293833571166445,42.27955822305856,51.375842529766075,NaN,NaN,50
1654047000,1.07226,1.0723,1.07086,1.07174,2892,1947.3,-646314,-641942.4,16.598052235703655,38.50399921191574,50.25789049104791,NaN,NaN,50
1654048800,1.07174,1.07174,1.07077,1.07138,2055,1850.65,-648369,-643965.4,17.887651006432968,36.1004797879437,49.02896319824356,NaN,NaN,50
1654050600,1.07138,1.07214,1.07133,1.07168,1915,1790.2,-646454,-645260.4,18.379272362748765,39.49025246433736,48.04216252518162,NaN,NaN,50
1654052400,1.07168,1.0722,1.07137,1.07192,1512,1738,-644942,-645900.2,18.731359927180385,42.13487994412519,47.28539361749699,NaN,NaN,50
1654054200,1.07192,1.07207,1.0717,1.07183,1313,1701.3,-646255,-646466.8,19.058298379866894,41.404080413340004,46.57595838137265,NaN,NaN,50
1654056000,1.07183,1.0719,1.07106,1.07126,1758,1662.85,-648013,-646806.6,20.055351849797315,37.02422742373544,45.498052533068055,NaN,NaN,50
1654057800,1.07126,1.07143,1.07071,1.07143,1594,1588.65,-646419,-646416.6,21.313148332635315,39.09359714389806,44.589220288353104,NaN,NaN,50
1654059600,1.07143,1.07156,1.07076,1.07098,1305,1518.85,-647724,-646670.6,22.215570672816565,35.745244903715204,43.35857594057938,NaN,NaN,50
1654061400,1.07098,1.07106,1.07052,1.07099,1945,1497.95,-645779,-646838,23.293930115196254,35.87668070290144,42.02198282940515,NaN,NaN,50
1654063200,1.07099,1.07178,1.0706,1.07134,2768,1581.5,-643011,-646189.2,22.9089267658115,40.46676447316171,41.17651940496378,NaN,NaN,50
1654065000,1.07134,1.07258,1.07096,1.0724,2937,1695.15,-640074,-644601.4,21.333094126182704,51.73507394375751,41.13593522842211,NaN,NaN,50
1654066800,1.0724,1.07374,1.07219,1.0725,5239,1785.45,-634835,-642284.6,21.07617147995044,52.64569474572411,41.37109137977303,NaN,NaN,50
1654068600,1.0725,1.0727,1.07114,1.07152,4687,2007.7,-639522,-640644.2,19.58446329000216,43.903578096863455,41.17172224846268,NaN,NaN,50
1654070400,1.07152,1.07394,1.07138,1.07258,6081,2261.15,-633441,-638176.6,19.332950582767165,52.99553419797944,41.93714910381417,NaN,NaN,50
1654072200,1.07258,1.0731,1.07174,1.07178,3708,2412.45,-637149,-637004.2,19.099403068906103,46.82693306846541,42.53164437928201,NaN,NaN,50
1654074000,1.07178,1.07267,1.0714,1.07235,2908,2534.35,-634241,-635837.6,18.475801266484513,51.18662501138659,43.609226180956504,NaN,NaN,50
1654075800,1.07235,1.0727,1.07193,1.0727,2209,2599.7,-632032,-635277,17.926451133988888,53.697068514543496,44.62399875597122,NaN,NaN,50
1654077600,1.0727,1.07286,1.07179,1.07201,2127,2619.8,-634159,-634204.4,17.581773780226957,48.41112496780347,45.07230197194824,NaN,NaN,50
1654079400,1.07201,1.07204,1.07136,1.07176,2401,2651.65,-636560,-634828.2,16.697141750733888,46.62042123765709,45.44489774511374,NaN,NaN,50
1654081200,1.07176,1.07205,1.07096,1.0712,3199,2727.65,-639759,-635350.2,15.624918912335911,42.801261409106814,45.85754302978313,NaN,NaN,50
1654083000,1.0712,1.07182,1.0702,1.07084,3615,2763.8,-643374,-637176.8,15.458428514009121,40.50410864808452,45.95829385151074,NaN,NaN,50
1654084800,1.07084,1.07174,1.07054,1.07161,4241,2873.1,-639133,-638597,15.303830286991385,47.050045446593195,46.765779604573446,NaN,NaN,50
1654086600,1.07161,1.07279,1.07141,1.07262,4537,3004.2,-634596,-638684.4,14.548536945386553,54.172452361011715,48.07262043729561,NaN,NaN,50
1654088400,1.07262,1.07308,1.0724,1.07242,3043,3080.75,-637639,-638900.2,14.154648888467754,52.661848484808985,48.94369786669899,NaN,NaN,50
1654090200,1.07242,1.07253,1.07025,1.07087,5508,3290.5,-643147,-639577.8,14.562937230950418,42.7195805248579,48.299734051063304,NaN,NaN,50
1654092000,1.07087,1.07087,1.06516,1.06536,13232,3864.2,-656379,-642178.8,17.250356434891813,24.7971784509528,46.310554315722506,NaN,NaN,50
1654093800,1.06536,1.06772,1.06532,1.06674,8778,4223.4,-647601,-643872.4,19.74581712426597,32.44185514023508,45.49185981882048,NaN,NaN,50
1654095600,1.06674,1.06678,1.06514,1.06521,5999,4458.1,-653600,-647673.2,22.118601448745817,28.930476938912747,43.772927157458575,NaN,NaN,50
1654097400,1.06521,1.0653,1.06273,1.06447,5491,4635.4,-659091,-651963.6,24.96034058148799,27.38652482383243,42.38432656855621,NaN,NaN,50
1654099200,1.06447,1.06471,1.06394,1.06408,4220,4708,-663311,-655996.4,27.59909834760573,26.58138121841661,40.62680915477264,NaN,NaN,50
1654101000,1.06408,1.0648,1.06382,1.06392,2816,4701.95,-666127,-657946,30.07891145640124,26.24054221620719,38.66562870489148,NaN,NaN,50
1654102800,1.06392,1.06473,1.06372,1.06428,2642,4572.1,-663485,-661122.8,32.407562850051086,28.463179407476886,37.24077545058243,NaN,NaN,50
1654104600,1.06428,1.06541,1.06405,1.06518,3150,4495.25,-660335,-662469.8,33.80311330936819,33.831367368167164,36.327271602761726,NaN,NaN,50
1654106400,1.06518,1.06576,1.06448,1.06562,3747,4378.55,-656588,-661969.2,34.71601598804829,36.3462455566611,35.86619904187275,NaN,NaN,50
1654108200,1.06562,1.06592,1.06504,1.06552,2770,4331.65,-659358,-661178.6,35.38493275665636,36.01125309441251,35.54528078803903,NaN,NaN,50
1654110000,1.06552,1.06607,1.06506,1.06586,2283,4300.4,-657075,-659368.2,35.83166077767322,38.10020429510527,34.90600642007561,NaN,NaN,50
1654111800,1.06586,1.06596,1.06497,1.06502,2306,4305.25,-659381,-658547.4,36.2916330577732,35.055365907832666,33.54050024484854,NaN,NaN,50
1654113600,1.06502,1.06546,1.06469,1.06534,1209,4259.35,-658172,-658114.8,36.863154176718716,37.11706427188689,32.4301585153541,NaN,NaN,50
1654115400,1.06534,1.06543,1.06502,1.06518,949,4186.75,-659121,-658621.4,37.39385235859669,36.49325879038589,31.98542124860611,NaN,NaN,50
1654117200,1.06518,1.06541,1.06476,1.06538,116,4032.6,-659005,-658550.8,38.03125564159604,37.89825156795934,32.92121218553515,NaN,NaN,50
1654119000,1.06538,1.0654,1.06522,1.06526,354,3869.55,-659359,-659007.6,38.623130118666865,37.364123989706584,33.27280281764025,NaN,NaN,50
1654120800,1.06526,1.06538,1.06512,1.06532,582,3686.6,-658777,-658886.8,39.23389793250941,37.83588308743037,33.90890325682008,NaN,NaN,50
1654122600,1.06532,1.06542,1.06482,1.06526,886,3504.05,-659663,-659185,39.98598140910679,37.53146021926036,34.63354149935065,NaN,NaN,50
1654124400,1.06526,1.06544,1.06512,1.06544,579,3380.85,-659084,-659177.6,40.64683358330778,39.114149687099605,35.52873924711373,NaN,NaN,50
1654126200,1.06544,1.06544,1.06504,1.06513,734,3142.15,-659818,-659340.2,41.31443652595842,37.358655220531844,36.322890175994054,NaN,NaN,50
1654128000,1.06513,1.06588,1.06458,1.06582,2264,2593.75,-657554,-658979.2,42.235715935542466,43.44312902534315,37.39288657727021,NaN,NaN,50
1654129800,1.06582,1.06596,1.06538,1.06566,1547,2232.2,-659101,-659044,42.91983826955399,42.41433093591028,38.005955403537584,NaN,NaN,50
1654131600,1.06566,1.06578,1.06464,1.06512,1697,2017.1,-660798,-659271,44.01689433433968,39.05292417183714,38.19928959033587,NaN,NaN,50
1654133400,1.06512,1.06558,1.065,1.06548,1659,1825.5,-659139,-659282,45.03558925164067,42.33403884091972,38.650917143657814,NaN,NaN,50
1654135200,1.06548,1.06584,1.0652,1.06572,1454,1687.2,-657685,-658855.4,45.395458605564734,44.479950331474015,39.10661328911272,NaN,NaN,50
1654137000,1.06572,1.06576,1.06451,1.06498,1799,1636.35,-659484,-659241.4,46.18978492474272,39.58821098651078,39.430387937589735,NaN,NaN,50
1654138800,1.06498,1.06552,1.06486,1.06547,1657,1587.1,-657827,-658986.6,46.9273736496937,43.9814039376167,39.92069791371329,NaN,NaN,50
1654140600,1.06547,1.06552,1.06512,1.06543,871,1473.15,-658698,-658566.6,47.612277465719615,43.702015363528034,40.43560909750916,NaN,NaN,50
1654142400,1.06543,1.06567,1.0653,1.0654,846,1328.1,-659544,-658647.6,47.86983295807792,43.47893343946324,40.83422923118801,NaN,NaN,50
1654144200,1.0654,1.06578,1.0654,1.06576,686,1223.9,-658858,-658882.2,47.82776568827506,46.976736096491386,41.52084438167264,NaN,NaN,50
1654146000,1.06576,1.06598,1.0652,1.06531,1156,1167.55,-660014,-658988.2,47.78870322345811,43.36420925451649,41.91572482217879,NaN,NaN,50
1654147800,1.06531,1.06658,1.06496,1.0658,1726,1138.55,-658288,-659080.4,46.26474930976013,48.049002055993874,42.66697781051689,NaN,NaN,50
1654149600,1.0658,1.06692,1.06576,1.06678,2277,1191.95,-656011,-658543,44.132091196804154,55.90503199851243,43.86632654704638,NaN,NaN,50
1654151400,1.06678,1.06789,1.06666,1.06766,2684,1278.7,-653327,-657299.6,41.43914396052114,61.530594907615225,45.59289366755234,NaN,NaN,50
1654153200,1.06766,1.06852,1.06747,1.06815,3907,1468.25,-649420,-655412,39.74503318290417,64.26445014403056,47.08013089031573,NaN,NaN,50
1654155000,1.06815,1.06922,1.06776,1.06857,3584,1629.75,-645836,-652576.4,38.91344036040926,66.46435834087613,48.79798999067043,NaN,NaN,50
1654156800,1.06857,1.06924,1.06842,1.06867,2594,1730.35,-643242,-649567.2,38.161106942463974,66.98548631456183,50.79317300086505,NaN,NaN,50
1654158600,1.06867,1.0695,1.06842,1.06842,1938,1782.95,-645180,-647401,37.7252504688015,64.29554182128561,52.3618517851769,NaN,NaN,50
1654160400,1.06842,1.0691,1.06808,1.06889,1897,1848.85,-643283,-645392.2,36.684280392834175,66.98014613275558,53.96900862812559,NaN,NaN,50
1654162200,1.06889,1.0691,1.06839,1.06885,1630,1893.65,-644913,-644490.8,35.71766532229309,66.52172130388149,55.89283079365207,NaN,NaN,50
1654164000,1.06885,1.06916,1.06847,1.06855,2098,1885.35,-647011,-644725.8,34.89483858586893,63.037034416682665,57.253947256442494,NaN,NaN,50
1654165800,1.06855,1.06971,1.06826,1.06955,1713,1893.65,-645298,-645137,34.77235819535521,68.88759289091757,59.052917079827445,NaN,NaN,50
1654167600,1.06955,1.06967,1.06868,1.06935,2020,1909.8,-647318,-645564.6,34.6586264041639,66.61653990469725,60.705603255915584,NaN,NaN,50
1654169400,1.06935,1.06958,1.06844,1.06942,2696,1961.65,-644622,-645832.4,34.01483414293886,67.02627857107922,62.13771343267185,NaN,NaN,50
1654171200,1.06942,1.0699,1.06892,1.06922,3946,2086.25,-648568,-646563.4,33.816053721398895,64.58713014741852,63.65363635359343,NaN,NaN,50
1654173000,1.06922,1.07163,1.0685,1.07032,6799,2336.25,-641769,-645515,35.12625241885157,70.86670331979016,65.2834721581503,NaN,NaN,50
1654174800,1.07032,1.07116,1.06968,1.07083,5580,2532.4,-636189,-643693.2,36.34286549505763,73.23631451988234,66.52142090967673,NaN,NaN,50
1654176600,1.07083,1.07096,1.06923,1.06994,6294,2803.55,-642483,-642726.2,36.55871831924258,63.52580238020038,66.6639357291471,NaN,NaN,50
1654178400,1.06994,1.07184,1.06954,1.07022,7094,3115.95,-635389,-640879.6,37.410716183388985,65.09388823561221,66.7231813071172,NaN,NaN,50
1654180200,1.07022,1.07185,1.0701,1.07159,6076,3385.45,-629313,-637028.6,38.20861873340036,71.5408274878937,67.0857862461899,NaN,NaN,50
1654182000,1.07159,1.0734,1.07127,1.07255,4225,3538.9,-625088,-633692.4,39.81167392773024,75.02213766728372,67.65983277138432,NaN,NaN,50
1654183800,1.07255,1.07384,1.07202,1.07322,3287,3616.95,-621801,-630814.8,41.488415267929746,77.12526149065232,68.57624131919623,NaN,NaN,50
1654185600,1.07322,1.07438,1.07304,1.07415,2977,3651.95,-618824,-626083,43.258594463750384,79.68250751610508,69.48355284657833,NaN,NaN,50
1654187400,1.07415,1.07449,1.07362,1.07443,2271,3631.3,-616553,-622315.8,44.944548288392475,80.39320179494797,70.47437288165452,NaN,NaN,50
1654189200,1.07443,1.07478,1.0738,1.07426,2560,3563.95,-619113,-620275.8,46.62225384445528,78.59562822212548,71.58570101061471,NaN,NaN,50
1654191000,1.07426,1.07484,1.07423,1.07454,1994,3484.45,-617119,-618682,48.203684311246995,79.41215789424362,72.33745565370944,NaN,NaN,50
1654192800,1.07454,1.07482,1.07442,1.07445,1660,3437.75,-618779,-618077.6,49.67215545898216,78.3771865700489,73.1775018440917,NaN,NaN,50
1654194600,1.07445,1.07489,1.07384,1.07391,2132,3447.45,-620911,-618495,49.77168503715112,72.28949754405102,73.55344605644682,NaN,NaN,50
1654196400,1.07391,1.07458,1.07379,1.07415,2109,3458.05,-618802,-618944.8,49.76007171028331,73.28274352040425,74.17456129737437,NaN,NaN,50
1654198200,1.07415,1.07489,1.07414,1.07487,1304,3441.75,-617498,-618621.8,49.96697989645093,76.05557092797986,74.54519469795936,NaN,NaN,50
1654200000,1.07487,1.07502,1.0746,1.07476,682,3370.95,-618180,-618834,50.24901959078899,74.77868045135322,74.6553636930644,NaN,NaN,50
1654201800,1.07476,1.07501,1.07474,1.07488,496,3310.1,-617684,-618615,50.510913592674335,75.26652449663605,75.49398670138125,NaN,NaN,50
1654203600,1.07488,1.07488,1.0741,1.0748,241,3221.15,-617925,-618017.8,49.305119610302604,74.23561874961422,76.14696745238139,NaN,NaN,50
1654205400,1.0748,1.07486,1.07473,1.07478,258,3099.25,-618183,-617894,48.185453769528856,73.96287451967896,76.31997081179462,NaN,NaN,50
1654207200,1.07478,1.07505,1.07474,1.07476,990,2951.45,-619173,-618229,47.351553379996886,73.6713824513877,76.22348829637347,NaN,NaN,50
1654209000,1.07476,1.07513,1.07474,1.07482,530,2638,-618643,-618321.6,46.66475698527917,74.00240085628766,76.0004268224903,NaN,NaN,50
1654210800,1.07482,1.07502,1.07476,1.07486,613,2389.65,-618030,-618390.8,46.027017475898425,74.23496791350881,75.61131685087628,NaN,NaN,50
1654212600,1.07486,1.07508,1.07474,1.07504,688,2109.35,-617342,-618274.2,45.508271822099914,75.30553000546436,75.24791172305602,NaN,NaN,50
1654214400,1.07504,1.07542,1.07468,1.07542,1059,1807.6,-616283,-617894.2,45.427004999189975,77.43697564383032,75.16515082460636,NaN,NaN,50
1654216200,1.07542,1.07631,1.07542,1.07594,2627,1635.15,-613656,-616790.8,46.16664845477381,79.9830801820253,75.20593098801933,NaN,NaN,50
1654218000,1.07594,1.07597,1.07535,1.07542,1377,1492.75,-615033,-616068.8,46.66342337860502,71.3163956615903,74.70158878027227,NaN,NaN,50
1654219800,1.07542,1.07622,1.07536,1.07601,1773,1417.05,-613260,-615114.8,47.33110573319945,74.67007897526604,74.87163031107335,NaN,NaN,50
1654221600,1.07601,1.07646,1.07574,1.07641,1165,1326.45,-612095,-614065.4,48.13932661511883,76.6623064394723,75.11302766243536,NaN,NaN,50
1654223400,1.07641,1.07642,1.07559,1.07576,1180,1271.9,-613275,-613463.8,48.45060809330331,67.38716911819299,74.49385610459345,NaN,NaN,50
1654225200,1.07576,1.07597,1.07546,1.07564,1261,1206.95,-614536,-613639.8,48.3593714974717,65.80429890610003,73.85282885136108,NaN,NaN,50
1654227000,1.07564,1.07565,1.07521,1.07532,1193,1166.9,-615729,-613779,47.565827575398366,61.64590395563441,72.87992738414667,NaN,NaN,50
1654228800,1.07532,1.07542,1.07494,1.07504,926,1130.2,-616655,-614458,46.116046293817675,58.18134495840524,71.73319354191746,NaN,NaN,50
1654230600,1.07504,1.07526,1.07462,1.07462,1026,1074.9,-617681,-615575.2,43.99771939373077,53.33890980923637,70.26005320545728,NaN,NaN,50
1654232400,1.07462,1.07546,1.07452,1.07541,895,1014.2,-616786,-616277.4,42.35338037767297,60.07074862473417,69.2885793606963,NaN,NaN,50
1654234200,1.07541,1.07556,1.07512,1.07542,1131,1005.55,-615655,-616501.2,40.98619843166395,60.14912303797496,68.29905951653112,NaN,NaN,50
1654236000,1.07542,1.07586,1.07524,1.07528,1263,1034.6,-616918,-616739,40.17604938587362,58.42026483402345,67.16943786799645,NaN,NaN,50
1654237800,1.07528,1.0757,1.07506,1.07532,2094,1114.5,-614824,-616372.8,38.948345334330945,58.78477062757024,65.9893836267183,NaN,NaN,50
1654239600,1.07532,1.07532,1.0745,1.07487,2259,1215.4,-617083,-616253.2,36.51901877756836,53.14076163470879,64.2539397689239,NaN,NaN,50
1654241400,1.07487,1.07608,1.07452,1.07564,2220,1313.5,-614863,-615868.6,35.46248104970748,60.18497850874242,62.8397896494037,NaN,NaN,50
1654243200,1.07564,1.07622,1.07496,1.076,2485,1388.25,-612378,-615213.2,34.670670640439944,62.986500884149415,62.244797165300774,NaN,NaN,50
1654245000,1.076,1.07624,1.07496,1.07536,2155,1469.5,-614533,-614736.2,33.96340369140299,55.50875375861636,60.87613107839723,NaN,NaN,50
1654246800,1.07536,1.07556,1.07469,1.07478,2149,1546.3,-616682,-615107.8,32.68239356054251,49.744999859644125,58.95346632269521,NaN,NaN,50
1654248600,1.07478,1.07487,1.07434,1.07471,1724,1598.1,-618406,-615372.4,30.754641161199398,49.08259095508898,57.64599645390207,NaN,NaN,50
1654250400,1.07471,1.07476,1.07396,1.07415,1737,1632,-620143,-616428.4,28.86329755314625,44.031190216402244,56.09077440463794,NaN,NaN,50
1654252200,1.07415,1.07442,1.07336,1.07406,2274,1614.35,-622417,-618436.2,28.05213931081611,43.26061297538146,54.777539334619874,NaN,NaN,50
1654254000,1.07406,1.07464,1.07349,1.07449,2496,1670.3,-619921,-619513.8,26.86451894909548,47.94773256841693,54.046567021049285,NaN,NaN,50
1654255800,1.07449,1.07462,1.07258,1.07288,3309,1747.1,-623230,-620823.4,26.947065889347133,35.9673240613952,52.80573946763206,NaN,NaN,50
1654257600,1.07288,1.07333,1.07266,1.07323,3815,1879.6,-619415,-621025.2,27.023716619580814,39.50601472672374,51.33682990348846,NaN,NaN,50
1654259400,1.07323,1.07398,1.07041,1.0716,15066,2573.9,-634481,-623892.8,28.891740903842873,30.932479661163953,49.24992680514481,NaN,NaN,50
1654261200,1.0716,1.07387,1.07145,1.07293,5068,2764.25,-629413,-625292,30.62633488208622,41.99407536328324,48.0766275572348,NaN,NaN,50
1654263000,1.07293,1.07522,1.0725,1.07444,7633,3086.25,-621780,-625663.8,30.096732562001993,51.492705167668,47.55576573867035,NaN,NaN,50
1654264800,1.07444,1.07488,1.073,1.07306,6258,3352.85,-628038,-626625.4,29.60495897906664,44.34565962246436,46.92754416636718,NaN,NaN,50
1654266600,1.07306,1.07364,1.07154,1.07232,5117,3557.4,-633155,-629373.4,30.22892803284997,41.05499121403284,45.56111650245935,NaN,NaN,50
1654268400,1.07232,1.07232,1.07168,1.07176,3379,3681.6,-636534,-629784,30.808327868505923,38.713785208627556,43.827351097064934,NaN,NaN,50
1654270200,1.07176,1.07219,1.07106,1.0711,2713,3760.7,-639247,-631750.8,31.735894775689566,36.100832919203455,42.44107103710686,NaN,NaN,50
1654272000,1.0711,1.07252,1.07106,1.0725,2421,3818.6,-636826,-634760,32.101600894827534,44.63685245229554,42.07620336515339,NaN,NaN,50
1654273800,1.0725,1.07291,1.07211,1.0729,1251,3776.45,-635575,-636267.4,31.875585403874684,46.82261905542161,41.91477680089144,NaN,NaN,50
1654275600,1.0729,1.07294,1.0719,1.0721,1202,3723.6,-636777,-636991.8,31.83049006389006,43.15309576038453,41.85205576831874,NaN,NaN,50
1654277400,1.0721,1.07224,1.07156,1.07188,1138,3669.5,-637915,-637268,32.0517004559287,42.17424024697315,41.77445771628958,NaN,NaN,50
1654279200,1.07188,1.07214,1.0716,1.07206,916,3591.05,-636999,-636818.4,32.25711010567887,43.30733956896281,41.44300107347143,NaN,NaN,50
1654281000,1.07206,1.0722,1.0718,1.0721,894,3528,-636105,-636674.2,32.34332920659755,43.57195417480008,41.98618893871463,NaN,NaN,50
1654282800,1.0721,1.07221,1.07175,1.07196,860,3463.55,-636965,-636952.2,32.46919821377031,42.818646082197446,42.22280546410561,NaN,NaN,50
1654284600,1.07196,1.07216,1.07187,1.07206,932,3423.95,-636033,-636803.4,32.58607657757358,43.56912590405302,43.12542305288341,NaN,NaN,50
1654286400,1.07206,1.07218,1.07189,1.07204,478,3361,-636511,-636522.6,32.65196541999046,43.446310690345264,43.229154147673555,NaN,NaN,50
1654288200,1.07204,1.07218,1.0715,1.07194,1127,3303.65,-637638,-636650.4,33.11917506263091,42.796721912294274,42.60801248657543,NaN,NaN,50
1654462800,1.07194,1.07222,1.07187,1.07195,70,3182.35,-637568,-636943,33.460007963270705,42.888680541202035,42.50394255219955,NaN,NaN,50
1654464600,1.07195,1.07225,1.0719,1.0721,278,3030.8,-637290,-637008,33.70263726518493,44.33423901268118,42.738174537817294,NaN,NaN,50
1654466400,1.0721,1.07212,1.07147,1.07195,1755,2927.8,-639045,-637610.4,34.395838595070884,43.1578315569293,43.055606419838846,NaN,NaN,50
1654468200,1.07195,1.07262,1.07188,1.07248,1251,2237.05,-637794,-637867,33.86180268465862,48.37077932509814,43.93203116311703,NaN,NaN,50
1654470000,1.07248,1.07275,1.07214,1.07256,890,2028.15,-636904,-637720.2,33.08316623448345,49.12914827975188,44.252909436506776,NaN,NaN,50
1654471800,1.07256,1.073,1.07245,1.07253,1035,1698.25,-637939,-637794.4,31.8272612843111,48.83943290707028,44.39696756876739,NaN,NaN,50
1654473600,1.07253,1.07318,1.0724,1.07278,1842,1477.45,-636097,-637555.8,30.290380926315713,51.41086415703791,44.98680816852834,NaN,NaN,50
1654475400,1.07278,1.07278,1.07156,1.07164,1746,1308.9,-637843,-637315.4,30.04340111528559,41.233425200100655,44.919607093751736,NaN,NaN,50
1654477200,1.07164,1.07223,1.07149,1.07183,1914,1235.65,-635929,-636942.4,29.899056598113205,43.24985905211993,44.91550134254868,NaN,NaN,50
1654479000,1.07183,1.07196,1.07101,1.07154,2287,1214.35,-638216,-637204.8,30.316260932275497,40.940780037301074,44.72756033272732,NaN,NaN,50
1654480800,1.07154,1.07219,1.07146,1.07218,1332,1159.9,-636884,-636993.8,30.1953477602022,47.59087254465718,45.06843365147445,NaN,NaN,50
1654482600,1.07218,1.07258,1.07202,1.07224,1050,1149.85,-635834,-636941.2,29.280353496533873,48.17997865500068,45.39778027654214,NaN,NaN,50
1654484400,1.07224,1.07251,1.07216,1.07219,878,1133.65,-636712,-636715,28.43071596598471,47.698809724099185,45.70153020752457,NaN,NaN,50
1654486200,1.07219,1.0726,1.07213,1.07254,864,1119.95,-635848,-636698.8,27.450180078281967,51.36066617465789,46.31324051197912,NaN,NaN,50
1654488000,1.07254,1.07258,1.07212,1.07254,1042,1126.25,-635848,-636225.2,26.556295172274268,51.36066617465789,46.91838234294024,NaN,NaN,50
1654489800,1.07254,1.07281,1.07225,1.07276,782,1120.65,-635066,-635861.6,25.206870934731707,53.7226774689897,47.588985089819424,NaN,NaN,50
1654491600,1.07276,1.07363,1.07276,1.07313,1310,1143.15,-633756,-635446,24.36186642017968,57.46391746393917,48.61084836889155,NaN,NaN,50
1654493400,1.07313,1.0735,1.07267,1.0727,1240,1158.55,-634996,-635102.8,23.39437176859695,52.183900733171846,48.88321418375397,NaN,NaN,50
1654495200,1.0727,1.07279,1.07182,1.07217,2032,1236.25,-637028,-635338.8,22.428974226514505,46.51120188258592,48.69621801252782,NaN,NaN,50
1654497000,1.07217,1.07337,1.07204,1.07238,2847,1322.25,-634181,-635005.4,21.06839326964254,48.88231605389722,48.69928109444403,NaN,NaN,50
1654498800,1.07238,1.07383,1.07234,1.0732,3963,1516.9,-630218,-634035.8,20.449855526429197,56.9139755976728,49.09236048306081,NaN,NaN,50
1654500600,1.0732,1.07426,1.07267,1.0742,3856,1695.8,-626362,-632557,20.41341452495935,64.28398370667645,50.73882894781621,NaN,NaN,50
1654502400,1.0742,1.07519,1.07386,1.0744,4085,1812.3,-622277,-630013.2,21.333683773846676,65.55308575634933,52.33191656954688,NaN,NaN,50
1654504200,1.0744,1.07514,1.07414,1.07508,2683,1883.9,-619594,-626526.4,22.188219504956336,69.51886283884843,54.37320819822884,NaN,NaN,50
1654506000,1.07508,1.07512,1.07434,1.0746,2327,1955.75,-621921,-624074.4,22.98171696955816,63.924361504493824,55.539885981074306,NaN,NaN,50
1654507800,1.0746,1.07466,1.07392,1.07448,2491,2028.55,-624412,-622913.2,22.899579356584287,62.56873274649984,56.56765413046711,NaN,NaN,50
1654509600,1.07448,1.07462,1.07384,1.07408,2340,2053.45,-626752,-622991.2,22.672429245020666,58.142525971292514,57.313633862409496,NaN,NaN,50
1654511400,1.07408,1.07408,1.07242,1.07279,2570,2094.65,-629322,-624400.2,21.773073998058013,46.67492928132678,56.9789383700287,NaN,NaN,50
1654513200,1.07279,1.07306,1.07242,1.07276,2348,2116.35,-631670,-626815.4,20.937958411592696,46.44550549822148,56.62785546456895,NaN,NaN,50
1654515000,1.07276,1.07321,1.07242,1.07308,2075,2105.75,-629595,-628350.2,19.929804152851133,49.30776879878622,56.3125048452687,NaN,NaN,50
1654516800,1.07308,1.07312,1.07158,1.07171,2771,2177.7,-632366,-629941,20.00157272448477,39.55963996349486,55.03362788095125,NaN,NaN,50
1654518600,1.07171,1.07233,1.07156,1.07228,2087,2229.55,-630279,-630646.4,20.090060190661823,44.477892493349835,54.48319872096397,NaN,NaN,50
1654520400,1.07228,1.07234,1.07088,1.07107,2138,2292.55,-632417,-631265.4,20.87015533889341,37.501544528089205,53.839651767071345,NaN,NaN,50
1654522200,1.07107,1.0715,1.07054,1.07142,3505,2424.6,-628912,-630713.8,21.90310065163239,40.412953080798424,53.23469726899286,NaN,NaN,50
1654524000,1.07142,1.0721,1.07008,1.07032,3905,2567.75,-632817,-631358.2,21.834243533324987,34.90893565014399,51.662908701312226,NaN,NaN,50
1654525800,1.07032,1.07239,1.06918,1.07178,6339,2845.6,-626478,-630180.6,22.598227524236417,45.515547152602295,50.32230609030693,NaN,NaN,50
1654527600,1.07178,1.07214,1.06839,1.06854,6494,3104.8,-632972,-630719.2,23.894240265810552,32.75837371914882,47.97982665907832,NaN,NaN,50
1654529400,1.06854,1.07011,1.06849,1.06976,3420,3213.8,-629552,-630146.2,25.09768066870082,39.62085474265597,45.84425465220743,NaN,NaN,50
1654531200,1.06976,1.07023,1.06912,1.06914,2619,3243.15,-632171,-630798,26.004120846105184,37.524913104974964,43.95857976652752,NaN,NaN,50
1654533000,1.06914,1.07014,1.06898,1.07006,2009,3201.25,-630162,-630267,26.960008614552333,42.39458267690359,42.51756904727064,NaN,NaN,50
1654534800,1.07006,1.07008,1.06945,1.06981,1805,3093.35,-631967,-631364.8,27.847618685253263,41.44911911764701,41.32518284343882,NaN,NaN,50
1654536600,1.06981,1.07032,1.06962,1.06986,1942,2997.65,-630025,-630775.4,28.187880284407957,41.72901818076381,40.97190347911289,NaN,NaN,50
1654538400,1.06986,1.07,1.06903,1.06924,2137,2900.25,-632162,-631297.4,29.052641332030444,39.225000788700115,40.4561531427185,NaN,NaN,50
1654540200,1.06924,1.06929,1.06883,1.06907,2248,2878.5,-634410,-631745.2,30.026044350123087,38.54207087608016,39.687174719668064,NaN,NaN,50
1654542000,1.06907,1.0694,1.06853,1.0693,2246,2874.45,-632164,-632145.6,31.178173042910284,40.06253146999032,39.7230955415606,NaN,NaN,50
1654543800,1.0693,1.06972,1.06928,1.06956,1755,2837.65,-630409,-631834,31.568208546937242,41.81495398414834,39.53288564804621,NaN,NaN,50
1654545600,1.06956,1.06974,1.06938,1.06964,763,2758.8,-629646,-631758.2,31.887794835952683,42.37325171700352,39.88086473296867,NaN,NaN,50
1654547400,1.06964,1.06972,1.06918,1.06958,551,2657.85,-630197,-631365.2,32.38960450782531,42.04738543550497,39.99760990116199,NaN,NaN,50
1654549200,1.06958,1.06986,1.06924,1.06953,2017,2641.3,-632214,-630926,32.53082440582447,41.75917943054851,40.48691302833374,NaN,NaN,50
1654551000,1.06953,1.06956,1.06943,1.06956,282,2551.65,-631932,-630879.6,32.66195716825226,42.015987242385805,40.236944463318274,NaN,NaN,50
1654552800,1.06956,1.06956,1.06912,1.06916,772,2451.7,-632704,-631338.6,33.1472023107713,39.51416215641908,40.71950078026616,NaN,NaN,50
1654554600,1.06916,1.06946,1.06916,1.06944,656,2380.15,-632048,-631819,33.59778708596755,42.112581704344045,40.897481277529586,NaN,NaN,50
1654556400,1.06944,1.06954,1.06851,1.06871,1211,2333.8,-633259,-632431.4,34.70220855339847,37.57984893116761,40.901405265114775,NaN,NaN,50
1654558200,1.06871,1.0692,1.06856,1.06898,2037,2260.4,-631222,-632233,35.727742773155754,40.14591386054921,40.74078606394661,NaN,NaN,50
1654560000,1.06898,1.06921,1.06851,1.06862,2380,2184.15,-633602,-632567,36.730799171933896,37.908225021904734,40.487865057107875,NaN,NaN,50
1654561800,1.06862,1.06886,1.06801,1.06846,2222,1978.3,-635824,-633191,38.13094136691754,36.92317220275134,40.14459034439269,NaN,NaN,50
1654563600,1.06846,1.06849,1.06742,1.06749,2667,1786.95,-638491,-634479.6,39.875175332054255,31.567619088330574,39.59763450865201,NaN,NaN,50
1654565400,1.06749,1.0681,1.0673,1.06801,2237,1727.8,-636254,-635078.6,41.57572201740407,36.85522453320579,39.477145484160985,NaN,NaN,50
1654567200,1.06801,1.06812,1.06742,1.06768,1910,1692.35,-638164,-636467,43.091677843193885,35.00662470200699,39.116009286447884,NaN,NaN,50
1654569000,1.06768,1.06778,1.06706,1.06762,1841,1683.95,-640005,-637747.6,44.75110083541711,34.666160399050256,38.6053811732266,NaN,NaN,50
1654570800,1.06762,1.06845,1.06734,1.06814,1896,1688.5,-638109,-638204.6,44.39607416376642,40.10319134824728,38.44323400402972,NaN,NaN,50
1654572600,1.06814,1.06848,1.06803,1.06818,1421,1662.45,-636688,-637844,43.99016086611685,40.513286776750675,38.333655528404414,NaN,NaN,50
1654574400,1.06818,1.06899,1.06796,1.06896,1207,1615.95,-635481,-637689.4,42.397928260292204,47.99115410978071,38.778796576921,NaN,NaN,50
1654576200,1.06896,1.07,1.06782,1.06826,5453,1776.2,-640934,-638243.4,39.62206847192893,42.792258350443866,38.83424451321086,NaN,NaN,50
1654578000,1.06826,1.06834,1.06724,1.06742,4314,1879.6,-645248,-639292,37.37991565916635,37.5371981253515,38.69303279670604,NaN,NaN,50
1654579800,1.06742,1.06782,1.06712,1.06744,2939,1938.8,-642309,-640132,35.45981601028803,37.73326488808694,38.38022445268768,NaN,NaN,50
1654581600,1.06744,1.06788,1.06652,1.06754,4079,2104.6,-638230,-640440.4,34.42729670790675,38.7682026002644,38.46510685762316,NaN,NaN,50
1654583400,1.06754,1.0693,1.06734,1.06858,3766,2265.35,-634464,-640237,32.45825441461854,48.377939100812725,39.05310866049913,NaN,NaN,50
1654585200,1.06858,1.06946,1.06849,1.06888,4335,2381.25,-630129,-638076,30.81070584556552,50.777705271630204,39.97235724976524,NaN,NaN,50
1654587000,1.06888,1.06947,1.0682,1.06874,3132,2523.75,-633261,-635678.6,28.887128250630855,49.61847825754293,40.8791648251075,NaN,NaN,50
1654588800,1.06874,1.07049,1.06848,1.06928,4138,2692.05,-629123,-633041.4,28.201293192364023,53.98233429642969,42.48021591140029,NaN,NaN,50
1654590600,1.06928,1.06972,1.06786,1.06794,2863,2802.4,-631986,-631792.6,26.755436467810316,43.83568493274205,42.97882022565288,NaN,NaN,50
1654592400,1.06794,1.06878,1.0676,1.06856,2986,2891.15,-629000,-630699.8,25.09578298931366,48.645426012259456,43.95302031924234,NaN,NaN,50
1654594200,1.06856,1.06918,1.0674,1.06776,2756,2927.1,-631756,-631025.2,23.994201586637658,43.47225984386005,44.58202742244304,NaN,NaN,50
1654596000,1.06776,1.06824,1.06718,1.06798,3305,2973.35,-628451,-630063.2,22.686141206577283,45.19820340955565,44.94595685539364,NaN,NaN,50
1654597800,1.06798,1.06828,1.0671,1.06736,3695,3047,-632146,-630667.8,21.365418786374914,41.365082211224234,45.00679938642747,NaN,NaN,50
1654599600,1.06736,1.06756,1.06651,1.06718,3962,3111.75,-636108,-631492.2,20.286969792900226,40.29660482655249,44.45718872333974,NaN,NaN,50
1654601400,1.06718,1.06729,1.06582,1.0662,3535,3176.65,-639643,-633620.8,20.037239876869833,34.99639560123242,43.90034138411035,NaN,NaN,50
1654603200,1.0662,1.067,1.06576,1.06649,3249,3243.6,-636394,-634548.4,19.867186652105158,37.6114807881823,43.90564728859827,NaN,NaN,50
1654605000,1.06649,1.0673,1.0654,1.06556,4071,3355.1,-640465,-636951.2,20.07978808206431,33.02331870096326,43.56922256094657,NaN,NaN,50
1654606800,1.06556,1.0666,1.0652,1.06654,4146,3467.6,-636319,-637785.8,20.47736740554082,41.16776357372209,43.7406197733364,NaN,NaN,50
1654608600,1.06654,1.06978,1.06654,1.06882,8635,3828.3,-627684,-636101,20.624115920465538,54.90646293958233,44.206942904677085,NaN,NaN,50
1654610400,1.06882,1.06912,1.06746,1.0691,4975,4016.7,-622709,-632714.2,20.760382398609917,56.257422955868016,44.59835131069408,NaN,NaN,50
1654612200,1.0691,1.071,1.06891,1.0705,7154,4101.75,-615555,-628546.4,22.03883699100792,62.33367922286461,45.506579951074194,NaN,NaN,50
1654614000,1.0705,1.07077,1.06928,1.06948,3860,4079.05,-619415,-624336.4,23.225973398234636,56.20758767444828,45.66552662093267,NaN,NaN,50
1654615800,1.06948,1.07017,1.06904,1.06967,3055,4084.85,-616360,-620344.6,24.032181681893405,57.054266804960136,46.60971104037681,NaN,NaN,50
1654617600,1.06967,1.07038,1.06958,1.07029,2147,3988.25,-614213,-617650.4,24.90898378267647,59.78648155074187,47.40550072169698,NaN,NaN,50
1654619400,1.07029,1.07084,1.06978,1.07012,1812,3890.55,-616025,-616313.6,25.999388725615248,58.68403712064456,48.49205624146731,NaN,NaN,50
1654621200,1.07012,1.07016,1.06934,1.0695,1673,3757.45,-617698,-616742.2,26.422540183405168,54.72094002562192,49.17225171404347,NaN,NaN,50
1654623000,1.0695,1.06988,1.06944,1.06948,1475,3674.6,-619173,-616693.8,26.81546653706724,54.592862306751975,50.117093149438304,NaN,NaN,50
1654624800,1.06948,1.0708,1.06932,1.07079,1611,3548.25,-617562,-616934.2,27.787720650585364,61.02724802378925,51.59785337781236,NaN,NaN,50
1654626600,1.07079,1.07143,1.07056,1.07074,2145,3512.35,-619707,-618033,29.049442461942874,60.67384693033211,53.43195704417662,NaN,NaN,50
1654628400,1.07074,1.07096,1.07055,1.07066,1293,3427.7,-621000,-619028,30.206083091565134,60.07441712367481,55.036452496711796,NaN,NaN,50
1654630200,1.07066,1.07124,1.0706,1.0708,1715,3375.65,-619285,-619345.4,31.442845048562845,60.80420890674525,57.020801797124804,NaN,NaN,50
1654632000,1.0708,1.07086,1.07049,1.07051,617,3241.25,-619902,-619491.2,32.40898645895106,58.422005660513285,58.25324766046703,NaN,NaN,50
1654633800,1.07051,1.0707,1.07051,1.07054,373,3075.15,-619529,-619884.6,33.30611776859726,58.60269195476193,58.51726401869415,NaN,NaN,50
1654635600,1.07054,1.07071,1.07018,1.07066,74,2880.75,-619455,-619834.2,33.55131426703636,59.363409808443876,58.739120222449564,NaN,NaN,50
1654637400,1.07066,1.07075,1.07056,1.0706,189,2713.45,-619644,-619563,33.81223634850982,58.78177698597846,58.48541291981484,NaN,NaN,50
1654639200,1.0706,1.0708,1.07054,1.07064,763,2589.15,-618881,-619482.2,34.098502107407086,59.069694759703076,58.689849140190184,NaN,NaN,50
1654641000,1.07064,1.07068,1.07026,1.07048,598,2415.5,-619479,-619397.6,33.81469289536213,57.34420100586001,58.710558725968745,NaN,NaN,50
1654642800,1.07048,1.0707,1.07008,1.0701,788,2247.6,-620267,-619545.2,33.20525919143624,53.35768133681385,58.25135871068817,NaN,NaN,50
1654644600,1.0701,1.07024,1.06966,1.06976,1766,1904.15,-622033,-620060.8,31.87408929322677,50.00785252088217,57.63163123927658,NaN,NaN,50
1654646400,1.06976,1.07012,1.06954,1.06966,1580,1734.4,-623613,-620854.6,30.428193134633926,49.03282175765279,57.22533707727878,NaN,NaN,50
1654648200,1.06966,1.06986,1.06912,1.06934,1644,1458.9,-625257,-622129.8,28.382929848883894,45.945660775068276,56.60767982501566,NaN,NaN,50
1654650000,1.06934,1.06936,1.06848,1.06902,2754,1403.6,-628011,-623836.2,27.146010775903324,43.02816712175719,55.32203118915623,NaN,NaN,50
1654651800,1.06902,1.06934,1.06844,1.06866,2644,1383.05,-630655,-625913.8,26.051005785247465,39.954424472149256,53.84207244214316,NaN,NaN,50
1654653600,1.06866,1.06925,1.0686,1.06907,1782,1364.8,-628873,-627281.8,25.03421543678131,44.79153865543268,52.75043826584016,NaN,NaN,50
1654655400,1.06907,1.06958,1.06894,1.06907,1476,1348,-628873,-628333.8,23.49380559779796,44.79153865543268,51.60667610503212,NaN,NaN,50
1654657200,1.06907,1.0692,1.06817,1.06826,1863,1357.5,-630736,-629429.6,23.152571884638913,37.8122877634097,50.13455339809616,NaN,NaN,50
1654659000,1.06826,1.06858,1.06812,1.06839,1309,1349.2,-629427,-629712.8,22.899144606593623,39.443156750039854,48.76601516918743,NaN,NaN,50
1654660800,1.06839,1.06848,1.06786,1.06834,1219,1329.6,-630646,-629711,22.994904302198353,39.01931332404201,47.312865420301584,NaN,NaN,50
1654662600,1.06834,1.06836,1.06784,1.06788,992,1271.95,-631638,-630264,23.109547013980418,35.26484631739706,45.63308465826005,NaN,NaN,50
1654664400,1.06788,1.06876,1.06776,1.06856,1178,1266.2,-630460,-630581.4,22.38942909049799,43.86383151490275,44.54695156934575,NaN,NaN,50
1654666200,1.06856,1.06912,1.06852,1.06883,1281,1244.5,-629179,-630270,21.054028884375484,46.880979493384224,43.79957860416891,NaN,NaN,50
1654668000,1.06883,1.06942,1.06856,1.06893,2718,1349.55,-626461,-629676.8,19.797375800583854,47.995820693829025,43.416588558241415,NaN,NaN,50
1654669800,1.06893,1.06948,1.06866,1.0688,3094,1485.6,-629555,-629458.6,18.731460672659633,46.62583016376943,43.17501553273337,NaN,NaN,50
1654671600,1.0688,1.06952,1.06818,1.06849,5095,1736.65,-634650,-630061,17.884513117278743,43.441473427115326,42.775633509123544,NaN,NaN,50
1654673400,1.06849,1.06948,1.06821,1.0689,4437,1949.05,-630213,-630011.6,17.09806181585363,48.455475627764066,42.95490599860182,NaN,NaN,50
1654675200,1.0689,1.0695,1.0684,1.06924,4142,2118,-626071,-629390,16.326681989755436,52.23692633724411,43.61267451399374,NaN,NaN,50
1654677000,1.06924,1.06926,1.06758,1.06792,4065,2291.35,-630136,-630125,16.895957985015382,39.97531600472842,43.61416676632082,NaN,NaN,50
1654678800,1.06792,1.06947,1.06715,1.06946,4218,2462.85,-625918,-629397.6,17.9537188393033,53.64595966031562,44.24662540952675,NaN,NaN,50
1654680600,1.06946,1.07092,1.06946,1.07042,3848,2566.95,-622070,-626881.6,16.873247495096024,59.7933668849543,45.31818456877829,NaN,NaN,50
1654682400,1.07042,1.07234,1.07036,1.07102,4712,2723.55,-617358,-624310.6,17.373484766955315,63.08820620786703,47.123607314810954,NaN,NaN,50
1654684200,1.07102,1.0729,1.07056,1.07196,4366,2859.65,-612992,-621694.8,18.296078224734018,67.57174924333609,49.13279249290355,NaN,NaN,50
1654686000,1.07196,1.07398,1.07154,1.07322,4622,2953.05,-608370,-617341.6,19.894283500259885,72.40949666372903,51.51780558859548,NaN,NaN,50
1654687800,1.07322,1.07396,1.07322,1.07356,4010,3021.35,-604360,-613030,21.378331256105334,73.55591030285676,54.252881587556885,NaN,NaN,50
1654689600,1.07356,1.0741,1.07214,1.07217,4450,3154.75,-608810,-610378,21.276570914941352,62.180734104616505,55.56123177253644,NaN,NaN,50
1654691400,1.07217,1.07338,1.0719,1.07317,3893,3275.6,-604917,-607889.8,20.89037508645964,66.22721351923889,56.94310563152606,NaN,NaN,50
1654693200,1.07317,1.07402,1.07249,1.07374,4391,3402,-600526,-605396.6,21.06697232580758,68.30865610570524,58.394022446660074,NaN,NaN,50
1654695000,1.07374,1.07486,1.07295,1.07412,7353,3704.2,-593173,-602357.2,21.84302327972471,69.65150789922845,60.03871371347857,NaN,NaN,50
1654696800,1.07412,1.07455,1.07361,1.0738,5406,3913.55,-598579,-601201,22.563642022647766,67.07404175523794,61.726754308344475,NaN,NaN,50
1654698600,1.0738,1.07424,1.07286,1.07314,4169,4072.4,-602748,-599988.6,22.254918566861374,61.97967311423239,62.692768414520785,NaN,NaN,50
1654700400,1.07314,1.07422,1.0728,1.0738,3551,4191.05,-599197,-598844.6,21.893410695131905,64.85436907601519,63.59401432443298,NaN,NaN,50
1654702200,1.0738,1.07418,1.07342,1.07418,2453,4249.65,-596744,-598088.2,21.557724814240252,66.42825874313725,65.48351023431933,NaN,NaN,50
1654704000,1.07418,1.07434,1.07344,1.07392,2521,4239.8,-599265,-599306.6,21.403777969399435,64.30632856214683,66.2449651558787,NaN,NaN,50
1654705800,1.07392,1.074,1.07252,1.07285,2653,4217.75,-601918,-599974.4,20.051854752258325,56.331447003985836,65.99768516438095,NaN,NaN,50
1654707600,1.07285,1.07286,1.07204,1.07258,2985,4112.25,-604903,-600405.4,18.982650758178394,54.49494496555963,65.38388078993043,NaN,NaN,50
1654709400,1.07258,1.07258,1.07168,1.07192,2496,4015.2,-607399,-602045.8,18.371071956432196,50.187671835607965,64.1421609750927,NaN,NaN,50
1654711200,1.07192,1.07204,1.0714,1.07164,1983,3907.25,-609382,-604573.4,18.091003003944056,48.43848762840258,62.42994604399796,NaN,NaN,50
1654713000,1.07164,1.07183,1.07127,1.07157,1713,3789.65,-611095,-606939.4,17.965354938504312,47.98819215705285,60.60368046215482,NaN,NaN,50
1654714800,1.07157,1.07192,1.07147,1.0719,1333,3645.4,-609762,-608508.2,17.71460621210843,50.33232086907623,59.757365231044794,NaN,NaN,50
1654716600,1.0719,1.07196,1.0713,1.07138,1550,3530.5,-611312,-609790,17.67595115496167,46.75634831119935,58.36658914475625,NaN,NaN,50
1654718400,1.07138,1.07162,1.07128,1.07134,590,3324.4,-611902,-610690.6,17.663782179531243,46.48277069630426,56.80759732979904,NaN,NaN,50
1654720200,1.07134,1.07171,1.0713,1.07164,787,3145.45,-611115,-611037.2,17.492477515591457,48.897816529797055,55.325190803411076,NaN,NaN,50
1654722000,1.07164,1.07186,1.07152,1.07162,528,2940.75,-611643,-611146.8,17.061015784342697,48.739906443149174,54.01560970969045,NaN,NaN,50
1654723800,1.07162,1.07175,1.0716,1.0717,155,2748,-611488,-611492,16.660372748183132,49.44321280719367,53.120148259187694,NaN,NaN,50
1654725600,1.0717,1.07209,1.07158,1.07184,1913,2621.15,-609575,-611144.6,15.651370992633701,50.71753803300256,52.110374613258216,NaN,NaN,50
1654727400,1.07184,1.07198,1.07177,1.07191,664,2459.7,-608911,-610546.4,14.71444079105209,51.377460836157574,51.03531761990252,NaN,NaN,50
1654729200,1.07191,1.07198,1.07172,1.07188,731,2276.7,-609642,-610251.8,13.938160307030047,51.061883743715754,50.08928584715744,NaN,NaN,50
1654731000,1.07188,1.07208,1.07158,1.07168,780,1948.05,-610422,-610007.6,13.485266749270203,48.905224577714314,49.55884138813805,NaN,NaN,50
1654732800,1.07168,1.07182,1.07122,1.07149,2034,1779.45,-612456,-610201.2,13.708238526243449,46.87951991751009,49.01488245613451,NaN,NaN,50
1654734600,1.07149,1.07153,1.07093,1.07122,1844,1663.2,-614300,-611146.2,14.379824423036311,44.085003921000904,48.578977605091154,NaN,NaN,50
1654736400,1.07122,1.07147,1.07096,1.07125,1672,1569.25,-612628,-611889.6,15.003439898629681,44.481014818905656,48.29630097584137,NaN,NaN,50
1654738200,1.07125,1.0715,1.07106,1.07116,2214,1557.3,-614842,-612929.6,15.500996624135066,43.485989496021,47.97471507148195,NaN,NaN,50
1654740000,1.07116,1.0716,1.07106,1.07158,2169,1539.7,-612673,-613379.8,15.682445131034692,49.19732285381204,47.893643784677366,NaN,NaN,50
1654741800,1.07158,1.07237,1.07155,1.07228,1495,1481.8,-611178,-613124.2,15.050676620803245,56.99756162305247,48.6251590212383,NaN,NaN,50
1654743600,1.07228,1.07252,1.07201,1.07224,1363,1400.7,-612541,-612772.4,14.745811268600134,56.46405477911228,49.338107884296015,NaN,NaN,50
1654745400,1.07224,1.07338,1.07206,1.07296,2187,1385.25,-610354,-612317.6,15.783522968092997,63.15020308454393,50.356135495349356,NaN,NaN,50
1654747200,1.07296,1.07319,1.07276,1.07284,1356,1353.9,-611710,-611691.2,16.747112403336374,61.45615077780777,51.26443866211069,NaN,NaN,50
1654749000,1.07284,1.0733,1.07262,1.07266,1026,1319.55,-612736,-611703.8,17.294156204380602,58.90362560508938,51.94018243338895,NaN,NaN,50
1654750800,1.07266,1.0728,1.07238,1.07242,1526,1329.2,-614262,-612320.6,17.22451413937172,55.58840587616602,52.288101565043476,NaN,NaN,50
1654752600,1.07242,1.07296,1.07187,1.0719,2146,1359,-616408,-613094,16.083967578282216,49.13566908207082,52.12797358260872,NaN,NaN,50
1654754400,1.0719,1.072,1.0709,1.07102,2460,1452.5,-618868,-614796.8,16.361523137242425,40.555864339319996,51.37754362515187,NaN,NaN,50
1654756200,1.07102,1.07172,1.07096,1.07146,2925,1559.4,-615943,-615643.4,16.61925329913405,45.66465004887647,51.146074015949175,NaN,NaN,50
1654758000,1.07146,1.07168,1.07097,1.07136,3820,1724,-619763,-617048.8,16.858574163747704,44.72388706957142,50.99210024109641,NaN,NaN,50
1654759800,1.07136,1.07153,1.07018,1.0702,2964,1864.45,-622727,-618741.8,18.085521795214262,35.569646744907004,50.38386044280399,NaN,NaN,50
1654761600,1.0702,1.07034,1.0694,1.07001,3040,1920.8,-625767,-620613.6,19.966726888420958,34.33016825445712,49.65879997391481,NaN,NaN,50
1654763400,1.07001,1.07178,1.06994,1.07155,3336,2054.4,-622431,-621326.2,19.254095168176597,49.646125325147075,50.09880967599525,NaN,NaN,50
1654765200,1.07155,1.0717,1.07112,1.07159,2343,2135,-620088,-622155.2,18.592365713663973,49.97249592276418,50.154179180920394,NaN,NaN,50
1654767000,1.07159,1.07196,1.0713,1.07164,1736,2182.8,-618352,-621873,17.604324922648857,50.40521776374697,49.68329747668429,NaN,NaN,50
1654768800,1.07164,1.07244,1.07134,1.07226,2788,2220.5,-615564,-620440.4,16.65320304433456,55.54057001740843,49.61733427941972,NaN,NaN,50
1654770600,1.07226,1.07245,1.07154,1.0719,3371,2296.85,-618935,-619074,15.783241016815225,52.163088045903955,48.832540348088294,NaN,NaN,50
1654772400,1.0719,1.07243,1.07116,1.07223,3824,2404.45,-615111,-617610,14.883640284350147,54.872176689101195,48.362256484609254,NaN,NaN,50
1654774200,1.07223,1.07498,1.06882,1.07284,24638,3525.65,-590473,-611687,16.146099312335977,59.44424914232405,48.400872451554584,NaN,NaN,50
1654776000,1.07284,1.07679,1.07236,1.07612,15612,4197.8,-574861,-602988.8,18.326953998069072,74.43978331703603,49.747399411616776,NaN,NaN,50
1654777800,1.07612,1.07742,1.07246,1.07344,19481,5097.1,-594342,-598744.4,20.629185095892293,56.16599514635844,50.24956555906589,NaN,NaN,50
1654779600,1.07344,1.07432,1.06809,1.06952,18242,5941.05,-612584,-597474.2,19.331517134376988,40.50373286497389,50.245841882326886,NaN,NaN,50
1654781400,1.06952,1.07061,1.06814,1.0687,11907,6427.05,-624491,-599350.2,18.12653974154135,38.10970557551918,49.70620299137279,NaN,NaN,50
1654783200,1.0687,1.06875,1.06452,1.06639,10825,6900.5,-635316,-608318.8,18.76886798692846,32.31511717825764,48.81986228485038,NaN,NaN,50
1654785000,1.06639,1.06678,1.0648,1.06492,8095,7253.95,-643411,-622028.8,19.36531564335935,29.265578471575537,48.36957169389814,NaN,NaN,50
1654786800,1.06492,1.06642,1.06456,1.06568,7358,7545.55,-636053,-630371,20.018418422444846,32.79660182458507,48.26003123462156,NaN,NaN,50
1654788600,1.06568,1.06664,1.06486,1.06576,4688,7672.65,-631365,-634127.2,20.455287112156725,33.17475817746683,47.08350500978725,NaN,NaN,50
1654790400,1.06576,1.06576,1.06455,1.06502,4156,7757.45,-635521,-636333.2,21.004833656879192,31.413884407300714,45.75788990153986,NaN,NaN,50
1654792200,1.06502,1.06601,1.06492,1.06524,3048,7763.6,-632473,-635764.6,21.303349479390572,32.559961708500424,44.48322875473654,NaN,NaN,50
1654794000,1.06524,1.0655,1.0618,1.06292,5076,7826.4,-637549,-634592.2,22.848111662975533,27.366600357489602,42.470802350456616,NaN,NaN,50
1654795800,1.06292,1.06399,1.06271,1.06389,2945,7825.45,-634604,-634302.4,24.282533690590142,32.23345560252116,41.04725717592927,NaN,NaN,50
1654797600,1.06389,1.06438,1.0635,1.06352,2345,7790.7,-636949,-635419.2,25.275108197441913,31.369997605907173,39.368530098558274,NaN,NaN,50
1654799400,1.06352,1.06356,1.06262,1.06264,3253,7786.55,-640202,-636355.4,26.526833532802396,29.355835478040333,37.21935769396658,NaN,NaN,50
1654801200,1.06264,1.06272,1.06153,1.06166,2580,7798.4,-642782,-638417.2,28.05957063215031,27.256965517794512,33.84915642259219,NaN,NaN,50
1654803000,1.06166,1.06178,1.06125,1.06134,2718,7847.5,-645500,-640007.4,29.57372971002103,26.588478228009564,31.736476642710123,NaN,NaN,50
1654804800,1.06134,1.06188,1.06113,1.0618,1563,7786.25,-643937,-641874,31.020206347053552,29.27375340474626,30.934335252693863,NaN,NaN,50
1654806600,1.0618,1.06205,1.06158,1.06188,897,7662.55,-643040,-643092.2,32.184103946831165,29.754988065456274,30.337569716260795,NaN,NaN,50
1654808400,1.06188,1.06196,1.06161,1.06171,1139,7528.3,-644179,-643887.6,33.264866003767516,29.298773293023544,30.12211658160121,NaN,NaN,50
1654810200,1.06171,1.06191,1.06167,1.06188,2150,6403.9,-642029,-643737,34.268430770922706,30.447214519400234,30.206519156445832,NaN,NaN,50
1654812000,1.06188,1.06216,1.0613,1.06139,1497,5698.15,-643526,-643342.2,35.36420394855188,28.98571817802653,29.934313181691657,NaN,NaN,50
1654813800,1.06139,1.06164,1.06112,1.06158,1659,4807.05,-641867,-642928.2,36.462000361685334,30.38118336549958,29.734772123693997,NaN,NaN,50
1654815600,1.06158,1.06186,1.06132,1.06186,1437,3966.8,-640430,-642406.2,37.174267372941934,32.486667469172744,29.81139948525628,NaN,NaN,50
1654817400,1.06186,1.0622,1.06181,1.06191,610,3401.95,-639820,-641534.4,37.36160094423388,32.87705236484496,29.834048817852324,NaN,NaN,50
1654819200,1.06191,1.06204,1.06116,1.06127,2048,2963.1,-641868,-641502.2,37.90256808968581,30.449967578898452,30.054289333667242,NaN,NaN,50
1654821000,1.06127,1.06246,1.06122,1.06241,1845,2650.6,-640023,-640801.6,37.82452715917363,39.07737387419007,30.54314063878645,NaN,NaN,50
1654822800,1.06241,1.06246,1.06174,1.06226,1780,2371.7,-641803,-640788.8,37.75206058084088,38.40236119064866,31.045452323410842,NaN,NaN,50
1654824600,1.06226,1.06257,1.06186,1.0625,1944,2234.5,-639859,-640674.6,37.52115372187531,40.18276121312723,31.818804161631334,NaN,NaN,50
1654826400,1.0625,1.063,1.06242,1.063,1698,2111.6,-638161,-640342.8,36.67407523970444,43.825564258116664,33.00227550022577,NaN,NaN,50
1654828200,1.063,1.06301,1.06236,1.06299,1952,2056.8,-640113,-639991.8,35.939524848692464,43.76815495863581,34.22939526669908,NaN,NaN,50
1654830000,1.06299,1.06338,1.06286,1.06334,1729,1889.45,-638384,-639664,34.70593182560863,46.413967449708316,35.45369626991065,NaN,NaN,50
1654831800,1.06334,1.06356,1.06306,1.06342,1299,1807.15,-637085,-638720.4,33.297576307509125,47.02749471540077,36.68744674490669,NaN,NaN,50
1654833600,1.06342,1.06354,1.06307,1.06313,1245,1752.15,-638330,-638414.6,31.98981761213101,45.01545476104383,37.81006684976528,NaN,NaN,50
1654835400,1.06313,1.06342,1.06296,1.06308,1096,1644.3,-639426,-638667.6,30.906068017349757,44.66066860299014,38.8253135700217,NaN,NaN,50
1654837200,1.06308,1.06384,1.06306,1.06367,2366,1633.6,-637060,-638057,29.221766128495176,49.698595145905855,40.30480478201308,NaN,NaN,50
1654839000,1.06367,1.06424,1.06332,1.06338,1918,1593.6,-638978,-638175.8,27.200929402586212,47.41376944000913,41.521418073049475,NaN,NaN,50
1654840800,1.06338,1.06349,1.06192,1.06236,3568,1693.85,-642546,-639268,26.81201926916304,40.381737670211955,42.085351658837986,NaN,NaN,50
1654842600,1.06236,1.06352,1.06218,1.063,3990,1848.5,-638556,-639313.2,26.406010167790434,45.8122629635258,43.00929527302948,NaN,NaN,50
1654844400,1.063,1.06392,1.06268,1.06382,6177,2100.4,-632379,-637903.8,25.43214599282097,51.862403850593715,44.538755006722,NaN,NaN,50
1654846200,1.06382,1.06418,1.062,1.06256,5789,2282.35,-638168,-638125.4,25.226498800101744,43.77464046214185,44.874274048718554,NaN,NaN,50
1654848000,1.06256,1.06334,1.06075,1.06128,4862,2450.6,-643030,-638935.8,26.040460006763073,37.39478370303563,44.80230422817476,NaN,NaN,50
1654849800,1.06128,1.062,1.0608,1.06146,3600,2547.65,-639430,-638312.6,26.796281127234305,38.746746437881214,44.69973174422862,NaN,NaN,50
1654851600,1.06146,1.06178,1.05902,1.0593,4264,2689,-643694,-639340.2,28.542832504852182,30.292799152402253,43.73310566524902,NaN,NaN,50
1654853400,1.0593,1.06065,1.05916,1.0597,3551,2836.05,-640143,-640893,30.16463021264021,33.199465328418825,42.978199263090666,NaN,NaN,50
1654855200,1.0597,1.06066,1.0594,1.06027,3686,2917.95,-636457,-640550.8,31.654365389051787,37.21699557968684,42.321272700946274,NaN,NaN,50
1654857000,1.06027,1.06058,1.05861,1.05932,3800,3015.7,-640257,-639996.2,33.43394493187735,33.59093735803599,41.36151860399165,NaN,NaN,50
1654858800,1.05932,1.05954,1.05821,1.05868,3698,3111.6,-643955,-640901.2,35.266862638035306,31.373280028784478,40.387077551687405,NaN,NaN,50
1654860600,1.05868,1.05868,1.05712,1.05742,5306,3279.7,-649261,-642014.6,37.39488590599942,27.52104720943757,39.16281888071937,NaN,NaN,50
1654862400,1.05742,1.05862,1.05708,1.05844,4716,3430.6,-644545,-642895,39.385206837768386,34.52936030061886,38.07930210605601,NaN,NaN,50
1654864200,1.05844,1.05844,1.05212,1.05225,23527,4509.35,-668072,-649218,42.30897918122082,21.158457162146092,36.20392265763723,NaN,NaN,50
1654866000,1.05225,1.05447,1.05225,1.05405,9677,4906.75,-658395,-652845.6,45.023910642998096,29.685240804160998,35.439887167205015,NaN,NaN,50
1654867800,1.05405,1.05422,1.0522,1.05266,10499,5366.75,-668894,-657833.4,47.55200688015229,27.23564322564819,34.11298575735661,NaN,NaN,50
1654869600,1.05266,1.0527,1.05059,1.05067,10982,5853.6,-679876,-663956.4,50.10769395729666,24.161644912550685,32.13436011892497,NaN,NaN,50
1654871400,1.05067,1.05354,1.05062,1.05306,9485,6273.05,-670391,-669125.6,51.470320101250024,33.822311425828644,31.42347947347402,NaN,NaN,50
1654873200,1.05306,1.05343,1.05196,1.05201,7645,6537,-678036,-671118.4,52.735615806349564,31.899744478816856,31.030976671744103,NaN,NaN,50
1654875000,1.05201,1.0523,1.05112,1.05201,4823,6682.25,-678036,-675046.6,54.09134127643408,31.899744478816856,30.54190510323951,NaN,NaN,50
1654876800,1.05201,1.05256,1.05129,1.05167,3683,6688,-681719,-677611.6,55.02333653749131,31.23301285875371,30.60906322512176,NaN,NaN,50
1654878600,1.05167,1.05249,1.05119,1.05167,3499,6663.45,-681719,-677980.2,55.91438875596321,31.23301285875371,30.4686023344314,NaN,NaN,50
1654880400,1.05167,1.05256,1.05152,1.05256,2662,6487.7,-679057,-679713.4,56.644122206664434,35.336059647665465,30.334249767858438,NaN,NaN,50
1654882200,1.05256,1.05334,1.0519,1.05192,3882,6392.35,-682939,-680694,56.26295686542473,33.77542259219152,30.34742728458383,NaN,NaN,50
1654884000,1.05192,1.05222,1.05134,1.05181,3187,6308.6,-686126,-682312,56.13346749412952,33.50155155242173,30.499446679129342,NaN,NaN,50
1654885800,1.05181,1.05232,1.0515,1.05222,3108,6284,-683018,-682571.8,55.87799260928191,35.597702411176726,31.076350622110713,NaN,NaN,50
1654887600,1.05222,1.0527,1.05182,1.05244,3575,6249.55,-679443,-682116.6,55.12023962565698,36.74981866963947,31.234954791326466,NaN,NaN,50
1654889400,1.05244,1.05268,1.05188,1.05189,3318,6237.9,-682761,-682857.4,54.4166118551481,35.06114500320754,32.22800392283086,NaN,NaN,50
1654891200,1.05189,1.05219,1.05162,1.05186,1618,6134.5,-684379,-683145.4,53.906014971358,34.96676299605831,32.605255507966376,NaN,NaN,50
1654893000,1.05186,1.05226,1.0515,1.05204,1094,5999.2,-683285,-682577.2,53.49904214464646,36.07861057371415,33.236896032828234,NaN,NaN,50
1655067600,1.05204,1.05204,1.05154,1.05172,65,5817.55,-683350,-682643.6,53.121138805557166,34.93511569149632,34.00642965989578,NaN,NaN,50
1655069400,1.05172,1.05172,1.05144,1.0515,62,5555.35,-683412,-683437.4,52.83289287057499,34.134119390983386,34.028701657406835,NaN,NaN,50
1655071200,1.0515,1.052,1.05024,1.05194,2655,5452.3,-680757,-683036.6,53.21836184976948,37.23374486401354,34.40970168492088,NaN,NaN,50
1655073000,1.05194,1.05204,1.0506,1.0508,2522,4402.05,-683279,-682816.6,53.503900921543654,32.91216952754988,34.482017759830384,NaN,NaN,50
1655074800,1.0508,1.05136,1.05016,1.0505,2648,4050.6,-685927,-683345,53.98458290665727,31.864057899757242,34.52709240561635,NaN,NaN,50
1655076600,1.0505,1.0506,1.04864,1.0491,4133,3732.3,-690060,-684687,55.021325708808256,27.467946537075903,34.25815909692508,NaN,NaN,50
1655078400,1.0491,1.04957,1.04859,1.04957,3673,3366.85,-686387,-685282,56.0004619936595,30.913925525020133,33.94229237387898,NaN,NaN,50
1655080200,1.04957,1.04957,1.04806,1.0485,2755,3030.35,-689142,-686959,57.08167825555874,27.688728383875286,33.50752850185639,NaN,NaN,50
1655082000,1.0485,1.04864,1.04758,1.04788,2350,2765.6,-691492,-688601.6,58.22969917177788,25.99631483684273,32.97144016502933,NaN,NaN,50
1655083800,1.04788,1.04866,1.04772,1.04812,4195,2734.2,-687297,-688875.6,59.25706600267733,27.835111316333453,32.41696937254052,NaN,NaN,50
1655085600,1.04812,1.04895,1.04812,1.0486,2904,2695.25,-684393,-687742.2,59.63735731888929,31.500999630502548,32.042053726887886,NaN,NaN,50
1655087400,1.0486,1.04928,1.04844,1.04888,2070,2623.8,-682323,-686929.4,59.3563189863524,33.61934276155567,31.93906785248418,NaN,NaN,50
1655089200,1.04888,1.04942,1.04886,1.04926,1916,2586.5,-680407,-685182.4,58.82784224814468,36.48989310253363,32.04786286008956,NaN,NaN,50
1655091000,1.04926,1.04929,1.0488,1.04916,1124,2448.6,-681531,-683190.2,58.37479161311061,36.04811190432456,32.04568438370459,NaN,NaN,50
1655092800,1.04916,1.04916,1.04852,1.04878,1774,2377.95,-683305,-682391.8,58.13158415610784,34.34640707802325,32.00363376845651,NaN,NaN,50
1655094600,1.04878,1.04911,1.04812,1.04911,1985,2321.8,-681320,-681777.2,58.14525099490836,37.122365331791606,32.217079907085676,NaN,NaN,50
1655096400,1.04911,1.04956,1.04882,1.04937,2664,2276.25,-678656,-681043.8,57.222156538651056,39.300010616608716,32.36467031798533,NaN,NaN,50
1655098200,1.04937,1.04954,1.0486,1.04864,2452,2232.95,-681108,-681184,56.528345349052714,35.574669756133474,32.5548489057413,NaN,NaN,50
1655100000,1.04864,1.0489,1.04762,1.04852,5231,2413.6,-686339,-682145.6,56.50969878612702,34.987545671789604,32.77795517517218,NaN,NaN,50
1655101800,1.04852,1.04879,1.04703,1.04704,4947,2606.25,-691286,-683741.8,56.797328691227754,28.696972089414587,32.86574271462495,NaN,NaN,50
1655103600,1.04704,1.04898,1.04692,1.04824,6656,2935.8,-684630,-684403.8,56.68890937658701,38.3721315058425,33.39847171325512,NaN,NaN,50
1655105400,1.04824,1.04886,1.04607,1.04657,5961,3230.75,-690591,-686790.8,57.02352210186653,31.887435044216716,33.69837933185094,NaN,NaN,50
1655107200,1.04657,1.04837,1.04564,1.04818,6158,3405.9,-684433,-687455.8,57.52490650908773,42.05433933380151,34.845381081633704,NaN,NaN,50
1655109000,1.04818,1.0486,1.04726,1.04752,6329,3596.25,-690762,-688340.4,57.541886332631606,39.45441981574663,35.67533168873464,NaN,NaN,50
1655110800,1.04752,1.04818,1.04706,1.04758,5355,3731.6,-685407,-687164.6,57.66207236292965,39.81867257532622,36.269451184793475,NaN,NaN,50
1655112600,1.04758,1.0477,1.04611,1.0462,4608,3755.35,-690015,-688241.6,58.21176697522804,34.654584704227034,36.34339703784143,NaN,NaN,50
1655114400,1.0462,1.04699,1.04582,1.04657,4034,3773.4,-685981,-687319.6,58.83879018467885,37.013234554871296,36.380778570151264,NaN,NaN,50
1655116200,1.04657,1.04718,1.04605,1.04687,4845,3877.9,-681136,-686660.2,59.03723699472451,38.93776704195301,36.58718250855329,NaN,NaN,50
1655118000,1.04687,1.0469,1.04518,1.04543,5087,4014.75,-686223,-685752.4,59.59694236049664,33.62665430717743,36.53577159635002,NaN,NaN,50
1655119800,1.04543,1.04652,1.04451,1.0446,6352,4122.6,-692575,-687186,60.357991299722535,31.001819678231527,36.098589763952866,NaN,NaN,50
1655121600,1.0446,1.04746,1.04458,1.04715,9086,4431.7,-683489,-685880.8,59.440980999708145,45.164018326780514,36.51744745753657,NaN,NaN,50
1655123400,1.04715,1.04738,1.0453,1.04655,8556,4756,-692045,-687093.6,58.58947143540908,42.931158764478404,37.04291095813263,NaN,NaN,50
1655125200,1.04655,1.04686,1.04552,1.0456,6306,4975.5,-698351,-690536.6,57.798783982845656,39.59344448079102,37.37190373020417,NaN,NaN,50
1655127000,1.0456,1.04658,1.04354,1.04376,10935,5466.05,-709286,-695149.2,58.03902617070686,34.068712994373286,37.755599509129794,NaN,NaN,50
1655128800,1.04376,1.04446,1.04254,1.04342,9176,5836.15,-718462,-700326.6,58.60575033046668,33.148274870172756,37.382466892296236,NaN,NaN,50
1655130600,1.04342,1.0442,1.04184,1.04212,7637,6118.75,-726099,-708848.6,59.33957344362225,29.829801388779515,37.23549305976501,NaN,NaN,50
1655132400,1.04212,1.04342,1.04212,1.04309,5132,6242.15,-720967,-714633,60.020980620123865,35.05425846287284,36.7354872832701,NaN,NaN,50
1655134200,1.04309,1.04354,1.04245,1.04345,5217,6380.4,-715750,-718112.8,60.45230688841706,36.931064577350355,36.55524762338465,NaN,NaN,50
1655136000,1.04345,1.04562,1.04338,1.04484,5223,6380,-710527,-718361,58.03438960040458,43.69657443696264,36.83224061350154,NaN,NaN,50
1655137800,1.04484,1.04526,1.04371,1.04372,4045,6334.9,-714572,-717583,55.78918069010727,39.97551188786278,37.21230684090409,NaN,NaN,50
1655139600,1.04372,1.04433,1.04339,1.04394,2820,6143.1,-711752,-714713.6,53.917576951028366,41.037656514131584,37.49976555227983,NaN,NaN,50
1655141400,1.04394,1.04586,1.04374,1.04488,3807,6035.4,-707945,-712109.2,50.57687078835581,45.477057112153325,37.96685770015129,NaN,NaN,50
1655143200,1.04488,1.04514,1.0431,1.04316,4449,5949.95,-712394,-711438,47.954698071055105,39.60152991762967,38.393634529469296,NaN,NaN,50
1655145000,1.04316,1.04368,1.04222,1.0425,4836,5875.3,-717230,-712778.6,46.11524223458909,37.59438976362183,38.86453239271146,NaN,NaN,50
1655146800,1.0425,1.0449,1.04094,1.04102,21963,6705.7,-739193,-717702.8,45.138699801051125,33.4947563742092,38.03101368181351,NaN,NaN,50
1655148600,1.04102,1.04187,1.04038,1.04105,12289,7089.75,-726904,-720733.2,44.5137206302597,33.652695412266084,37.368266299512634,NaN,NaN,50
1655150400,1.04105,1.04126,1.03998,1.04038,3773,7076.7,-730677,-725279.6,44.128724513780824,31.83438393143065,36.814047688844035,NaN,NaN,50
1655152200,1.04038,1.0411,1.04032,1.04086,2077,6938.3,-728600,-728520.8,43.77122811990758,34.56227929672275,36.84930242472614,NaN,NaN,50
1655154000,1.04086,1.04096,1.04081,1.04096,178,6692.85,-728422,-730759.2,43.43926718273958,35.14458631388766,36.9918960992772,NaN,NaN,50
1655155800,1.04096,1.04096,1.04082,1.04092,67,6378.6,-728489,-728618.4,43.131017741083575,35.010382336193985,37.36193759552109,NaN,NaN,50
1655157600,1.04092,1.04141,1.04036,1.04124,2276,6038.1,-726213,-728480.2,43.115921205702165,37.080370118669,37.506659856649385,NaN,NaN,50
1655159400,1.04124,1.04149,1.04072,1.04072,1941,5707.35,-728154,-727975.6,42.98405983644883,35.12265631558856,37.37748783795212,NaN,NaN,50
1655161200,1.04072,1.04144,1.04067,1.04134,1173,5450.7,-726981,-727651.8,42.89395987549046,39.24158797575469,37.05927451929441,NaN,NaN,50
1655163000,1.04134,1.04164,1.04086,1.0415,882,4948.05,-726099,-727187.2,42.48490089556565,40.29504036387524,37.08209798186673,NaN,NaN,50
1655164800,1.0415,1.04221,1.04039,1.04206,4214,4699.95,-721885,-725866.4,41.225250968314434,43.95754653342498,37.2906615546734,NaN,NaN,50
1655166600,1.04206,1.04244,1.04176,1.04226,3216,4478.9,-718669,-724357.6,39.72065723210089,45.249313507154916,37.27439415431637,NaN,NaN,50
1655168400,1.04226,1.04248,1.04082,1.041,3278,4386.2,-721947,-723116.2,39.132472498078904,39.13000714051232,37.240713955950845,NaN,NaN,50
1655170200,1.041,1.04106,1.0397,1.04016,3357,4293.2,-725304,-722780.8,39.33988423533872,35.66702310375878,37.103044908817765,NaN,NaN,50
1655172000,1.04016,1.04097,1.04002,1.04061,2642,4164.15,-722662,-722093.4,39.532480848508555,38.792135907204866,37.4814291611746,NaN,NaN,50
1655173800,1.04061,1.042,1.04056,1.04174,2896,4106.7,-719766,-721669.6,38.280124961520684,45.899143853716886,38.356175478421086,NaN,NaN,50
1655175600,1.04174,1.04248,1.04151,1.04222,4166,4174,-715600,-721055.8,36.54106809041578,48.627838225830615,39.555707928021086,NaN,NaN,50
1655177400,1.04222,1.04324,1.04162,1.04274,3645,4165.9,-711955,-719057.4,34.10171832769451,51.48275640649436,40.764313435861915,NaN,NaN,50
1655179200,1.04274,1.0436,1.04272,1.04316,3804,4133.65,-708151,-715626.8,31.854566976206293,53.719884683767674,42.091120462281914,NaN,NaN,50
1655181000,1.04316,1.04316,1.04232,1.04246,2250,4004.35,-710401,-713174.6,29.797733438915348,49.613775632855855,43.13421998347205,NaN,NaN,50
1655182800,1.04246,1.04274,1.04179,1.04186,1925,3002.45,-712326,-711686.6,28.39626677340714,46.34393766308543,43.795903379501794,NaN,NaN,50
1655184600,1.04186,1.04393,1.04182,1.04388,3133,2544.65,-709193,-710405.2,26.82762931239729,56.69234326788366,45.33659530466573,NaN,NaN,50
1655186400,1.04388,1.04418,1.04268,1.04374,5866,2649.3,-715059,-711026,25.591501458966558,55.88782994397312,46.5256125881099,NaN,NaN,50
1655188200,1.04374,1.04504,1.04364,1.0439,5736,2832.25,-709323,-711260.4,25.147453110311467,56.64505350383113,47.69347066953532,NaN,NaN,50
1655190000,1.0439,1.0467,1.04375,1.04606,8335,3240.1,-700988,-709377.8,25.798137998313337,65.30397606262875,49.21821563590702,NaN,NaN,50
1655191800,1.04606,1.04752,1.04567,1.04678,6553,3564.4,-694435,-705799.6,26.822229397050318,67.62509369050728,50.81648564900362,NaN,NaN,50
1655193600,1.04678,1.04759,1.0463,1.04727,5407,3720.95,-689028,-701766.6,27.8080343144092,69.1382581832866,52.959932152058926,NaN,NaN,50
1655195400,1.04727,1.0485,1.04652,1.04657,6599,3953.85,-695627,-697880.2,29.157930088582866,64.50030826088991,55.01945252042543,NaN,NaN,50
1655197200,1.04657,1.04666,1.04439,1.04478,6773,4233.85,-702400,-696495.6,28.26066434225532,54.44285179335719,56.13736079800775,NaN,NaN,50
1655199000,1.04478,1.0454,1.0433,1.04357,6554,4517.45,-708954,-698088.8,26.58120400999964,48.8929002233882,56.35120053869855,NaN,NaN,50
1655200800,1.04357,1.04418,1.04254,1.04276,5241,4568.8,-714195,-702040.8,24.873804214777806,45.545711856186934,56.131048655152576,NaN,NaN,50
1655202600,1.04276,1.04382,1.04265,1.04354,4702,4643.1,-709493,-706133.8,23.288361547786103,49.155429283237865,55.9648110034914,NaN,NaN,50
1655204400,1.04354,1.04442,1.04326,1.04438,5327,4745.55,-704166,-707841.6,21.88068332188035,52.785273340399854,55.8980530503937,NaN,NaN,50
1655206200,1.04438,1.04557,1.0442,1.04421,5689,4862.15,-709855,-709332.6,21.343203132048966,51.9765405140053,56.0668219704758,NaN,NaN,50
1655208000,1.04421,1.04568,1.0442,1.04528,6776,5068.85,-703079,-708157.6,20.91373463811274,56.49462881697528,56.7918713386108,NaN,NaN,50
1655209800,1.04528,1.04685,1.0448,1.04488,9014,5374.75,-712093,-707737.2,21.212412885402113,54.432936130642794,56.630485114522166,NaN,NaN,50
1655211600,1.04488,1.04598,1.04446,1.04482,7086,5520.75,-719179,-709674.4,21.17849941593399,54.11392798505914,56.503777831742596,NaN,NaN,50
1655213400,1.04482,1.04524,1.04338,1.04388,9579,5817.45,-728758,-714592.8,20.22876357508528,49.24469301261029,55.97518065379825,NaN,NaN,50
1655215200,1.04388,1.04455,1.0416,1.04238,8015,6028,-736773,-719976.4,19.445652997548027,42.64968154796924,54.357016759893995,NaN,NaN,50
1655217000,1.04238,1.0427,1.04081,1.04102,8599,6345.45,-745372,-728435,19.176079211169068,37.717577353813795,52.22076559298732,NaN,NaN,50
1655218800,1.04102,1.04234,1.04068,1.04194,8482,6673.3,-736890,-733394.4,19.000197350292026,42.55693435983345,50.32209960559781,NaN,NaN,50
1655220600,1.04194,1.04258,1.04087,1.04168,8029,6918.1,-744919,-738542.4,18.636963073019633,41.57380173313229,48.684491996472275,NaN,NaN,50
1655222400,1.04168,1.04236,1.04122,1.04229,6610,6955.3,-738309,-740452.6,18.299674101266696,44.7960086327344,47.995431770713495,NaN,NaN,50
1655224200,1.04229,1.04245,1.04157,1.04202,5674,6952.2,-743983,-741894.6,17.902492604461102,43.64855723143513,47.62083584271686,NaN,NaN,50
1655226000,1.04202,1.04436,1.042,1.04268,5264,6798.65,-738719,-740564,17.25085134424695,47.20835272851133,47.73959590502574,NaN,NaN,50
1655227800,1.04268,1.04274,1.04182,1.04189,3533,6647.65,-742252,-741636.4,16.498100026662375,43.653611223539016,47.346608900761545,NaN,NaN,50
1655229600,1.04189,1.04312,1.04187,1.04233,3088,6531.7,-739164,-740485.4,16.07508178184385,46.088509305560464,46.86826861255873,NaN,NaN,50
1655231400,1.04233,1.04262,1.04111,1.04115,2252,6314.35,-741416,-741106.8,15.035439474295112,40.97470033783539,46.082422885689446,NaN,NaN,50
1655233200,1.04115,1.04133,1.03999,1.04112,2607,6106.05,-744023,-741114.8,14.686984875845916,40.850599645127495,44.96499223055747,NaN,NaN,50
1655235000,1.04112,1.04154,1.04033,1.04108,3190,5937.85,-747213,-742813.6,14.184818751308597,40.673712750879766,43.982190560574395,NaN,NaN,50
1655236800,1.04108,1.04166,1.04104,1.04122,780,5714.8,-746433,-743649.8,13.61258773938643,41.62643469447022,43.09022675410376,NaN,NaN,50
1655238600,1.04122,1.0418,1.04122,1.0417,544,5506.9,-745889,-744994.8,12.952200748429071,44.89393959080157,42.779458652546,NaN,NaN,50
1655240400,1.0417,1.04214,1.04114,1.04154,199,5250.5,-746088,-745929.2,12.032691498189491,44.00961635032084,42.87659685271397,NaN,NaN,50
1655242200,1.04154,1.04208,1.0415,1.0416,1008,5016.45,-745080,-746140.6,11.178861480109882,44.45150371028622,43.35759159246199,NaN,NaN,50
1655244000,1.0416,1.04213,1.04138,1.04172,1075,4731.4,-744005,-745499,10.497243715156737,45.37996707537173,43.55923678642902,NaN,NaN,50
1655245800,1.04172,1.04275,1.04168,1.04272,900,4325.7,-743105,-744833.4,10.262615545494276,52.504385434286384,44.339992765082876,NaN,NaN,50
1655247600,1.04272,1.04324,1.0425,1.0431,1265,4034.65,-741840,-744023.6,10.501977006923854,54.911156767409686,45.06250334613111,NaN,NaN,50
1655249400,1.0431,1.04384,1.04298,1.0437,1258,3618.6,-740582,-742922.4,11.238777776722234,58.48805616603211,46.12246755574518,NaN,NaN,50
1655251200,1.0437,1.04406,1.04264,1.04306,2793,3357.5,-743375,-742581.4,11.50506561258323,53.60330333466646,46.57924974189912,NaN,NaN,50
1655253000,1.04306,1.0435,1.04276,1.04348,2531,3054.1,-740844,-741949.2,11.75233288873987,56.18919675385797,47.47464870835047,NaN,NaN,50
1655254800,1.04348,1.04496,1.04322,1.04488,2491,2754.55,-738353,-740998.8,13.162075798372946,63.49319716486174,48.71784069830056,NaN,NaN,50
1655256600,1.04488,1.04517,1.04394,1.04411,2490,2477.6,-740843,-740799.4,14.614104055187052,57.786876576798235,49.91871042965505,NaN,NaN,50
1655258400,1.04411,1.04467,1.04394,1.0444,2089,2251.55,-738754,-740433.8,15.962416007943006,59.27151000834277,51.23448974131328,NaN,NaN,50
1655260200,1.0444,1.04468,1.04404,1.0445,1769,2056.3,-736985,-739155.8,17.222073301881345,59.79658505328963,52.60040919148542,NaN,NaN,50
1655262000,1.0445,1.04474,1.04409,1.04443,1288,1857.5,-738273,-738641.6,18.440619092508186,59.221036722703246,53.857166479216346,NaN,NaN,50
1655263800,1.04443,1.04458,1.04382,1.04429,1330,1747.35,-739603,-738891.6,19.11602522894336,58.018260595569856,54.794617979556946,NaN,NaN,50
1655265600,1.04429,1.04434,1.04292,1.04294,1599,1672.9,-741202,-738963.4,18.411141583775233,47.91290283327061,55.0734241569105,NaN,NaN,50
1655267400,1.04294,1.04306,1.04242,1.04268,1445,1632.55,-742647,-739742,17.130481274748437,46.242383659901016,55.20134415331155,NaN,NaN,50
1655269200,1.04268,1.04356,1.04244,1.04348,2363,1620.35,-740284,-740401.8,16.50667931072958,51.809861278366625,55.66062231066833,NaN,NaN,50
1655271000,1.04348,1.04754,1.04347,1.0464,5253,1723.5,-735031,-739753.4,18.580014966785637,65.7520419669024,56.60688349156948,NaN,NaN,50
1655272800,1.0464,1.04938,1.04524,1.04863,6656,2017.3,-728375,-737507.8,21.158631284940128,72.33486302979595,57.851433938882785,NaN,NaN,50
1655274600,1.04863,1.04946,1.04716,1.04734,4799,2230.05,-733174,-735902.2,23.57831713419923,64.59957389956155,58.28797091984917,NaN,NaN,50
1655276400,1.04734,1.04882,1.04638,1.0487,5158,2478,-728016,-732976,24.98665779387677,68.43228367737,59.34718380147085,NaN,NaN,50
1655278200,1.0487,1.04934,1.04463,1.04664,7049,2780.05,-735065,-731932.2,24.71143076250919,58.16064659201488,59.48800164705348,NaN,NaN,50
1655280000,1.04664,1.04903,1.04656,1.04845,5932,3022.9,-729133,-730752.6,24.455862804810728,63.36399368170156,59.47877282682776,NaN,NaN,50
1655281800,1.04845,1.05078,1.04763,1.04939,4647,3210.25,-724486,-729974.8,25.07530240282519,65.7465137838202,60.04731834161502,NaN,NaN,50
1655283600,1.04939,1.04978,1.04782,1.04809,3804,3337.2,-728290,-728998,25.65049631526719,59.940854311864264,60.0951286490094,NaN,NaN,50
1655285400,1.04809,1.04953,1.04774,1.04946,3553,3451.95,-724737,-728342.2,26.10854329317692,63.58977245555117,60.366070606313805,NaN,NaN,50
1655287200,1.04946,1.04946,1.0472,1.0478,3861,3505.35,-728598,-727048.8,26.01552487531321,56.834446950968974,60.19559990833279,NaN,NaN,50
1655289000,1.0478,1.0488,1.04758,1.0482,3690,3563.3,-724908,-726203.8,25.92915063015406,57.99248437239023,60.19375874953424,NaN,NaN,50
1655290800,1.0482,1.04893,1.04784,1.04818,3995,3638.5,-728903,-727087.2,25.93010328223973,57.90883074688162,60.90775360050645,NaN,NaN,50
1655292600,1.04818,1.04858,1.04552,1.04582,4632,3745.6,-733535,-728136.2,24.249436878653256,48.93811698933268,61.10030598118014,NaN,NaN,50
1655294400,1.04582,1.04608,1.04212,1.04258,8088,4045.55,-741623,-731513.4,24.515964290053958,39.81836005994757,60.2437701798645,NaN,NaN,50
1655296200,1.04258,1.04394,1.04042,1.04148,6784,4296.3,-748407,-735475.2,25.399657243477353,37.2784068817523,58.20993910235378,NaN,NaN,50
1655298000,1.04148,1.04186,1.0403,1.04154,5085,4486.15,-743322,-739158,26.26221629029004,37.51254838565072,55.72263091348626,NaN,NaN,50
1655299800,1.04154,1.04289,1.04078,1.04262,4744,4656.85,-738578,-741093,26.284769819036313,41.72921603692818,54.08903392329817,NaN,NaN,50
1655301600,1.04262,1.04322,1.04183,1.04216,4110,4782.4,-742688,-742923.6,26.065012861190944,40.47637231701703,52.092183111844385,NaN,NaN,50
1655303400,1.04216,1.0426,1.04092,1.04113,4500,4935.15,-747188,-744036.6,26.262834892742664,37.743831043304766,50.633839144079374,NaN,NaN,50
1655305200,1.04113,1.04118,1.0393,1.04062,3094,4971.7,-750282,-744411.6,27.072605744509886,36.43232682317114,48.710148654184344,NaN,NaN,50
1655307000,1.04062,1.04074,1.03852,1.03858,3144,4866.25,-753426,-746432.4,28.09209837194811,31.689058207341745,46.27747325586445,NaN,NaN,50
1655308800,1.03858,1.03929,1.03849,1.03858,2250,4645.95,-753426,-749402,29.049161454980066,31.689058207341745,44.25948781982713,NaN,NaN,50
1655310600,1.03858,1.03904,1.038,1.03818,2240,4518,-755666,-751997.6,30.112568902304602,30.777828282474616,41.91577752175023,NaN,NaN,50
1655312400,1.03818,1.03967,1.03814,1.03958,2420,4381.1,-753246,-753209.2,30.5374842842672,37.54684732408134,40.5380918341154,NaN,NaN,50
1655314200,1.03958,1.04087,1.03928,1.04037,2909,4174.1,-750337,-753220.2,29.95133873803188,41.04991623726278,39.327908395892,NaN,NaN,50
1655316000,1.04037,1.04288,1.03593,1.03835,15913,4673.15,-766250,-755785,30.698366883871348,35.55781710644388,37.73140742157502,NaN,NaN,50
1655317800,1.03835,1.04551,1.03657,1.04224,18539,5367.75,-747711,-754642,29.74289359140247,49.554659321039324,37.77544615955407,NaN,NaN,50
1655319600,1.04224,1.0465,1.04149,1.04608,14787,5916.9,-732924,-750093.6,28.331973548123297,59.01755398177579,39.14681715397037,NaN,NaN,50
1655321400,1.04608,1.04608,1.04322,1.04543,9817,6230.1,-742741,-747992.6,27.021833507935494,57.06614500916409,40.56022702021407,NaN,NaN,50
1655323200,1.04543,1.04698,1.04502,1.04517,3572,6215.65,-746313,-747187.8,25.31963062475703,56.26474722295887,41.899669794307506,NaN,NaN,50
1655325000,1.04517,1.04542,1.04446,1.04466,1795,6120.9,-748108,-743559.4,24.01404649840872,54.64371614564916,42.822134087787575,NaN,NaN,50
1655326800,1.04466,1.04466,1.04437,1.04442,314,5936.85,-748422,-743701.6,22.847114410645457,53.85734841125396,43.77791809451878,NaN,NaN,50
1655328600,1.04442,1.04474,1.04438,1.04469,96,5710.05,-748326,-746782,21.713525337407322,54.64806076989424,44.98536307498946,NaN,NaN,50
1655330400,1.04469,1.04535,1.04446,1.045,1983,5404.8,-746343,-747502.4,20.27360304652772,55.58905849267984,46.353701051382934,NaN,NaN,50
1655332200,1.045,1.0451,1.04427,1.04444,806,5105.9,-747149,-747669.6,19.054088129493923,53.43227098232711,47.90678767816761,NaN,NaN,50
1655334000,1.04444,1.045,1.04426,1.04492,662,4884.75,-746487,-747345.4,17.928226907885314,55.0423941916619,49.574883105619044,NaN,NaN,50
1655335800,1.04492,1.04588,1.04482,1.04576,1764,4735.75,-744723,-746605.6,17.01991509696619,57.79272002685615,51.50451823021773,NaN,NaN,50
1655337600,1.04576,1.04694,1.04575,1.04614,2304,4645.45,-742419,-745424.2,16.829788980293614,59.014246520433915,53.03790388710006,NaN,NaN,50
1655339400,1.04614,1.04664,1.0452,1.04528,2068,4523.85,-744487,-745053,16.235350668431856,55.125851532027234,54.043327836726085,NaN,NaN,50
1655341200,1.04528,1.0459,1.04482,1.0455,2627,4500.5,-741860,-743995.2,15.39916259369197,55.92588113956397,55.49818955337752,NaN,NaN,50
1655343000,1.0455,1.04556,1.04312,1.04344,2866,4486.6,-744726,-743643,15.096754778184424,47.40369098231512,55.344548957754355,NaN,NaN,50
1655344800,1.04344,1.04438,1.04336,1.0436,2032,4475.7,-742694,-743237.2,14.815947520927416,48.065649139742504,54.56227004046627,NaN,NaN,50
1655346600,1.0436,1.04462,1.04354,1.04456,1788,4453.1,-740906,-742934.6,14.36468295287929,51.97145484434492,54.19836360012204,NaN,NaN,50
1655348400,1.04456,1.04518,1.0444,1.04486,1581,4411.15,-739325,-741902.2,13.504976397964688,53.15704588437768,53.976384933080524,NaN,NaN,50
1655350200,1.04486,1.0449,1.04406,1.0443,2189,4375.15,-741514,-741833,12.956760488873522,50.64391998092208,53.6906852070286,NaN,NaN,50
1655352000,1.0443,1.04438,1.04364,1.04396,1472,3653.1,-742986,-741485,12.753866715216667,49.12535057888179,53.352685361859166,NaN,NaN,50
1655353800,1.04396,1.04441,1.0436,1.04385,965,2774.4,-743951,-741736.4,12.595298220672383,48.61742771862905,52.92192585819736,NaN,NaN,50
1655355600,1.04385,1.04441,1.04378,1.04419,1767,2123.4,-742184,-741992,12.448056047166975,50.32698452931909,52.546063432243024,NaN,NaN,50
1655357400,1.04419,1.04432,1.04248,1.04294,2211,1743.1,-744395,-743006,13.263763234508371,44.46908798224368,51.9058360750942,NaN,NaN,50
1655359200,1.04294,1.04358,1.04271,1.0433,3592,1744.1,-740803,-742863.8,14.021205622753955,46.403953197966175,51.28880457554451,NaN,NaN,50
1655361000,1.0433,1.04334,1.04084,1.04087,4127,1860.7,-744930,-743252.6,15.807407605243599,37.025946538233505,49.805463612071456,NaN,NaN,50
1655362800,1.04087,1.0417,1.03862,1.03942,5123,2101.15,-750053,-744473,18.34978022690014,32.770153980434216,47.930885573500056,NaN,NaN,50
1655364600,1.03942,1.0409,1.03809,1.0397,7946,2493.65,-742107,-744457.6,20.882683753130465,34.33962165214025,46.446154867793844,NaN,NaN,50
1655366400,1.0397,1.04048,1.03852,1.03894,5394,2664.2,-747501,-745078.8,23.234665598915765,32.14602024494674,44.74759337532118,NaN,NaN,50
1655368200,1.03894,1.04129,1.0384,1.04095,4746,2861.2,-742755,-745469.2,24.531077288295062,42.591035368448,44.403832260044965,NaN,NaN,50
1655370000,1.04095,1.04244,1.03946,1.04166,5081,3082.15,-737674,-744018,24.62460132614077,45.766783737049494,44.23962758842403,NaN,NaN,50
1655371800,1.04166,1.04219,1.04084,1.04086,4299,3208.9,-741973,-742402,24.711445075568932,42.88794133320066,43.59080519477087,NaN,NaN,50
1655373600,1.04086,1.0412,1.03948,1.04082,4407,3314.05,-746380,-743256.6,25.486174944878016,42.74316789388392,42.846956766878456,NaN,NaN,50
1655375400,1.04082,1.04124,1.03916,1.04054,4374,3429.35,-750754,-743907.2,26.353487876203957,41.682474394644444,42.20685351071577,NaN,NaN,50
1655377200,1.04054,1.04264,1.03932,1.04188,7492,3672.6,-743262,-744008.6,25.86614226410629,48.29526765431123,42.147561873246445,NaN,NaN,50
1655379000,1.04188,1.04236,1.03836,1.03858,6798,3869.2,-750060,-746485.8,25.922353513495334,37.12929846774884,41.326981212469285,NaN,NaN,50
1655380800,1.03858,1.04176,1.0384,1.04132,6466,4090.9,-743594,-746810,25.974549673642304,47.900141521837774,41.15363528336348,NaN,NaN,50
1655382600,1.04132,1.04366,1.04118,1.04284,7726,4387.8,-735868,-744707.6,24.49540585368259,52.737373876907796,41.744227132982346,NaN,NaN,50
1655384400,1.04284,1.04634,1.04278,1.04628,6092,4613.35,-729776,-740512,23.904488279700047,61.458761838158814,42.81957060728182,NaN,NaN,50
1655386200,1.04628,1.04736,1.04494,1.04496,7042,4856,-736818,-739223.2,23.81781875674575,57.104279019018456,44.25373721305216,NaN,NaN,50
1655388000,1.04496,1.04796,1.04354,1.04748,6410,5102.9,-730408,-735292.8,22.839616238667304,62.558330940141865,46.38146413874557,NaN,NaN,50
1655389800,1.04748,1.04999,1.04711,1.04944,6471,5378.2,-723937,-731361.4,22.816580383772173,66.16203970982791,48.654494000008995,NaN,NaN,50
1655391600,1.04944,1.05177,1.04912,1.0508,5608,5570.25,-718329,-727853.6,23.43285266172987,68.43244286616434,51.246381330095964,NaN,NaN,50
1655393400,1.0508,1.05294,1.05008,1.05292,5861,5752.75,-712468,-724392,24.374362849341384,71.62815743569692,53.3204614777566,NaN,NaN,50
1655395200,1.05292,1.05626,1.05224,1.0557,5390,5842.65,-707078,-718444,26.096546997780717,75.17691535035729,55.421185164421445,NaN,NaN,50
1655397000,1.0557,1.0573,1.05432,1.05602,5699,5921.25,-701379,-712638.2,27.914379181629386,75.55592675216529,57.754612694347486,NaN,NaN,50
1655398800,1.05602,1.05804,1.05546,1.05734,5304,5930.3,-696075,-707065.8,29.753099685047037,77.10859145228076,60.209285805661544,NaN,NaN,50
1655400600,1.05734,1.06014,1.0568,1.0585,5684,5817.2,-690391,-701478.2,31.84932623247275,78.40664601670463,62.83244092152298,NaN,NaN,50
1655402400,1.0585,1.0585,1.0567,1.0571,4162,5755.6,-694553,-697895.2,33.727774621433696,73.02463529322755,64.59882432430273,NaN,NaN,50
1655404200,1.0571,1.05827,1.05654,1.05752,3111,5673.85,-691442,-694768,35.356689022424284,73.60988196552309,67.20458028842945,NaN,NaN,50
1655406000,1.05752,1.0583,1.05678,1.05731,3838,5611.7,-695280,-693548.2,36.875641565426676,72.75988317313212,68.98027612066475,NaN,NaN,50
1655407800,1.05731,1.05744,1.0555,1.05609,3521,5572.8,-698801,-694093.4,37.3196696320198,67.85752095939594,70.06028662655676,NaN,NaN,50
1655409600,1.05609,1.0561,1.05461,1.05474,1523,5428.6,-700324,-696080,37.1110047120594,62.81405757090591,70.15709346461013,NaN,NaN,50
1655411400,1.05474,1.05538,1.05468,1.05524,665,5243.15,-699659,-697101.2,36.91724442923901,63.88469659712493,70.64140900590344,NaN,NaN,50
1655413200,1.05524,1.05532,1.05487,1.05527,96,4873.35,-699563,-698725.4,36.73732416662009,63.951759798189556,70.74093963862114,NaN,NaN,50
1655415000,1.05527,1.05567,1.05516,1.05556,181,4542.5,-699382,-699545.8,36.706035491970056,64.63539319707002,70.63189345913845,NaN,NaN,50
1655416800,1.05556,1.05612,1.05478,1.05478,1650,4301.7,-701032,-699992,36.852495374687415,61.26976082003694,70.1202733129865,NaN,NaN,50
1655418600,1.05478,1.05496,1.05452,1.05482,921,3961.45,-700111,-699949.4,36.75618554136172,61.38081870964953,69.38832054684026,NaN,NaN,50
1655420400,1.05482,1.05508,1.05438,1.05474,1045,3709.1,-701156,-700248.8,36.53696524784196,61.00405193386305,68.37597315994782,NaN,NaN,50
1655422200,1.05474,1.05513,1.0546,1.05466,1370,3425.5,-702526,-700841.4,36.35770757439891,60.60344183341398,67.30793852289415,NaN,NaN,50
1655424000,1.05466,1.05522,1.0541,1.05414,3406,3275.3,-705932,-702151.4,35.689951554207724,57.9400203639342,65.93875487372654,NaN,NaN,50
1655425800,1.05414,1.05428,1.05354,1.05408,2985,3101,-708917,-703728.4,34.530945865639524,57.6253262687409,64.45437489172913,NaN,NaN,50
1655427600,1.05408,1.05429,1.05282,1.05393,3161,2978.65,-712078,-706121.8,32.8061718097233,56.79481914214739,63.29510230950912,NaN,NaN,50
1655429400,1.05393,1.05422,1.05332,1.0534,3549,2863.05,-715627,-709016,31.204595900658244,53.84210573103731,61.88311829276013,NaN,NaN,50
1655431200,1.0534,1.05355,1.05276,1.05321,2459,2716.5,-718086,-712128,29.21154359799432,52.78268977828133,60.456175907413645,NaN,NaN,50
1655433000,1.05321,1.05393,1.05222,1.05266,6842,2773.65,-724928,-715927.2,27.350073693747984,49.732158033882286,59.16150712701982,NaN,NaN,50
1655434800,1.05266,1.05372,1.05261,1.0527,4386,2727.75,-720542,-718252.2,25.621565925519242,49.95867192636567,58.243265295266944,NaN,NaN,50
1655436600,1.0527,1.05305,1.05176,1.05204,3346,2610.85,-723888,-720614.2,24.724640131362317,46.255004695044086,56.984001587975456,NaN,NaN,50
1655438400,1.05204,1.05304,1.05202,1.05246,2449,2525.2,-721439,-721776.6,23.89178046535946,48.85352901636746,55.90555653213102,NaN,NaN,50
1655440200,1.05246,1.05283,1.05214,1.05276,1853,2462.3,-719586,-722076.6,23.11841077549967,50.68754057182391,54.90928134461344,NaN,NaN,50
1655442000,1.05276,1.05288,1.05212,1.05226,2143,2377.55,-721729,-721436.8,22.33999976580234,47.62252791548075,53.934478994288,NaN,NaN,50
1655443800,1.05226,1.05286,1.05182,1.05182,2779,2340.45,-724508,-722230,21.90568062185343,45.04139571827827,52.7673773520472,NaN,NaN,50
1655445600,1.05182,1.05206,1.05098,1.0518,4340,2481.3,-728848,-723222,22.231157607437435,44.922210902859355,51.61867442126122,NaN,NaN,50
1655447400,1.0518,1.05185,1.04998,1.05005,5069,2701.5,-733917,-725717.6,23.243025989078916,35.956590802447806,49.85818506190649,NaN,NaN,50
1655449200,1.05005,1.05267,1.0494,1.05264,5213,2957.35,-728704,-727541.2,23.144170522378012,51.412381333709696,49.391925131176166,NaN,NaN,50
1655451000,1.05264,1.05308,1.05141,1.05176,4350,3165.8,-733054,-729806.2,22.579927475996104,47.240792054285144,48.65017268728648,NaN,NaN,50
1655452800,1.05176,1.05184,1.05002,1.05016,4113,3288.95,-737167,-732338,23.057278081413727,40.764351878290306,47.50513931129668,NaN,NaN,50
1655454600,1.05016,1.05284,1.04999,1.052,4804,3483.1,-732363,-733041,22.451778764396817,49.361976124641295,47.18513005369697,NaN,NaN,50
1655456400,1.052,1.05359,1.05169,1.0518,4369,3649.3,-736732,-733604,21.201772275138392,48.53732919319099,46.88189001190481,NaN,NaN,50
1655458200,1.0518,1.05294,1.05108,1.0518,4175,3789.55,-736732,-735209.6,20.50650769784444,48.53732919319099,46.79654509471256,NaN,NaN,50
1655460000,1.0518,1.05267,1.05126,1.0515,3170,3777.75,-739902,-736579.2,19.860904876071487,47.1665415877767,46.59710721338478,NaN,NaN,50
1655461800,1.0515,1.05268,1.05121,1.05202,2899,3773.45,-737003,-736546.4,19.302363550593924,49.812347301195764,46.851203113824184,NaN,NaN,50
1655463600,1.05202,1.05234,1.05072,1.05132,3595,3795.15,-740598,-738193.4,19.185604218477543,46.44080922751807,46.67886598604923,NaN,NaN,50
1655465400,1.05132,1.05146,1.04836,1.04859,3329,3784.15,-743927,-739632.4,20.542266688829166,36.16107873103935,45.64126156885034,NaN,NaN,50
1655467200,1.04859,1.04928,1.04758,1.04922,4233,3872.85,-739694,-740224.8,22.161690270357052,39.48976871295032,45.06035019724102,NaN,NaN,50
1655469000,1.04922,1.05082,1.04876,1.04948,4016,3731.55,-735678,-739380,22.155382287307194,40.860285978613646,44.761699501550694,NaN,NaN,50
1655470800,1.04948,1.05002,1.04816,1.04866,3941,3709.3,-739619,-739903.2,22.474170794858026,37.941542865645516,44.26308035603542,NaN,NaN,50
1655472600,1.04866,1.04902,1.0474,1.04844,5770,3830.5,-745389,-740861.4,23.156476563348484,37.174303593863655,44.350059841136556,NaN,NaN,50
1655474400,1.04844,1.04872,1.04522,1.04658,6537,4034.9,-751926,-742461.2,24.69040322611484,31.39414849269987,42.92018606677872,NaN,NaN,50
1655476200,1.04658,1.04662,1.04445,1.04584,5605,4222.5,-757531,-746028.6,26.375351980745275,29.433321046489198,41.648223851936145,NaN,NaN,50
1655478000,1.04584,1.04776,1.0455,1.04632,5107,4370.7,-752424,-749377.8,26.933043109214193,32.38342968036554,41.04958655208437,NaN,NaN,50
1655479800,1.04632,1.04752,1.04628,1.04735,3689,4416.2,-748735,-751201,27.450899157078197,38.34032829391906,40.26232599274707,NaN,NaN,50
1655481600,1.04735,1.04764,1.0467,1.04696,2984,4348.4,-751719,-752467,27.82180454575556,37.010770376193875,39.439000362961565,NaN,NaN,50
1655483400,1.04696,1.04732,1.04649,1.04676,2828,4236.35,-754547,-752991.2,28.268041237461816,36.315280349473554,38.56599687412461,NaN,NaN,50
1655485200,1.04676,1.04832,1.04666,1.04788,2545,4102.95,-752002,-751885.4,27.744802005100063,42.797858752915296,38.25394810020593,NaN,NaN,50
1655487000,1.04788,1.04998,1.04777,1.04906,2944,4032.65,-749058,-751212.2,25.97212988337202,48.7203723659,38.17594989054195,NaN,NaN,50
1655488800,1.04906,1.05028,1.04906,1.04972,2643,3959.15,-746415,-750748.2,24.118943306606546,51.73068452750857,38.55379812625556,NaN,NaN,50
1655490600,1.04972,1.04998,1.04902,1.04912,2527,3845.3,-748942,-750192.8,22.426899242542614,48.91918581653398,39.465091489505184,NaN,NaN,50
1655492400,1.04912,1.04978,1.0488,1.04942,2699,3761.8,-746243,-748532,21.021491556318843,50.37154848059264,40.2423614729082,NaN,NaN,50
1655494200,1.04942,1.04971,1.04912,1.04948,2184,3662.25,-744059,-746943.4,19.716470133396772,50.67362097359234,40.94331397254954,NaN,NaN,50
1655496000,1.04948,1.04976,1.04896,1.04976,1078,3557.65,-742981,-745728,18.638598347991923,52.13770315578416,41.957325421845155,NaN,NaN,50
1655497800,1.04976,1.05003,1.04938,1.04938,887,3457.05,-743868,-745218.6,17.384718825875684,49.96997125968094,42.871301683689246,NaN,NaN,50
1655672400,1.04938,1.04938,1.04841,1.04916,47,3279.65,-743915,-744213.2,17.038643028564746,48.70735327444334,44.10795916809949,NaN,NaN,50
1655674200,1.04916,1.04939,1.04832,1.04878,206,3123.5,-744121,-743788.8,16.78875068501974,46.52082124423672,45.32849489651004,NaN,NaN,50
1655676000,1.04878,1.04912,1.04746,1.04845,1376,2980.65,-745497,-744076.4,17.207133150783147,44.64641827720996,46.20442265342749,NaN,NaN,50
1655677800,1.04845,1.04914,1.0484,1.04907,1082,2833.95,-744415,-744363.2,17.57258444452502,48.818839557349335,46.95288774367251,NaN,NaN,50
1655679600,1.04907,1.0492,1.04846,1.04876,1076,2690.7,-745491,-744687.8,17.83829522621368,46.91466932622738,47.66030909724633,NaN,NaN,50
1655681400,1.04876,1.0493,1.04862,1.049,1328,2468.6,-744163,-744737.4,17.955924752218966,48.58663956051371,48.53683475517777,NaN,NaN,50
1655683200,1.049,1.04953,1.04852,1.0492,2169,2250.2,-741994,-744312,17.76135479202233,49.99991937636938,49.05126765685306,NaN,NaN,50
1655685000,1.0492,1.04968,1.04889,1.04934,1861,2063,-740133,-743239.2,17.37992729501557,51.01499419212458,49.2151692158691,NaN,NaN,50
1655686800,1.04934,1.05002,1.04932,1.04969,1890,1902.15,-738243,-742004.8,16.574513571519383,53.55364893513404,49.345380959270926,NaN,NaN,50
1655688600,1.04969,1.04994,1.04913,1.04934,2636,1849.5,-740879,-741082.4,16.046017054904027,50.722727856653016,49.474205390708,NaN,NaN,50
1655690400,1.04934,1.05054,1.04928,1.05024,2246,1812.6,-738633,-739976.4,15.025139597145468,57.01509196508321,49.94874421102876,NaN,NaN,50
1655692200,1.05024,1.05238,1.05022,1.05184,2712,1806.8,-735921,-738761.8,15.820813492100358,65.45932427655131,51.00486587552582,NaN,NaN,50
1655694000,1.05184,1.05265,1.05183,1.05194,1665,1762.8,-734256,-737586.4,16.758908008682415,65.91007344802685,51.98860661068602,NaN,NaN,50
1655695800,1.05194,1.0529,1.05186,1.05284,1478,1689.5,-732778,-736493.4,17.814235137380365,69.73772874592832,53.400589288275114,NaN,NaN,50
1655697600,1.05284,1.05306,1.05226,1.0529,1364,1625.55,-731414,-734600.4,18.91356763402002,69.97972842812374,54.92004465639514,NaN,NaN,50
1655699400,1.0529,1.05298,1.05226,1.0523,779,1538.15,-732193,-733312.4,19.934376380899696,64.43100751058881,56.19934367542029,NaN,NaN,50
1655701200,1.0523,1.05294,1.0522,1.05242,1347,1470.55,-730846,-732297.4,20.782314201576416,65.02825267197056,57.65518898933176,NaN,NaN,50
1655703000,1.05242,1.05318,1.0522,1.05292,1927,1457.7,-728919,-731230,21.7805773342693,67.47857955090855,58.98802756030028,NaN,NaN,50
1655704800,1.05292,1.0543,1.05248,1.05288,3483,1577.95,-732402,-731154.8,23.54031639302266,67.07369278671126,60.427957807477696,NaN,NaN,50
1655706600,1.05288,1.05318,1.05237,1.05246,3195,1693.35,-735597,-731991.4,24.980350855584216,62.81198058358812,61.444053594840156,NaN,NaN,50
1655708400,1.05246,1.053,1.05136,1.05226,4360,1909,-739957,-733544.2,24.726562171605867,60.82993056473125,62.21762582258028,NaN,NaN,50
1655710200,1.05226,1.05254,1.05103,1.0517,3486,2073,-743443,-736063.6,24.042329351540292,55.54477195577355,62.54118137712664,NaN,NaN,50
1655712000,1.0517,1.05216,1.05121,1.05158,2630,2135.7,-746073,-739494.4,23.406970304336543,54.45297909141973,62.605419245432756,NaN,NaN,50
1655713800,1.05158,1.05275,1.05122,1.05246,2578,2210.5,-743495,-741713,23.40400683431118,60.57329276645689,63.30903102470446,NaN,NaN,50
1655715600,1.05246,1.0546,1.05244,1.05422,3207,2317.05,-740288,-742651.2,24.750290633879032,69.42291076329042,64.19530379600498,NaN,NaN,50
1655717400,1.05422,1.05423,1.0531,1.05328,2469,2374.1,-742757,-743211.2,26.000411304906322,61.48505098289745,63.911427132172555,NaN,NaN,50
1655719200,1.05328,1.05339,1.05242,1.05282,2316,2381.45,-745073,-743537.2,26.19523491364725,57.99064617959913,63.345753755856286,NaN,NaN,50
1655721000,1.05282,1.05378,1.05252,1.0532,2227,2399.75,-742846,-742891.8,26.65849948649476,60.01244959123205,62.651090959092265,NaN,NaN,50
1655722800,1.0532,1.05342,1.05202,1.05256,1984,2404.45,-744830,-743158.8,26.414560649324308,55.19442310767774,61.59499772191755,NaN,NaN,50
1655724600,1.05256,1.05357,1.05227,1.05262,2158,2380.55,-742672,-743635.6,26.3112086041431,55.554677965524135,60.96097418298435,NaN,NaN,50
1655726400,1.05262,1.05277,1.0515,1.052,2041,2370.3,-744713,-744026.8,25.229172616448903,50.992143452155354,59.95839495299755,NaN,NaN,50
1655728200,1.052,1.05232,1.05162,1.05172,1637,2316.55,-746350,-744282.2,24.224424913590006,49.03361247981701,58.640897305062445,NaN,NaN,50
1655730000,1.05172,1.05222,1.05074,1.05194,2953,2380.95,-743397,-744392.4,22.710883880646385,50.63785682178202,57.46690902185321,NaN,NaN,50
1655731800,1.05194,1.05249,1.05148,1.05184,3081,2461.1,-746478,-744722,21.169908825256385,49.86946388136288,56.542443543122836,NaN,NaN,50
1655733600,1.05184,1.05363,1.05182,1.0532,2533,2519.55,-743945,-744976.6,20.83700917662508,58.98486504195301,56.41065314863868,NaN,NaN,50
1655735400,1.0532,1.05418,1.0527,1.0535,2718,2616.5,-741227,-744279.4,20.97365950128675,60.68318231057957,56.77768245969626,NaN,NaN,50
1655737200,1.0535,1.05354,1.05237,1.05293,1830,2640.65,-743057,-743620.8,20.696581184442973,55.943365523960026,56.88413863344913,NaN,NaN,50
1655739000,1.05293,1.05383,1.05262,1.0538,1363,2612.45,-741694,-743280.2,20.686717802827406,60.95610796240675,56.91148257601697,NaN,NaN,50
1655740800,1.0538,1.05383,1.05226,1.0525,1218,2499.2,-742912,-742567,20.222004627292282,51.52264762304202,55.63289235171352,NaN,NaN,50
1655742600,1.0525,1.05262,1.05193,1.05234,1027,2390.8,-743939,-742565.8,19.385701300429226,50.48704050779289,54.84732017492034,NaN,NaN,50
1655744400,1.05234,1.05234,1.0511,1.05116,410,2193.3,-744349,-743190.2,18.311395281816885,43.536796785808654,53.81490236107817,NaN,NaN,50
1655746200,1.05116,1.0515,1.0506,1.0506,553,2046.65,-744902,-743559.2,17.80159636841531,40.6750025017415,52.43365614040027,NaN,NaN,50
1655748000,1.0506,1.05074,1.0499,1.05044,896,1959.95,-745798,-744380,17.94475773694682,39.868640589860235,51.33895738912759,NaN,NaN,50
1655749800,1.05044,1.05065,1.0499,1.04992,563,1859.2,-746361,-745069.8,18.077693293440365,37.28181299212139,50.03375274817025,NaN,NaN,50
1655751600,1.04992,1.05038,1.04981,1.05036,383,1718,-745978,-745477.6,18.282948877014856,40.78300888807335,49.30452885073582,NaN,NaN,50
1655753400,1.05036,1.05122,1.05034,1.05114,426,1615.85,-745552,-745718.2,17.38895635257144,46.486169036884654,49.12256860481208,NaN,NaN,50
1655755200,1.05114,1.05146,1.0509,1.05094,526,1526.35,-746078,-745953.4,16.27784968966219,45.2819258551314,48.74000210719417,NaN,NaN,50
1655757000,1.05094,1.05122,1.05094,1.05112,270,1428.5,-745808,-745955.4,15.246107788389313,46.62215382616971,48.50805138896609,NaN,NaN,50
1655758800,1.05112,1.0515,1.05086,1.05116,106,1334.6,-745702,-745823.6,14.37463223778106,46.933212873894256,47.64721909124761,NaN,NaN,50
1655760600,1.05116,1.0513,1.05104,1.05116,180,1235.7,-745702,-745768.4,13.565404940787682,46.933212873894256,46.66507841719865,NaN,NaN,50
1655762400,1.05116,1.05134,1.0509,1.05104,463,1156.8,-746165,-745891,12.61501697202484,46.000527375085575,45.95487569227905,NaN,NaN,50
1655764200,1.05104,1.05188,1.05104,1.05184,632,1106.55,-745533,-745782,12.45170866730784,52.7429364086786,45.36822058129847,NaN,NaN,50
1655766000,1.05184,1.05185,1.05152,1.05175,685,993.15,-746218,-745864,12.300065241499194,51.956965339377746,45.399243275322455,NaN,NaN,50
1655767800,1.05175,1.05212,1.05138,1.05175,1197,898.95,-746218,-745967.2,12.513465334132828,51.956965339377746,45.504237906149946,NaN,NaN,50
1655769600,1.05175,1.05274,1.05166,1.05273,2176,881.1,-744042,-745635.2,13.439571892406214,59.566181855478064,46.649193982554905,NaN,NaN,50
1655771400,1.05273,1.05332,1.05194,1.05328,2429,866.65,-741613,-744724.8,14.874929799735545,63.09861145618419,48.25088033644367,NaN,NaN,50
1655773200,1.05328,1.05426,1.05316,1.05344,1699,860.1,-739914,-743601,16.961310209754007,64.08168650843405,49.9803836163418,NaN,NaN,50
1655775000,1.05344,1.05372,1.05303,1.05341,2017,892.8,-741931,-742743.6,18.660987749702418,63.738813029677914,51.870169333310116,NaN,NaN,50
1655776800,1.05341,1.05409,1.05315,1.05336,1304,897.1,-743235,-742147,20.518995320671017,63.13251454724981,53.466562594679864,NaN,NaN,50
1655778600,1.05336,1.05358,1.05314,1.05335,925,892,-744160,-742170.6,22.224443340745967,63.00343381848486,54.64636722193702,NaN,NaN,50
1655780400,1.05335,1.0534,1.05229,1.05288,1320,937.5,-745480,-742944,22.266071811729134,57.0947957756019,55.49014364482777,NaN,NaN,50
1655782200,1.05288,1.05324,1.05252,1.05323,1448,982.25,-744032,-743767.6,22.30472682049922,60.09599305106839,56.452560732320535,NaN,NaN,50
1655784000,1.05323,1.05329,1.05265,1.05269,910,982.95,-744942,-744369.8,22.396290827447732,53.83866077781629,56.94580701117211,NaN,NaN,50
1655785800,1.05269,1.05273,1.05208,1.05224,869,998.25,-745811,-744885,21.507766418397996,49.237735214462674,57.11041574978414,NaN,NaN,50
1655787600,1.05224,1.05259,1.05189,1.0519,918,1025,-746729,-745398.8,20.383612258272716,46.0365912614284,57.112991741665766,NaN,NaN,50
1655789400,1.0519,1.05194,1.05132,1.05184,1558,1081.6,-748287,-745960.2,19.343204061000534,45.4747233648928,56.59383366710964,NaN,NaN,50
1655791200,1.05184,1.05218,1.05146,1.05204,1729,1141.75,-746558,-746465.4,18.019405091192148,47.76332403697659,56.29428785979527,NaN,NaN,50
1655793000,1.05204,1.05328,1.05192,1.05324,2991,1277.8,-743567,-746190.4,18.0379753274805,58.90795783023803,56.79078732342815,NaN,NaN,50
1655794800,1.05324,1.05536,1.05316,1.0547,3770,1461,-739797,-744987.6,19.679674585295366,67.88534286177014,57.38501310959187,NaN,NaN,50
1655796600,1.0547,1.05649,1.05446,1.05568,3610,1632.5,-736187,-742879.2,21.793978910683872,72.26533172293284,58.039778842931064,NaN,NaN,50
1655798400,1.05568,1.05688,1.05538,1.05634,3509,1784.8,-732678,-739757.4,23.936479301609356,74.76182398536912,58.802645805569284,NaN,NaN,50
1655800200,1.05634,1.05794,1.05628,1.05784,3927,1949.55,-728751,-736196,26.36150157869826,79.31826905823507,59.915464093323365,NaN,NaN,50
1655802000,1.05784,1.05826,1.05728,1.05778,2529,2041.75,-731280,-733738.6,28.732115945592167,78.70617011592824,61.027868062514685,NaN,NaN,50
1655803800,1.05778,1.05792,1.0566,1.0568,2182,2091,-733462,-732471.6,29.988713890619696,69.29946001184707,61.47758421918341,NaN,NaN,50
1655805600,1.0568,1.05682,1.05508,1.05599,2932,2128.8,-736394,-732513,29.416909337532637,62.636044010675775,61.873387664545824,NaN,NaN,50
1655807400,1.05599,1.05671,1.05515,1.05522,2709,2142.8,-739103,-733798,28.885947966808935,57.02289314922417,61.65388052869981,NaN,NaN,50
1655809200,1.05522,1.05569,1.05444,1.0551,3452,2230.45,-742555,-736558.8,27.672624701980713,56.177957673588224,61.8209731641121,NaN,NaN,50
1655811000,1.0551,1.05603,1.0546,1.05502,3875,2323.35,-746430,-739588.8,26.8032781394055,55.586616712968656,62.27446469971966,NaN,NaN,50
1655812800,1.05502,1.05624,1.0546,1.0556,3941,2455.2,-742489,-741394.2,26.15583549616619,58.95954331519854,63.197532703560384,NaN,NaN,50
1655814600,1.0556,1.05632,1.05484,1.05518,3748,2596.35,-746237,-743362.8,25.61777910929034,55.66295101312197,63.92526324986246,NaN,NaN,50
1655816400,1.05518,1.05578,1.05456,1.0548,3159,2688.3,-749396,-745421.4,24.788324192952953,52.78715313140649,64.28410818517888,NaN,NaN,50
1655818200,1.0548,1.05616,1.05477,1.05591,3879,2809.85,-745517,-746013.8,24.34876932185217,59.38761978621584,64.31836975346302,NaN,NaN,50
1655820000,1.05591,1.05618,1.05446,1.05511,3340,2931.35,-748857,-746499.2,23.557955979864193,53.57431888789843,63.296153755329314,NaN,NaN,50
1655821800,1.05511,1.05664,1.05472,1.05655,3829,3079.35,-745028,-747007,23.240546176377137,60.978657603286685,62.489962746783156,NaN,NaN,50
1655823600,1.05655,1.05668,1.05486,1.05582,2714,3169.15,-747742,-747308,22.981995074140258,56.09446216864563,61.15657975987433,NaN,NaN,50
1655825400,1.05582,1.05664,1.05468,1.05485,2533,3217.9,-750275,-747483.8,22.49020608123516,50.32622526646836,59.085719489033856,NaN,NaN,50
1655827200,1.05485,1.05488,1.0529,1.05342,3126,3287.75,-753401,-749060.6,21.71430157775291,43.263200472529284,56.55407880021965,NaN,NaN,50
1655829000,1.05342,1.05378,1.0528,1.05341,1942,3235.3,-755343,-750357.8,21.08372025072847,43.21752270306641,54.69108327816389,NaN,NaN,50
1655830800,1.05341,1.05379,1.05282,1.05286,2160,3154.8,-757503,-752852.8,20.485832082405025,40.67391796375857,53.12235998909837,NaN,NaN,50
1655832600,1.05286,1.05404,1.05272,1.0539,1676,3058.1,-755827,-754469.8,19.611847840613148,47.02328084601401,52.40810196744051,NaN,NaN,50
1655834400,1.0539,1.05399,1.05299,1.05332,1382,2951.75,-757209,-755856.6,18.800291044663545,44.18325971002543,51.551337827186025,NaN,NaN,50
1655836200,1.05332,1.0536,1.05188,1.05315,2122,2861.5,-759331,-757042.6,19.15667595147931,43.35670701518143,50.67777284877264,NaN,NaN,50
1655838000,1.05315,1.054,1.05312,1.05398,1515,2810.8,-757816,-757537.2,18.942266344851404,48.4292963471289,49.92561235105338,NaN,NaN,50
1655839800,1.05398,1.05406,1.0529,1.05316,1345,2768.95,-759161,-757868.8,18.954240678047,44.21636226630045,49.10799886913757,NaN,NaN,50
1655841600,1.05316,1.05318,1.05287,1.05294,636,2654.15,-759797,-758662.8,18.995109469588083,43.132255181585926,48.41836330129323,NaN,NaN,50
1655843400,1.05294,1.05355,1.05294,1.05348,426,2540,-759371,-759095.2,18.486561595570798,46.593550402042126,47.50450120242368,NaN,NaN,50
1655845200,1.05348,1.05358,1.05348,1.05352,69,2370.85,-759302,-759089.4,17.96992224406016,46.85160624414316,47.024307442155454,NaN,NaN,50
1655847000,1.05352,1.05356,1.05344,1.0535,66,2180.4,-759368,-759399.8,17.54037713990126,46.7300238535496,46.0065478886028,NaN,NaN,50
1655848800,1.0535,1.0536,1.05327,1.05344,491,2007.9,-759859,-759539.4,17.361447027689188,46.341495979958765,45.30990744655374,NaN,NaN,50
1655850600,1.05344,1.05392,1.05331,1.0538,782,1859.6,-759077,-759395.4,16.651342267081436,49.07723155850213,45.22069361027043,NaN,NaN,50
1655852400,1.0538,1.05387,1.05315,1.05323,988,1751.05,-760065,-759534.2,16.21956984248262,45.15196419035065,45.35560530440053,NaN,NaN,50
1655854200,1.05323,1.05362,1.05312,1.05314,1175,1615.85,-761240,-759921.8,15.862709921421722,44.546133129936486,45.450506049176965,NaN,NaN,50
1655856000,1.05314,1.05318,1.05184,1.05255,2092,1553.45,-763332,-760714.6,17.05817333983016,40.69158332062505,45.451767860381715,NaN,NaN,50
1655857800,1.05255,1.05256,1.05104,1.05128,2272,1475.6,-765604,-761863.6,18.839665309304625,33.89310911782216,44.51389845122515,NaN,NaN,50
1655859600,1.05128,1.05157,1.05084,1.05146,2096,1444.7,-763508,-762749.8,20.643834956674137,35.536992097724365,43.896307907489366,NaN,NaN,50
1655861400,1.05146,1.05148,1.05022,1.05077,2858,1460.95,-766366,-764010,22.749547713832463,32.228531593827384,43.10143823453551,NaN,NaN,50
1655863200,1.05077,1.05152,1.05069,1.0515,1370,1373.15,-764996,-764761.2,24.625141122426434,38.72783711011947,42.4084768604634,NaN,NaN,50
1655865000,1.0515,1.05153,1.05071,1.05098,2225,1387.3,-767221,-765539,26.3455049163257,36.07397004885585,41.82687741636021,NaN,NaN,50
1655866800,1.05098,1.0512,1.05068,1.0512,1717,1365.15,-765504,-765519,27.966474868367325,38.00943597334232,41.46096175862852,NaN,NaN,50
1655868600,1.0512,1.0514,1.05104,1.05108,1138,1338.25,-766642,-766145.8,29.003184870771616,37.345254935102275,40.800369225275674,NaN,NaN,50
1655870400,1.05108,1.0514,1.05078,1.05112,877,1313,-765765,-766025.6,30.20427737029282,37.73582299850426,40.14924185058718,NaN,NaN,50
1655872200,1.05112,1.05128,1.04938,1.04967,1271,1270.45,-767036,-766433.6,32.294037965017,30.35006489847234,38.97924478236738,NaN,NaN,50
1655874000,1.04967,1.04986,1.04924,1.04976,1400,1264.7,-765636,-766116.6,34.310975464257496,31.24951323154967,37.90124601462388,NaN,NaN,50
1655875800,1.04976,1.0498,1.0486,1.04884,1793,1287.1,-767429,-766501.6,36.5081126387732,27.35995023727027,36.35001163453589,NaN,NaN,50
1655877600,1.04884,1.05084,1.04884,1.0507,2746,1392.6,-764683,-766109.8,36.57266145751762,42.848057536326245,36.18544687353414,NaN,NaN,50
1655879400,1.0507,1.05074,1.04832,1.04916,3950,1568.8,-768633,-766683.4,37.00257340667696,36.003314351220986,35.575245532197314,NaN,NaN,50
1655881200,1.04916,1.04955,1.04688,1.04907,6524,1891.55,-775157,-768307.6,38.213487913661915,35.64494534313826,35.214771390948265,NaN,NaN,50
1655883000,1.04907,1.0508,1.0489,1.05045,4866,2131.55,-770291,-769238.6,37.62072967858172,44.729481564342606,35.98879799427116,NaN,NaN,50
1655884800,1.05045,1.05142,1.04938,1.051,4351,2324.55,-765940,-768940.8,36.355891821877954,47.88692160521273,36.87093581623461,NaN,NaN,50
1655886600,1.051,1.05144,1.04994,1.05078,3559,2463.4,-769499,-769904,35.158552814502215,46.73679622555857,37.90724043278685,NaN,NaN,50
1655888400,1.05078,1.05173,1.05044,1.05086,3094,2568.7,-766405,-769458.4,33.70515705115447,47.233093501216516,38.51475874643664,NaN,NaN,50
1655890200,1.05086,1.05246,1.0505,1.05192,3724,2696.15,-762681,-766963.2,31.55355679033334,53.425549217275446,39.754157258466606,NaN,NaN,50
1655892000,1.05192,1.05278,1.05152,1.05222,3548,2768.95,-759133,-764731.6,29.37033198827711,55.0339207217496,40.97019188335285,NaN,NaN,50
1655893800,1.05222,1.05269,1.05192,1.05202,2619,2786.3,-761752,-763894,27.34305181493918,53.70246636258613,42.138564128173115,NaN,NaN,50
1655895600,1.05202,1.05274,1.05175,1.05256,3840,2873.5,-757912,-761576.6,25.510317498196443,56.745295896989965,43.496383620922096,NaN,NaN,50
1655897400,1.05256,1.05292,1.05102,1.05116,3629,2912.05,-761541,-760603.8,24.574365908254386,47.946972585485874,44.753305598565916,NaN,NaN,50
1655899200,1.05116,1.05268,1.05112,1.05254,3452,3016.15,-758089,-759685.4,23.705268003308188,55.30359374291898,46.47145420652087,NaN,NaN,50
1655901000,1.05254,1.05356,1.0515,1.05308,4736,3141.7,-753353,-758529.4,22.188073119441672,57.815943476869585,48.646882295063676,NaN,NaN,50
1655902800,1.05308,1.055,1.05306,1.05428,5032,3307.45,-748321,-755843.2,22.096435441874444,62.81763262383047,50.073280515599684,NaN,NaN,50
1655904600,1.05428,1.05702,1.05364,1.05598,7303,3615.7,-741018,-752464.4,23.266489526874675,68.51333601551985,52.39542492019246,NaN,NaN,50
1655906400,1.05598,1.05694,1.05523,1.05666,5090,3826.35,-735928,-747341.8,24.35296832008918,70.46241730594133,54.88238720324983,NaN,NaN,50
1655908200,1.05666,1.06058,1.05654,1.05972,5575,4041.55,-730353,-741794.6,26.75523310615378,77.27853197185257,57.207319375214816,NaN,NaN,50
1655910000,1.05972,1.05972,1.05836,1.05932,3905,4166.8,-734258,-737975.6,28.985907550356625,74.84711062553527,59.13304716238071,NaN,NaN,50
1655911800,1.05932,1.05974,1.05798,1.05798,3843,4269.3,-738101,-735931.6,30.64004921208906,67.21732907567716,60.59594236596062,NaN,NaN,50
1655913600,1.05798,1.05896,1.05774,1.05866,3138,4288.9,-734963,-734720.6,31.909469095942995,68.94724878121949,62.146953457389394,NaN,NaN,50
1655915400,1.05866,1.05866,1.05702,1.0575,2363,4209.55,-737326,-735000.2,32.309806395263024,62.85400790025183,62.82041479188771,NaN,NaN,50
1655917200,1.0575,1.05833,1.0569,1.05826,2248,3995.75,-735078,-735945.2,32.55377667548185,65.03429640129349,63.53472734042656,NaN,NaN,50
1655919000,1.05826,1.05833,1.05755,1.05786,1598,3832.35,-736676,-736428.8,32.78032050711362,62.94036550378929,64.19457727908392,NaN,NaN,50
1655920800,1.05786,1.05846,1.05751,1.05766,2060,3717.8,-738736,-736555.8,33.064509914914225,61.867762529640785,64.5604677528447,NaN,NaN,50
1655922600,1.05766,1.05782,1.05655,1.0567,1927,3636.2,-740663,-737695.8,32.22080462816355,56.858953018172045,65.19703778375086,NaN,NaN,50
1655924400,1.0567,1.05748,1.05652,1.05694,1997,3581.35,-738666,-737963.8,31.404441172279036,57.77923495149825,65.37386929864938,NaN,NaN,50
1655926200,1.05694,1.05698,1.0566,1.0567,1580,3474.15,-740246,-738997.4,30.64638939181484,56.48168950513423,65.27856544352542,NaN,NaN,50
1655928000,1.0567,1.05684,1.05634,1.05646,1179,3355.7,-741425,-739947.2,29.624957503163163,55.14796849408883,64.73073229140101,NaN,NaN,50
1655929800,1.05646,1.05692,1.05646,1.05688,664,3257.95,-740761,-740352.2,28.748473883846632,57.058934082618485,63.91256072476521,NaN,NaN,50
1655931600,1.05688,1.05689,1.05658,1.0566,265,3079.2,-741026,-740424.8,27.934596237338422,55.36536718305468,62.834200001701866,NaN,NaN,50
1655933400,1.0566,1.05664,1.05644,1.05648,616,2928.55,-741642,-741020,26.978776866377125,54.6171704670328,61.21553132278617,NaN,NaN,50
1655935200,1.05648,1.05696,1.05648,1.05666,703,2791.1,-740939,-741158.6,26.429921718511462,55.58671213893399,59.83978857374321,NaN,NaN,50
1655937000,1.05666,1.05684,1.05656,1.05675,341,2571.35,-740598,-740993.2,25.920270509779066,56.091809544139565,59.04510860720482,NaN,NaN,50
1655938800,1.05675,1.05679,1.0561,1.05636,1032,2371.35,-741630,-741167,24.725451663173953,53.26491114040728,57.924941632861085,NaN,NaN,50
1655940600,1.05636,1.05659,1.05626,1.05648,1212,2066.8,-740418,-741045.4,23.61597701989778,54.032559619336865,57.294838184224304,NaN,NaN,50
1655942400,1.05648,1.05744,1.0563,1.0565,2153,1919.95,-738265,-740370,23.582036469008063,54.16768115875402,56.51865138118576,NaN,NaN,50
1655944200,1.0565,1.05753,1.05612,1.05744,2488,1765.6,-735777,-739337.6,23.252839046248198,60.10363045006806,56.316027448777106,NaN,NaN,50
1655946000,1.05744,1.05812,1.05694,1.05774,2916,1716.15,-732861,-737790.2,23.564789828897254,61.80389130730755,56.31146521861045,NaN,NaN,50
1655947800,1.05774,1.05776,1.05568,1.0558,3068,1677.4,-735929,-736650,22.058051081789827,47.65918464065635,55.65433890593075,NaN,NaN,50
1655949600,1.0558,1.0563,1.05559,1.05564,2451,1643.05,-738380,-736242.4,20.549639897923573,46.70969958064717,54.863657808012825,NaN,NaN,50
1655951400,1.05564,1.05772,1.05561,1.05707,2833,1666.55,-735547,-735698.8,20.580938410746132,55.2841079678244,54.77811626963354,NaN,NaN,50
1655953200,1.05707,1.0574,1.05666,1.05702,2159,1662.1,-737706,-736084.6,20.61000131550994,54.95117894156117,54.76405987302443,NaN,NaN,50
1655955000,1.05702,1.0575,1.05646,1.05694,1564,1660.4,-739270,-737366.4,20.3604446387259,54.38682736156787,54.5731951072351,NaN,NaN,50
1655956800,1.05694,1.05749,1.05662,1.05744,1770,1645.9,-737500,-737680.6,20.12871343885501,57.33599241800123,54.71395405258842,NaN,NaN,50
1655958600,1.05744,1.05748,1.05674,1.05674,1310,1615.05,-738810,-737766.6,19.91353446754632,52.24325007490024,54.54438831029324,NaN,NaN,50
1655960400,1.05674,1.05702,1.05646,1.0568,1658,1598.1,-737152,-738087.6,19.2704475117602,52.63162461677215,54.333310630138826,NaN,NaN,50
1655962200,1.0568,1.05733,1.0566,1.05702,1620,1600.1,-735532,-737652.8,19.051448988190025,54.10540787585146,54.191424796689674,NaN,NaN,50
1655964000,1.05702,1.05714,1.05576,1.05633,2606,1671.45,-738138,-737426.4,17.759807816099972,48.96023773675961,53.88394812500055,NaN,NaN,50
1655965800,1.05633,1.05794,1.05601,1.05778,3349,1805.7,-734789,-736884.2,17.371331168905606,57.99922824836787,54.16728159850277,NaN,NaN,50
1655967600,1.05778,1.05792,1.0528,1.05307,6226,2103.75,-741015,-737325.2,18.159175379122793,35.812807516787515,52.856219195505155,NaN,NaN,50
1655969400,1.05307,1.05307,1.04982,1.05077,7036,2424.75,-748051,-739505,20.25130937702576,29.815012285393948,50.692746469457006,NaN,NaN,50
1655971200,1.05077,1.05194,1.05026,1.05085,5419,2660.55,-742632,-740925,22.19400523222137,30.252562956165463,48.439080158661135,NaN,NaN,50
1655973000,1.05085,1.05114,1.04829,1.04937,5497,2918.35,-748129,-742923.2,24.63385092599069,26.91017361833204,46.957007942780834,NaN,NaN,50
1655974800,1.04937,1.0515,1.04915,1.05141,3461,3039.8,-744668,-744899,26.539093604541687,37.20813750101061,46.278324937092506,NaN,NaN,50
1655976600,1.05141,1.05188,1.05029,1.05181,3291,3143.75,-741377,-744971.4,27.92588298680343,39.022315396234724,45.116768324836094,NaN,NaN,50
1655978400,1.05181,1.05219,1.0505,1.05169,3065,3189.35,-744442,-744249.6,28.89934529017969,38.661437368686116,43.95321535534502,NaN,NaN,50
1655980200,1.05169,1.0517,1.05019,1.05047,2897,3209.8,-747339,-745191,29.934539719249408,35.10675082317316,42.57606703117398,NaN,NaN,50
1655982000,1.05047,1.05103,1.04956,1.05048,2663,3197.15,-744676,-744500.4,31.15612827237549,35.15937621603467,40.992023016747794,NaN,NaN,50
1655983800,1.05048,1.05156,1.04952,1.05055,3664,3226.95,-741012,-743769.2,31.711589205451222,35.55336043960426,39.79988804279809,NaN,NaN,50
1655985600,1.05055,1.0514,1.04904,1.05124,4413,3325.05,-736599,-742813.6,32.44989751816606,39.458364843615904,38.85894091614407,NaN,NaN,50
1655987400,1.05124,1.05185,1.04996,1.05044,4898,3428.3,-741497,-742224.6,32.63848244517495,36.6830499403163,37.61448677789156,NaN,NaN,50
1655989200,1.05044,1.05252,1.0504,1.05226,4827,3561.7,-736670,-740090.8,32.11093760932769,45.990110811059196,37.40233485462725,NaN,NaN,50
1655991000,1.05226,1.05441,1.05124,1.05439,7674,3867.2,-728996,-736954.8,30.000431421864004,54.43209490074018,37.147539615510986,NaN,NaN,50
1655992800,1.05439,1.05542,1.05134,1.05208,7024,4129.9,-736020,-735956.4,28.3660372347824,46.029317833787765,37.877290352439566,NaN,NaN,50
1655994600,1.05208,1.05328,1.05124,1.05288,6572,4393,-729448,-734526.2,26.772132551514012,48.96749109969043,39.24532455346075,NaN,NaN,50
1655996400,1.05288,1.0542,1.05134,1.0515,5711,4595.65,-735159,-733258.6,25.89513558515728,44.47009315193433,40.260862424587096,NaN,NaN,50
1655998200,1.0515,1.05232,1.05018,1.0502,4953,4762.3,-740112,-733947,24.1913678911297,40.679732762735036,41.244402363473014,NaN,NaN,50
1656000000,1.0502,1.05151,1.04942,1.0504,4567,4860.35,-735545,-735256.8,22.836964952602987,41.50576473977383,41.55137573767039,NaN,NaN,50
1656001800,1.0504,1.05118,1.05014,1.05086,4098,4897.8,-731447,-734342.2,21.579305081113894,43.45602519470854,41.868069294704235,NaN,NaN,50
1656003600,1.05086,1.052,1.05048,1.05122,3853,4779.15,-727594,-733971.4,20.27978052585371,45.00149243761732,42.32093037105646,NaN,NaN,50
1656005400,1.05122,1.05166,1.05066,1.0507,2688,4561.75,-730282,-732996,19.07307915311211,43.16620997255958,42.89660602458407,NaN,NaN,50
1656007200,1.0507,1.05154,1.05066,1.05104,3001,4440.85,-727281,-730429.8,17.952570735566344,44.75273539326873,43.58184596581507,NaN,NaN,50
1656009000,1.05104,1.05218,1.05097,1.05204,2456,4288.8,-724825,-728285.8,17.42217533689713,49.24081758088882,44.55952147590682,NaN,NaN,50
1656010800,1.05204,1.05338,1.05198,1.05308,2131,4222.3,-722694,-726535.2,17.759629190207463,53.47397119894014,45.56063621557284,NaN,NaN,50
1656012600,1.05308,1.05319,1.0525,1.05274,1855,4150.5,-724549,-725926.2,18.07297919685277,51.94867514064109,46.651038015596036,NaN,NaN,50
1656014400,1.05274,1.0531,1.05209,1.05212,732,4033.85,-725281,-724926,17.936947106925864,49.193093395624906,46.879822485922155,NaN,NaN,50
1656016200,1.05212,1.05239,1.05202,1.05212,362,3907.1,-725281,-724526,17.736629586747423,49.193093395624906,46.50560809269964,NaN,NaN,50
1656018000,1.05212,1.0527,1.05212,1.05236,126,3780.25,-725155,-724592,17.797937887099096,50.37485408307643,46.81600353907739,NaN,NaN,50
1656019800,1.05236,1.05238,1.05208,1.05226,311,3612.6,-725466,-725146.4,17.807113291286097,49.85451704534143,46.879362535195334,NaN,NaN,50
1656021600,1.05226,1.0528,1.05214,1.05253,601,3422,-724865,-725209.6,18.166935842932492,51.31669241342624,47.3684053395876,NaN,NaN,50
1656023400,1.05253,1.05272,1.05209,1.05266,491,3201.65,-724374,-725028.2,18.434158411229394,52.04178740467987,48.17998067115509,NaN,NaN,50
1656025200,1.05266,1.05286,1.05239,1.0528,582,2989.4,-723792,-724730.4,18.807647354559155,52.856134191096864,48.99072134624959,NaN,NaN,50
1656027000,1.0528,1.0528,1.05194,1.05196,979,2654.65,-724771,-724653.6,18.516921516436074,47.63019131699322,49.288876069269925,NaN,NaN,50
1656028800,1.05196,1.0526,1.05169,1.0519,2329,2419.9,-727100,-724980.4,17.90770943305074,47.27067573352954,49.45096059040652,NaN,NaN,50
1656030600,1.0519,1.05252,1.05122,1.05169,2172,2199.9,-729272,-725861.8,16.734503574989425,45.963010468475254,49.6507320544005,NaN,NaN,50
1656032400,1.05169,1.05306,1.05136,1.05255,2074,2018.05,-727198,-726426.6,16.259590896995523,51.8387962074414,50.156879255412825,NaN,NaN,50
1656034200,1.05255,1.05339,1.0523,1.05291,2084,1874.6,-725114,-726691,16.1676367518825,54.089288653893774,50.50319861777033,NaN,NaN,50
1656036000,1.05291,1.05312,1.05269,1.05292,1533,1722.9,-723581,-726453,16.08225075999184,54.1533756289701,50.55172750562961,NaN,NaN,50
1656037800,1.05292,1.05374,1.05292,1.05344,1489,1592.45,-722092,-725451.4,16.64601511096456,57.47739567169057,50.946636114990284,NaN,NaN,50
1656039600,1.05344,1.05345,1.05288,1.05321,1273,1463.45,-723365,-724270,17.104842695187244,55.55865121208113,51.40131881616573,NaN,NaN,50
1656041400,1.05321,1.05356,1.05308,1.05329,1182,1388.15,-722183,-723267,17.647223102580814,56.10750561637239,51.89520540336198,NaN,NaN,50
1656043200,1.05329,1.05386,1.0531,1.05381,1266,1301.4,-720917,-722427.6,18.465710863035493,59.60010074886645,52.55415159377556,NaN,NaN,50
1656045000,1.05381,1.05434,1.05352,1.05402,970,1227.1,-719947,-721700.8,19.68969176791497,60.95143773865256,53.346788786154924,NaN,NaN,50
1656046800,1.05402,1.05432,1.05386,1.05429,1360,1188.55,-718587,-720999.8,20.82624546530305,62.679882626439905,54.158445229941606,NaN,NaN,50
1656048600,1.05429,1.05467,1.0541,1.0543,1335,1162.55,-717252,-719777.2,22.212390510267863,62.745655729430055,54.92300725313805,NaN,NaN,50
1656050400,1.0543,1.05461,1.05346,1.05368,2375,1244.7,-719627,-719266,22.25706202522913,56.139480454978425,55.157531986272446,NaN,NaN,50
1656052200,1.05368,1.05421,1.05308,1.05346,1900,1321.6,-721527,-719388,21.653768166826264,53.96818022323957,55.61024547957576,NaN,NaN,50
1656054000,1.05346,1.05378,1.05232,1.05258,3469,1488.75,-724996,-720397.8,20.231441156147795,46.26076168177934,55.5381087615936,NaN,NaN,50
1656055800,1.05258,1.05318,1.05222,1.05236,2576,1602,-727572,-722194.8,19.04402781456575,44.54789694832583,55.437029224440074,NaN,NaN,50
1656057600,1.05236,1.05298,1.05192,1.05251,3528,1748.35,-724044,-723553.2,18.339538677485464,46.015579048250274,55.021085141640704,NaN,NaN,50
1656059400,1.05251,1.0546,1.05222,1.05444,3144,1881,-720900,-723807.8,18.336215893423134,60.501480509379476,55.47909884560397,NaN,NaN,50
1656061200,1.05444,1.05542,1.05398,1.05536,2878,1995.8,-718022,-723106.8,19.03712017326971,65.28366330443427,56.274119393851414,NaN,NaN,50
1656063000,1.05536,1.05542,1.0542,1.05533,2347,2064.2,-720369,-722181.4,19.687959861698673,65.00727134607507,56.811967656307445,NaN,NaN,50
1656064800,1.05533,1.0555,1.0542,1.0547,2570,2076.25,-722939,-721254.8,20.36141431922581,59.32690247470537,57.08112846078061,NaN,NaN,50
1656066600,1.0547,1.05474,1.05361,1.05378,2176,2076.45,-725115,-721469,20.095782500955654,52.15923605977407,56.799109206737874,NaN,NaN,50
1656068400,1.05378,1.05402,1.05258,1.05344,2065,2076,-727180,-722725,18.752274098066795,49.76626770462164,56.09669256072039,NaN,NaN,50
1656070200,1.05344,1.05374,1.0514,1.0516,3482,2145.9,-730662,-725253,18.628728960665626,39.267037462789496,54.547806826730174,NaN,NaN,50
1656072000,1.0516,1.05333,1.0516,1.0533,3243,2231.4,-727419,-726663,18.514008475935963,49.80383646274552,53.62808924360915,NaN,NaN,50
1656073800,1.0533,1.0534,1.05222,1.0523,3522,2333.05,-730941,-728263.4,18.316803042299924,44.872135555341316,52.35140923117423,NaN,NaN,50
1656075600,1.0523,1.0535,1.05158,1.05345,3484,2443.6,-727457,-728731.8,18.714425937478932,50.89424752083962,51.97674973587861,NaN,NaN,50
1656077400,1.05345,1.05458,1.05312,1.05343,5455,2657.25,-732912,-729878.2,17.76328690927425,50.790333163243375,51.7497606601646,NaN,NaN,50
1656079200,1.05343,1.05712,1.05343,1.0571,8712,3029.55,-724200,-728585.8,18.17370084012073,64.93752355544225,53.08381507971195,NaN,NaN,50
1656081000,1.0571,1.05712,1.05404,1.05433,5607,3261.4,-729807,-729063.4,18.55479949019247,52.637328439027854,53.66163161476209,NaN,NaN,50
1656082800,1.05433,1.05598,1.05424,1.05512,3920,3389.4,-725887,-728052.6,18.908676808116226,55.24124056832037,54.32060743762424,NaN,NaN,50
1656084600,1.05512,1.05591,1.05366,1.05382,2955,3470.4,-728842,-728329.6,18.597264815961758,50.33693166645131,53.59456823455794,NaN,NaN,50
1656086400,1.05382,1.05454,1.05372,1.05412,2340,3468.65,-726502,-727047.6,18.308096537532606,51.409024993754905,52.60352264093798,NaN,NaN,50
1656088200,1.05412,1.05486,1.0539,1.05468,1681,3457.7,-724821,-727171.8,18.310347954635127,53.42998125035094,51.77657334838626,NaN,NaN,50
1656090000,1.05468,1.05492,1.05425,1.05443,1402,3354.35,-726223,-726455,18.364222974765397,52.382552189448816,51.280548328010795,NaN,NaN,50
1656091800,1.05443,1.05453,1.05346,1.05388,1652,3308.15,-727875,-726852.6,17.463345991823186,50.057584863237516,51.130430385401034,NaN,NaN,50
1656093600,1.05388,1.0551,1.05388,1.05492,1143,3188.9,-726732,-726430.6,17.16493546974073,54.19735380837464,51.44693653566911,NaN,NaN,50
1656095400,1.05492,1.05523,1.05466,1.05488,1204,3091.9,-727936,-726717.4,17.0071029879635,54.01191208721561,52.500141865985256,NaN,NaN,50
1656097200,1.05488,1.0553,1.05452,1.05528,1090,3002.5,-726846,-727122.4,16.681186073442646,55.64625921561246,52.91745777690432,NaN,NaN,50
1656099000,1.05528,1.05594,1.05466,1.0559,1297,2950,-725549,-726987.6,16.985781892269706,58.13006492153347,53.86445273163233,NaN,NaN,50
1656100800,1.0559,1.0559,1.05496,1.05496,789,2860.95,-726338,-726680.2,17.26862086689483,53.26026070027666,54.033453673020695,NaN,NaN,50
1656102600,1.05496,1.05571,1.05494,1.05564,632,2783.75,-725706,-726475,17.500963216332526,56.12381421079923,54.414416604988965,NaN,NaN,50
1656277200,1.05564,1.05564,1.05516,1.05526,35,2682.25,-725741,-726036,17.716709683667535,54.12808751240121,53.642314030486034,NaN,NaN,50
1656279000,1.05526,1.05586,1.05526,1.05536,169,2516.6,-725572,-725781.2,18.160137464766247,54.58575188339693,53.781487133655254,NaN,NaN,50
1656280800,1.05536,1.05586,1.05528,1.05547,676,2388.25,-724896,-725650.6,18.57189183292934,55.11622937317052,53.772557762573115,NaN,NaN,50
1656282600,1.05547,1.05649,1.05542,1.05648,911,2257.7,-723985,-725180,19.63079224321851,59.76360011162111,54.44589122294239,NaN,NaN,50
1656284400,1.05648,1.05749,1.05638,1.05708,1383,2152.65,-722602,-724559.2,21.448894529409817,62.26334638892773,55.221199894026164,NaN,NaN,50
1656286200,1.05708,1.05739,1.05652,1.05666,1140,1936.9,-723742,-724159.4,23.13713236658745,59.47777525409097,55.6531851800076,NaN,NaN,50
1656288000,1.05666,1.05716,1.05633,1.05658,2098,1606.2,-725840,-724213,24.31897381818092,58.93690326836828,56.12135311421614,NaN,NaN,50
1656289800,1.05658,1.05701,1.05527,1.0556,2489,1450.3,-728329,-724899.6,23.592647576142557,52.62380186192901,56.30465432840838,NaN,NaN,50
1656291600,1.0556,1.05648,1.0556,1.05625,2363,1372.45,-725966,-725295.8,22.918201779964082,55.99100176152928,56.432772039347995,NaN,NaN,50
1656293400,1.05625,1.05654,1.05576,1.0561,2394,1344.4,-728360,-726447.4,22.36464079413489,55.01918269833026,56.504719940141904,NaN,NaN,50
1656295200,1.0561,1.05638,1.0559,1.05604,1871,1320.95,-730231,-727745.2,21.850619878722064,54.610871810677274,56.43076369693225,NaN,NaN,50
1656297000,1.05604,1.05668,1.05551,1.0556,2186,1346.2,-732417,-729060.6,20.698334887282186,51.587395715206235,55.963430182194585,NaN,NaN,50
1656298800,1.0556,1.05574,1.05523,1.05554,1417,1346.95,-733834,-730161.6,19.261887542294627,51.17135331837564,55.8142225120588,NaN,NaN,50
1656300600,1.05554,1.05566,1.05502,1.05566,1705,1349.6,-732129,-731394.2,18.254458460545102,52.00504270813291,55.520024547582636,NaN,NaN,50
1656302400,1.05566,1.05652,1.05548,1.05646,1432,1364.05,-730697,-731861.6,17.848248746208952,57.245883290508544,55.742724246018874,NaN,NaN,50
1656304200,1.05646,1.05654,1.05616,1.05648,1243,1366,-729454,-731706.2,17.49730742243558,57.371206950166325,55.941685322216685,NaN,NaN,50
1656306000,1.05648,1.05708,1.05642,1.05678,1760,1399.5,-727694,-730761.6,17.848796403326347,59.29847344235278,56.240417041444,NaN,NaN,50
1656307800,1.05678,1.05682,1.05585,1.0559,1898,1429.55,-729592,-729913.2,17.21180448069961,51.887913235461376,55.67786797886116,NaN,NaN,50
1656309600,1.0559,1.05626,1.05542,1.05592,2948,1537.5,-726644,-728816.2,15.983685543238332,52.03462582089538,54.94724508114456,NaN,NaN,50
1656311400,1.05592,1.05698,1.05566,1.05684,2848,1648.3,-723796,-727436,15.762484003336668,58.32946662059914,54.86522303589514,NaN,NaN,50
1656313200,1.05684,1.05842,1.05634,1.05816,3788,1835.95,-720008,-725546.8,16.91025013900174,65.35485159440513,55.323647916326344,NaN,NaN,50
1656315000,1.05816,1.05904,1.05789,1.05878,3172,1986.1,-716836,-723375.2,18.422043704240114,68.07720451331264,56.42746239142517,NaN,NaN,50
1656316800,1.05878,1.05912,1.05784,1.05811,2745,2089.55,-719581,-721373,19.881444134900995,62.373344867998284,56.88334404188724,NaN,NaN,50
1656318600,1.05811,1.05878,1.05751,1.05839,2619,2174.95,-716962,-719436.6,20.712131629636296,63.74061844485204,57.506303738067366,NaN,NaN,50
1656320400,1.05839,1.05884,1.05756,1.05784,2431,2227.35,-719393,-718556,21.533618279872364,59.19070959804922,57.83343500859394,NaN,NaN,50
1656322200,1.05784,1.05864,1.05681,1.05688,2408,2290.75,-721801,-718914.6,21.151558539365602,52.18822480246031,57.87635137196923,NaN,NaN,50
1656324000,1.05688,1.0581,1.05684,1.05798,2459,2308.8,-719342,-719415.8,20.79678878032361,58.27883971360727,58.38402897162863,NaN,NaN,50
1656325800,1.05798,1.05889,1.05791,1.05848,2362,2302.45,-716980,-718895.6,21.239615895960554,60.7277562813269,59.007079941142486,NaN,NaN,50
1656327600,1.05848,1.0586,1.05718,1.05719,2039,2286.25,-719019,-719307,20.618857842900727,52.21252080630545,58.6475540494137,NaN,NaN,50
1656329400,1.05719,1.05791,1.05645,1.05668,2328,2282.95,-721347,-719697.8,19.165026201899593,49.27103816988676,58.06897056510801,NaN,NaN,50
1656331200,1.05668,1.0574,1.05636,1.05677,2963,2337.55,-718384,-719014.4,17.87945030184426,49.80841575630407,57.391109301818815,NaN,NaN,50
1656333000,1.05677,1.05708,1.05536,1.05684,3609,2408.7,-714775,-718101,17.71617389668303,50.24984210361897,57.27410422097294,NaN,NaN,50
1656334800,1.05684,1.05857,1.05684,1.0583,2858,2480.75,-711917,-717088.4,16.90381785667397,58.456556795249114,57.732813576283924,NaN,NaN,50
1656336600,1.0583,1.05863,1.05741,1.05818,4311,2611.05,-716228,-716530.2,16.204093256843333,57.61530536891442,57.68180205830644,NaN,NaN,50
1656338400,1.05818,1.05862,1.05701,1.05741,4199,2749.4,-720427,-716346.2,15.130821293908584,52.403949133241014,56.75673759679471,NaN,NaN,50
1656340200,1.05741,1.05988,1.05722,1.0597,4705,2922.5,-715722,-715813.8,15.250219537655099,63.09513643430996,56.40087559115165,NaN,NaN,50
1656342000,1.0597,1.06151,1.05946,1.06095,3851,3027.05,-711871,-715233,16.43377739483613,67.39975869161185,56.75990514998119,NaN,NaN,50
1656343800,1.06095,1.06136,1.05994,1.06003,3064,3085.35,-714935,-715836.6,17.532795405075667,61.69588212585403,56.613852555767046,NaN,NaN,50
1656345600,1.06003,1.06047,1.05972,1.05988,2100,3042.95,-717035,-715998,18.29458161320585,60.79254426724461,56.72826931785244,NaN,NaN,50
1656347400,1.05988,1.06002,1.05934,1.05976,1797,2990.4,-718832,-715679,18.556664863930767,60.03523216275378,57.28876984358768,NaN,NaN,50
1656349200,1.05976,1.05992,1.05818,1.05886,2924,2947.2,-721756,-716885.8,17.59929886843188,54.54689756965647,57.02220254759119,NaN,NaN,50
1656351000,1.05886,1.0592,1.05844,1.05906,2087,2892.95,-719669,-718445.4,16.71031615832577,55.52002801525041,56.650221957157164,NaN,NaN,50
1656352800,1.05906,1.05942,1.0587,1.05916,2108,2861.1,-717561,-718970.6,16.08417423170764,56.026958861475556,56.92268181824074,NaN,NaN,50
1656354600,1.05916,1.05926,1.05796,1.05844,1772,2818.75,-719333,-719430.2,15.110505965393276,51.47789366014912,57.08031435325948,NaN,NaN,50
1656356400,1.05844,1.0589,1.05784,1.05872,1709,2782.65,-717624,-719188.6,14.321648673418478,53.07359857117623,57.31354169717891,NaN,NaN,50
1656358200,1.05872,1.05876,1.05787,1.05802,1984,2761.45,-719608,-718759,13.589138330870451,48.75669920283197,57.206888632836986,NaN,NaN,50
1656360000,1.05802,1.05836,1.05782,1.05808,913,2684.15,-718695,-718564.2,12.963293525588401,49.13857296907412,56.54131835953877,NaN,NaN,50
1656361800,1.05808,1.05835,1.05783,1.05823,466,2589.35,-718229,-718697.8,12.38215192068364,50.13896158001336,56.0072938031887,NaN,NaN,50
1656363600,1.05823,1.05857,1.05823,1.0584,97,2492.25,-718132,-718457.6,11.55128548390719,51.30787217956354,55.92900259221174,NaN,NaN,50
1656365400,1.0584,1.05862,1.05836,1.05847,196,2385.65,-717936,-718520,10.740483410116843,51.808852935195524,55.12283948513214,NaN,NaN,50
1656367200,1.05847,1.05858,1.05822,1.05828,590,2267,-718526,-718303.6,10.15690448921145,50.29620536197847,53.90115710444404,NaN,NaN,50
1656369000,1.05828,1.05828,1.05764,1.05798,746,2123.85,-719272,-718419,10.379214517107057,47.91729327446538,52.916972186487705,NaN,NaN,50
1656370800,1.05798,1.05821,1.05766,1.05776,612,2011.55,-719884,-718750,10.585645257295836,46.19187316276417,51.87406710759625,NaN,NaN,50
1656372600,1.05776,1.05812,1.05766,1.058,531,1822.55,-719353,-718994.2,10.777330944613986,48.37575692536864,51.041247447783014,NaN,NaN,50
1656374400,1.058,1.05856,1.0579,1.05828,2160,1720.6,-717193,-718845.6,10.192855653544692,50.88052124492559,50.77936342458795,NaN,NaN,50
1656376200,1.05828,1.05854,1.05706,1.05762,1710,1570.85,-718903,-718921,10.779377267205167,45.30106162910508,50.049437254149,NaN,NaN,50
1656378000,1.05762,1.05866,1.05762,1.05813,1880,1472.3,-717023,-718471.2,11.117965559210683,49.875150441638965,49.61002236701781,NaN,NaN,50
1656379800,1.05813,1.05834,1.05732,1.0575,2600,1449.1,-719623,-718419,11.803795502111862,44.88222448406437,49.13890314015462,NaN,NaN,50
1656381600,1.0575,1.05797,1.05716,1.05736,2350,1461.6,-721973,-718943,12.63400257658222,43.83211282115937,48.47879701515342,NaN,NaN,50
1656383400,1.05736,1.05816,1.05728,1.05768,1816,1462.55,-720157,-719535.8,13.036035897250112,46.890816190717466,48.34551965714524,NaN,NaN,50
1656385200,1.05768,1.0581,1.05758,1.05784,1652,1398.95,-718505,-719456.2,13.409352552156012,48.4037573503914,48.29303282723934,NaN,NaN,50
1656387000,1.05784,1.05848,1.05779,1.05812,1580,1373.6,-716925,-719436.6,13.008715829571369,51.032701086139724,48.35687136339122,NaN,NaN,50
1656388800,1.05812,1.0582,1.0578,1.058,1086,1322.5,-718011,-719114.2,12.636696015742771,49.86016867469106,48.25346397018604,NaN,NaN,50
1656390600,1.058,1.05804,1.05741,1.05756,1187,1293.25,-719198,-718559.2,12.918643860628285,45.712821055264065,47.81803312161951,NaN,NaN,50
1656392400,1.05756,1.05778,1.05743,1.05756,1130,1264.3,-719198,-718367.4,13.18045257373626,45.712821055264065,47.49064852828276,NaN,NaN,50
1656394200,1.05756,1.05777,1.05705,1.05712,1501,1240.15,-720699,-718806.2,14.002650590573307,41.69095244581234,47.045909897664686,NaN,NaN,50
1656396000,1.05712,1.05958,1.05708,1.05948,3838,1386.4,-716861,-718793.4,14.201875001666927,61.338626468295686,48.1278208480598,NaN,NaN,50
1656397800,1.05948,1.06063,1.05827,1.05828,3727,1549.45,-720588,-719308.8,15.409593109387373,51.78379562153105,48.37125218349997,NaN,NaN,50
1656399600,1.05828,1.05954,1.05822,1.05886,4379,1763.55,-716209,-718711,16.449127952689498,55.40001754621607,48.69407334787786,NaN,NaN,50
1656401400,1.05886,1.0594,1.05824,1.05842,3501,1928.8,-719710,-718813.4,17.414410307184326,52.20146067317695,49.186958993883,NaN,NaN,50
1656403200,1.05842,1.05896,1.05744,1.05876,4249,2111.75,-715461,-717765.8,17.01437837015978,54.39269830289205,49.509640983972496,NaN,NaN,50
1656405000,1.05876,1.05974,1.05856,1.05922,3339,2241.4,-712122,-716818,17.448434071104614,57.248264298756496,50.392929542164794,NaN,NaN,50
1656406800,1.05922,1.05972,1.05826,1.05844,2729,2347.25,-714851,-715670.6,17.409206814413647,51.374374129832745,50.93166249278432,NaN,NaN,50
1656408600,1.05844,1.05887,1.05812,1.05859,2710,2456.2,-712141,-714857,17.166894061497864,52.386135900532715,51.3241853291997,NaN,NaN,50
1656410400,1.05859,1.05906,1.05841,1.05896,2392,2467.8,-709749,-712864.8,17.155521359142252,54.880024581601994,51.786775845714736,NaN,NaN,50
1656412200,1.05896,1.05906,1.05776,1.05782,3114,2538,-712863,-712345.2,16.195572370122793,46.75444492603729,51.48118611999314,NaN,NaN,50
1656414000,1.05782,1.05882,1.05762,1.05836,2756,2581.8,-710107,-711942.2,15.114004137047369,50.49361213736505,51.52643208161271,NaN,NaN,50
1656415800,1.05836,1.05839,1.05637,1.05696,3359,2619.75,-713466,-711665.2,15.388197354339159,42.21627893744462,51.27667907319704,NaN,NaN,50
1656417600,1.05696,1.05708,1.05481,1.05568,4146,2709.55,-717612,-712759.4,16.85944940510535,36.34927512897709,50.607854364176546,NaN,NaN,50
1656419400,1.05568,1.05577,1.05329,1.05378,4217,2829.6,-721829,-715175.4,19.051762299537383,29.74184424401463,49.754346635476715,NaN,NaN,50
1656421200,1.05378,1.0542,1.05232,1.05296,4227,2958.35,-726056,-717814,21.501283523508782,27.424844514041183,47.331933638744246,NaN,NaN,50
1656423000,1.05296,1.05388,1.0526,1.05332,4242,3091.45,-721814,-720155.4,23.775838945767937,30.003009970081607,45.77616323506929,NaN,NaN,50
1656424800,1.05332,1.05344,1.0513,1.0517,4569,3265.6,-726383,-722738.8,26.376230094698727,25.596449488230462,43.647336945213176,NaN,NaN,50
1656426600,1.0517,1.05207,1.05032,1.05174,5439,3478.2,-720944,-723405.2,29.093245568848776,25.885894082522825,41.767653617309314,NaN,NaN,50
1656428400,1.05174,1.05316,1.05134,1.05251,4036,3623.5,-716908,-722421,30.289657073214897,31.416902219506568,40.126525325638916,NaN,NaN,50
1656430200,1.05251,1.0539,1.05246,1.05342,3532,3725.05,-713376,-719885,30.60593202478077,37.365972664551805,38.70636163748144,NaN,NaN,50
1656432000,1.05342,1.05414,1.0528,1.05391,3109,3688.6,-710267,-717575.6,30.649883846225993,40.36560615857167,37.92002106810565,NaN,NaN,50
1656433800,1.05391,1.05404,1.05215,1.05231,2679,3636.2,-712946,-714888.2,31.036398572142502,34.5474836375503,36.64583162074977,NaN,NaN,50
1656435600,1.05231,1.05252,1.05168,1.05208,2987,3566.6,-715933,-713886,31.63255945548927,33.79344026500212,35.13964702670691,NaN,NaN,50
1656437400,1.05208,1.05328,1.05182,1.05318,2169,3500,-713764,-713257.2,31.360200973950796,40.48401000502167,34.69175881806294,NaN,NaN,50
1656439200,1.05318,1.05344,1.05264,1.0532,2135,3394.3,-711629,-712907.8,30.93874478081607,40.601542847364435,33.985182440205755,NaN,NaN,50
1656441000,1.0532,1.0532,1.05203,1.05224,1878,3321.25,-713507,-713555.8,30.922530171132205,36.84074569108672,33.60121577975161,NaN,NaN,50
1656442800,1.05224,1.05282,1.05197,1.05259,1837,3276.65,-711670,-713300.6,30.94413747255353,39.05711376633201,33.79463282527696,NaN,NaN,50
1656444600,1.05259,1.05276,1.052,1.05258,1512,3216.75,-713182,-712750.4,30.9642013953019,39.0149874967013,34.45700020046887,NaN,NaN,50
1656446400,1.05258,1.0528,1.0519,1.05216,731,3133.7,-713913,-712780.2,31.05218286218069,37.20017479291585,35.155238077531344,NaN,NaN,50
1656448200,1.05216,1.05233,1.05198,1.05222,503,3003.15,-713410,-713136.4,31.133879938568132,37.646394302224635,35.701194101255844,NaN,NaN,50
1656450000,1.05222,1.05222,1.05194,1.05214,103,2870.5,-713513,-713137.6,31.241253108709728,37.26618002834328,36.534746282692474,NaN,NaN,50
1656451800,1.05214,1.05225,1.05213,1.0522,104,2707.75,-713409,-713485.4,31.29142892418181,37.77378325542907,37.383881223614345,NaN,NaN,50
1656453600,1.0522,1.05236,1.05178,1.05192,979,2549.4,-714388,-713726.6,31.6376309671489,36.29775761521209,37.732513751879026,NaN,NaN,50
1656455400,1.05192,1.05266,1.0519,1.05263,616,2369.35,-713772,-713698.4,31.43565372216114,42.439773210879494,38.09492807661672,NaN,NaN,50
1656457200,1.05263,1.0527,1.05219,1.05222,830,2199.5,-714602,-713936.8,31.17753273027694,40.03900796988164,38.07159963456743,NaN,NaN,50
1656459000,1.05222,1.05242,1.05206,1.05222,753,2025.05,-714602,-714154.6,31.07263440095836,40.03900796988164,38.463851372591094,NaN,NaN,50
1656460800,1.05222,1.05314,1.05208,1.05298,1811,1887.15,-712791,-714031,29.725404934270173,46.54033450524342,39.37434381832261,NaN,NaN,50
1656462600,1.05298,1.05304,1.05192,1.05211,1944,1712.4,-714735,-714100.4,28.670511790958436,41.05292223256364,39.41498040600418,NaN,NaN,50
1656464400,1.05211,1.0528,1.05174,1.05274,2179,1619.55,-712556,-713857.2,27.91272514221845,46.01660757605014,39.80177074376745,NaN,NaN,50
1656466200,1.05274,1.05328,1.05244,1.05294,2488,1567.35,-710068,-712950.4,26.40886114353867,47.52721024165737,40.565089640236785,NaN,NaN,50
1656468000,1.05294,1.05354,1.0529,1.05328,1905,1507.15,-708163,-711662.6,24.61208265070453,50.084383296655304,41.35275174954558,NaN,NaN,50
1656469800,1.05328,1.05356,1.05275,1.05285,1744,1460.4,-709907,-711085.8,23.166236603041433,46.966981127580745,41.9207512946084,NaN,NaN,50
1656471600,1.05285,1.053,1.05242,1.05274,1531,1387.6,-711438,-710426.4,22.298861883155162,46.175194524386754,42.56182413257061,NaN,NaN,50
1656473400,1.05274,1.0531,1.05262,1.05298,1162,1337.25,-710276,-709970.4,21.317401232725434,48.226027226996734,43.31751219862576,NaN,NaN,50
1656475200,1.05298,1.05324,1.05274,1.05283,1017,1281.35,-711293,-710215.4,20.15492547729468,47.020167914747525,44.014225619083206,NaN,NaN,50
1656477000,1.05283,1.05284,1.0501,1.05044,3389,1356.9,-714682,-711519.2,21.766451715427365,32.90312745065087,43.66632163302762,NaN,NaN,50
1656478800,1.05044,1.05151,1.05042,1.05124,2199,1375,-712483,-712034.4,23.262868936550575,39.45566838046056,43.89188668768822,NaN,NaN,50
1656480600,1.05124,1.05144,1.05021,1.05026,1970,1397.9,-714453,-712637.4,24.796871512509938,34.95260751607188,43.35708913805911,NaN,NaN,50
1656482400,1.05026,1.05046,1.04896,1.04944,3756,1549.15,-718209,-714224,26.949817101891526,31.69321156251833,42.760960823247444,NaN,NaN,50
1656484200,1.04944,1.04949,1.04861,1.04894,3849,1716.45,-722058,-716377,29.118668293544697,29.864466613479678,42.03420786921873,NaN,NaN,50
1656486000,1.04894,1.05185,1.04894,1.04984,5731,1997.85,-716327,-716706,28.021821873818105,36.92008638130637,41.34704728893752,NaN,NaN,50
1656487800,1.04984,1.05206,1.0493,1.05172,4802,2232.75,-711525,-716514.4,26.79331951468257,48.56105547202659,41.88334252032773,NaN,NaN,50
1656489600,1.05172,1.0519,1.05072,1.0515,4911,2429.35,-716436,-716911,25.65256732405671,47.457355342056545,41.98625307504248,NaN,NaN,50
1656491400,1.0515,1.05154,1.05031,1.05103,3560,2576.55,-719996,-717268.4,24.945435616058827,45.09910059394361,41.812816671634344,NaN,NaN,50
1656493200,1.05103,1.05286,1.05103,1.05136,4473,2758.7,-715523,-715961.4,23.368290414664582,47.087246760932096,41.59873549051127,NaN,NaN,50
1656495000,1.05136,1.05232,1.05086,1.05098,4149,2928.5,-719672,-716630.4,21.743465087441212,45.06353592617499,41.46277511898228,NaN,NaN,50
1656496800,1.05098,1.05264,1.05049,1.05242,4034,3039.65,-715638,-717453,20.495738623631592,53.261138627311404,41.968913983476895,NaN,NaN,50
1656498600,1.05242,1.05284,1.05156,1.0521,3127,3098.8,-718765,-717918.8,19.131975531182064,51.42472580061459,42.19739245302103,NaN,NaN,50
1656500400,1.0521,1.05352,1.05206,1.0532,2949,3137.3,-715816,-717082.8,18.328770510768287,56.92307092216167,42.904742667836324,NaN,NaN,50
1656502200,1.0532,1.05335,1.05118,1.05225,4143,3220.05,-719959,-717970,17.328748010236854,51.501194203186074,44.23317600730312,NaN,NaN,50
1656504000,1.05225,1.05274,1.05052,1.0512,4438,3346.7,-724397,-718915,16.972741005021575,46.25688730155674,44.71897735880999,NaN,NaN,50
1656505800,1.0512,1.05292,1.05062,1.05212,4581,3488.55,-719816,-719750.6,16.449426207016774,50.96810021679839,45.86294112314759,NaN,NaN,50
1656507600,1.05212,1.05266,1.04906,1.04934,5270,3675.5,-725086,-721014.8,17.14531630216628,39.65565082417377,46.43168678469441,NaN,NaN,50
1656509400,1.04934,1.04974,1.04742,1.04812,6240,3929.4,-731326,-724116.8,18.696801851403187,35.89085266456847,46.86214293120076,NaN,NaN,50
1656511200,1.04812,1.04924,1.04748,1.04766,6016,4179.35,-737342,-727593.4,20.13746700426603,34.55863295460024,46.69346768643602,NaN,NaN,50
1656513000,1.04766,1.04834,1.04671,1.04776,6100,4314.9,-731242,-728962.4,21.84862113467326,35.12241804338298,45.733565012961485,NaN,NaN,50
1656514800,1.04776,1.04792,1.04664,1.047,3600,4384.95,-734842,-731967.6,23.470702575107634,32.80900809612352,44.68725449539484,NaN,NaN,50
1656516600,1.047,1.04774,1.04671,1.04769,2980,4435.45,-731862,-733322.8,24.976921055510985,36.87432501681144,44.09977052559969,NaN,NaN,50
1656518400,1.04769,1.04772,1.0462,1.04622,2638,4379.55,-734500,-733957.6,26.63514614237589,32.37955787812942,43.04922131968521,NaN,NaN,50
1656520200,1.04622,1.04623,1.04446,1.04457,2342,4304.2,-736842,-733857.6,28.893207429114348,28.22129994131751,41.84620446362396,NaN,NaN,50
1656522000,1.04457,1.04538,1.04444,1.04516,2203,4127.8,-734639,-734537,30.99712685412408,31.603706655849805,40.299245037091,NaN,NaN,50
1656523800,1.04516,1.04516,1.04442,1.0449,1633,3969.35,-736272,-734823,32.95842619048993,30.91240273273874,38.83407910367129,NaN,NaN,50
1656525600,1.0449,1.04539,1.04452,1.04458,1373,3792.45,-737645,-735979.6,34.429893687624954,30.04141371433174,36.91396073168344,NaN,NaN,50
1656527400,1.04458,1.04468,1.0441,1.04414,1484,3688.65,-739129,-736905.4,35.98628762112675,28.838219483329823,35.295176823122276,NaN,NaN,50
1656529200,1.04414,1.04438,1.04352,1.04438,1465,3538.25,-737664,-737069.8,37.67701558877263,30.47392948004976,34.167822693014635,NaN,NaN,50
1656531000,1.04438,1.0445,1.04396,1.04411,890,3375.3,-738554,-737852.8,39.05092487405773,29.648279075967906,32.64497832581247,NaN,NaN,50
1656532800,1.04411,1.04438,1.04396,1.04426,688,3208,-737866,-738171.6,40.32669778182245,30.770481567175253,32.010323378883996,NaN,NaN,50
1656534600,1.04426,1.0443,1.04411,1.04416,478,3075.55,-738344,-738311.4,41.511344053318275,30.42208100612207,31.619696831852114,NaN,NaN,50
1656536400,1.04416,1.04452,1.04405,1.0441,576,2956.9,-738920,-738269.6,42.18688171511213,30.201126113216873,31.308446343181878,NaN,NaN,50
1656538200,1.0441,1.04428,1.04404,1.04416,295,2764.5,-738625,-738461.8,42.820647694238325,30.742832695310796,30.995618818319578,NaN,NaN,50
1656540000,1.04416,1.04439,1.0437,1.04434,2211,2653.15,-736414,-738033.8,43.63097900493922,32.43690206313423,30.969039815963203,NaN,NaN,50
1656541800,1.04434,1.04458,1.04432,1.04444,818,2465,-735596,-737579.8,43.97835916776053,33.41139470025141,30.72168765049463,NaN,NaN,50
1656543600,1.04444,1.04446,1.04409,1.04422,1355,2269.25,-736951,-737301.2,44.4692774074607,32.307371998471126,30.71653151623332,NaN,NaN,50
1656545400,1.04422,1.04468,1.04415,1.04458,756,1995.05,-736195,-736756.2,44.44008191666821,36.0322250709691,31.27445473977986,NaN,NaN,50
1656547200,1.04458,1.04465,1.04379,1.04409,1807,1784.6,-738002,-736631.6,44.70664562111909,33.34286502398844,31.39868033750405,NaN,NaN,50
1656549000,1.04409,1.04474,1.04409,1.04421,1537,1556.45,-736465,-736641.8,44.748803391145266,34.629657395485935,31.664198527700275,NaN,NaN,50
1656550800,1.04421,1.04434,1.0433,1.04432,2818,1517.35,-733647,-736252,45.3935731149708,35.85213293343206,32.07924990049315,NaN,NaN,50
1656552600,1.04432,1.04449,1.04372,1.04374,2999,1518.3,-736646,-736191,45.654863955911836,32.41049577100047,32.33441249246963,NaN,NaN,50
1656554400,1.04374,1.04559,1.04374,1.04559,2163,1494.55,-734483,-735848.6,43.8188587421351,49.17108672822652,33.66992372448225,NaN,NaN,50
1656556200,1.04559,1.04569,1.045,1.04524,1747,1464.8,-736230,-735494.2,41.953297787287184,46.80628238637209,34.895495389511126,NaN,NaN,50
1656558000,1.04524,1.04561,1.04488,1.04555,1212,1415.25,-735018,-735204.8,40.36010472056458,49.13944410866467,36.20756414247465,NaN,NaN,50
1656559800,1.04555,1.0456,1.04511,1.04518,1575,1412.35,-736593,-735794,38.88071115860788,46.51691614179043,37.35719522359382,NaN,NaN,50
1656561600,1.04518,1.0454,1.04498,1.04537,862,1386.8,-735731,-735611,37.672708707990274,48.05015804509318,38.6321260758707,NaN,NaN,50
1656563400,1.04537,1.04575,1.04526,1.04534,833,1354.25,-736564,-736027.2,35.87797954908879,47.81706490577576,39.85171409090391,NaN,NaN,50
1656565200,1.04534,1.0458,1.04504,1.04541,1642,1363.1,-734922,-735765.6,34.52186896351823,48.445503271959055,40.99518560581998,NaN,NaN,50
1656567000,1.04541,1.04568,1.04475,1.04559,1931,1415.15,-732991,-735360.2,33.653800387403784,50.1093469658408,42.1878964819335,NaN,NaN,50
1656568800,1.04559,1.0466,1.0454,1.04639,3131,1537.3,-729860,-734013.6,31.258364087462397,56.78485220723339,43.93628792541652,NaN,NaN,50
1656570600,1.04639,1.04688,1.04385,1.04406,4508,1738.8,-734368,-733741,30.805349738343274,39.99841984958048,44.21958755246019,NaN,NaN,50
1656572400,1.04406,1.04458,1.04299,1.04453,5890,2004.5,-728478,-732123.8,31.081822745915655,43.619055882664206,44.953601185222745,NaN,NaN,50
1656574200,1.04453,1.04568,1.04365,1.04454,5108,2245.15,-723370,-729813.4,29.877704128514864,43.69690277729409,45.60126156963761,NaN,NaN,50
1656576000,1.04454,1.04488,1.0434,1.04352,4084,2338.8,-727454,-728706,28.979158066678444,37.94227576199895,45.75055748596382,NaN,NaN,50
1656577800,1.04352,1.04682,1.04339,1.04416,5368,2566.3,-722086,-727151.2,27.604558100995813,43.013394705703064,46.50790740987115,NaN,NaN,50
1656579600,1.04416,1.04429,1.04255,1.04272,3811,2689.1,-725897,-725457,25.698051786029417,35.90420001374693,45.560272644551176,NaN,NaN,50
1656581400,1.04272,1.04335,1.04256,1.04296,3101,2806.35,-722796,-724320.6,23.927724493560625,37.750845705620144,44.91345573878318,NaN,NaN,50
1656583200,1.04296,1.04309,1.04119,1.04126,3362,2884.1,-726158,-724878.2,23.381452457107425,30.949048627896843,43.61414177587119,NaN,NaN,50
1656585000,1.04126,1.04174,1.04004,1.04006,3033,2958.9,-729191,-725225.6,23.609466234378125,27.220724404405274,42.235842366057966,NaN,NaN,50
1656586800,1.04006,1.04084,1.03919,1.03926,3753,3005.65,-732944,-727397.2,24.288736721018413,25.053847580824694,40.593248761467365,NaN,NaN,50
1656588600,1.03926,1.03954,1.03824,1.03936,4565,3083.95,-728379,-727893.6,25.382397655282023,25.84844926312573,39.0240619298495,NaN,NaN,50
1656590400,1.03936,1.04066,1.03846,1.04044,3714,3161.5,-724665,-728267.4,25.305571099342266,33.98851779853132,37.99142011031895,NaN,NaN,50
1656592200,1.04044,1.0415,1.03868,1.03979,6440,3396.15,-731105,-729256.8,24.512454633916573,31.730831676678307,36.678669018235915,NaN,NaN,50
1656594000,1.03979,1.04178,1.03978,1.0416,5114,3591.25,-725991,-728616.8,23.544701112327,43.070897516292334,35.69910082602585,NaN,NaN,50
1656595800,1.0416,1.04242,1.04092,1.04168,4829,3753.95,-721162,-726260.4,22.12898006145347,43.517479428054415,35.95046222448827,NaN,NaN,50
1656597600,1.04168,1.04324,1.04125,1.04229,4553,3938.5,-716609,-723906.4,20.894156776597452,46.93565325985287,36.187362037144595,NaN,NaN,50
1656599400,1.04229,1.04607,1.04191,1.04514,6385,4216.1,-710224,-721018.2,21.343855269668083,59.321915670707845,37.30343438667415,NaN,NaN,50
1656601200,1.04514,1.04652,1.04427,1.04615,5939,4430.95,-704285,-715654.2,21.962503872153377,62.64926081689705,39.068219033452586,NaN,NaN,50
1656603000,1.04615,1.04792,1.04537,1.04688,3969,4532.85,-700316,-710519.2,23.110322606591428,64.88497611347572,40.63047484829349,NaN,NaN,50
1656604800,1.04688,1.04766,1.04619,1.0474,2887,4520.65,-697429,-705772.6,24.176154288569617,66.42659782107881,42.81064612024576,NaN,NaN,50
1656606600,1.0474,1.04854,1.04694,1.04824,3041,4447.3,-694388,-701328.4,25.507348114992872,68.80879460079413,45.02907104132962,NaN,NaN,50
1656608400,1.04824,1.04888,1.04768,1.04854,2666,4286.1,-691722,-697628,26.87050558601997,69.63740024449213,47.79252472822929,NaN,NaN,50
1656610200,1.04854,1.04872,1.048,1.04802,2461,4153.75,-694183,-695607.6,28.136294666259413,66.34732436596923,50.587281868340995,NaN,NaN,50
1656612000,1.04802,1.0484,1.04781,1.04801,2405,4069.8,-696588,-694862,29.10759409730633,66.2824693778111,53.5321834252686,NaN,NaN,50
1656613800,1.04801,1.04822,1.04778,1.04805,2291,3915.95,-694297,-694235.6,29.975613378613662,66.42385183271978,56.430426465953886,NaN,NaN,50
1656615600,1.04805,1.04822,1.04676,1.04746,2081,3829.45,-696378,-694633.6,29.6795916384034,62.275875201063,58.45095199470615,NaN,NaN,50
1656617400,1.04746,1.04792,1.04736,1.04792,2672,3808,-693706,-695030.4,29.404714308208156,64.15531128802976,60.76698625265983,NaN,NaN,50
1656619200,1.04792,1.0485,1.04786,1.04843,1112,3695.5,-692594,-694712.6,29.505421856580732,66.16780963425327,62.41676568965703,NaN,NaN,50
1656621000,1.04843,1.0485,1.04814,1.04834,476,3567.65,-693070,-694009,29.59893600864098,65.46924742997176,63.98474911836542,NaN,NaN,50
1656622800,1.04834,1.04858,1.04804,1.04856,805,3420.25,-692265,-693602.6,29.561899167880462,66.40298299304264,65.37527267073611,NaN,NaN,50
1656624600,1.04856,1.04857,1.048,1.04804,1038,3243.9,-693303,-692987.6,29.47515418758963,62.126745597241005,65.57561766548848,NaN,NaN,50
1656626400,1.04804,1.04828,1.0474,1.0477,1230,3119.7,-694533,-693153,28.624347333052086,59.4317800794198,65.34579761281154,NaN,NaN,50
1656628200,1.0477,1.04796,1.04754,1.0477,685,2831.95,-694533,-693540.8,27.834312396695797,59.4317800794198,64.95628361037897,NaN,NaN,50
1656630000,1.0477,1.04787,1.04758,1.04776,691,2610.8,-693842,-693695.2,27.100708527222096,59.78877628344037,64.48215350054765,NaN,NaN,50
1656631800,1.04776,1.04796,1.04748,1.04784,975,2418.1,-692867,-693815.6,26.275161999758385,60.29053520134794,63.8737064005872,NaN,NaN,50
1656633600,1.04784,1.04786,1.04698,1.04726,2015,2291.2,-694882,-694131.4,24.809423122312072,54.9381817847636,62.82376222489232,NaN,NaN,50
1656635400,1.04726,1.04762,1.04667,1.04714,2551,2099.5,-697433,-694711.4,23.043977613332476,53.87256456635513,61.93270795349132,NaN,NaN,50
1656637200,1.04714,1.04738,1.04675,1.04686,2592,1932.15,-700025,-695809.8,21.404635354994276,51.368831072919384,60.867448074570476,NaN,NaN,50
1656639000,1.04686,1.04712,1.04641,1.047,2969,1882.15,-697056,-696452.6,20.324897155111117,52.55611711357267,59.87689559463139,NaN,NaN,50
1656640800,1.047,1.04728,1.04677,1.0469,1364,1806,-698420,-697563.2,19.08465917086518,51.58730372870186,59.11342620374846,NaN,NaN,50
1656642600,1.0469,1.04694,1.0462,1.04665,2567,1782.3,-700987,-698784.2,18.67609522487109,49.1480988838279,58.04148246059118,NaN,NaN,50
1656644400,1.04665,1.04676,1.04606,1.04613,2147,1756.35,-703134,-699924.4,18.467355489002184,44.44115716038088,56.489578712457444,NaN,NaN,50
1656646200,1.04613,1.0463,1.04501,1.04544,2302,1748.4,-705436,-701006.6,19.369645186640952,39.091295068265424,54.60543925804985,NaN,NaN,50
1656648000,1.04544,1.04565,1.04472,1.04492,2368,1746.55,-707804,-703156.2,20.460420849600183,35.61199074650226,52.40608266901125,NaN,NaN,50
1656649800,1.04492,1.04614,1.04477,1.04539,2100,1737,-705704,-704613,20.65081639967459,40.745484164594366,50.87884970953649,NaN,NaN,50
1656651600,1.04539,1.04616,1.04523,1.04615,2154,1740.65,-703550,-705125.6,20.79467544077632,47.96932092553732,50.06010262711631,NaN,NaN,50
1656653400,1.04615,1.04706,1.0457,1.04631,2411,1727.6,-701139,-704726.6,19.58234062453257,49.368766620143084,49.34131595145369,NaN,NaN,50
1656655200,1.04631,1.04702,1.04549,1.04564,3382,1841.1,-704521,-704543.6,18.711922707051578,44.02842313487078,48.21557644084157,NaN,NaN,50
1656657000,1.04564,1.04644,1.04408,1.04616,3999,2017.25,-700522,-703087.2,19.304724537265855,48.66937133893657,47.38549330781219,NaN,NaN,50
1656658800,1.04616,1.04635,1.04328,1.04448,6073,2280.65,-706595,-703265.4,20.45260512533326,37.77242780591415,46.15936802360866,NaN,NaN,50
1656660600,1.04448,1.04586,1.04435,1.04465,4844,2470.95,-701751,-702905.6,21.518494242824424,39.25456009396123,45.115224847009095,NaN,NaN,50
1656662400,1.04465,1.04575,1.04368,1.0455,4162,2617.55,-697589,-702195.6,22.97057239087145,46.15961245367709,44.7431378027775,NaN,NaN,50
1656664200,1.0455,1.04602,1.04518,1.0459,3422,2754.4,-694167,-700124.8,23.89688098671556,49.09227908809224,44.49572080095747,NaN,NaN,50
1656666000,1.0459,1.0468,1.04506,1.04546,4395,2939.6,-698562,-699732.8,23.643041937913402,46.116580192647874,44.104954834096475,NaN,NaN,50
1656667800,1.04546,1.04692,1.04544,1.04561,3439,3062.8,-695123,-697438.4,23.246991314082834,47.2895736354775,43.972203030642866,NaN,NaN,50
1656669600,1.04561,1.04687,1.0454,1.04652,3050,3114.55,-692073,-695502.8,22.918142267351588,53.85284262558176,44.64446627815722,NaN,NaN,50
1656671400,1.04652,1.04742,1.04481,1.04506,3462,3160.1,-695535,-695092,23.168103590017846,44.31824489814255,45.01781983743415,NaN,NaN,50
1656673200,1.04506,1.046,1.04452,1.04538,3957,3228.35,-691578,-694574.2,23.653270764771193,46.551859047007795,45.79923900175597,NaN,NaN,50
1656675000,1.04538,1.0454,1.04318,1.04362,4239,3291.85,-695817,-694025.2,25.070738911281104,37.61468795118047,45.57561070079784,NaN,NaN,50
1656676800,1.04362,1.04394,1.04154,1.04156,4290,3438.15,-700107,-695022,27.20635706688229,30.285755880581206,44.3124989118724,NaN,NaN,50
1656678600,1.04156,1.04223,1.04066,1.04066,3565,3488.05,-703672,-697341.8,29.52717097037298,27.742506743558152,42.76776606354491,NaN,NaN,50
1656680400,1.04066,1.04128,1.03926,1.04014,4100,3585.7,-707772,-699789.2,32.12113557967463,26.36490942229689,41.506086512646775,NaN,NaN,50
1656682200,1.04014,1.041,1.03962,1.03998,5418,3741.5,-713190,-704111.6,34.529817002597596,25.93811733187502,39.882425512142376,NaN,NaN,50
1656684000,1.03998,1.04134,1.03655,1.03731,9805,4113.35,-722995,-709547.2,37.44817170693985,20.092816589919437,38.61959613957133,NaN,NaN,50
1656685800,1.03731,1.03998,1.03684,1.03903,8075,4412.1,-714920,-712509.8,40.1580725038291,30.896467176414276,38.02258950260369,NaN,NaN,50
1656687600,1.03903,1.04065,1.0384,1.04031,5487,4578.75,-709433,-713662,41.84694481350403,37.652194118062894,37.414916764345534,NaN,NaN,50
1656689400,1.04031,1.042,1.04025,1.04074,4161,4666.25,-705272,-713162,41.94846759124724,39.78200621188858,36.749897273188125,NaN,NaN,50
1656691200,1.04074,1.0411,1.04014,1.04042,2790,4636.65,-708062,-712136.4,42.08682918676004,38.721915205827244,36.221706916986655,NaN,NaN,50
1656693000,1.04042,1.0413,1.03996,1.04014,3288,4601.1,-711350,-709807.4,42.00091889241892,37.773419205488366,35.541981600558856,NaN,NaN,50
1656694800,1.04014,1.04014,1.03934,1.03962,3002,4447.55,-714352,-709693.8,42.196059970369504,36.009317731590706,34.267444108130924,NaN,NaN,50
1656696600,1.03962,1.04126,1.03962,1.04108,2148,4312.75,-712204,-710248,41.215064677001145,43.92743425757309,34.23952906237596,NaN,NaN,50
1656698400,1.04108,1.04237,1.04108,1.04214,2006,4204.95,-710198,-711233.2,39.32111462712943,48.87380134855427,34.40538208391499,NaN,NaN,50
1656700200,1.04214,1.04325,1.04214,1.04238,1405,4104.1,-708793,-711379.4,36.87587437563133,49.950333883780715,35.286499650529294,NaN,NaN,50
1656702000,1.04238,1.04305,1.04218,1.04222,1523,3960.5,-710316,-711172.6,34.60529414209738,49.206460183029584,36.63797852927561,NaN,NaN,50
1656703800,1.04222,1.04296,1.0422,1.04286,1465,3861.8,-708851,-710072.4,32.496898210958705,52.26849822977145,38.389835064005126,NaN,NaN,50
1656705600,1.04286,1.04328,1.04272,1.04328,746,3746.6,-708105,-709252.6,30.26388539208455,54.218978584160965,40.379411432709695,NaN,NaN,50
1656707400,1.04328,1.0433,1.04253,1.04265,415,3594.25,-708520,-708917,28.351977034551627,50.86158458036985,42.15965909331647,NaN,NaN,50
1656882000,1.04265,1.04288,1.04176,1.04244,236,3408.2,-708756,-708909.6,27.20313947327741,49.75558180628518,44.2784280373426,NaN,NaN,50
1656883800,1.04244,1.04247,1.04232,1.04232,102,3201.35,-708858,-708618,26.136361737808496,49.09855711024095,45.57857731833021,NaN,NaN,50
1656885600,1.04232,1.04354,1.04214,1.04338,1277,3050.7,-707581,-708364,24.417737384027692,54.77908310380144,46.80192653159725,NaN,NaN,50
1656887400,1.04338,1.04366,1.04312,1.04366,587,2901.8,-706994,-708141.8,22.928164751257693,56.17051413260398,47.97253424021979,NaN,NaN,50
1656889200,1.04366,1.04372,1.04328,1.04371,956,2744.6,-706038,-707645.4,21.600897535644616,56.42833799044563,49.237278724835384,NaN,NaN,50
1656891000,1.04371,1.04374,1.04291,1.04326,1471,2547.25,-707509,-707396,20.128707705864386,53.38464875292334,50.352366549652174,NaN,NaN,50
1656892800,1.04326,1.04444,1.04324,1.04424,3070,2210.5,-704439,-706512.2,19.300943757221624,58.61942171392889,51.967373976962044,NaN,NaN,50
1656894600,1.04424,1.04436,1.04299,1.04341,1985,1906,-706424,-706280.8,18.260768247541435,53.173165083868774,52.62778332169745,NaN,NaN,50
1656896400,1.04341,1.0436,1.04264,1.04309,2150,1739.15,-708574,-706596.8,16.99320579635673,51.19816316782181,52.793809165930845,NaN,NaN,50
1656898200,1.04309,1.044,1.04304,1.04334,2550,1658.6,-706024,-706594,16.16006981955875,52.677005721799716,52.98857144007506,NaN,NaN,50
1656900000,1.04334,1.04371,1.0428,1.04286,1876,1612.9,-707900,-706672.2,15.114026401523223,49.57101944241974,53.014611387174355,NaN,NaN,50
1656901800,1.04286,1.0433,1.04264,1.04317,1613,1529.15,-706287,-707041.8,14.109929507584024,51.55761345761201,52.96383390344868,NaN,NaN,50
1656903600,1.04317,1.0439,1.04302,1.04374,1259,1442,-705028,-706762.6,13.696647129946522,55.062962111482264,53.02411844111448,NaN,NaN,50
1656905400,1.04374,1.04375,1.04243,1.0426,1423,1405.75,-706451,-706338,12.816259872475197,47.63830103529071,52.79388390218026,NaN,NaN,50
1656907200,1.0426,1.04291,1.04247,1.04282,848,1347.85,-705603,-706253.8,11.998757419108967,49.06565057483369,52.744603099933734,NaN,NaN,50
1656909000,1.04282,1.04288,1.04256,1.04276,709,1313.05,-706312,-705936.2,11.239647998126042,48.67593820247477,52.714416035093286,NaN,NaN,50
1656910800,1.04276,1.04318,1.04264,1.0429,1298,1301.8,-705014,-705681.6,10.728304443086147,49.680245490872736,52.35021334845552,NaN,NaN,50
1656912600,1.0429,1.04342,1.0428,1.04331,1319,1294.5,-703695,-705415,10.556893384512804,52.60518527391895,52.095547001406594,NaN,NaN,50
1656914400,1.04331,1.04388,1.04303,1.04339,2452,1379.8,-701243,-704373.4,10.946129338134313,53.17709513260171,51.863315368703454,NaN,NaN,50
1656916200,1.04339,1.0435,1.04218,1.04252,2723,1495.2,-703966,-704046,10.20467903321473,46.592531358277476,51.378164126228754,NaN,NaN,50
1656918000,1.04252,1.04381,1.0425,1.04377,3490,1657.9,-700476,-702878.8,9.816981569473402,55.17974330040874,51.13247281097732,NaN,NaN,50
1656919800,1.04377,1.04388,1.04286,1.04306,3089,1807.25,-703565,-702589,9.543727691950062,50.23866954734576,50.92286598693996,NaN,NaN,50
1656921600,1.04306,1.0431,1.04207,1.0428,2886,1887.7,-706451,-703140.2,9.45015554410165,48.52507695501127,50.731931257453496,NaN,NaN,50
1656923400,1.0428,1.0439,1.04241,1.04377,2294,1973.05,-704157,-703723,9.174086472803822,54.729077916941264,50.878507842820746,NaN,NaN,50
1656925200,1.04377,1.04411,1.0435,1.04398,2520,2051.25,-701637,-703257.2,9.152666559330088,55.96642722214004,51.33532268422933,NaN,NaN,50
1656927000,1.04398,1.04572,1.04371,1.04421,3915,2173.45,-697722,-702706.4,10.586706475022552,57.34164140844656,51.74846753786038,NaN,NaN,50
1656928800,1.04421,1.04518,1.04412,1.04514,2427,2141.3,-695295,-701052.4,11.918314968165555,62.448496608541596,52.27600571622175,NaN,NaN,50
1656930600,1.04514,1.04559,1.04486,1.04519,2233,2153.7,-693062,-698374.6,13.467659724034235,62.706989489047366,53.3523406057758,NaN,NaN,50
1656932400,1.04519,1.04628,1.04489,1.04599,2680,2180.2,-690382,-695619.6,15.38460612411334,66.66133105456879,54.60917492575688,NaN,NaN,50
1656934200,1.04599,1.04617,1.04507,1.04522,2640,2184.7,-693022,-693896.6,17.164627781329653,60.06019210100363,55.42233591850895,NaN,NaN,50
1656936000,1.04522,1.04582,1.04492,1.04549,2819,2231.85,-690203,-692392.8,18.568995242378197,61.499868319772354,56.266594692001775,NaN,NaN,50
1656937800,1.04549,1.04554,1.04454,1.04511,2007,2251.55,-692210,-691775.8,19.25377201330049,58.31394166761337,56.67436300583709,NaN,NaN,50
1656939600,1.04511,1.0457,1.04474,1.04526,2089,2293.05,-690121,-691187.6,20.03296326075224,59.21216551518259,57.10543946173572,NaN,NaN,50
1656941400,1.04526,1.04576,1.04441,1.0446,2350,2339.4,-692471,-691605.4,20.21342006216795,53.72661076461444,57.61501656218836,NaN,NaN,50
1656943200,1.0446,1.04474,1.04323,1.04332,2884,2441.2,-695355,-692072,18.77344412020185,45.01635926093039,56.88906055936848,NaN,NaN,50
1656945000,1.04332,1.04372,1.04224,1.04233,2992,2555.35,-698347,-693700.8,18.44564418362142,39.660715260933344,56.133492396053306,NaN,NaN,50
1656946800,1.04233,1.04349,1.04226,1.04296,2949,2637.9,-695398,-694338.4,18.141258528225304,44.209463580288244,55.825234297858806,NaN,NaN,50
1656948600,1.04296,1.043,1.04171,1.04276,1964,2670.15,-697362,-695786.6,18.373431803287335,43.098679008412326,54.99449151867817,NaN,NaN,50
1656950400,1.04276,1.04312,1.04224,1.0424,1520,2623.55,-698882,-697068.8,18.42122157620136,41.097055078149175,53.932393508393105,NaN,NaN,50
1656952200,1.0424,1.04249,1.04202,1.04236,1318,2553.3,-700200,-698037.8,18.678412215068622,40.86993025819744,52.75584271194674,NaN,NaN,50
1656954000,1.04236,1.0425,1.04184,1.04214,654,2411.5,-700854,-698539.2,19.09217316083668,39.57449229961807,51.121985261309355,NaN,NaN,50
1656955800,1.04214,1.04225,1.04194,1.04216,562,2285.15,-700292,-699518,19.476379753335596,39.76142248122849,49.48301618932229,NaN,NaN,50
1656957600,1.04216,1.0425,1.04216,1.04243,663,2174,-699629,-699971.4,19.404998729840724,42.35408568240001,47.74678437702452,NaN,NaN,50
1656959400,1.04243,1.04253,1.04223,1.04252,565,2087.55,-699064,-700007.8,19.286377093856228,43.23117680608496,46.544711855958894,NaN,NaN,50
1656961200,1.04252,1.04254,1.04214,1.04223,373,1980.2,-699437,-699855.2,19.291327821683087,41.06313117660089,45.08494491716093,NaN,NaN,50
1656963000,1.04223,1.0425,1.04214,1.04238,282,1798.55,-699155,-699515.4,19.295924926093747,42.66479251874903,43.9671485493849,NaN,NaN,50
1656964800,1.04238,1.04252,1.04218,1.04236,636,1709,-699791,-699415.2,19.25736645427775,42.49895404353084,42.77334772998121,NaN,NaN,50
1656966600,1.04236,1.04237,1.0422,1.04228,456,1620.15,-700247,-699538.8,19.221562159020042,41.79906863748481,41.92138043518624,NaN,NaN,50
1656968400,1.04228,1.04238,1.04225,1.04233,35,1487.9,-700212,-699768.4,19.163677127323695,42.43712039372492,41.7371490875287,NaN,NaN,50
1656970200,1.04233,1.04241,1.04224,1.04232,465,1379.15,-700677,-700016.4,19.03129552449158,42.33715209672266,41.92832314722794,NaN,NaN,50
1656972000,1.04232,1.04279,1.04224,1.04253,900,1283.2,-699777,-700140.8,17.965325146114196,45.25373840927538,42.002914206441304,NaN,NaN,50
1656973800,1.04253,1.04276,1.04234,1.04275,1095,1237.6,-698682,-699919,16.975495509049487,48.20916211227514,42.36794871386008,NaN,NaN,50
1656975600,1.04275,1.04365,1.04266,1.04326,1578,1212.05,-697104,-699290.4,17.21059811167674,54.3601100492629,43.315309783225345,NaN,NaN,50
1656977400,1.04326,1.04348,1.0431,1.04329,1276,1158.35,-695828,-698413.6,17.428907671259193,54.70092155087374,44.303237732702215,NaN,NaN,50
1656979200,1.04329,1.04358,1.04272,1.04298,2219,1125.1,-698047,-697887.6,16.739146307238162,50.504091884541324,45.08392341733959,NaN,NaN,50
1656981000,1.04298,1.04357,1.04283,1.04338,2362,1093.6,-695685,-697069.2,16.09865361207578,55.27260802066284,46.1918652415849,NaN,NaN,50
1656982800,1.04338,1.04357,1.04232,1.04291,2484,1070.35,-698169,-696966.6,15.465148977463997,49.26656063366051,46.68561345238923,NaN,NaN,50
1656984600,1.04291,1.04384,1.04274,1.04351,2824,1113.35,-695345,-696614.8,14.407260466396446,55.86049119003676,47.587707336957216,NaN,NaN,50
1656986400,1.04351,1.04357,1.04294,1.04302,1625,1118.6,-696970,-696843.2,13.424935420405149,50.130172500656414,48.23535314581833,NaN,NaN,50
1656988200,1.04302,1.04324,1.04284,1.04295,1694,1137.4,-698664,-696966.6,12.639364644008893,49.35131254329383,48.71296171900009,NaN,NaN,50
1656990000,1.04295,1.04319,1.04278,1.04308,1326,1171,-697338,-697297.2,12.045107091562976,50.8777138999583,49.311444565887776,NaN,NaN,50
1656991800,1.04308,1.04368,1.04306,1.04347,1489,1217.35,-695849,-696833.2,11.962197231986234,55.23617958405551,50.27123820492854,NaN,NaN,50
1656993600,1.04347,1.04378,1.04302,1.04372,1260,1247.2,-694589,-696682,12.082777343411676,57.81977237941877,51.36999906104953,NaN,NaN,50
1656995400,1.04372,1.04378,1.04298,1.04378,2238,1330.85,-692351,-695758.2,12.08763962491712,58.4397429439215,52.52018412156373,NaN,NaN,50
1656997200,1.04378,1.04446,1.04371,1.04428,1842,1404.3,-690509,-694127.2,13.312962016001576,63.28295328131514,53.80798518385229,NaN,NaN,50
1656999000,1.04428,1.04488,1.04424,1.04426,1829,1481.65,-692338,-693127.2,15.029867590188914,62.96686249699557,54.86210663990375,NaN,NaN,50
1657000800,1.04426,1.04428,1.04322,1.0436,2694,1584.55,-695032,-692963.8,14.362032364009067,53.474571714893955,54.798853901734546,NaN,NaN,50
1657002600,1.0436,1.04364,1.04299,1.0436,2411,1682.3,-695032,-693052.4,13.341650486255304,53.474571714893955,54.71125748487884,NaN,NaN,50
1657004400,1.0436,1.04398,1.0383,1.03856,6264,1993.75,-701296,-694841.4,16.2288151586924,22.900300049132994,52.739558068063964,NaN,NaN,50
1657006200,1.03856,1.03875,1.03656,1.0375,5850,2263,-707146,-698168.8,19.494056585495006,20.274728462633448,50.23970952820473,NaN,NaN,50
1657008000,1.0375,1.03757,1.03308,1.03354,6992,2567.6,-714138,-702528.8,23.27611218865951,13.874716222832674,47.71172064171702,NaN,NaN,50
1657009800,1.03354,1.03423,1.0306,1.03074,6926,2859.15,-721064,-707735.2,27.131991798254766,11.185984355819073,44.520684439272905,NaN,NaN,50
1657011600,1.03074,1.03249,1.02976,1.03095,5643,3062.4,-715421,-711813,30.80978967126034,12.554676953351603,41.836720471608274,NaN,NaN,50
1657013400,1.03095,1.03098,1.02804,1.02956,5568,3277,-720989,-715751.6,34.403118133475836,11.31203673031358,39.11962934210969,NaN,NaN,50
1657015200,1.02956,1.0303,1.02922,1.0296,4183,3375.2,-716806,-717683.6,37.73978027696166,11.583245861127779,36.312881625050366,NaN,NaN,50
1657017000,1.0296,1.03065,1.02916,1.02996,4044,3459.3,-712762,-717408.4,40.49132157571323,14.12841300084142,33.376612583392216,NaN,NaN,50
1657018800,1.02996,1.03036,1.02889,1.02931,3601,3515.15,-716363,-716468.2,43.083262508068024,13.379523199635187,30.20230907055053,NaN,NaN,50
1657020600,1.02931,1.03019,1.02862,1.02961,3397,3543.8,-712966,-715977.2,45.52808593626337,15.603057480525209,27.14254582316508,NaN,NaN,50
1657022400,1.02961,1.03012,1.02843,1.02962,5449,3735,-707517,-713282.8,47.82595165890564,15.68075611595016,23.742388882781864,NaN,NaN,50
1657024200,1.02962,1.02964,1.02843,1.02918,5293,3914.95,-712810,-712483.6,49.95968411564489,15.02529483750746,20.317991192818425,NaN,NaN,50
1657026000,1.02918,1.02937,1.0259,1.0263,5720,4134.65,-718530,-713637.2,52.273410253276175,11.605692565005086,17.32735696782637,NaN,NaN,50
1657027800,1.0263,1.02747,1.02544,1.02612,6680,4394.2,-725210,-715406.6,54.471353131490105,11.43059260719015,14.32421560299038,NaN,NaN,50
1657029600,1.02612,1.02668,1.02518,1.02582,5866,4624.5,-731076,-719028.6,56.54056248608259,11.129213672676414,13.48342371895777,NaN,NaN,50
1657031400,1.02582,1.0263,1.02383,1.02423,5138,4769.5,-736214,-724768,58.59850265455984,9.673463946881157,12.726190539261179,NaN,NaN,50
1657033200,1.02423,1.02468,1.02367,1.02441,3218,4838.3,-732996,-728805.2,60.524638073652106,11.091301751782623,12.527375219900458,NaN,NaN,50
1657035000,1.02441,1.02612,1.02402,1.02539,2948,4894.25,-730048,-731108.8,60.67810043999239,18.584331290363778,13.05582857236794,NaN,NaN,50
1657036800,1.02539,1.02554,1.02352,1.02408,2899,4904.5,-732947,-732656.2,60.938165802297796,16.573575584975416,13.342892760341067,NaN,NaN,50
1657038600,1.02408,1.02476,1.02382,1.02449,2397,4903.8,-730550,-732551,61.17965506729567,19.50890894035797,13.928383632487094,NaN,NaN,50
1657040400,1.02449,1.02574,1.02396,1.0252,2313,4706.25,-728237,-730955.6,60.33463446722534,24.46523486668589,14.848525704312673,NaN,NaN,50
1657042200,1.0252,1.0253,1.02462,1.02526,1772,4502.35,-726465,-729649.4,59.54997248144576,24.88616456372641,15.616936530233032,NaN,NaN,50
1657044000,1.02526,1.02659,1.02502,1.02652,2559,4280.7,-723906,-728421,57.51885434749079,33.293094983543114,17.03933451479788,NaN,NaN,50
1657045800,1.02652,1.02708,1.02602,1.02618,2770,4072.9,-726676,-727166.8,55.18731373450563,32.2443633306853,18.22799921838074,NaN,NaN,50
1657047600,1.02618,1.02667,1.02562,1.02623,2394,3910.45,-724282,-725913.2,53.23770263628981,32.58069691519765,19.43513784689842,NaN,NaN,50
1657049400,1.02623,1.02712,1.02622,1.02662,2048,3734.45,-722234,-724712.6,51.00369073364829,35.27934941945186,20.881856031323025,NaN,NaN,50
1657051200,1.02662,1.02678,1.02636,1.02658,699,3560.25,-722933,-724006.2,48.929251109766874,35.124057999872235,22.561739276670675,NaN,NaN,50
1657053000,1.02658,1.02694,1.02646,1.02652,514,3383.75,-723447,-723914.4,46.839513895231946,34.87607016471054,24.23641624506499,NaN,NaN,50
1657054800,1.02652,1.02682,1.02652,1.02668,180,3212.7,-723267,-723232.6,44.89904362459237,36.17027226232817,26.02506328718297,NaN,NaN,50
1657056600,1.02668,1.02682,1.02646,1.02655,397,3062.7,-723664,-723109,43.143624843456315,35.55206460630326,27.873534762855975,NaN,NaN,50
1657058400,1.02655,1.0271,1.02655,1.02674,1366,2858.55,-722298,-723121.8,41.17761329162209,37.2403961209329,29.741327217795284,NaN,NaN,50
1657060200,1.02674,1.02718,1.02674,1.02684,1014,2644.6,-721284,-722792,39.253874701345445,38.15864164639494,31.13949224322608,NaN,NaN,50
1657062000,1.02684,1.02694,1.02634,1.02641,988,2408,-722272,-722557,37.83597985949736,35.73731340912005,32.508330659236414,NaN,NaN,50
1657063800,1.02641,1.02647,1.02558,1.02568,1315,2139.75,-723587,-722621,37.15024533232982,32.02236143838795,33.40214869480998,NaN,NaN,50
1657065600,1.02568,1.02664,1.02538,1.02592,2059,1949.4,-721528,-722193.8,36.66789567222366,34.43545102450496,34.11430699179706,NaN,NaN,50
1657067400,1.02592,1.02674,1.02588,1.02664,2478,1816.4,-719050,-721544.2,36.071342477087825,41.18119015645357,35.278237391277564,NaN,NaN,50
1657069200,1.02664,1.02716,1.02552,1.02564,2894,1800.2,-721944,-721676.2,34.90029352396451,35.68898394282026,35.44937231694022,NaN,NaN,50
1657071000,1.02564,1.02668,1.02564,1.0262,3413,1823.45,-718531,-720928,33.81289092463571,40.476488451094205,36.03738125411228,NaN,NaN,50
1657072800,1.0262,1.02699,1.02598,1.02644,2608,1808.9,-715923,-719395.2,32.337322692566694,42.453682349485554,36.742594499418566,NaN,NaN,50
1657074600,1.02644,1.02688,1.02602,1.02654,1972,1787.65,-713951,-717879.8,30.967152191359755,43.29881771113822,37.31541366311045,NaN,NaN,50
1657076400,1.02654,1.02685,1.02627,1.02638,1843,1764.15,-715794,-717228.6,29.694851011667595,42.23016599031706,37.822992805285075,NaN,NaN,50
1657078200,1.02638,1.027,1.02626,1.02638,1690,1760.05,-715794,-715998.6,28.255731369081396,42.23016599031706,38.348285364256974,NaN,NaN,50
1657080000,1.02638,1.02662,1.02546,1.02557,1641,1714.15,-717435,-715779.4,27.91943129458406,36.885181178433015,38.3993502868359,NaN,NaN,50
1657081800,1.02557,1.02559,1.02394,1.02472,1937,1672.5,-719372,-716469.2,28.9206527735554,32.26951198916659,38.1648822427547,NaN,NaN,50
1657083600,1.02472,1.02524,1.02442,1.02456,1913,1648.45,-721285,-717936,29.85035843260021,31.471183604780762,37.75279563445812,NaN,NaN,50
1657085400,1.02456,1.02518,1.02426,1.02474,2360,1664.05,-718925,-718562.2,30.831965722190617,33.46540734192632,37.41756461271036,NaN,NaN,50
1657087200,1.02474,1.02606,1.02386,1.02569,4576,1857.9,-714349,-718273.2,30.260957100853375,42.90838127372018,37.92978374589608,NaN,NaN,50
1657089000,1.02569,1.02768,1.02496,1.02692,4159,2040.15,-710190,-716824.2,28.422449392683628,52.339914427442096,39.38103753082852,NaN,NaN,50
1657090800,1.02692,1.02739,1.0256,1.02684,5876,2324.95,-716066,-716163,26.715263663668864,51.741205081898656,40.617162820642356,NaN,NaN,50
1657092600,1.02684,1.02688,1.02536,1.02589,4904,2550.3,-720970,-716100,24.8548416540111,45.13814779792823,40.89980265217626,NaN,NaN,50
1657094400,1.02589,1.02744,1.02541,1.02563,4379,2700.95,-725349,-717384.8,23.728734185984948,43.50189236688693,41.457867539609595,NaN,NaN,50
1657096200,1.02563,1.02636,1.02264,1.02444,4722,2886.35,-730071,-720529.2,23.80855521345485,36.907429044470504,41.202934724850756,NaN,NaN,50
1657098000,1.02444,1.02446,1.0225,1.02309,5375,3105.7,-735446,-725580.4,23.97205396968661,31.140233659133983,40.3948312469685,NaN,NaN,50
1657099800,1.02309,1.02314,1.02206,1.02234,3965,3238.2,-739411,-730249.4,24.405482034903986,28.47785219264044,39.33619085279008,NaN,NaN,50
1657101600,1.02234,1.02274,1.02123,1.02204,3370,3303.75,-742781,-734611.6,25.296557358420994,27.466288874040075,38.28162820162744,NaN,NaN,50
1657103400,1.02204,1.02231,1.01862,1.01956,3805,3370.1,-746586,-738859,27.24549403573368,20.867417586908275,36.75571760138396,NaN,NaN,50
1657105200,1.01956,1.02012,1.01865,1.0192,3629,3406.85,-750215,-742887.8,29.055220950381184,20.112044682312643,35.55763642308965,NaN,NaN,50
1657107000,1.0192,1.01962,1.01801,1.01919,4394,3455.9,-754609,-746720.4,30.959455843223754,20.090289582765223,34.68769196548955,NaN,NaN,50
1657108800,1.01919,1.01934,1.01662,1.01689,5143,3582.65,-759752,-750788.6,33.151063074609596,15.844982325075051,33.57153473122485,NaN,NaN,50
1657110600,1.01689,1.01886,1.0167,1.01873,4570,3712.55,-755182,-753268.8,35.18612693232504,28.806047797263886,33.23872333517754,NaN,NaN,50
1657112400,1.01873,1.02008,1.01842,1.01916,3093,3775.05,-752089,-754369.4,35.69138719563668,31.462631066621398,32.421169748956196,NaN,NaN,50
1657114200,1.01916,1.02014,1.01764,1.01772,5379,3959.5,-757468,-755820,36.47509081500584,27.730803989194243,30.663376146224206,NaN,NaN,50
1657116000,1.01772,1.01877,1.01615,1.0177,8196,4287.25,-765664,-758031,37.71946927470715,27.6816938322942,28.94483962839531,NaN,NaN,50
1657117800,1.0177,1.01973,1.01722,1.01936,7798,4580.3,-757866,-757653.8,37.929563616277825,37.564950942914926,28.403896995894364,NaN,NaN,50
1657119600,1.01936,1.01956,1.01739,1.0174,5140,4741.65,-763006,-759218.6,38.12465121916488,32.00356676062481,27.58258802401849,NaN,NaN,50
1657121400,1.0174,1.0176,1.01615,1.01706,3567,4802,-766573,-762115.4,38.789550814055026,31.142260250011503,27.170790252985704,NaN,NaN,50
1657123200,1.01706,1.01736,1.01652,1.01734,3163,4731.35,-763410,-763303.8,39.40695758073874,32.747469938684446,27.285592844382162,NaN,NaN,50
1657125000,1.01734,1.01782,1.01696,1.01729,2906,4668.7,-766316,-763434.2,39.48736355987227,32.60131590834517,27.580125966932503,NaN,NaN,50
1657126800,1.01729,1.01894,1.0172,1.01871,2713,4510.55,-763603,-764581.6,38.46476014886848,40.69633046874831,28.525128937983087,NaN,NaN,50
1657128600,1.01871,1.01896,1.01822,1.01864,1915,4361.1,-765518,-765084,37.4964445886928,40.43848737815932,29.923062494501018,NaN,NaN,50
1657130400,1.01864,1.01988,1.0173,1.01859,8644,4574.35,-774162,-766601.8,36.59729442567253,40.24235905007814,31.360942092198552,NaN,NaN,50
1657132200,1.01859,1.01874,1.0177,1.01812,5437,4610.1,-779599,-769839.6,35.76236927429656,38.35903259595565,32.66585230742644,NaN,NaN,50
1657134000,1.01812,1.0188,1.01784,1.01874,2102,4446.45,-777497,-772075.8,34.91750138684449,42.20172454550154,34.54847675174262,NaN,NaN,50
1657135800,1.01874,1.01882,1.01768,1.01867,1661,4331.25,-779158,-775186.8,34.25200067328417,41.88425073171684,35.48263410420355,NaN,NaN,50
1657137600,1.01867,1.01886,1.01817,1.0183,1188,4222.15,-780346,-778152.4,33.58143510091172,40.16433693699639,36.10418452351605,NaN,NaN,50
1657139400,1.0183,1.01856,1.01816,1.01851,466,4055.2,-779880,-779296,32.96722544252061,41.629386907470746,37.09694044625008,NaN,NaN,50
1657141200,1.01851,1.01862,1.01824,1.01835,1659,3956.7,-781539,-779684,32.306891727263995,40.80952771568344,38.03464286649216,NaN,NaN,50
1657143000,1.01835,1.01836,1.0183,1.01834,84,3741.2,-781623,-780509.2,31.693724705954285,40.75550328282171,38.2625394621998,NaN,NaN,50
1657144800,1.01834,1.01886,1.01777,1.01828,806,3524.35,-782429,-781163.4,31.634368093063138,40.40984121364357,38.862987637415415,NaN,NaN,50
1657146600,1.01828,1.0188,1.01828,1.01876,558,3323.75,-781871,-781468.4,31.579251238235646,44.46760306143084,39.81479783823109,NaN,NaN,50
1657148400,1.01876,1.01882,1.01812,1.01857,998,3219,-782869,-782066.2,31.684784434325984,43.213232612479295,40.56235231493071,NaN,NaN,50
1657150200,1.01857,1.01874,1.01834,1.01847,1085,3004.3,-783954,-782549.2,31.7827795449813,42.53318228570128,41.27177134188473,NaN,NaN,50
1657152000,1.01847,1.01853,1.01761,1.0184,2212,2705.1,-786166,-783457.8,32.561255894660974,42.03451252107299,41.36735577419363,NaN,NaN,50
1657153800,1.0184,1.0189,1.018,1.01871,2167,2423.55,-783999,-783771.8,32.54252019849779,45.10405576562158,41.70061065901236,NaN,NaN,50
1657155600,1.01871,1.0188,1.0183,1.0184,2971,2315.1,-786970,-784791.6,32.52512276634626,42.67063053096217,41.874058621932654,NaN,NaN,50
1657157400,1.0184,1.01886,1.01805,1.01856,3048,2289.15,-783922,-785002.2,32.7698385851045,44.33976161905896,42.301253552154314,NaN,NaN,50
1657159200,1.01856,1.0194,1.01845,1.01916,1961,2229.05,-781961,-784603.6,31.91436797537103,50.19569486235678,42.87225143192969,NaN,NaN,50
1657161000,1.01916,1.021,1.0191,1.02038,2394,2203.45,-779567,-783283.8,30.413640982092538,59.52119271324441,44.1320330020388,NaN,NaN,50
1657162800,1.02038,1.02088,1.01994,1.02041,2073,2171.45,-777494,-781982.8,29.020108774048225,59.720916974539534,45.52893157614903,NaN,NaN,50
1657164600,1.02041,1.02078,1.02004,1.02038,1470,2149.2,-778964,-780381.6,27.726114580864227,59.40526194424693,46.79863693591876,NaN,NaN,50
1657166400,1.02038,1.02062,1.0201,1.02032,1161,1775.05,-780125,-779622.2,26.524548544336223,58.736595245690474,48.07914175949069,NaN,NaN,50
1657168200,1.02032,1.02032,1.01985,1.02018,940,1550.2,-781065,-779443,24.994764866235812,57.12096569081655,49.24810336006175,NaN,NaN,50
1657170000,1.02018,1.02156,1.02012,1.02074,2097,1549.95,-778968,-779323.2,25.053573455252863,61.663424627102096,50.76621646102307,NaN,NaN,50
1657171800,1.02074,1.02212,1.02048,1.02186,1806,1557.2,-777162,-779256.8,25.616653566889564,68.78564034079596,52.50321912383487,NaN,NaN,50
1657173600,1.02186,1.02186,1.02059,1.0213,3134,1654.5,-780296,-779523.2,26.139513670552212,62.53035152437912,53.88301333182771,NaN,NaN,50
1657175400,1.0213,1.02164,1.02005,1.02006,3263,1794.35,-783559,-780210,25.704753440135686,51.38688704742545,54.51542081480801,NaN,NaN,50
1657177200,1.02006,1.02053,1.01826,1.01857,4114,1917.1,-787673,-781531.6,24.640554863593174,41.75723917534826,54.49561557582767,NaN,NaN,50
1657179000,1.01857,1.01969,1.01822,1.01922,4317,2128.75,-783356,-782409.2,23.691538189943135,46.46991734484893,54.59317711720105,NaN,NaN,50
1657180800,1.01922,1.02132,1.01908,1.02054,4680,2322.45,-778676,-782712,22.87823054601177,54.5182867756577,55.43943827753645,NaN,NaN,50
1657182600,1.02054,1.02106,1.01853,1.01976,4265,2507.8,-782941,-783241,21.548063996779483,49.75754837794642,55.82642304602842,NaN,NaN,50
1657184400,1.01976,1.02066,1.01748,1.01895,6324,2774.1,-789265,-784382.2,20.661336077326666,45.33065360926593,55.47892009937907,NaN,NaN,50
1657186200,1.01895,1.02112,1.01882,1.02075,3815,2910.6,-785450,-783937.6,19.392588799701358,54.92741798339809,55.15079333296147,NaN,NaN,50
1657188000,1.02075,1.02176,1.02017,1.02072,3520,2976,-788970,-785060.4,18.37989772160242,54.75489881186373,54.7960777499132,NaN,NaN,50
1657189800,1.02072,1.02072,1.0185,1.01906,3651,3050.2,-792621,-787849.4,18.057758198954847,46.12248259415866,53.84730779633547,NaN,NaN,50
1657191600,1.01906,1.01973,1.01868,1.01938,3063,3054.8,-789558,-789172.8,17.758628642210674,47.82996825751378,53.0682630114657,NaN,NaN,50
1657193400,1.01938,1.01987,1.01866,1.01903,4056,3105.2,-793614,-790042.6,17.339910216673086,46.108751360151125,52.281676273561025,NaN,NaN,50
1657195200,1.01903,1.01966,1.01776,1.01898,4069,3210.6,-797683,-792489.2,17.625247726636687,45.85488348622946,51.152494763498694,NaN,NaN,50
1657197000,1.01898,1.01918,1.01696,1.01704,3623,3272.05,-801306,-794956.4,18.41281766256452,37.278579782396285,48.901990437898725,NaN,NaN,50
1657198800,1.01704,1.0177,1.0165,1.0173,4124,3374.6,-797182,-795868.6,19.421667271780777,38.92719286265385,47.21605053348976,NaN,NaN,50
1657200600,1.0173,1.01935,1.0172,1.01846,4629,3532.55,-792553,-796467.6,18.713091988583777,45.77528311597827,46.81522168124354,NaN,NaN,50
1657202400,1.01846,1.01854,1.01687,1.01758,4302,3689.6,-796855,-797115.8,18.288378771706316,41.93383038426371,46.82783533902322,NaN,NaN,50
1657204200,1.01758,1.01842,1.01696,1.01714,5020,3893.6,-801875,-797954.2,17.89400221317725,40.12086532719131,46.374331623476245,NaN,NaN,50
1657206000,1.01714,1.01756,1.01572,1.01602,3016,3939.55,-804891,-798671.2,18.374459071319563,35.869746571174815,45.04229303744175,NaN,NaN,50
1657207800,1.01602,1.01658,1.01516,1.01584,2332,3965.85,-807223,-800679.4,19.154364473893953,35.223782880463034,44.004166930478654,NaN,NaN,50
1657209600,1.01584,1.01682,1.01524,1.01524,2382,3928.25,-809605,-804089.8,19.621687354492572,33.08496453284545,43.129474853591475,NaN,NaN,50
1657211400,1.01524,1.01606,1.0151,1.01552,1994,3864.8,-807611,-806241,20.146774814272238,35.06648376114815,41.71083669485933,NaN,NaN,50
1657213200,1.01552,1.01596,1.01442,1.0151,1699,3744.05,-809310,-807728,21.06430393077357,33.465637509195375,40.19017517324016,NaN,NaN,50
1657215000,1.0151,1.0157,1.01491,1.01562,1421,3599.25,-807889,-808327.6,21.916295253239095,37.28314926280342,39.558794221000504,NaN,NaN,50
1657216800,1.01562,1.01668,1.01562,1.01658,1507,3440.6,-806382,-808159.4,21.55718330555389,43.70495450207796,39.26415038132652,NaN,NaN,50
1657218600,1.01658,1.01683,1.01566,1.01576,1403,3297.5,-807785,-807795.4,21.060340061265045,39.942783619046935,38.823724114104785,NaN,NaN,50
1657220400,1.01576,1.01596,1.01538,1.01596,1549,3058.75,-806236,-807520.4,20.829860944166896,41.27067837705648,38.496280892021,NaN,NaN,50
1657222200,1.01596,1.01668,1.01566,1.01661,1277,2931.85,-804959,-806650.2,19.817360254807816,45.48909882667482,39.0827465380409,NaN,NaN,50
1657224000,1.01661,1.01661,1.0157,1.01591,574,2784.55,-805533,-806179,18.8771810432601,41.99108633333234,39.301596071660796,NaN,NaN,50
1657225800,1.01591,1.01633,1.01571,1.01614,375,2620.75,-805158,-805934.2,18.00415748968008,43.52769754387453,39.14105424508195,NaN,NaN,50
1657227600,1.01614,1.01659,1.01614,1.01626,114,2473.3,-805044,-805386,16.88090158063859,44.35588114691206,39.3140578709854,NaN,NaN,50
1657229400,1.01626,1.01639,1.0162,1.01624,193,2280.15,-805237,-805186.2,15.837878236528638,44.23943258917766,39.60824124684158,NaN,NaN,50
1657231200,1.01624,1.01676,1.01611,1.01618,668,2110.1,-805905,-805375.4,15.007208318186146,43.86735773749456,40.17949918729299,NaN,NaN,50
1657233000,1.01618,1.01666,1.01609,1.01658,424,1950.15,-805481,-805365,14.208490812190188,47.06380063729083,41.02521474135211,NaN,NaN,50
1657234800,1.01658,1.01665,1.01626,1.01638,744,1781.15,-806225,-805578.4,13.46682455662251,45.663643703130184,41.92369182494388,NaN,NaN,50
1657236600,1.01638,1.01688,1.01623,1.01686,813,1590.35,-805412,-805652,13.09940889750741,49.54339320300722,42.957756785076675,NaN,NaN,50
1657238400,1.01686,1.01748,1.01674,1.01736,1701,1460.3,-803711,-805346.8,13.518689855446528,53.28519807302655,44.373439682493185,NaN,NaN,50
1657240200,1.01736,1.01873,1.01734,1.01869,1710,1294.8,-802001,-804566,15.104338826700506,61.47031477655021,46.101094362046524,NaN,NaN,50
1657242000,1.01869,1.01914,1.01832,1.01876,2027,1245.35,-799974,-803464.6,16.889149706315017,61.849197778070796,47.397111738903156,NaN,NaN,50
1657243800,1.01876,1.01892,1.01756,1.01768,2332,1245.35,-802306,-802680.8,17.349829598344925,53.16300299658676,48.34141312301313,NaN,NaN,50
1657245600,1.01768,1.01794,1.01728,1.01732,1404,1196.45,-803710,-802340.4,17.37853382469354,50.611432614901496,49.00860985428778,NaN,NaN,50
1657247400,1.01732,1.01742,1.01628,1.0165,2738,1233.65,-806448,-802887.8,16.15724935474036,45.280476900579494,48.993708288138116,NaN,NaN,50
1657249200,1.0165,1.01659,1.01572,1.01598,3229,1310.15,-809677,-804423,15.571417016835113,42.241874996001734,49.01162176404307,NaN,NaN,50
1657251000,1.01598,1.01634,1.01538,1.01584,2366,1357.4,-812043,-806836.8,15.362499365809096,41.435668052741164,48.86219108610498,NaN,NaN,50
1657252800,1.01584,1.01585,1.01398,1.01425,2462,1405.15,-814505,-809276.6,16.318675639893762,33.593848005132486,48.09347443312072,NaN,NaN,50
1657254600,1.01425,1.01551,1.01424,1.01546,1426,1406.3,-813079,-811150.4,17.20655360868667,42.51053858145969,47.969982003998005,NaN,NaN,50
1657256400,1.01546,1.01554,1.01478,1.01504,1859,1421.8,-814938,-812848.4,17.98907409483099,40.47878313390915,47.727940960884766,NaN,NaN,50
1657258200,1.01504,1.01617,1.01454,1.01602,2273,1471.6,-812665,-813446,17.85985458565865,46.86071286880452,47.71343469170717,NaN,NaN,50
1657260000,1.01602,1.01702,1.01525,1.01685,2817,1583.75,-809848,-813007,16.747402820511216,51.59452882083776,48.137069342972,NaN,NaN,50
1657261800,1.01685,1.01699,1.01577,1.01602,2609,1695.45,-812457,-812597.4,15.714411895731455,47.07806123566418,47.9609742024475,NaN,NaN,50
1657263600,1.01602,1.01644,1.01105,1.01135,4894,1934.45,-817351,-813451.8,17.791975196168824,30.761559110298762,46.352142847966945,NaN,NaN,50
1657265400,1.01135,1.01194,1.00716,1.01086,6730,2261.3,-824081,-815280.4,20.819557247349106,29.602255526631282,44.07585290154417,NaN,NaN,50
1657267200,1.01086,1.01136,1.00867,1.00994,5841,2519.95,-829922,-818731.8,23.630883437730795,27.506231038621607,41.62278384872637,NaN,NaN,50
1657269000,1.00994,1.01198,1.00968,1.01136,4904,2743.95,-825018,-821765.8,25.681078982010124,35.139916368751315,40.33542051816669,NaN,NaN,50
1657270800,1.01136,1.0122,1.01048,1.01156,3997,2906.6,-821021,-823478.6,27.384941031126818,36.15957703094491,39.30314511931265,NaN,NaN,50
1657272600,1.01156,1.01246,1.0114,1.01216,3382,3035.05,-817639,-823536.2,28.723071177916147,39.24534764380463,38.872064458114444,NaN,NaN,50
1657274400,1.01216,1.0146,1.01182,1.01402,3283,3114.15,-814356,-821591.2,28.207950039451813,47.68694013947661,39.26099768264836,NaN,NaN,50
1657276200,1.01402,1.01509,1.01365,1.01385,3298,3193.55,-817654,-819137.6,27.383568333830127,47.04356287513461,39.6615615985336,NaN,NaN,50
1657278000,1.01385,1.01478,1.01361,1.01388,3157,3250.05,-814497,-817033.4,26.638862073871827,47.17899756228826,40.631929424044735,NaN,NaN,50
1657279800,1.01388,1.01594,1.01368,1.01506,3509,3308.9,-810988,-815026.8,25.125667770624926,52.3418934821625,41.33416905980921,NaN,NaN,50
1657281600,1.01506,1.01689,1.0149,1.01557,4149,3446.15,-806839,-812866.8,23.542652853321247,54.41573031923461,42.32966528733245,NaN,NaN,50
1657283400,1.01557,1.01613,1.01156,1.0143,10133,3815.9,-816972,-813390,23.356230780116434,48.7292240185188,42.46313036945491,NaN,NaN,50
1657285200,1.0143,1.01692,1.01424,1.01652,6659,3987.4,-810313,-811921.8,22.700973556155983,57.1573549708801,42.860475094457925,NaN,NaN,50
1657287000,1.01652,1.01778,1.0134,1.01428,7914,4264.8,-818227,-812667.8,21.591601432239614,48.49496448321096,42.9616824692827,NaN,NaN,50
1657288800,1.01428,1.01694,1.01357,1.01645,5518,4417.6,-812709,-813012,20.561470174317268,55.52668408661676,44.730619967591124,NaN,NaN,50
1657290600,1.01645,1.01818,1.01644,1.01736,4749,4583.75,-807960,-813236.2,19.29364111695248,58.109501601518545,46.76685183008307,NaN,NaN,50
1657292400,1.01736,1.01912,1.01711,1.01843,4035,4692.55,-803925,-810626.8,18.606915647391457,60.97908424837728,49.157769916494196,NaN,NaN,50
1657294200,1.01843,1.01861,1.01736,1.01784,3149,4736.35,-807074,-809979,17.969241997084794,58.595553345006515,50.83317255765527,NaN,NaN,50
1657296000,1.01784,1.01786,1.01608,1.01613,2734,4732.2,-809808,-808295.2,16.780826854522743,52.22408524887458,51.98063743036454,NaN,NaN,50
1657297800,1.01613,1.01706,1.01585,1.01674,2731,4738.3,-807077,-807168.8,15.811604474396484,54.139793064279374,53.04452638896988,NaN,NaN,50
1657299600,1.01674,1.01726,1.01639,1.01679,2619,4624.55,-804458,-806468.4,14.78235635805652,54.30154393980812,53.51699808899356,NaN,NaN,50
1657301400,1.01679,1.01688,1.01636,1.01656,1576,4366.85,-806034,-806890.2,13.846516047790121,53.369057176563196,53.96881911052417,NaN,NaN,50
1657303200,1.01656,1.01706,1.01654,1.01696,1215,4135.55,-804819,-806439.2,12.867600392775206,54.822083670640346,54.514753832549324,NaN,NaN,50
1657305000,1.01696,1.01778,1.01694,1.0174,1361,3958.4,-803458,-805169.2,12.469798249702361,56.43036002402407,54.80678715696801,NaN,NaN,50
1657306800,1.0174,1.01774,1.01718,1.01758,1233,3820.2,-802225,-804198.8,12.100410545420436,57.10312694160346,54.99874405856578,NaN,NaN,50
1657308600,1.01758,1.01798,1.01736,1.01786,976,3699.9,-801249,-803557,11.93591890659691,58.18477337027912,55.67414044083437,NaN,NaN,50
1657310400,1.01786,1.01836,1.01768,1.01836,650,3568.25,-800599,-802470,12.066338636140134,60.11863907322946,55.88566073385933,NaN,NaN,50
1657312200,1.01836,1.01864,1.01816,1.01854,537,3430.2,-800062,-801518.6,12.395023749133225,60.82111447039929,56.7661000186585,NaN,NaN,50
1657486800,1.01854,1.01854,1.01766,1.01812,64,3275.55,-800126,-800852.2,12.193046978307851,58.2432037462529,56.96013713720394,NaN,NaN,50
1657488600,1.01812,1.01834,1.01809,1.01812,60,3103.1,-800126,-800432.4,12.00549711968429,58.2432037462529,56.96968729039924,NaN,NaN,50
1657490400,1.01812,1.01836,1.01716,1.01752,1194,2955.35,-801320,-800446.6,11.37282805191727,54.421513846548315,56.50128940455431,NaN,NaN,50
1657492200,1.01752,1.01778,1.01724,1.01748,951,2496.25,-802271,-800781,10.785349631847895,54.16634178711304,56.18491715041906,NaN,NaN,50
1657494000,1.01748,1.01759,1.01683,1.01703,1009,2213.75,-803280,-801424.6,10.627330552533335,51.25472881149264,56.11567740489179,NaN,NaN,50
1657495800,1.01703,1.01724,1.0165,1.01674,1517,1893.9,-804797,-802358.8,10.782982655845839,49.41140550016896,55.77793543602676,NaN,NaN,50
1657497600,1.01674,1.01676,1.01565,1.01577,2816,1758.8,-807613,-803856.2,11.636408838148283,43.74445978177786,55.02385799616745,NaN,NaN,50
1657499400,1.01577,1.0162,1.01535,1.01546,2109,1626.8,-809722,-805536.6,12.657749154663641,42.08331888297329,54.217733832339604,NaN,NaN,50
1657501200,1.01546,1.01553,1.01456,1.01476,2913,1570.7,-812635,-807609.4,14.16281624718565,38.525733297090646,53.05370880565748,NaN,NaN,50
1657503000,1.01476,1.01476,1.0135,1.01398,3107,1568.6,-815742,-810101.8,16.185135709835457,34.97747612889289,51.521359956005256,NaN,NaN,50
1657504800,1.01398,1.01473,1.0139,1.0147,2208,1542.3,-813534,-811849.2,18.063003782295993,40.431343326262635,50.33051826919519,NaN,NaN,50
1657506600,1.0147,1.01525,1.01445,1.01496,1895,1500.5,-811639,-812654.4,19.095938526571267,42.31301611091404,49.196821322097676,NaN,NaN,50
1657508400,1.01496,1.01563,1.01496,1.01522,1453,1442.2,-810186,-812747.2,19.561885745426558,44.21086068211898,48.06055143701837,NaN,NaN,50
1657510200,1.01522,1.01527,1.0146,1.01496,1302,1428.5,-811488,-812517.8,20.262717810896184,42.69808044079591,46.766049006332416,NaN,NaN,50
1657512000,1.01496,1.01543,1.0148,1.01506,1466,1441.05,-810022,-811373.8,20.69550651257463,43.4988644378426,45.712881912874536,NaN,NaN,50
1657513800,1.01506,1.01548,1.01484,1.0151,1260,1436,-808762,-810419.4,21.026316394160663,43.83696156830439,44.68386461444964,NaN,NaN,50
1657515600,1.0151,1.01522,1.01475,1.01513,1432,1445.95,-807330,-809557.6,21.41370559770999,44.107100324684936,43.9471207914594,NaN,NaN,50
1657517400,1.01513,1.01514,1.0138,1.01398,1818,1488.05,-809148,-809350,22.54038054216871,36.799995528134716,42.706667487246655,NaN,NaN,50
1657519200,1.01398,1.01441,1.01318,1.01336,3271,1619.1,-812419,-809536.2,24.00408977074204,33.570917281487155,41.44353809224627,NaN,NaN,50
1657521000,1.01336,1.01418,1.01196,1.01275,2911,1737.8,-815330,-810597.8,26.03349603283503,30.71524951430382,40.10809837897019,NaN,NaN,50
1657522800,1.01275,1.01375,1.0115,1.01178,4212,1945.2,-819542,-812753.8,28.131021167092236,26.80985023192386,38.89848341112347,NaN,NaN,50
1657524600,1.01178,1.01245,1.01056,1.0111,3577,2121.05,-823119,-815911.6,30.464953105967556,24.461729536145413,37.639798457778625,NaN,NaN,50
1657526400,1.0111,1.01224,1.01066,1.01198,3533,2238,-819586,-817999.2,32.6321756206375,32.679125595738014,37.222183621967716,NaN,NaN,50
1657528200,1.01198,1.01324,1.01183,1.01185,2932,2337.05,-822518,-820019,33.15006448846493,32.12318153104566,37.0183054364072,NaN,NaN,50
1657530000,1.01185,1.01254,1.01136,1.01156,3039,2438.55,-825557,-822064.4,33.89629091494136,30.861870360123973,36.33477165311158,NaN,NaN,50
1657531800,1.01156,1.01192,1.01021,1.01028,3220,2523.7,-828777,-823911.4,35.15331996339049,26.007819827941987,35.17011477575643,NaN,NaN,50
1657533600,1.01028,1.01103,1.00958,1.01065,2953,2530.55,-825824,-824452.4,36.584926932045335,29.461519644761665,34.1165904159452,NaN,NaN,50
1657535400,1.01065,1.0115,1.01018,1.01128,2230,2536.6,-823594,-825254,37.273954477352746,35.02289997988363,33.56836324016575,NaN,NaN,50
1657537200,1.01128,1.01186,1.00958,1.00962,2297,2505.8,-825891,-825928.6,38.196317948747996,28.619980346010635,32.5055858050349,NaN,NaN,50
1657539000,1.00962,1.01005,1.00826,1.009,3173,2509.1,-829064,-826630,39.5809258096752,26.659568375938207,31.278629148437314,NaN,NaN,50
1657540800,1.009,1.01042,1.00856,1.00905,3888,2593.1,-825176,-825909.8,40.38393386616854,27.093287456473305,30.063356800707915,NaN,NaN,50
1657542600,1.00905,1.00973,1.00749,1.0081,4077,2702.2,-829253,-826595.6,41.54344867430148,24.168747882009498,29.16112482598469,NaN,NaN,50
1657544400,1.0081,1.00826,1.0056,1.00638,4932,2876.15,-834185,-828713.8,43.18749239707698,19.96645524950607,28.18937753798604,NaN,NaN,50
1657546200,1.00638,1.0076,1.0052,1.00694,5662,3094.15,-828523,-829240.2,44.81550835199423,24.56528824968089,27.750094590512976,NaN,NaN,50
1657548000,1.00694,1.0081,1.00621,1.00641,4843,3263,-833366,-830100.6,45.72063788317009,23.20618673913637,27.492690055313865,NaN,NaN,50
1657549800,1.00641,1.00932,1.00629,1.00818,4451,3422.55,-828915,-830848.4,45.227952605145695,35.950779420249475,28.31333647560701,NaN,NaN,50
1657551600,1.00818,1.00914,1.00786,1.00822,3364,3519.15,-825551,-830108,44.77045913269447,36.20843195091951,28.565429786691404,NaN,NaN,50
1657553400,1.00822,1.00889,1.00736,1.00854,3123,3584.4,-822428,-827756.6,44.57867013008343,38.34522256820114,29.009861289345366,NaN,NaN,50
1657555200,1.00854,1.00876,1.00672,1.00688,2835,3562.6,-825263,-827104.6,44.68384615634468,32.30080065906061,29.112642024983696,NaN,NaN,50
1657557000,1.00688,1.00718,1.00626,1.00638,2268,3530.45,-827531,-825937.6,44.97547383458546,30.72954712410366,29.44990826042382,NaN,NaN,50
1657558800,1.00638,1.00728,1.00603,1.00668,2002,3419.95,-825529,-825260.4,45.34283886256962,32.840489772492134,29.69126326954742,NaN,NaN,50
1657560600,1.00668,1.00734,1.00644,1.00706,1846,3333.4,-823683,-824886.8,45.6050566769253,35.52085931020089,29.72683179314151,NaN,NaN,50
1657562400,1.00706,1.00732,1.00612,1.00656,2015,3257.5,-825698,-825540.8,45.9962298496508,33.61956091589866,30.083944690990656,NaN,NaN,50
1657564200,1.00656,1.00718,1.00596,1.00632,1869,3204.35,-827567,-826001.6,46.43412964660785,32.71438802419598,30.516431808723354,NaN,NaN,50
1657566000,1.00632,1.00658,1.00448,1.00468,2149,3159.85,-829716,-826438.6,47.44090570410711,27.30447147234551,30.531516381285652,NaN,NaN,50
1657567800,1.00468,1.00528,1.00337,1.00454,2201,3108.9,-831917,-827716.2,48.725812244063,26.895586030284534,30.726290534733867,NaN,NaN,50
1657569600,1.00454,1.00468,1.00411,1.00444,1000,3011.25,-832917,-829563,49.918939745450615,26.58929704619655,31.199350663068905,NaN,NaN,50
1657571400,1.00444,1.00446,1.0039,1.00393,631,2931.3,-833548,-831133,51.09232868103175,25.0241180700406,31.232124221666023,NaN,NaN,50
1657573200,1.00393,1.004,1.00384,1.00388,111,2822,-833659,-832351.4,52.201360195783344,24.869553606278487,31.350936140747603,NaN,NaN,50
1657575000,1.00388,1.00392,1.00374,1.00386,205,2673.6,-833864,-833181,53.26531769032672,24.8035588325902,30.55470609877194,NaN,NaN,50
1657576800,1.00386,1.00464,1.0038,1.00462,743,2516.35,-833121,-833421.8,53.06051889349829,32.16960107546559,30.26621817909666,NaN,NaN,50
1657578600,1.00462,1.00462,1.0039,1.00402,716,2348.3,-833837,-833605.8,52.870348582157604,29.696380879755267,29.6484437727791,NaN,NaN,50
1657580400,1.00402,1.0047,1.00398,1.0044,841,2143.75,-832996,-833495.4,52.55717873512449,33.19918536484094,29.71261410890627,NaN,NaN,50
1657582200,1.0044,1.00478,1.00428,1.00459,889,1905.1,-832107,-833185,52.123120226687305,34.944512489137736,30.013683063551557,NaN,NaN,50
1657584000,1.00459,1.00556,1.00389,1.0039,1833,1754.6,-833940,-833200.2,50.420486885804095,31.704841959455592,29.932565362620377,NaN,NaN,50
1657585800,1.0039,1.00492,1.00354,1.00402,2020,1633.05,-831920,-832960,49.129517632100104,32.87044973421699,29.74325039290724,NaN,NaN,50
1657587600,1.00402,1.00416,1.0006,1.00134,4499,1689.8,-836419,-833476.4,49.56758632295689,23.304305612848196,29.00644644268935,NaN,NaN,50
1657589400,1.00134,1.00312,1.00134,1.00284,4579,1762.6,-831840,-833245.2,49.974364393038194,34.75024198202759,29.151864582534465,NaN,NaN,50
1657591200,1.00284,1.00309,1.00146,1.00206,3189,1780.3,-835029,-833829.6,50.35208688668512,32.0700380179282,29.49226219293323,NaN,NaN,50
1657593000,1.00206,1.00276,1.0019,1.00254,2867,1810.25,-832162,-833474,50.7028292022144,35.373374471562556,30.097818510167375,NaN,NaN,50
1657594800,1.00254,1.00288,1.00182,1.00246,2283,1824.3,-834445,-833979,50.826052469418705,35.06729993583116,30.703390145141277,NaN,NaN,50
1657596600,1.00246,1.0027,1.0019,1.00262,2165,1840.25,-832280,-833151.2,50.94047407467984,36.25528121354054,31.505616083962703,NaN,NaN,50
1657598400,1.00262,1.00262,1.00131,1.00158,2088,1843.9,-834368,-833656.8,51.3671052885116,32.13923947810794,32.02487936052195,NaN,NaN,50
1657600200,1.00158,1.00164,1.00088,1.00155,1868,1843.85,-836236,-833898.2,51.97532151767854,32.026289094544566,32.540788664947264,NaN,NaN,50
1657602000,1.00155,1.00174,1.00049,1.00137,2772,1875,-839008,-835267.4,52.72078811664724,31.315169228926052,32.47975781876586,NaN,NaN,50
1657603800,1.00137,1.00182,1.00088,1.00108,2991,1914.5,-841999,-836778.2,53.253629708063585,30.153495850133126,32.51240888807857,NaN,NaN,50
1657605600,1.00108,1.00272,1.00089,1.00253,4381,2083.55,-837618,-837845.8,52.11576802095078,41.782388142449605,33.1254948007649,NaN,NaN,50
1657607400,1.00253,1.00393,1.00198,1.00224,4654,2284.7,-842272,-839426.6,49.37964512379484,40.33594750127542,33.510597301631876,NaN,NaN,50
1657609200,1.00224,1.00298,1.00044,1.00128,7115,2634.9,-849387,-842056.8,48.00916913044978,35.904785647407735,33.81059327934275,NaN,NaN,50
1657611000,1.00128,1.00158,1.0003,1.00086,4564,2852.85,-853951,-845045.4,46.82767843314895,34.137836366768056,33.90112089595353,NaN,NaN,50
1657612800,1.00086,1.0011,1.00018,1.00069,3613,2996.35,-857564,-848158.4,45.811761601781456,33.420910359651984,34.62373552072523,NaN,NaN,50
1657614600,1.00069,1.00178,1.00062,1.00106,3563,3138.7,-854001,-851435,43.99790860775745,36.54443916676065,34.75189246249188,NaN,NaN,50
1657616400,1.00106,1.00136,1.00009,1.00048,4269,3310.1,-858270,-854634.6,42.72072000724961,33.862564595806774,34.87993007519749,NaN,NaN,50
1657618200,1.00048,1.00144,1,1.00129,3336,3432.45,-854934,-855744,41.60298238968284,40.43668604064207,35.2415951872746,NaN,NaN,50
1657620000,1.00129,1.00276,1.00102,1.00135,3406,3511.1,-851528,-855259.4,39.026001109209446,40.90527280695355,35.65859324949763,NaN,NaN,50
1657621800,1.00135,1.00238,1.00063,1.0021,2500,3535.1,-849028,-853552.2,36.97853621805682,46.56424797862425,36.394948018432174,NaN,NaN,50
1657623600,1.0021,1.00694,1.00182,1.00528,5134,3566.85,-843894,-851530.8,36.686774159961686,62.82109166836731,38.58650888916499,NaN,NaN,50
1657625400,1.00528,1.00611,1.00346,1.004,5490,3612.4,-849384,-849753.6,36.41585224887335,55.501653311650784,40.26332061895829,NaN,NaN,50
1657627200,1.004,1.00476,1.00333,1.00387,5290,3717.45,-854674,-849701.6,36.04284371022011,54.80326529322899,41.9410417664085,NaN,NaN,50
1657629000,1.00387,1.00554,1.0033,1.00532,4384,3793.3,-850290,-849454,36.07172868133935,60.737659334840494,44.12562487245903,NaN,NaN,50
1657630800,1.00532,1.00588,1.00386,1.0041,4342,3896.25,-854632,-850574.8,36.255623889291904,54.27985993548929,45.018301429104724,NaN,NaN,50
1657632600,1.0041,1.00556,1.00334,1.00476,6289,4102.45,-848343,-851464.6,35.892416812631986,56.94672753331753,46.204785717107725,NaN,NaN,50
1657634400,1.00476,1.00593,1.0044,1.00508,5346,4265.35,-842997,-850187.2,35.75021836287056,58.2192369250073,47.79867509407912,NaN,NaN,50
1657636200,1.00508,1.00636,1.00414,1.00497,5336,4438.75,-848333,-848919,35.84153477245589,57.589117823979535,49.47376662673709,NaN,NaN,50
1657638000,1.00497,1.00739,1.00486,1.007,3663,4483.3,-844670,-847795,36.415543536620476,65.09685034256199,51.73633376837352,NaN,NaN,50
1657639800,1.007,1.00716,1.00618,1.00687,2598,4463.65,-847268,-846322.2,36.948551674773306,64.311698842158,53.71970945947333,NaN,NaN,50
1657641600,1.00687,1.00726,1.00604,1.00642,1975,4343.35,-849243,-846502.2,37.27025614985679,61.54452308434823,55.696992208654855,NaN,NaN,50
1657643400,1.00642,1.00673,1.00614,1.0062,1456,4183.45,-850699,-848042.6,37.56898173386289,60.18118874178194,57.10731383016485,NaN,NaN,50
1657645200,1.0062,1.00644,1.0053,1.00548,1980,3926.7,-852679,-848911.8,36.78565969036971,55.82286408664013,58.172856064428174,NaN,NaN,50
1657647000,1.00548,1.0059,1.00524,1.00586,1319,3764.45,-851360,-850249.8,35.98584694342811,57.56938552471329,58.95893731772025,NaN,NaN,50
1657648800,1.00586,1.00624,1.00517,1.0053,1414,3654.5,-852774,-851351,35.49089164414019,54.170560497583395,58.341042234092825,NaN,NaN,50
1657650600,1.0053,1.00549,1.00424,1.00449,1586,3555.65,-854360,-852374.4,33.9184583289759,49.60836585685204,57.920093130178635,NaN,NaN,50
1657652400,1.00449,1.00472,1.0042,1.00425,1645,3424.45,-856005,-853435.6,32.41327069434431,48.310112553513704,57.45629650591325,NaN,NaN,50
1657654200,1.00425,1.0046,1.00322,1.00326,2113,3363.3,-858118,-854523.4,30.21174537971551,43.278726679959206,56.20922988770745,NaN,NaN,50
1657656000,1.00326,1.00416,1.00317,1.00328,730,3229.5,-857388,-855729,28.216540393426428,43.40695740698901,55.432593992814574,NaN,NaN,50
1657657800,1.00328,1.00377,1.00328,1.00374,396,3124.3,-856992,-856572.6,26.36385004901513,46.40791138506526,54.67982141079655,NaN,NaN,50
1657659600,1.00374,1.00374,1.00328,1.0035,125,2873.85,-857117,-857124,24.643494729204647,45.06522096557365,53.74024884226558,NaN,NaN,50
1657661400,1.0035,1.0036,1.00344,1.0036,207,2609.7,-856910,-857305,23.04602193223777,45.76926976296154,52.89597398076429,NaN,NaN,50
1657663200,1.0036,1.0039,1.00253,1.00294,915,2390.95,-857825,-857246.4,22.581376102634557,41.94810032199996,51.24249183643844,NaN,NaN,50
1657665000,1.00294,1.00329,1.0029,1.00312,327,2188.1,-857498,-857268.4,22.149919260860145,43.33751281410182,49.744335691577284,NaN,NaN,50
1657666800,1.00312,1.00336,1.00258,1.0033,1021,2022.05,-856477,-857165.4,22.084175739464257,44.761293019439016,48.54553354408377,NaN,NaN,50
1657668600,1.0033,1.00342,1.00298,1.00302,854,1750.3,-857331,-857208.2,21.92600320363574,42.953230837521936,47.314965122350905,NaN,NaN,50
1657670400,1.00302,1.00396,1.00272,1.00292,2488,1607.4,-859819,-857790,20.939590157417996,42.296121056982805,46.3487691916611,NaN,NaN,50
1657672200,1.00292,1.00358,1.00282,1.00302,2169,1449.05,-857650,-857755,20.023635185930093,43.23138687726315,45.32462643112894,NaN,NaN,50
1657674000,1.00302,1.00454,1.00255,1.00287,3039,1417.85,-860689,-858393.2,19.312332917965364,42.1283737225972,44.46447023291564,NaN,NaN,50
1657675800,1.00287,1.0033,1.00229,1.00272,2779,1426.9,-863468,-859791.4,18.284254710271643,41.001775982530056,43.849713813321216,NaN,NaN,50
1657677600,1.00272,1.00312,1.0023,1.00298,2396,1447.95,-861072,-860539.6,17.329610660270337,43.806850036793385,43.52805220498404,NaN,NaN,50
1657679400,1.00298,1.00417,1.00296,1.00402,2439,1497.1,-858633,-860302.4,17.663222786696544,53.359306492869045,44.24809362019189,NaN,NaN,50
1657681200,1.00402,1.00417,1.00356,1.00386,2057,1500.95,-860690,-860910.4,17.973005475520875,51.89763236110961,44.85457040262907,NaN,NaN,50
1657683000,1.00386,1.00472,1.00344,1.00368,2012,1535.6,-862702,-861313,18.808866209237948,50.23059284608723,45.127619078416366,NaN,NaN,50
1657684800,1.00368,1.00404,1.00332,1.00401,1071,1518.45,-861631,-860945.6,19.375715987482867,53.19871804782285,45.70858315571987,NaN,NaN,50
1657686600,1.00401,1.00404,1.00331,1.00358,1146,1496.45,-862777,-861286.6,19.883754189523287,49.090474534149756,45.9458120679476,NaN,NaN,50
1657688400,1.00358,1.00376,1.00311,1.00337,2002,1514.3,-864779,-862515.8,19.978118783820634,47.174465629651294,46.31912387563698,NaN,NaN,50
1657690200,1.00337,1.00408,1.00321,1.00374,2334,1525.35,-862445,-862866.8,20.443624043040717,50.81683416492618,46.853361114981574,NaN,NaN,50
1657692000,1.00374,1.00507,1.003,1.00403,4299,1703.8,-858146,-861955.6,21.835652012401106,53.52184979582993,47.47911517043808,NaN,NaN,50
1657693800,1.00403,1.00469,1.00328,1.00334,3648,1866.4,-861794,-861988.2,23.12824941252146,46.910913593656964,47.76180679587629,NaN,NaN,50
1657695600,1.00334,1.00531,1.00074,1.00104,5834,2151.85,-867628,-862958.4,22.145286507555426,32.50029594195655,47.062105001945845,NaN,NaN,50
1657697400,1.00104,1.00354,1.00063,1.00326,4609,2371.95,-863019,-862606.4,21.33718646407718,48.837287589638954,47.462526481401255,NaN,NaN,50
1657699200,1.00326,1.00428,1.00244,1.00306,3792,2515.8,-866811,-863479.6,19.869337733042077,47.71680962114224,47.861700474154475,NaN,NaN,50
1657701000,1.00306,1.0048,1.00233,1.00366,3847,2691.8,-862964,-864443.2,19.027230358657228,51.32480075977281,48.599059386814666,NaN,NaN,50
1657702800,1.00366,1.00404,1.00321,1.00342,2675,2774.5,-865639,-865212.2,18.245273511014158,49.84312452443952,49.03022185021797,NaN,NaN,50
1657704600,1.00342,1.00414,1.00335,1.00372,2341,2848.85,-863298,-864346.2,17.62507117497159,51.719386675986314,48.91308472044063,NaN,NaN,50
1657706400,1.00372,1.00612,1.00353,1.00542,2735,2861.2,-860563,-863855,18.70231186257016,60.692628922908284,49.54129876056911,NaN,NaN,50
1657708200,1.00542,1.00677,1.00497,1.00612,2977,2901.6,-857586,-862010,20.10140453553721,63.68551576107516,50.50236468306825,NaN,NaN,50
1657710000,1.00612,1.00649,1.00512,1.00544,2505,2874.9,-860091,-861435.4,21.400562017578036,58.986925097511204,50.91580804376027,NaN,NaN,50
1657711800,1.00544,1.00698,1.00512,1.00678,3544,2913.15,-856547,-859617,22.905033068882883,64.53903506306867,52.01927665296886,NaN,NaN,50
1657713600,1.00678,1.01031,1.00608,1.00647,4399,3013.3,-860946,-859146.6,25.66275033556599,62.4333475186422,53.109196787896785,NaN,NaN,50
1657715400,1.00647,1.00684,0.9998,1.00204,13286,3555.65,-874232,-861880.4,24.074419314392827,41.563787542502936,52.44826488629513,NaN,NaN,50
1657717200,1.00204,1.00492,1.00088,1.00234,8071,3856.35,-866161,-863595.4,22.599540509017753,42.95444663647549,51.693450374912665,NaN,NaN,50
1657719000,1.00234,1.00356,1.00108,1.00212,6728,4092.15,-872889,-866155,21.2300101897409,42.162043148375844,51.35424534310687,NaN,NaN,50
1657720800,1.00212,1.00452,1.00168,1.0036,8380,4457.6,-864509,-867747.4,19.9955372708664,48.98066715544578,52.53141471549896,NaN,NaN,50
1657722600,1.0036,1.01224,1.00284,1.0107,10668,4933.7,-853841,-866326.4,21.468239277794083,68.2926001622374,53.92107989925601,NaN,NaN,50
1657724400,1.0107,1.0115,1.00844,1.00862,6291,5148.15,-860132,-863506.4,22.835748284226934,61.0070752815188,54.8703845892829,NaN,NaN,50
1657726200,1.00862,1.00944,1.00742,1.0078,4306,5246.75,-864438,-863161.8,23.550547692253357,58.36366279117627,55.373160448668855,NaN,NaN,50
1657728000,1.0078,1.00943,1.00766,1.00938,3371,5200.35,-861067,-860797.4,24.214289999706466,61.798404996438286,56.227109053811624,NaN,NaN,50
1657729800,1.00938,1.00974,1.00807,1.00822,2694,5152.65,-863761,-860647.8,24.92227262813365,58.014471006129135,56.67675793453612,NaN,NaN,50
1657731600,1.00822,1.00854,1.0074,1.0082,3394,5030.65,-867155,-863310.6,25.17178106721543,57.94858914760572,56.48075509344308,NaN,NaN,50
1657733400,1.0082,1.00876,1.00773,1.00812,1734,4886.9,-868889,-865062,25.479309011012013,57.66649263453326,56.05082487011866,NaN,NaN,50
1657735200,1.00812,1.00812,1.00604,1.00704,5021,4948.35,-873910,-866956.4,24.75407469356338,53.85496517917707,55.684256304523366,NaN,NaN,50
1657737000,1.00704,1.00756,1.00628,1.00631,2498,4880.9,-876408,-870024.6,24.080642827361075,51.38280225806815,54.74452538988047,NaN,NaN,50
1657738800,1.00631,1.00644,1.00589,1.00606,1846,4839.45,-878254,-872923.2,23.221201348368883,50.52738115485223,53.894099221038324,NaN,NaN,50
1657740600,1.00606,1.00622,1.00543,1.00592,1687,4806.75,-879941,-875480.4,22.14429354033149,50.02512751915398,54.49848064794197,NaN,NaN,50
1657742400,1.00592,1.0062,1.0054,1.00571,1011,4720.55,-880952,-877893,21.12545110938538,49.23455402279639,54.94705974696489,NaN,NaN,50
1657744200,1.00571,1.0061,1.00544,1.0058,589,4601.15,-880363,-879183.6,20.17938313779257,49.602152692297565,55.478496142959294,NaN,NaN,50
1657746000,1.0058,1.00599,1.0057,1.00584,130,4482.4,-880233,-879948.6,19.30089144988496,49.776220029587996,55.535321348255174,NaN,NaN,50
1657747800,1.00584,1.006,1.00568,1.00572,139,4312.15,-880372,-880372.2,18.469518300532737,49.22691464733854,54.17348666861954,NaN,NaN,50
1657749600,1.00572,1.00592,1.00566,1.00578,422,4113.3,-879950,-880374,17.680766468796243,49.52683584386903,53.35346956593027,NaN,NaN,50
1657751400,1.00578,1.00582,1.00502,1.0054,902,3494.1,-880852,-880354,16.4234841997742,47.60871020530468,52.585258666939446,NaN,NaN,50
1657753200,1.0054,1.0054,1.00438,1.00443,1220,3151.55,-882072,-880695.8,15.755457115753021,43.027736595252385,51.2444966382833,NaN,NaN,50
1657755000,1.00443,1.00453,1.00307,1.00344,1323,2881.3,-883395,-881328.2,16.022218588234647,38.912381376809435,49.88006166476047,NaN,NaN,50
1657756800,1.00344,1.00438,1.00282,1.00282,2497,2587.15,-885892,-882432.2,16.42365033089877,36.55440360344478,48.35190555446326,NaN,NaN,50
1657758600,1.00282,1.00286,1.00211,1.00221,2568,2182.15,-888460,-884134.2,17.219417284316787,34.3489964482053,46.6863701125827,NaN,NaN,50
1657760400,1.00221,1.00272,1.0015,1.0027,3252,2030.2,-885208,-885005.4,18.2965030377709,37.60546264101366,45.525691359856744,NaN,NaN,50
1657762200,1.0027,1.00282,1.00144,1.00186,3694,1999.6,-888902,-886371.4,19.188859519909233,34.45067034912786,44.31625336636101,NaN,NaN,50
1657764000,1.00186,1.0025,1.00138,1.00226,2460,1954.05,-886442,-886980.8,20.053647232350748,37.15438111958732,43.3610390781278,NaN,NaN,50
1657765800,1.00226,1.00288,1.00194,1.00218,2375,1938.1,-888817,-887565.8,20.410898437250932,36.82720961650761,42.4183306565102,NaN,NaN,50
1657767600,1.00218,1.00386,1.00218,1.00384,1602,1848.5,-887215,-887316.8,19.70095290875457,47.214112076091794,42.274013374602724,NaN,NaN,50
1657769400,1.00384,1.00404,1.00306,1.00332,1377,1830.65,-888592,-887993.6,18.863803782277394,44.7329048730971,41.926209958945556,NaN,NaN,50
1657771200,1.00332,1.00347,1.00296,1.00326,928,1626,-889520,-888117.2,18.173935346962214,44.44268703304391,41.54524331633526,NaN,NaN,50
1657773000,1.00326,1.00336,1.0021,1.0023,1353,1568.75,-890873,-889003.4,18.245063398543877,39.97400612070563,40.88432127871863,NaN,NaN,50
1657774800,1.0023,1.00254,1.00206,1.0023,2299,1591.4,-890873,-889414.6,18.34267472126541,39.97400612070562,40.201976298492674,NaN,NaN,50
1657776600,1.0023,1.00249,1.00147,1.00186,2797,1646.9,-893670,-890705.6,18.89211038622403,37.94588214230485,39.51177429399269,NaN,NaN,50
1657778400,1.00186,1.00274,1.00096,1.00242,3801,1786.4,-889869,-890961,19.768063262079952,41.98057326188284,39.43697691303772,NaN,NaN,50
1657780200,1.00242,1.00262,1.00061,1.00068,3705,1942.2,-893574,-891771.8,20.82080858046142,34.47917169365974,39.120319078527025,NaN,NaN,50
1657782000,1.00068,1.00263,1.00054,1.00226,6196,2245.5,-887378,-891072.8,21.846894074705073,44.22514126682837,39.66822891162585,NaN,NaN,50
1657783800,1.00226,1.00466,1.00218,1.00364,5016,2489.35,-882362,-889370.6,20.436564779427382,51.07087225006851,40.862648611758935,NaN,NaN,50
1657785600,1.00364,1.00415,1.002,1.00211,5017,2719.1,-887379,-888112.4,19.286655288151678,44.54318098475029,41.35819992202585,NaN,NaN,50
1657787400,1.00211,1.00284,1.0015,1.00202,4437,2895.85,-891816,-888501.8,18.655808208270955,44.1854133787881,42.05353870985872,NaN,NaN,50
1657789200,1.00202,1.00334,1.00184,1.00331,4117,3040.7,-887699,-887326.8,17.561727306693157,50.342011360007774,42.995512298460184,NaN,NaN,50
1657791000,1.00331,1.00506,1.0028,1.00468,4015,3175.3,-883684,-886588,17.491105685819523,55.904883950275206,44.35820332230072,NaN,NaN,50
1657792800,1.00468,1.00479,1.00168,1.00248,3850,3242.95,-887534,-887622.4,16.43435890371754,46.83210264856965,44.33091693462057,NaN,NaN,50
1657794600,1.00248,1.00292,1.0013,1.00161,3818,3305.45,-891352,-888417,15.37360825471843,43.804553479881825,44.26460612081947,NaN,NaN,50
1657796400,1.00161,1.0018,1.00052,1.00102,3689,3327.3,-895041,-889062,14.98168080934143,41.82963547006957,44.07795958060702,NaN,NaN,50
1657798200,1.00102,1.0018,1.00048,1.00096,5226,3403.9,-900267,-891575.6,14.647598530027159,41.62411327514618,44.19582437735278,NaN,NaN,50
1657800000,1.00096,1.00106,1.00035,1.00062,4063,3484.05,-904330,-895704.8,14.439710005292211,40.41239518733321,44.22713788211189,NaN,NaN,50
1657801800,1.00062,1.00171,1.0002,1.00022,5017,3616.15,-909347,-900067.4,13.614613300787152,38.97489692295758,44.3006389378728,NaN,NaN,50
1657803600,1.00022,1.0012,0.99698,0.9972,5876,3829.85,-915223,-904841.6,14.908649510550125,30.23143949621631,43.46141509746805,NaN,NaN,50
1657805400,0.9972,0.99835,0.99522,0.99804,6338,4077.9,-908885,-907610.4,16.835906049908345,34.62452928562176,43.47179778260819,NaN,NaN,50
1657807200,0.99804,0.99842,0.996,0.99826,4822,4272.6,-904063,-908369.6,18.56131123547673,35.76532511754952,42.86752520051685,NaN,NaN,50
1657809000,0.99826,0.99996,0.9981,0.9996,5494,4479.65,-898569,-907217.4,18.849465768201025,42.362595907003154,42.24550546172647,NaN,NaN,50
1657810800,0.9996,1.0036,0.99938,1.00085,8775,4803.45,-889794,-903306.8,18.07234712676518,47.75327805583875,42.474798109661364,NaN,NaN,50
1657812600,1.00085,1.0048,1.00078,1.00274,7738,5050.5,-882056,-896673.4,17.885284378131512,54.65841760541178,43.22286984013448,NaN,NaN,50
1657814400,1.00274,1.0036,1.00121,1.00144,5069,5113.9,-887125,-892321.4,17.711583254400256,49.784544865072036,43.18305080478193,NaN,NaN,50
1657816200,1.00144,1.00203,0.99838,0.99905,5919,5224.6,-893044,-890117.6,16.84309494076103,42.31417301094172,42.21228573768667,NaN,NaN,50
1657818000,0.99905,1.00136,0.99905,1.00119,4929,5161.25,-888115,-888026.8,16.036641506667465,49.60586375105872,42.41041153072161,NaN,NaN,50
1657819800,1.00119,1.0015,1.00021,1.0014,4220,5121.45,-883895,-886847,15.209901607442008,50.27016691969149,42.87224106213659,NaN,NaN,50
1657821600,1.0014,1.00298,1.00124,1.00262,4073,5074.25,-879822,-886400.2,14.589980591227675,54.05905246057766,43.74577084717288,NaN,NaN,50
1657823400,1.00262,1.00378,1.00248,1.00294,3258,5015.3,-876564,-884288,14.399728040295628,55.02693313816514,44.703115123102805,NaN,NaN,50
1657825200,1.00294,1.0032,1.00182,1.00222,3569,4987.9,-880133,-881705.8,13.833049713367387,52.35428781385563,45.55610745356869,NaN,NaN,50
1657827000,1.00222,1.00264,1.00126,1.00156,2346,4904.45,-882479,-880578.6,12.982322564356632,49.958904343756174,46.34067941219716,NaN,NaN,50
1657828800,1.00156,1.0018,1.00104,1.0016,1097,4766.8,-881382,-880076,12.063252386125214,50.10789374330126,47.76042614413179,NaN,NaN,50
1657830600,1.0016,1.00232,1.00146,1.00206,612,4606.5,-880770,-880265.6,11.517988926734226,51.88215375142891,48.99311360597517,NaN,NaN,50
1657832400,1.00206,1.00206,1.00176,1.00186,78,4425.95,-880848,-881122.4,11.011672857299738,51.032409285925326,50.083619618002004,NaN,NaN,50
1657834200,1.00186,1.00194,1.0018,1.00191,1069,4218.1,-879779,-881051.6,10.541522221396287,51.24738675226383,50.718247535520625,NaN,NaN,50
1657836000,1.00191,1.00239,1.00187,1.00202,830,4056.45,-878949,-880345.6,10.409425586523792,51.74926171529787,51.0036749397677,NaN,NaN,50
1657837800,1.00202,1.00212,1.00171,1.00183,710,3841.1,-879659,-880001,10.156399860088024,50.776940505189124,50.726426575466085,NaN,NaN,50
1657839600,1.00183,1.00196,1.00154,1.00186,977,3596.15,-878682,-879583.4,9.777549747174826,50.93370266005112,50.808509275107454,NaN,NaN,50
1657841400,1.00186,1.00266,1.00186,1.00266,918,3325.15,-877764,-878966.6,9.950054119532165,55.0452181498167,51.71786964216995,NaN,NaN,50
1657843200,1.00266,1.00278,1.00112,1.00154,2551,3211.6,-880315,-879073.8,9.463242476997163,48.87099218584883,51.66537881608353,NaN,NaN,50
1657845000,1.00154,1.00222,1.00136,1.00193,2755,3074.65,-877560,-878796,9.011203094643232,50.934793210725275,51.71285212258594,NaN,NaN,50
1657846800,1.00193,1.00258,1.00178,1.00216,2725,2772.15,-874835,-877831.2,8.892890999681773,52.161183761459164,51.57729007264891,NaN,NaN,50
1657848600,1.00216,1.00336,1.00196,1.00334,2769,2523.7,-872066,-876508,9.39366819528453,57.96607352743522,51.78722867188248,NaN,NaN,50
1657850400,1.00334,1.00392,1.00297,1.00382,1688,2354.65,-870378,-875030.8,10.258699896739067,60.08767817741834,52.33961369785125,NaN,NaN,50
1657852200,1.00382,1.00412,1.00322,1.00372,2090,2163.2,-872468,-873461.4,11.201966755928447,59.41485187139387,53.01503852125394,NaN,NaN,50
1657854000,1.00372,1.00377,1.00268,1.00276,1849,2009.2,-874317,-872812.8,11.480823296925871,53.25037627763383,53.23950155942055,NaN,NaN,50
1657855800,1.00276,1.00292,1.00251,1.00257,1347,1865.55,-875664,-872978.6,11.555285646196015,52.0982727792657,53.254938632837465,NaN,NaN,50
1657857600,1.00257,1.00281,1.00226,1.0027,1261,1724.95,-874403,-873446,11.348628432290012,52.849939807941226,53.384762241552885,NaN,NaN,50
1657859400,1.0027,1.00337,1.00264,1.00306,1230,1623.55,-873173,-874005,11.655499285363868,54.957781230193774,53.64979041854787,NaN,NaN,50
1657861200,1.00306,1.00315,1.00219,1.00226,1630,1526.6,-874803,-874472,11.427872535689735,49.646310063931814,53.49957958630745,NaN,NaN,50
1657863000,1.00226,1.00304,1.00184,1.00212,1928,1505.7,-876731,-874954.8,10.833703948540599,48.75822160511432,53.355385379159245,NaN,NaN,50
1657864800,1.00212,1.0025,1.0011,1.00194,3642,1632.95,-880373,-875896.6,10.58251978403871,47.57974619579636,53.11581706028391,NaN,NaN,50
1657866600,1.00194,1.00224,1.00084,1.00163,4051,1804.9,-884424,-877900.8,10.593247228021426,45.538365612968185,52.43675616479472,NaN,NaN,50
1657868400,1.00163,1.00266,1.0007,1.00264,4769,2039.45,-879655,-879197.2,10.12668225964463,52.664203116318255,52.7076998026854,NaN,NaN,50
1657870200,1.00264,1.00356,1.00213,1.00287,3611,2166.55,-876044,-879445.4,10.020533613673743,54.135870106177805,52.93634815236057,NaN,NaN,50
1657872000,1.00287,1.00324,1.00232,1.00258,2921,2271.1,-878965,-879892.2,9.921967013843634,51.94305414958585,52.92076746579819,NaN,NaN,50
1657873800,1.00258,1.0033,1.0017,1.00311,3052,2388.2,-875913,-879000.2,9.285594823050642,55.49138189437378,52.74400377772238,NaN,NaN,50
1657875600,1.00311,1.00441,1.00284,1.00388,2997,2489.2,-872916,-876698.6,9.605297707308948,60.10065903454793,52.744930981803066,NaN,NaN,50
1657877400,1.00388,1.00488,1.00376,1.00437,3120,2599.3,-869796,-874726.8,10.287306492244552,62.74469223756457,52.98277672224383,NaN,NaN,50
1657879200,1.00437,1.00438,1.00365,1.00396,2302,2586.85,-872098,-873937.6,10.788557621537166,59.209100535397596,53.408399883512665,NaN,NaN,50
1657881000,1.00396,1.00594,1.00394,1.00587,2406,2569.4,-869692,-872083,12.385502172384284,68.19908469674817,54.558457877618544,NaN,NaN,50
1657882800,1.00587,1.00594,1.00488,1.0053,2869,2576.6,-872561,-871412.6,13.868379255313751,63.688015071498306,55.33260611072977,NaN,NaN,50
1657884600,1.0053,1.00662,1.00525,1.00541,2718,2574.05,-869843,-870798,15.666948050573218,64.18042178404798,55.99136615029078,NaN,NaN,50
1657886400,1.00541,1.00712,1.0053,1.00675,3608,2670.05,-866235,-870085.8,17.62153731426251,69.59025155298136,57.4159333995086,NaN,NaN,50
1657888200,1.00675,1.00768,1.00438,1.00725,9191,3025.1,-857044,-867075,18.265303246990833,71.33020492418976,59.0282179222997,NaN,NaN,50
1657890000,1.00725,1.00848,1.00576,1.0061,5815,3223.4,-862859,-865708.4,19.371125463766205,62.47598306019987,60.09223484118568,NaN,NaN,50
1657891800,1.0061,1.00666,1.0041,1.00455,5867,3449.4,-868726,-864941.4,18.696863629790112,52.93787992570887,60.62077157781001,NaN,NaN,50
1657893600,1.00455,1.00782,1.00455,1.0076,8355,3804.1,-860371,-863047,18.830984284572068,64.44171299613761,61.46202228351139,NaN,NaN,50
1657895400,1.0076,1.00882,1.00643,1.00804,5974,4041.3,-854397,-860679.4,19.516373972299004,65.74266760983076,62.29107924805804,NaN,NaN,50
1657897200,1.00804,1.0098,1.00772,1.00964,4412,4180.4,-849985,-859267.6,20.635809717723372,70.03581478598477,63.5834192935151,NaN,NaN,50
1657899000,1.00964,1.00971,1.00874,1.009,2927,4230.35,-852912,-857278.2,21.675285767046006,66.4486363276024,64.36608032446,NaN,NaN,50
1657900800,1.009,1.009,1.00751,1.00752,2424,4169.45,-855336,-854600.2,21.47309959412232,58.93158763516594,64.28257522450414,NaN,NaN,50
1657902600,1.00752,1.00818,1.00718,1.00812,1883,4061.05,-853453,-853216.6,20.998840393146736,60.86447553529084,64.14827403148459,NaN,NaN,50
1657904400,1.00812,1.00938,1.0081,1.00836,1892,3917.2,-851561,-852649.4,21.268647672531568,61.64214972894631,64.32206325959523,NaN,NaN,50
1657906200,1.00836,1.00852,1.0075,1.00767,1926,3832.95,-853487,-853349.8,20.992055797249584,58.069448005877405,63.59851778167587,NaN,NaN,50
1657908000,1.00767,1.00786,1.00726,1.00777,1638,3768.8,-851849,-853137.2,20.52688796883542,58.44534963558862,63.2240416791109,NaN,NaN,50
1657909800,1.00777,1.00826,1.00745,1.00802,1001,3666.25,-850848,-852239.6,20.355716666053322,59.42468232162314,62.88434600322341,NaN,NaN,50
1657911600,1.00802,1.00815,1.00741,1.00766,1310,3581.9,-852158,-851980.6,20.15815799537201,57.32943425479973,62.00857333906759,NaN,NaN,50
1657913400,1.00766,1.00835,1.00728,1.00825,1396,3495.7,-850762,-851820.8,20.116272050954983,59.829275551092366,61.18707838384635,NaN,NaN,50
1657915200,1.00825,1.00857,1.00794,1.00854,744,3417.8,-850018,-851127,20.236507525356508,61.037537514511406,61.08433227344002,NaN,NaN,50
1657917000,1.00854,1.0088,1.00846,1.00878,478,3321.4,-849540,-850665.2,20.5170837659403,62.054738830740966,61.735536480942315,NaN,NaN,50
1658091600,1.00878,1.00878,1.00842,1.00844,40,3179.95,-849580,-850411.6,20.72766641344672,59.67775960701063,61.39525409600468,NaN,NaN,50
1658093400,1.00844,1.00866,1.00832,1.00863,79,3048,-849501,-849880.2,20.791475176972003,60.586326107068196,61.02694398866449,NaN,NaN,50
1658095200,1.00863,1.00899,1.00787,1.00798,1026,2918.9,-850527,-849833.2,20.26431690351499,55.94227857644135,60.02026283083996,NaN,NaN,50
1658097000,1.00798,1.00859,1.00794,1.0085,448,2481.75,-850079,-849845.4,19.77481279244777,58.67154468166931,59.464756284701885,NaN,NaN,50
1658098800,1.0085,1.00934,1.00803,1.0093,972,2239.6,-849107,-849758.8,20.034127570546165,62.51845980678821,59.72096143981776,NaN,NaN,50
1658100600,1.0093,1.00982,1.00921,1.00975,1251,2008.8,-847856,-849414,20.678072203253034,64.51908377402124,59.98200488544135,NaN,NaN,50
1658102400,1.00975,1.00989,1.00907,1.00944,1707,1676.4,-849563,-849426.4,21.067494962673752,62.06152264809968,60.011960093952304,NaN,NaN,50
1658104200,1.00944,1.00963,1.00868,1.00916,1720,1463.7,-851283,-849577.6,20.856534147037713,59.84424760231829,60.13873149369808,NaN,NaN,50
1658106000,1.00916,1.01108,1.00916,1.01088,2588,1372.5,-848695,-849300.8,21.8470883438012,67.52067628392545,60.78696911143642,NaN,NaN,50
1658107800,1.01088,1.01116,1.01042,1.01088,2133,1332.8,-848695,-849218.4,22.822414357080632,67.52067628392544,61.36525439445802,NaN,NaN,50
1658109600,1.01088,1.01144,1.01062,1.01066,1323,1277.75,-850018,-849650.8,23.925987189799432,65.65872840374391,61.96020397652546,NaN,NaN,50
1658111400,1.01066,1.01114,1.0101,1.01017,1269,1247.05,-851287,-849995.6,24.16929586609908,61.58524903535408,62.08563065397272,NaN,NaN,50
1658113200,1.01017,1.01104,1.01015,1.01076,1727,1238.8,-849560,-849651,24.39522535123447,64.44552501169578,62.32905833234304,NaN,NaN,50
1658115000,1.01076,1.01076,1.01018,1.01044,1401,1212.55,-850961,-850104.2,24.605017016003046,61.759581286001705,62.30797565057595,NaN,NaN,50
1658116800,1.01044,1.0105,1.00904,1.00912,1413,1201.3,-852374,-850840,23.180289472303155,52.11139877598844,61.767521305502946,NaN,NaN,50
1658118600,1.00912,1.00916,1.0087,1.00916,1018,1202.15,-851356,-851107.6,21.596200332293428,52.35430329394532,61.179519675994165,NaN,NaN,50
1658120400,1.00916,1.00954,1.00887,1.00952,1337,1203.5,-850019,-850854,20.423014855057637,54.58690736294104,61.08270744645842,NaN,NaN,50
1658122200,1.00952,1.01058,1.00877,1.0088,1651,1216.25,-851670,-851276,20.367753907219896,49.582725287737425,60.433506061177575,NaN,NaN,50
1658124000,1.0088,1.00938,1.00812,1.00892,3213,1339.7,-848457,-850775.2,19.52004498841941,50.398874521091514,59.56782139791352,NaN,NaN,50
1658125800,1.00892,1.01118,1.00866,1.01111,3969,1514.25,-844488,-849198,20.15419001274113,62.37077371815895,59.41437067963765,NaN,NaN,50
1658127600,1.01111,1.01493,1.01034,1.01418,7526,1888.55,-836962,-846319.2,22.420133128579376,72.42020522679395,60.15427657811581,NaN,NaN,50
1658129400,1.01418,1.01485,1.01376,1.0146,4578,2113.5,-832384,-842792.2,24.524223164714893,73.46430562376055,61.127137865361696,NaN,NaN,50
1658131200,1.0146,1.01494,1.01338,1.01338,3910,2257.7,-836294,-839717,26.075465857265783,65.68545123528708,60.99605036188752,NaN,NaN,50
1658133000,1.01338,1.01352,1.01198,1.01306,3952,2432.9,-840246,-838074.8,26.175356165083073,63.77786546095883,60.72870673167562,NaN,NaN,50
1658134800,1.01306,1.01494,1.01237,1.01478,3611,2564.85,-836635,-836504.2,26.90502087741578,68.99065953250567,60.966701812301444,NaN,NaN,50
1658136600,1.01478,1.01581,1.01428,1.01556,2922,2648.4,-833713,-835854.4,27.923481717914505,71.02695813186122,61.6411096049091,NaN,NaN,50
1658138400,1.01556,1.01754,1.01524,1.01622,2971,2711.6,-830742,-835526,29.45099161817288,72.66278457580985,62.228056716631535,NaN,NaN,50
1658140200,1.01622,1.0165,1.01508,1.01563,2669,2759.05,-833411,-834949.4,30.72434288831244,68.9168408310577,62.73928954127838,NaN,NaN,50
1658142000,1.01563,1.01594,1.01464,1.01468,2921,2775.7,-836332,-834166.6,31.499416244403793,63.26166504004807,63.53573713156836,NaN,NaN,50
1658143800,1.01468,1.01537,1.01376,1.01424,3234,2830.75,-839566,-834752.8,31.440700377288135,60.77421778328596,64.1371595950927,NaN,NaN,50
1658145600,1.01424,1.01472,1.01194,1.01204,4583,2993.75,-844149,-836840,30.020082949095656,50.15520870338438,63.820609690838644,NaN,NaN,50
1658147400,1.01204,1.01396,1.01204,1.01368,3073,3083.95,-841076,-838906.8,28.700938194345493,56.28692215657498,64.29948089575562,NaN,NaN,50
1658149200,1.01368,1.01452,1.01242,1.01432,3423,3168.75,-837653,-839755.2,27.789595596648702,58.43575566552458,64.8735438346437,NaN,NaN,50
1658151000,1.01432,1.0166,1.01422,1.01552,4794,3338.4,-832859,-839060.6,27.937937410029406,62.18891086923685,64.86055363114926,NaN,NaN,50
1658152800,1.01552,1.01816,1.01548,1.01767,4869,3511.2,-827990,-836745.4,28.66684042518391,67.79919945140844,64.5304817900503,NaN,NaN,50
1658154600,1.01767,1.02014,1.0176,1.0194,5398,3730.2,-822592,-832434,29.95737013162835,71.46774890408926,64.38787059578806,NaN,NaN,50
1658156400,1.0194,1.0198,1.01646,1.01656,4110,3868.85,-826702,-829559.2,30.32465293757246,59.48647805056181,63.94508679687912,NaN,NaN,50
1658158200,1.01656,1.01676,1.01581,1.01602,2582,3915.4,-829284,-827885.4,30.217674415506313,57.5121800020288,63.49753783552696,NaN,NaN,50
1658160000,1.01602,1.01764,1.0159,1.01762,2186,3864.05,-827098,-826733.2,30.44064789114826,61.5808555165326,62.968266120100324,NaN,NaN,50
1658161800,1.01762,1.01772,1.0164,1.0167,2015,3766.35,-829113,-826957.8,30.677066699719806,58.13363838267282,62.047314709444,NaN,NaN,50
1658163600,1.0167,1.01776,1.01668,1.01672,1985,3489.3,-827128,-827865,30.91226454979073,58.18843404826713,61.01343252890524,NaN,NaN,50
1658165400,1.01672,1.01678,1.01528,1.01548,2558,3388.3,-829686,-828461.8,30.069042911123457,53.512062105774646,59.91309119138502,NaN,NaN,50
1658167200,1.01548,1.01574,1.01506,1.01524,2192,3302.4,-831878,-828980.6,29.129267642748996,52.63043771190472,59.15371781080335,NaN,NaN,50
1658169000,1.01524,1.01599,1.01503,1.01509,2119,3210.75,-833997,-830360.4,28.387512326192933,52.05321400170614,58.53078896926194,NaN,NaN,50
1658170800,1.01509,1.0156,1.01498,1.0152,2234,3141.9,-831763,-830890.4,27.65863898209705,52.46493910213691,58.69576971202998,NaN,NaN,50
1658172600,1.0152,1.01523,1.0141,1.01435,2496,3120.6,-834259,-832316.6,26.28757458437651,48.96587207971575,58.17283756368289,NaN,NaN,50
1658174400,1.01435,1.01463,1.01421,1.01425,958,3019.95,-835217,-833422.8,25.014443357921724,48.55558481660749,57.46711107447452,NaN,NaN,50
1658176200,1.01425,1.01464,1.01416,1.01444,402,2906.6,-834815,-834010.2,23.79049050741053,49.42272292008802,56.555240506678174,NaN,NaN,50
1658178000,1.01444,1.01462,1.0143,1.0146,178,2769.45,-834637,-834138.2,22.65396286050729,50.18421964291015,55.29702766321402,NaN,NaN,50
1658179800,1.0146,1.01476,1.0145,1.01468,834,2649.45,-833803,-834546.2,21.711809145145146,50.58483494342914,53.805390951738296,NaN,NaN,50
1658181600,1.01468,1.01492,1.01436,1.01456,580,2449.3,-834383,-834571,20.97103172741697,49.936123790504396,53.123222790305626,NaN,NaN,50
1658183400,1.01456,1.01481,1.01416,1.0142,844,2337.85,-835227,-834573,20.06722611256435,47.94947620941213,52.44017251940443,NaN,NaN,50
1658185200,1.0142,1.01428,1.01387,1.0141,809,2207.15,-836036,-834817.2,18.913277019226324,47.385534814631896,51.426221040697236,NaN,NaN,50
1658187000,1.0141,1.01472,1.01394,1.01466,950,2014.95,-835086,-834907,18.269475645735525,50.87025062500481,50.90740762943524,NaN,NaN,50
1658188800,1.01466,1.01484,1.01347,1.01359,1472,1845.1,-836558,-835458,17.14654792013499,44.76898555744958,49.94887559437684,NaN,NaN,50
1658190600,1.01359,1.01372,1.01286,1.0129,1586,1654.5,-838144,-836210.2,16.366059632918773,41.32677429911985,49.0784978939015,NaN,NaN,50
1658192400,1.0129,1.01343,1.01268,1.01338,1857,1541.85,-836287,-836422.2,15.818514590731137,44.52239204564066,48.49935177488265,NaN,NaN,50
1658194200,1.01338,1.01369,1.01196,1.01226,2611,1543.3,-838898,-836994.6,15.977171965122666,39.16260103438393,47.5785937057882,NaN,NaN,50
1658196000,1.01226,1.01352,1.01226,1.01297,1718,1519.9,-837180,-837413.4,16.124496669914794,43.78282859054022,46.95844295495987,NaN,NaN,50
1658197800,1.01297,1.0133,1.01266,1.01296,1315,1484.9,-838495,-837800.8,16.261298181507485,43.732452681332845,46.5846272836468,NaN,NaN,50
1658199600,1.01296,1.01384,1.0128,1.01372,1365,1453.9,-837130,-837598,15.65106773953063,48.57518124293284,46.58602702838432,NaN,NaN,50
1658201400,1.01372,1.01378,1.01241,1.0127,1475,1399.75,-838605,-838061.6,15.504173925176396,43.20116622141325,46.14163012133613,NaN,NaN,50
1658203200,1.0127,1.01352,1.01269,1.01348,1197,1350,-837408,-837763.6,15.367772526133178,47.94396446964662,45.98161189467445,NaN,NaN,50
1658205000,1.01348,1.01436,1.01243,1.01282,1680,1328.05,-839088,-838145.2,14.41257306151669,44.55384910041487,45.550827191602,NaN,NaN,50
1658206800,1.01282,1.01495,1.01273,1.01482,2409,1336.8,-836679,-837782,14.183956284622958,54.94948458043047,45.90892439088243,NaN,NaN,50
1658208600,1.01482,1.01544,1.01449,1.01474,2337,1328.85,-839016,-838159.2,14.463731078936764,54.50923957430922,46.377478916946515,NaN,NaN,50
1658210400,1.01474,1.01589,1.01458,1.01584,3542,1458.05,-835474,-837533,15.140426814341618,59.333740800479745,47.23092220164993,NaN,NaN,50
1658212200,1.01584,1.0169,1.0151,1.01664,3268,1601.35,-832206,-836492.6,16.567146613955472,62.45256890245339,48.058230650039114,NaN,NaN,50
1658214000,1.01664,1.01952,1.0165,1.0193,5006,1842.75,-827200,-834115,19.240811309923835,70.54227510309967,49.89917990329984,NaN,NaN,50
1658215800,1.0193,1.02439,1.01922,1.02415,7826,2192.35,-819374,-830654,22.933082587985748,79.29966491063514,52.61152923269378,NaN,NaN,50
1658217600,1.02415,1.02534,1.02318,1.02377,5511,2438.9,-824885,-827827.8,26.510658579780827,77.35916427169116,54.95701296312597,NaN,NaN,50
1658219400,1.02377,1.02451,1.02252,1.02441,4154,2604.4,-820731,-824879.2,29.202793340092022,78.32134325732451,57.7540659790503,NaN,NaN,50
1658221200,1.02441,1.02447,1.02202,1.02316,4897,2808.8,-825628,-823563.6,31.234392287544228,71.89482470833656,59.76206570175004,NaN,NaN,50
1658223000,1.02316,1.02591,1.02272,1.02418,3877,2955.15,-821751,-822473.8,33.45420875618386,73.78507413144419,61.90868151961513,NaN,NaN,50
1658224800,1.02418,1.02694,1.02417,1.02564,4283,3095.7,-817468,-822092.6,35.72606774650177,76.24758397190757,63.885281714541904,NaN,NaN,50
1658226600,1.02564,1.02649,1.02438,1.02647,4409,3236.85,-813059,-819727.4,37.83565109465412,77.53928734181204,66.33800465171325,NaN,NaN,50
1658228400,1.02647,1.02676,1.02508,1.02616,3967,3342.35,-817026,-818986.4,39.85219596826653,75.87951758404164,68.33340130274146,NaN,NaN,50
1658230200,1.02616,1.02662,1.02524,1.02538,3486,3386.1,-820512,-817963.2,41.7247019223352,71.71962927440066,70.27381417231187,NaN,NaN,50
1658232000,1.02538,1.02543,1.02316,1.02354,3895,3494.95,-824407,-818494.4,41.42459628109393,62.952135256654635,70.84543207775646,NaN,NaN,50
1658233800,1.02354,1.02406,1.02248,1.02288,4220,3640.2,-828627,-820726.2,40.5854041446726,60.11343346311858,71.24573164124284,NaN,NaN,50
1658235600,1.02288,1.02492,1.02286,1.02395,3930,3768.45,-824697,-823053.8,40.16838936808217,63.02447362690996,71.50935541455928,NaN,NaN,50
1658237400,1.02395,1.02568,1.02395,1.02414,5232,3956.3,-819465,-823541.6,40.0804966806883,63.53341891577301,71.58655898693925,NaN,NaN,50
1658239200,1.02414,1.02648,1.02302,1.02534,7107,4251.8,-812358,-821910.8,39.22450826963214,66.65516538761389,71.30890829297597,NaN,NaN,50
1658241000,1.02534,1.02554,1.0229,1.02456,5702,4452.9,-818060,-820641.4,38.3315171324277,62.88674178136225,70.13655664088505,NaN,NaN,50
1658242800,1.02456,1.0255,1.02342,1.02352,4299,4547.4,-822359,-819387.8,37.50231107645215,58.164911259552554,68.76553856858943,NaN,NaN,50
1658244600,1.02352,1.02472,1.02312,1.02388,2959,4578.5,-819400,-818328.4,36.45931564860804,59.30399824320691,67.40715678186675,NaN,NaN,50
1658246400,1.02388,1.02394,1.02298,1.02368,2453,4524.05,-821853,-818806,35.35973625316415,58.35340531724154,66.43991253964568,NaN,NaN,50
1658248200,1.02368,1.02452,1.0234,1.02404,1967,4459,-819886,-820311.6,34.69085699662149,59.60844754337367,65.4272963547835,NaN,NaN,50
1658250000,1.02404,1.02441,1.02348,1.02379,2011,4309.25,-821897,-821079,34.069754829831886,58.294646193316886,64.14494365631273,NaN,NaN,50
1658251800,1.02379,1.02402,1.0235,1.02353,1391,3987.5,-823288,-821264.8,33.493017103527244,56.89028750978028,62.670015096881876,NaN,NaN,50
1658253600,1.02353,1.02366,1.02284,1.023,1662,3795.05,-824950,-822374.8,32.22370741857623,54.0327393150146,61.10953093480852,NaN,NaN,50
1658255400,1.023,1.02334,1.02258,1.0232,2003,3687.5,-822947,-822593.6,30.768707178836568,54.952271929035035,59.911862552996695,NaN,NaN,50
1658257200,1.0232,1.0232,1.02262,1.02296,2783,3581.8,-825730,-823762.4,29.41763552764974,53.56747647036025,59.2415297825471,NaN,NaN,50
1658259000,1.02296,1.02318,1.02213,1.02215,2651,3520.5,-828381,-825059.2,27.618989949237655,49.072792026406866,58.45291253706768,NaN,NaN,50
1658260800,1.02215,1.02264,1.02215,1.02244,1254,3369.05,-827127,-825827,25.948819054997863,50.66873701079616,57.57035992163098,NaN,NaN,50
1658262600,1.02244,1.02276,1.02242,1.02258,489,3173.05,-826638,-826164.6,24.5277374910467,51.45957288851281,56.70794234825525,NaN,NaN,50
1658264400,1.02258,1.02367,1.02258,1.02304,418,2995.6,-826220,-826819.2,24.108496684473334,54.06524640878561,55.8086624211961,NaN,NaN,50
1658266200,1.02304,1.02326,1.02276,1.02284,590,2850.8,-826810,-827035.2,23.719201649798062,52.739652447566314,55.08387032592496,NaN,NaN,50
1658268000,1.02284,1.02357,1.02273,1.02355,829,2697.5,-825981,-826555.2,23.65019272911961,56.78997733752319,54.98566076006572,NaN,NaN,50
1658269800,1.02355,1.02416,1.02348,1.02356,733,2523.15,-825248,-826179.4,24.10216452094552,56.846074331993876,54.81009476640764,NaN,NaN,50
1658271600,1.02356,1.0237,1.02305,1.02314,1111,2382.2,-826359,-826123.6,23.886934826275553,53.69318834234138,54.477222125343346,NaN,NaN,50
1658273400,1.02314,1.02326,1.02298,1.02306,955,2168.35,-827314,-826342.4,23.58460998427673,53.089185158868894,54.01156052645014,NaN,NaN,50
1658275200,1.02306,1.02457,1.02306,1.02451,1476,1886.8,-825838,-826148,24.410038621269077,61.53511024219278,54.243022244227,NaN,NaN,50
1658277000,1.02451,1.02488,1.02405,1.02462,1457,1674.55,-824381,-825828,25.393417330466246,62.092689471635836,54.61462238435953,NaN,NaN,50
1658278800,1.02462,1.02468,1.02391,1.02396,1632,1541.2,-826013,-825981,26.086811910071965,56.77486342104258,54.810488391932964,NaN,NaN,50
1658280600,1.02396,1.024,1.02332,1.02339,1607,1473.6,-827620,-826233.2,25.845073822657728,52.586150115302054,54.64147969095203,NaN,NaN,50
1658282400,1.02339,1.0239,1.02312,1.02346,1250,1413.45,-826370,-826044.4,25.336493037703384,53.04431373172631,54.60411092390675,NaN,NaN,50
1658284200,1.02346,1.02432,1.02336,1.02418,1461,1388.15,-824909,-825858.6,25.260762752957643,57.58436248429742,55.2120802423275,NaN,NaN,50
1658286000,1.02418,1.0246,1.02397,1.02438,1274,1351.3,-823635,-825709.4,25.443281686504864,58.77669480467834,55.79122008474766,NaN,NaN,50
1658287800,1.02438,1.0245,1.02394,1.02432,1024,1332.95,-824659,-825438.6,25.563784467403135,58.247694411013924,56.276085907783454,NaN,NaN,50
1658289600,1.02432,1.02482,1.02418,1.02446,1137,1306.7,-823522,-824619,25.977823865541623,59.17107397674736,56.64078787692358,NaN,NaN,50
1658291400,1.02446,1.02479,1.02422,1.02438,999,1256.5,-824521,-824249.2,26.36228902095593,58.376589979261716,57.04342627204468,NaN,NaN,50
1658293200,1.02438,1.02472,1.02392,1.0246,1733,1204,-822788,-823825,26.162245792720718,59.96841689765243,57.27045766919678,NaN,NaN,50
1658295000,1.0246,1.0246,1.02357,1.02381,1606,1151.75,-824394,-823976.8,25.363859850375775,52.24217144040778,56.941607462654915,NaN,NaN,50
1658296800,1.02381,1.02409,1.02295,1.02353,2657,1221.9,-827051,-824455.2,23.662090513000567,49.793480230718664,56.66305688325328,NaN,NaN,50
1658298600,1.02353,1.02509,1.02287,1.02502,3035,1349.2,-824016,-824554,23.269193896394917,60.424060209685855,57.186976529740214,NaN,NaN,50
1658300400,1.02502,1.02734,1.02456,1.02609,5070,1581.8,-818946,-823439,24.601412738716004,65.99272270108062,57.505377419660775,NaN,NaN,50
1658302200,1.02609,1.02651,1.02214,1.02258,5414,1823,-824360,-823753.4,23.28749630470826,44.08091246978445,56.21882191952854,NaN,NaN,50
1658304000,1.02258,1.02444,1.02192,1.02284,5710,2067.05,-818650,-822604.6,21.885026501406543,45.52382411876539,55.41517625508017,NaN,NaN,50
1658305800,1.02284,1.0242,1.02284,1.02315,3447,2202.75,-815203,-820235,20.582733112626382,47.27086605895303,55.03551310819809,NaN,NaN,50
1658307600,1.02315,1.02518,1.023,1.02425,3238,2309.1,-811965,-817824.8,20.133865657981197,53.02735185131413,55.03430154531151,NaN,NaN,50
1658309400,1.02425,1.0253,1.02412,1.02516,2778,2400.25,-809187,-815873,19.804972939454192,57.19101092450151,55.00620500532609,NaN,NaN,50
1658311200,1.02516,1.02516,1.02296,1.02398,2964,2474.65,-812151,-813431.2,18.42630682146944,50.89157959502343,54.44298249035074,NaN,NaN,50
1658313000,1.02398,1.02402,1.01734,1.01978,7223,2762.95,-819374,-813576,19.97628942453811,35.783522214449235,52.83839876202468,NaN,NaN,50
1658314800,1.01978,1.02144,1.01896,1.02,3952,2878.95,-815422,-813619.8,21.41555898453045,36.841203007277755,51.24340797849114,NaN,NaN,50
1658316600,1.02,1.02024,1.01808,1.01908,3994,2998.3,-819416,-815110,23.044519782730323,34.29720538754832,49.523451936225904,NaN,NaN,50
1658318400,1.01908,1.02024,1.01794,1.01919,4567,3164.15,-814849,-816242.4,24.603271146749115,34.87624975407054,47.731154283112915,NaN,NaN,50
1658320200,1.01919,1.0221,1.01876,1.0211,5630,3372.6,-809219,-815656,24.579720951552954,44.09011694046094,47.148864675973854,NaN,NaN,50
1658322000,1.0211,1.02363,1.02088,1.02318,4678,3542.8,-804541,-812689.4,23.565049755236853,52.046842921280955,47.30981915387116,NaN,NaN,50
1658323800,1.02318,1.02379,1.02154,1.02158,4809,3732.05,-809350,-811475,22.524786568279648,46.557992509537854,46.31938574671773,NaN,NaN,50
1658325600,1.02158,1.0226,1.02135,1.02188,4315,3890.95,-805035,-808598.8,21.660607418735122,47.672298884181835,45.01078404551067,NaN,NaN,50
1658327400,1.02188,1.02236,1.02042,1.02124,4753,4078.65,-809788,-807586.6,21.3459937659729,45.49303335464275,45.11164982300055,NaN,NaN,50
1658329200,1.02124,1.02152,1.0198,1.01986,4040,4194,-813828,-808508.4,21.360598713458096,41.12729234575487,44.797611839214085,NaN,NaN,50
1658331000,1.01986,1.02173,1.01956,1.0215,2469,4237.15,-811359,-809872,21.492830529939592,47.567014168271065,44.81876527559394,NaN,NaN,50
1658332800,1.0215,1.02176,1.02102,1.02104,1636,4186.1,-812995,-810601,21.590598694172353,46.04562562185301,44.320070544918146,NaN,NaN,50
1658334600,1.02104,1.02116,1.01832,1.01907,3103,4189.5,-816098,-812813.6,22.8715764185038,40.12648750040285,43.10117601462539,NaN,NaN,50
1658336400,1.01907,1.01932,1.01672,1.01678,3969,4134.45,-820067,-814869.4,24.58439400419144,34.56423185621564,41.93493689042483,NaN,NaN,50
1658338200,1.01678,1.01721,1.01554,1.01578,2774,4002.45,-822841,-816672,26.508097742808438,32.448943574362005,41.696752701847174,NaN,NaN,50
1658340000,1.01578,1.01709,1.01573,1.01702,2637,3848.8,-820204,-818441,28.29439407152422,37.55240394826916,41.74755276906085,NaN,NaN,50
1658341800,1.01702,1.01776,1.01686,1.01774,2087,3780.8,-818117,-819465.4,29.361717741614214,40.36946836322168,42.181285838751805,NaN,NaN,50
1658343600,1.01774,1.01841,1.01772,1.01794,1566,3697.2,-816551,-819556,29.800251173313075,41.1634499576067,42.630371567575814,NaN,NaN,50
1658345400,1.01794,1.0181,1.01741,1.01776,1280,3622.3,-817831,-819108.8,30.331803698885462,40.638990576015715,42.38386254154401,NaN,NaN,50
1658347200,1.01776,1.01787,1.01752,1.01766,594,3503.8,-818425,-818225.6,30.825388186916967,40.33155281146589,41.54705610512865,NaN,NaN,50
1658349000,1.01766,1.01816,1.01741,1.0181,989,3192.1,-817436,-817672,31.004830120745293,42.39646137177399,41.249803881002656,NaN,NaN,50
1658350800,1.0181,1.01811,1.01774,1.01811,157,3002.35,-817279,-817504.4,31.171454773585882,42.44521080414785,40.87644044671451,NaN,NaN,50
1658352600,1.01811,1.01812,1.01789,1.01796,153,2810.3,-817432,-817680.6,31.315354093305555,41.87277331463909,40.61785044385711,NaN,NaN,50
1658354400,1.01796,1.01876,1.01784,1.01872,953,2629.6,-816479,-817410.2,30.75795424930174,45.85703987260087,40.95568955291754,NaN,NaN,50
1658356200,1.01872,1.01872,1.01818,1.01818,584,2377.3,-817063,-817137.8,30.240368679869622,43.57176328750543,40.67031449000571,NaN,NaN,50
1658358000,1.01818,1.01849,1.01768,1.01786,826,2184.7,-817889,-817228.4,30.097122274566075,42.22874529045422,40.39768018062008,NaN,NaN,50
1658359800,1.01786,1.01838,1.01768,1.0181,1083,1998.4,-816806,-817133.8,29.964107755355634,43.63205914777959,40.64807815543271,NaN,NaN,50
1658361600,1.0181,1.01868,1.01784,1.01848,1646,1864.95,-815160,-816679.4,29.463225852029957,45.87390995726497,41.45591230550765,NaN,NaN,50
1658363400,1.01848,1.01936,1.01844,1.0187,1964,1725.5,-813196,-816022.8,28.19561301815022,47.18359580864126,42.508387465099034,NaN,NaN,50
1658365200,1.0187,1.01886,1.01816,1.01872,2190,1633,-811006,-814811.4,27.26411471307888,47.308418548687,43.20524565084316,NaN,NaN,50
1658367000,1.01872,1.0195,1.01867,1.0194,2507,1634.9,-808499,-812933.4,25.679651277832782,51.50490918655462,44.000634281081226,NaN,NaN,50
1658368800,1.0194,1.02029,1.01914,1.02026,1819,1644.05,-806680,-810908.2,24.26428753512074,56.25052023219321,45.07828215783741,NaN,NaN,50
1658370600,1.02026,1.02104,1.02017,1.02094,1298,1553.8,-805382,-808952.6,23.597205652288892,59.61565564243302,46.433758234010064,NaN,NaN,50
1658372400,1.02094,1.02136,1.02068,1.02082,2103,1460.5,-807485,-807810.4,23.235140802867154,58.75675199186273,47.749843889752704,NaN,NaN,50
1658374200,1.02082,1.02101,1.02044,1.02091,1399,1391.75,-806086,-806826.4,22.6189016681474,59.23116692581997,48.95232285789884,NaN,NaN,50
1658376000,1.02091,1.02128,1.02056,1.02084,1350,1327.4,-807436,-806613.8,22.281687984201056,58.66592853069391,50.11094555265214,NaN,NaN,50
1658377800,1.02084,1.02255,1.02078,1.02231,2255,1335.8,-805181,-806314,22.92622571934353,66.00304432149255,51.83453633885596,NaN,NaN,50
1658379600,1.02231,1.02285,1.02108,1.02168,1927,1353.85,-807108,-806659.2,23.72043295742484,61.005101971252614,52.91654077447394,NaN,NaN,50
1658381400,1.02168,1.0227,1.02156,1.0223,1995,1389.6,-805113,-806184.8,24.457911107071766,63.90208046360428,54.36870628705242,NaN,NaN,50
1658383200,1.0223,1.02308,1.02144,1.02164,4002,1560,-809115,-806790.6,25.403468227041344,58.886830419352535,55.55856951054516,NaN,NaN,50
1658385000,1.02164,1.02217,1.02014,1.02057,3803,1700.7,-812918,-807887,24.6155637752665,51.79023567154517,56.141296405099844,NaN,NaN,50
1658386800,1.02057,1.0218,1.02026,1.0204,6052,1995.45,-818970,-810644.8,23.883938212904148,50.74391306697306,56.48915377007899,NaN,NaN,50
1658388600,1.0204,1.02178,1.01902,1.0196,4913,2233.45,-823883,-813999.8,22.440503962208812,46.03095619001011,56.406822368748195,NaN,NaN,50
1658390400,1.0196,1.01968,1.0173,1.01866,4793,2425.45,-828676,-818712.4,22.412666610041835,41.19007280053472,55.969797672451605,NaN,NaN,50
1658392200,1.01866,1.0195,1.01708,1.01913,5387,2665.6,-823289,-821547.2,22.529374652811367,44.34186765065404,55.458151848458705,NaN,NaN,50
1658394000,1.01913,1.01914,1.017,1.0176,4041,2826.35,-827330,-824429.6,22.69160354878103,37.32850694834451,54.106579471040945,NaN,NaN,50
1658395800,1.0176,1.01837,1.0166,1.0182,3602,2952.3,-823728,-825381.2,23.114796839292065,41.25265124768038,52.79493629998718,NaN,NaN,50
1658397600,1.0182,1.01992,1.01802,1.01966,3536,3046.8,-820192,-824643,21.902391715360427,49.5333288380153,52.13612036042665,NaN,NaN,50
1658399400,1.01966,1.01974,1.01821,1.01888,3733,3135.25,-823925,-823692.8,20.77658695742391,45.817660482605454,51.1780127573399,NaN,NaN,50
1658401200,1.01888,1.01968,1.01822,1.01912,4114,3231.45,-819811,-822997.2,19.731196825054283,47.13178169452792,50.35414512618519,NaN,NaN,50
1658403000,1.01912,1.01951,1.01792,1.01902,4858,3349,-824669,-822465,19.03220223572002,46.62436581830479,48.96995380452892,NaN,NaN,50
1658404800,1.01902,1.02604,1.01883,1.02423,10387,3777.4,-814282,-820575.8,20.788475142672652,66.72444904500907,49.378478595511524,NaN,NaN,50
1658406600,1.02423,1.02781,1.024,1.0265,10372,4231.1,-803910,-817319.4,22.92071799370415,71.7212087712779,49.93698776034536,NaN,NaN,50
1658408400,1.0265,1.02751,1.01536,1.01717,12560,4753.95,-816470,-815828.4,21.923021067930375,43.0844352020212,48.80824524482169,NaN,NaN,50
1658410200,1.01717,1.02183,1.016,1.02124,8969,5132.45,-807501,-813366.4,20.9965882082833,52.07411242631604,48.82852215587676,NaN,NaN,50
1658412000,1.02124,1.02142,1.017,1.01722,8692,5499.55,-816193,-811671.2,20.1363291243253,44.5837036501881,48.38850719753498,NaN,NaN,50
1658413800,1.01722,1.01969,1.01684,1.01916,5782,5675.9,-810411,-810897,19.396482419454166,48.4382366185255,48.56045579957179,NaN,NaN,50
1658415600,1.01916,1.02124,1.01824,1.01948,4469,5803,-805942,-811303.4,18.031852945965344,49.06754255732125,49.12313221077083,NaN,NaN,50
1658417400,1.01948,1.02094,1.01912,1.02004,3338,5870.15,-802604,-808530.2,16.76469700629715,50.21272622810623,49.54247925201741,NaN,NaN,50
1658419200,1.02004,1.02004,1.01802,1.01903,3264,5833.25,-805868,-808203.6,16.060980920176316,48.11161760609008,50.31270144185638,NaN,NaN,50
1658421000,1.01903,1.01914,1.0175,1.01814,2257,5755.95,-808125,-806590,15.624956181197835,46.2741224161581,50.6713779538905,NaN,NaN,50
1658422800,1.01814,1.01865,1.01786,1.01849,2076,5557.15,-806049,-805717.6,15.220076066432101,47.129295591439366,50.499661293420786,NaN,NaN,50
1658424600,1.01849,1.01888,1.01756,1.01844,2307,5426.85,-808356,-806200.4,14.98182424634445,47.01416627297799,50.58512599273312,NaN,NaN,50
1658426400,1.01844,1.01996,1.01832,1.01947,1628,5268.6,-806728,-807025.2,14.148051450334329,49.738036062826744,50.77128701904017,NaN,NaN,50
1658428200,1.01947,1.02,1.01902,1.0193,2047,5101.6,-808775,-807606.6,13.351343461763726,49.28767454020273,50.961523356318594,NaN,NaN,50
1658430000,1.0193,1.01976,1.01916,1.01941,1894,4994.25,-806881,-807357.8,12.611543186662452,49.605642241940096,49.73875144181367,NaN,NaN,50
1658431800,1.01941,1.0212,1.0194,1.02116,1862,4907.25,-805019,-807151.8,12.32731951493647,54.494052941246856,48.50824031109717,NaN,NaN,50
1658433600,1.02116,1.02262,1.0205,1.02213,1640,4812.45,-803379,-806156.4,12.762018055310262,56.9847808115454,49.5011221403489,NaN,NaN,50
1658435400,1.02213,1.02311,1.022,1.02304,1001,4675.85,-802378,-805286.4,13.38862332807476,59.23880893497212,50.01288617668148,NaN,NaN,50
1658437200,1.02304,1.02304,1.02256,1.02264,154,4477.85,-802532,-804037.8,13.970471081356079,57.8049529784585,50.957261128700786,NaN,NaN,50
1658439000,1.02264,1.02288,1.02262,1.0228,222,4246.05,-802310,-803123.6,14.51075828083159,58.24036515882564,51.65741316729366,NaN,NaN,50
1658440800,1.0228,1.02284,1.02224,1.02242,1125,3782.95,-803435,-802806.8,14.702255914778206,56.74275823616045,52.205642858639315,NaN,NaN,50
1658442600,1.02242,1.02264,1.0223,1.0224,639,3296.3,-804074,-802945.8,14.880075146300062,56.66017673809107,52.66617503792395,NaN,NaN,50
1658444400,1.0224,1.02277,1.02234,1.0227,955,2716.05,-803119,-803094,15.127878217962357,57.65568163971914,53.34789389746887,NaN,NaN,50
1658446200,1.0227,1.02306,1.02201,1.02202,1077,2321.45,-804196,-803426.8,15.046818236683546,54.59457741424625,53.942212111618026,NaN,NaN,50
1658448000,1.02202,1.02218,1.02105,1.02108,2138,1993.75,-806334,-804231.6,14.12968009652786,50.59557073604852,54.18980319337583,NaN,NaN,50
1658449800,1.02108,1.02116,1.02034,1.02046,1853,1797.3,-808187,-805182,13.518238854800716,48.09329221765915,54.26688361799591,NaN,NaN,50
1658451600,1.02046,1.02084,1.01908,1.0195,2343,1691,-810530,-806473.2,13.806755979941219,44.429282046643365,53.88768690255424,NaN,NaN,50
1658453400,1.0195,1.0205,1.0194,1.02024,2364,1642.3,-808166,-807482.6,14.074664739000259,47.73473148891509,53.776762398890845,NaN,NaN,50
1658455200,1.02024,1.02034,1.01932,1.01934,1773,1567.75,-809939,-808631.2,14.377975843062298,44.28462164132635,53.396689498847,NaN,NaN,50
1658457000,1.01934,1.02014,1.0193,1.01958,1690,1539.4,-808249,-809014.2,14.674133185468365,45.417556215613835,52.74836830415893,NaN,NaN,50
1658458800,1.01958,1.01978,1.01877,1.01883,1390,1505.1,-809639,-809304.6,15.334857363609292,42.50857449126645,51.71435356699614,NaN,NaN,50
1658460600,1.01883,1.0191,1.01848,1.0191,1176,1448.55,-808463,-808891.2,16.152635400095576,43.90158691772904,50.61883770862163,NaN,NaN,50
1658462400,1.0191,1.01937,1.01882,1.01882,1028,1418.55,-809491,-809156.2,16.583103412848583,42.74490169675604,49.543119759928594,NaN,NaN,50
1658464200,1.01882,1.01886,1.01805,1.0181,1132,1372.8,-810623,-809293,17.540623639842217,39.838241422058516,48.228682350159524,NaN,NaN,50
1658466000,1.0181,1.01872,1.01804,1.01856,1715,1363.85,-808908,-809424.8,18.436758267713277,42.527189441297196,47.21328457909785,NaN,NaN,50
1658467800,1.01856,1.01936,1.01844,1.0185,1965,1369,-810873,-809671.6,18.45038509906411,42.261858087019796,46.18483324687848,NaN,NaN,50
1658469600,1.0185,1.01956,1.01828,1.01951,3694,1471.7,-807179,-809414.8,18.219078797513024,48.12869326662147,45.5043340773715,NaN,NaN,50
1658471400,1.01951,1.0209,1.0191,1.02088,2740,1558.65,-804439,-808404.4,17.24666037551583,54.83289690660878,45.521356898254545,NaN,NaN,50
1658473200,1.02088,1.02136,1.01786,1.01828,5481,1825,-809920,-808263.8,16.779171192134807,43.375165906888775,45.0056136961717,NaN,NaN,50
1658475000,1.01828,1.01828,1.01298,1.01381,6666,2147.2,-816586,-809799.4,18.786653064595168,31.275355922239115,43.80433253221313,NaN,NaN,50
1658476800,1.01381,1.0159,1.0135,1.01574,4677,2324.8,-811909,-810006.6,20.65074337473693,39.166093116589224,43.428390465780694,NaN,NaN,50
1658478600,1.01574,1.01722,1.01497,1.01533,4692,2527.45,-816601,-811891,21.272198492845845,38.16363543189383,42.74474074742203,NaN,NaN,50
1658480400,1.01533,1.01682,1.01486,1.01556,5384,2748.9,-811217,-813246.6,21.897353635823947,39.105231088888814,42.37478427939078,NaN,NaN,50
1658482200,1.01556,1.0162,1.01434,1.01596,3851,2887.6,-807366,-812735.8,22.709122194157974,40.7937460763369,42.04451212658528,NaN,NaN,50
1658484000,1.01596,1.016,1.0143,1.0155,3128,2937.1,-810494,-811517.4,23.48110931450322,39.43937557176017,41.82528363233483,NaN,NaN,50
1658485800,1.0155,1.01726,1.0152,1.01726,3604,3024.65,-806890,-810513.6,23.104297345864495,46.7270677487022,42.02710369169006,NaN,NaN,50
1658487600,1.01726,1.01726,1.01542,1.01627,4091,3112.05,-810981,-809389.6,22.754400517842825,43.55225897387399,42.08477206862706,NaN,NaN,50
1658489400,1.01627,1.01858,1.01572,1.0176,5121,3249.9,-805860,-808318.2,21.396957249374147,48.60440686821814,42.71092674335274,NaN,NaN,50
1658491200,1.0176,1.01965,1.01696,1.01946,4726,3397.55,-801134,-807071.8,20.315556987912004,54.70937980671975,43.58108319802579,NaN,NaN,50
1658493000,1.01946,1.01972,1.01778,1.01874,4057,3515.9,-805191,-806011.2,19.35659617675611,52.12810618316128,44.285815204893034,NaN,NaN,50
1658494800,1.01874,1.01963,1.01798,1.01848,4215,3657.15,-809406,-806514.4,18.466132566397068,51.18887315470284,44.50439948261313,NaN,NaN,50
1658496600,1.01848,1.02432,1.01812,1.02339,8313,4014,-801093,-804536.8,19.927413521831273,64.27842628040558,45.179080152170044,NaN,NaN,50
1658498400,1.02339,1.02554,1.02265,1.02359,7390,4332.1,-793703,-802105.4,21.667819137497816,64.69375380955859,46.701836430932175,NaN,NaN,50
1658500200,1.02359,1.02403,1.02252,1.02304,5568,4553.9,-799271,-801732.8,23.18097768552477,62.54029083764866,48.93504606774714,NaN,NaN,50
1658502000,1.02304,1.02344,1.02173,1.02196,4461,4691.2,-803732,-801441,23.960066190374732,58.42748684226247,50.310859905295224,NaN,NaN,50
1658503800,1.02196,1.02279,1.0214,1.0227,3581,4772,-800151,-799590,24.426277693864083,60.3514555839503,51.895704201870686,NaN,NaN,50
1658505600,1.0227,1.0227,1.02172,1.02251,2608,4717.7,-802759,-799923.2,24.859188375675625,59.588913591969465,53.35882438066216,NaN,NaN,50
1658507400,1.02251,1.02394,1.0223,1.02321,2673,4714.35,-800086,-801199.8,25.781414502012506,61.51804691848957,54.839131583673066,NaN,NaN,50
1658509200,1.02321,1.02377,1.02234,1.02274,2688,4574.7,-802774,-801900.4,26.63776733361104,59.46541685008067,56.2695631035531,NaN,NaN,50
1658511000,1.02274,1.02274,1.02201,1.02236,2378,4360.3,-805152,-802184.4,27.124682292366337,57.786591012284354,57.059529050951824,NaN,NaN,50
1658512800,1.02236,1.0229,1.0203,1.02045,3344,4293.65,-808496,-803853.4,26.158389450984,50.12636102878851,57.52910776916001,NaN,NaN,50
1658514600,1.02045,1.02088,1.01903,1.01952,2927,4205.4,-811423,-805586.2,24.398146287689098,46.86851754783813,57.405115674847146,NaN,NaN,50
1658516400,1.01952,1.02018,1.01918,1.01986,2209,4046.65,-809214,-807411.8,22.76363477891526,48.19415108904234,56.93974219501305,NaN,NaN,50
1658518200,1.01986,1.02128,1.01963,1.02122,1981,3953.15,-807233,-808303.6,21.924884270361982,53.22174552915699,57.0178592911556,NaN,NaN,50
1658520000,1.02122,1.02122,1.02062,1.02113,1321,3862.8,-808554,-808984,21.146044512419653,52.85617978055454,57.13695262157358,NaN,NaN,50
1658521800,1.02113,1.02162,1.02096,1.02151,617,3713.45,-807937,-808872.2,20.67143618401049,54.28398996008465,56.42306431297923,NaN,NaN,50
1658696400,1.02151,1.02192,1.02118,1.02173,124,3515.1,-807813,-808150.2,20.417758010872657,55.131243712764196,55.74002787749391,NaN,NaN,50
1658698200,1.02173,1.02188,1.02166,1.02177,147,3266.4,-807666,-807840.6,20.18219970724467,55.29347629349987,55.22239826719757,NaN,NaN,50
1658700000,1.02177,1.02195,1.02112,1.02162,1123,3086.25,-808789,-808151.8,19.460765085613748,54.497705105333964,54.94169957170268,NaN,NaN,50
1658701800,1.02162,1.02168,1.02118,1.02124,885,2927.65,-809674,-808375.8,18.79086150838503,52.4387646403339,54.37650736144436,NaN,NaN,50
1658703600,1.02124,1.02139,1.02026,1.02028,1189,2776.35,-810863,-808961,17.56301973961771,47.5511299790879,53.516665674809964,NaN,NaN,50
1658705400,1.02028,1.0206,1.01992,1.01996,1338,2427.6,-812201,-809838.6,16.707730298471812,46.01163808080822,52.40906504354701,NaN,NaN,50
1658707200,1.01996,1.02036,1.01916,1.01946,2227,2169.45,-814428,-811191,16.512963229399134,43.63451624765385,51.27828642908795,NaN,NaN,50
1658709000,1.01946,1.01946,1.01822,1.01824,2402,2011.15,-816830,-812799.2,16.98255682917972,38.41892588372247,49.89488177704782,NaN,NaN,50
1658710800,1.01824,1.01925,1.01811,1.01885,2528,1914.5,-814302,-813724.8,17.490936726460696,42.14272280088083,49.32462190362584,NaN,NaN,50
1658712600,1.01885,1.0202,1.01855,1.02,2950,1882.95,-811352,-813822.6,16.995989959137887,48.46915270434634,49.438952986233566,NaN,NaN,50
1658714400,1.02,1.02088,1.01979,1.02038,2269,1866,-809083,-813199,15.923807159477226,50.39916525790979,49.59645399829553,NaN,NaN,50
1658716200,1.02038,1.02131,1.02026,1.02112,1975,1831.1,-807108,-811735,15.010079021344827,54.01139907809167,49.652857823219435,NaN,NaN,50
1658718000,1.02112,1.02123,1.0207,1.02078,1609,1777.15,-808717,-810112.4,14.161617178793309,52.13281797002742,49.601189122467495,NaN,NaN,50
1658719800,1.02078,1.02114,1.0206,1.02072,1562,1736.35,-810279,-809307.8,13.275402142658812,51.790482815050225,49.42308146925075,NaN,NaN,50
1658721600,1.02072,1.02116,1.02068,1.02104,1428,1640.55,-808851,-808807.6,12.472611326737928,53.54266011334487,49.30961121214936,NaN,NaN,50
1658723400,1.02104,1.02114,1.02039,1.02074,1180,1553.2,-810031,-808997.2,11.748626799141741,51.64748053684442,49.04918294381683,NaN,NaN,50
1658725200,1.02074,1.02096,1.01958,1.02012,2048,1545.15,-812079,-809991.4,11.872978127410166,47.87590718954718,48.576197378403485,NaN,NaN,50
1658727000,1.02012,1.02018,1.01948,1.01989,2434,1567.8,-814513,-811150.6,12.080862944211308,46.51877389040103,48.153340896265426,NaN,NaN,50
1658728800,1.01989,1.02048,1.01952,1.01952,3244,1663.95,-817757,-812646.2,11.89600568656567,44.34120667552059,47.924060660296334,NaN,NaN,50
1658730600,1.01952,1.0209,1.01932,1.01967,3562,1811.2,-814195,-813715,11.216179833119792,45.45592492169918,47.88436686321711,NaN,NaN,50
1658732400,1.01967,1.0222,1.01862,1.02025,6048,2107.4,-808147,-813338.2,11.54701130920774,49.65460240529466,48.31437301733432,NaN,NaN,50
1658734200,1.02025,1.02076,1.01905,1.0193,4031,2301.6,-812178,-813358,11.85421196557512,43.7183905133709,48.69290620516635,NaN,NaN,50
1658736000,1.0193,1.02118,1.01786,1.02016,5982,2544.55,-806196,-811694.6,11.19084146414423,49.59325761378169,49.2250872632307,NaN,NaN,50
1658737800,1.02016,1.02284,1.02014,1.02222,4652,2732.9,-801544,-808452,11.620369042790294,60.286766601277066,50.0692025415829,NaN,NaN,50
1658739600,1.02222,1.02542,1.02195,1.02422,4375,2892.2,-797169,-805046.8,13.46186314848477,67.49636397956779,51.290431021701316,NaN,NaN,50
1658741400,1.02422,1.02491,1.0238,1.02428,3020,2976.3,-794149,-802247.2,15.171821960915356,67.68589219420525,52.267180529995144,NaN,NaN,50
1658743200,1.02428,1.02432,1.02202,1.0222,2907,3010.3,-797056,-799222.8,15.156850423854582,55.585482536251455,52.513799427582576,NaN,NaN,50
1658745000,1.0222,1.02348,1.02146,1.02348,3156,3048,-793900,-796763.6,14.712416522170898,60.290174681606935,53.120920275193775,NaN,NaN,50
1658746800,1.02348,1.02579,1.02307,1.02468,3734,3108.3,-790166,-794488,15.528524893358927,64.12666395125777,53.876920549330414,NaN,NaN,50
1658748600,1.02468,1.02496,1.0229,1.02296,3750,3148.3,-793916,-793837.4,16.153434940060247,55.80448583660694,54.173849499313455,NaN,NaN,50
1658750400,1.02296,1.02427,1.0223,1.02343,3902,3229.95,-790014,-793010.4,16.262425032743717,57.43023560268861,54.85630152882356,NaN,NaN,50
1658752200,1.02343,1.02478,1.0233,1.02456,3997,3331.05,-786017,-790802.6,16.636147400484486,61.132188325416564,55.90011684561038,NaN,NaN,50
1658754000,1.02456,1.02549,1.02357,1.02485,3147,3407.95,-782870,-788596.6,17.347495589368634,62.04442891007281,57.16463271950696,NaN,NaN,50
1658755800,1.02485,1.02504,1.02356,1.02486,4365,3548.1,-778505,-786264.4,17.999130966318237,62.07748132219697,58.35188674811395,NaN,NaN,50
1658757600,1.02486,1.02516,1.02174,1.02244,5300,3741.7,-783805,-784242.2,17.143049192863078,50.59501010924016,58.4190587269672,NaN,NaN,50
1658759400,1.02244,1.02292,1.02034,1.02184,7030,4034.2,-790835,-784406.4,16.38373526395837,48.213823566647605,58.74016108791553,NaN,NaN,50
1658761200,1.02184,1.02232,1.0206,1.021,3993,4131.45,-794828,-786168.6,15.678658044261143,45.01936117508554,58.41345419943724,NaN,NaN,50
1658763000,1.021,1.02208,1.02064,1.02102,2985,4159,-791843,-787963.2,15.023943483113717,45.112608030207895,57.32958573007515,NaN,NaN,50
1658764800,1.02102,1.02137,1.02062,1.02125,2297,4111.65,-789546,-790171.4,14.430042995008296,46.241758932983515,55.811399655319136,NaN,NaN,50
1658766600,1.02125,1.0225,1.0212,1.02214,2323,4049.7,-787223,-790855,13.785069444253237,50.48648801329797,54.58287078525433,NaN,NaN,50
1658768400,1.02214,1.0229,1.02208,1.02248,1967,3845.65,-785256,-789739.2,13.466364778089998,52.04431290092595,54.32993009701679,NaN,NaN,50
1658770200,1.02248,1.02258,1.02138,1.02204,1471,3717.65,-786727,-788119,12.604402096764403,49.858116298482024,53.58478306965072,NaN,NaN,50
1658772000,1.02204,1.02258,1.02187,1.02249,1459,3491.5,-785268,-786804,11.804008178390637,52.07538872060978,52.72397769603301,NaN,NaN,50
1658773800,1.02249,1.02274,1.02194,1.02214,1599,3338.85,-786867,-786268.2,11.193564059792239,50.21546095505053,52.32476163306469,NaN,NaN,50
1658775600,1.02214,1.02255,1.02208,1.02242,1422,3191.2,-785445,-785912.6,10.626723092522301,51.70163826850051,51.915576109194106,NaN,NaN,50
1658777400,1.02242,1.0226,1.02207,1.02254,1282,3104.3,-784163,-785694,10.14726560011659,52.35804587017808,51.28885164810565,NaN,NaN,50
1658779200,1.02254,1.02268,1.02233,1.02239,805,2999.2,-784968,-785342.2,9.781382507767903,51.41735776230957,50.529775137551134,NaN,NaN,50
1658781000,1.02239,1.02256,1.02208,1.02224,450,2863.9,-785418,-785372.2,9.160755215743196,50.44139334843686,49.69862599656826,NaN,NaN,50
1658782800,1.02224,1.02224,1.02194,1.02207,156,2685,-785574,-785113.6,8.587821464915578,49.299285289445635,49.6060742237258,NaN,NaN,50
1658784600,1.02207,1.02218,1.0219,1.02215,147,2504.85,-785427,-785110,8.103465596254122,49.87446674596,49.72469159367669,NaN,NaN,50
1658786400,1.02215,1.02224,1.02197,1.02204,692,2344.35,-786119,-785501.2,7.575287475010542,49.05047773857195,50.012628491068575,NaN,NaN,50
1658788200,1.02204,1.02226,1.02192,1.02201,596,2174.3,-786715,-785850.6,7.152815482868004,48.813614657596794,50.276986107310634,NaN,NaN,50
1658790000,1.02201,1.02216,1.02192,1.02194,529,2043.4,-787244,-786215.8,6.760520061592789,48.228395659617206,50.418888730641605,NaN,NaN,50
1658791800,1.02194,1.02241,1.02164,1.02234,736,1861.95,-786508,-786402.6,6.807890614192663,51.78553924724631,50.51167810449506,NaN,NaN,50
1658793600,1.02234,1.02279,1.02219,1.0227,1692,1681.55,-784816,-786280.4,6.3967104208495735,54.79587562514616,50.70821829908222,NaN,NaN,50
1658795400,1.0227,1.02332,1.02247,1.02302,1886,1424.35,-782930,-785642.6,6.763700451109138,57.34527026551025,51.243015011012815,NaN,NaN,50
1658797200,1.02302,1.02437,1.02276,1.02428,2562,1352.8,-780368,-784373.2,8.269471140874714,65.57733455415723,52.20743971340907,NaN,NaN,50
1658799000,1.02428,1.02502,1.02399,1.02408,1857,1296.4,-782225,-783369.4,10.231822380613313,63.483013647824805,53.15512204860723,NaN,NaN,50
1658800800,1.02408,1.02414,1.02358,1.0237,1503,1256.7,-783728,-782813.4,11.382982122744552,59.58903046734441,53.718507205667514,NaN,NaN,50
1658802600,1.0237,1.02452,1.02363,1.02386,1721,1226.6,-782007,-782251.6,12.791840169978721,60.68259018633251,54.31311751396426,NaN,NaN,50
1658804400,1.02386,1.0243,1.02362,1.02372,1090,1182.75,-783097,-782285,14.082948405183075,59.173676071732274,54.867140250351596,NaN,NaN,50
1658806200,1.02372,1.02372,1.02268,1.02304,1133,1165.85,-784230,-783057.4,13.822286920593454,52.36299629734313,55.0043976038449,NaN,NaN,50
1658808000,1.02304,1.02318,1.02256,1.02274,932,1139.5,-785162,-783644.8,13.414475364058816,49.648050660565644,55.02930941606776,NaN,NaN,50
1658809800,1.02274,1.02289,1.02232,1.02256,723,1095.7,-785885,-784076.2,12.70139203633405,48.03865286527646,54.8981798531618,NaN,NaN,50
1658811600,1.02256,1.02294,1.02224,1.02254,1083,1078.75,-786968,-785068.4,11.926157820286786,47.85303794263462,54.81264843916627,NaN,NaN,50
1658813400,1.02254,1.02267,1.02134,1.0215,1197,1074.5,-788165,-786082,12.080334666566465,39.34064647235672,54.13600785450627,NaN,NaN,50
1658815200,1.0215,1.02239,1.0215,1.02233,1859,1127.2,-786306,-786497.2,12.223498880969021,47.38483831762985,54.07575375865002,NaN,NaN,50
1658817000,1.02233,1.02294,1.02102,1.02126,2450,1227.2,-788756,-787216,11.54311647463191,40.01729440557657,53.235164841387906,NaN,NaN,50
1658818800,1.02126,1.02358,1.02084,1.02342,4003,1419.55,-784753,-786989.6,11.341372993010934,55.17043131677783,53.26191881936159,NaN,NaN,50
1658820600,1.02342,1.02362,1.02132,1.02194,3189,1571.65,-787942,-787184.4,11.202464213425452,46.501995577116176,52.48739919876201,NaN,NaN,50
1658822400,1.02194,1.02223,1.02022,1.02164,3559,1715,-791501,-787851.6,11.13993842141353,44.959925327028245,51.01472711110994,NaN,NaN,50
1658824200,1.02164,1.02205,1.02024,1.0208,3166,1843.5,-794667,-789523.8,11.081878757402459,40.8728708550885,49.39971691162878,NaN,NaN,50
1658826000,1.0208,1.02082,1.01747,1.01832,3442,1989.15,-798109,-791394.4,13.237310000462582,31.708255011651588,47.40823295050786,NaN,NaN,50
1658827800,1.01832,1.0185,1.01708,1.01758,3481,2126.4,-801590,-794761.8,15.44731809090516,29.577171431064798,45.18641732513159,NaN,NaN,50
1658829600,1.01758,1.01784,1.01357,1.01514,5182,2300.9,-806772,-798527.8,18.795768259776434,23.878453866226707,42.665330024738346,NaN,NaN,50
1658831400,1.01514,1.01522,1.01375,1.01515,3679,2390.55,-803093,-800846.2,21.905043416585475,23.94313145076879,40.63533967855445,NaN,NaN,50
1658833200,1.01515,1.01527,1.0135,1.01419,3111,2418,-806204,-803153.6,24.862605147277005,22.009751350748516,38.66117544213895,NaN,NaN,50
1658835000,1.01419,1.01428,1.01248,1.01314,3683,2509.3,-809887,-805509.2,27.879016029489286,20.098158849868142,36.665425869609784,NaN,NaN,50
1658836800,1.01314,1.01329,1.01162,1.01238,3646,2616.45,-813533,-807897.8,30.88111929565701,18.823787030734337,34.591907947331194,NaN,NaN,50
1658838600,1.01238,1.01492,1.01224,1.01484,3561,2708.45,-809972,-808537.8,31.86412500937456,33.5181060994385,34.17601220640846,NaN,NaN,50
1658840400,1.01484,1.0153,1.01335,1.01488,4385,2873.2,-805587,-809036.6,32.40508862576848,33.72817375336071,33.200536166103525,NaN,NaN,50
1658842200,1.01488,1.01506,1.01274,1.01438,4503,3041.7,-810090,-809813.8,33.16078736112504,32.35206576669346,32.65301983475472,NaN,NaN,50
1658844000,1.01438,1.01508,1.012,1.01372,5617,3275.95,-815707,-810977.8,34.15198586858747,30.578549468999242,30.896456845627682,NaN,NaN,50
1658845800,1.01372,1.01457,1.0128,1.01343,4840,3481.8,-820547,-812380.6,35.072384482659714,29.805394090844175,29.703842453751115,NaN,NaN,50
1658847600,1.01343,1.01408,1.01215,1.0123,3429,3599.1,-823976,-815181.4,36.18247715044028,26.946384975293725,28.41716100005579,NaN,NaN,50
1658849400,1.0123,1.01268,1.01128,1.01158,2698,3674.15,-826674,-819398.8,37.52615664947452,25.282298242818896,27.303548670607956,NaN,NaN,50
1658851200,1.01158,1.01229,1.01076,1.01218,2355,3698.95,-824319,-822244.6,38.94747792103565,29.2058232161652,27.124803542358933,NaN,NaN,50
1658853000,1.01218,1.01282,1.01198,1.01272,1739,3663.4,-822580,-823619.2,39.6379940719311,32.6344331388989,27.343179378632794,NaN,NaN,50
1658854800,1.01272,1.01328,1.01234,1.01272,1998,3563.15,-822580,-824025.8,39.75152266097714,32.6344331388989,27.96860646953795,NaN,NaN,50
1658856600,1.01272,1.01272,1.01164,1.01172,1982,3502.8,-824562,-824143,40.17315926568719,29.559772193850947,28.369795094043816,NaN,NaN,50
1658858400,1.01172,1.013,1.01172,1.01235,1813,3415.5,-822749,-823358,40.23770672311758,33.79188847086799,29.211376316909497,NaN,NaN,50
1658860200,1.01235,1.01242,1.01192,1.01219,1638,3339.1,-824387,-823371.6,40.297643647874374,33.245583792461346,30.1504780985233,NaN,NaN,50
1658862000,1.01219,1.01246,1.01182,1.01224,1464,3240.2,-822923,-823440.2,40.40738322987069,33.60681119605606,31.206408396046278,NaN,NaN,50
1658863800,1.01224,1.01272,1.01142,1.01142,1468,3139.55,-824391,-823802.4,40.72720424103436,30.675136843959308,31.003339163512045,NaN,NaN,50
1658865600,1.01142,1.01226,1.0114,1.01168,1149,2937.9,-823242,-823538.4,41.035268261529644,32.68041234342414,30.92849906280229,NaN,NaN,50
1658867400,1.01168,1.01204,1.0116,1.01174,559,2781.9,-822683,-823525.2,41.32132770913242,33.16089557368467,30.98627262044452,NaN,NaN,50
1658869200,1.01174,1.01221,1.01164,1.01196,382,2645.45,-822301,-823108,41.30709432173871,34.993011494677816,31.30159133656442,NaN,NaN,50
1658871000,1.01196,1.01202,1.0117,1.01186,180,2470.3,-822481,-823019.6,41.29387760487312,34.529695726967304,31.639041453430355,NaN,NaN,50
1658872800,1.01186,1.01328,1.01177,1.01268,1281,2352.05,-821200,-822381.4,39.3820333984143,41.38325248529032,32.67024627557297,NaN,NaN,50
1658874600,1.01268,1.013,1.01267,1.01292,546,2201.3,-820654,-821863.8,37.60674949241684,43.2555594206111,33.95405064541527,NaN,NaN,50
1658876400,1.01292,1.01338,1.01292,1.01328,759,2020,-819895,-821306.2,35.45240813468811,46.03978819310411,35.15647671519662,NaN,NaN,50
1658878200,1.01328,1.01334,1.01287,1.01288,956,1842.65,-820851,-821016.2,33.50937303177047,43.48661999845175,35.931632919450394,NaN,NaN,50
1658880000,1.01288,1.01408,1.01281,1.01366,1686,1646.1,-819165,-820353,31.466864477329104,49.381496425257936,37.127851725618896,NaN,NaN,50
1658881800,1.01366,1.01442,1.01328,1.01404,1470,1477.6,-817695,-819652,29.95573543251157,52.007930922667704,38.731291634820096,NaN,NaN,50
1658883600,1.01404,1.01452,1.01384,1.01402,1683,1390.3,-819378,-819396.8,28.665679901590835,51.8554264556972,40.02154434802218,NaN,NaN,50
1658885400,1.01402,1.01476,1.01369,1.0145,2736,1392.2,-816642,-818746.2,27.742480677060655,55.24721653547658,41.59308954395184,NaN,NaN,50
1658887200,1.0145,1.0147,1.01381,1.0141,1775,1363.2,-818417,-818259.4,26.88522425428263,51.96195078548666,42.90417094319689,NaN,NaN,50
1658889000,1.0141,1.01472,1.01392,1.01442,1565,1354.5,-816852,-817796.8,26.1144846510601,54.30306112402841,44.59187982034467,NaN,NaN,50
1658890800,1.01442,1.01472,1.01428,1.01455,1153,1312.25,-815699,-817397.6,25.39879787663918,55.2570411420863,46.20449616310626,NaN,NaN,50
1658892600,1.01455,1.0147,1.01426,1.01428,1161,1271.2,-816860,-816894,24.694024351746567,52.79199345029523,47.60671744000701,NaN,NaN,50
1658894400,1.01428,1.01506,1.01416,1.01498,1095,1235.3,-815765,-816718.6,24.557947438728466,58.02067412566822,49.25155048507776,NaN,NaN,50
1658896200,1.01498,1.01522,1.01482,1.01508,1038,1205.3,-814727,-815980.6,24.649419362638415,58.724006544535875,50.97971554347551,NaN,NaN,50
1658898000,1.01508,1.01508,1.01462,1.01507,872,1175.7,-815599,-815730,24.280576209234635,58.61824138129295,52.21078617890428,NaN,NaN,50
1658899800,1.01507,1.01523,1.01445,1.01462,1406,1172.6,-817005,-815991.2,23.56108707523874,53.91264371628449,52.972006485738085,NaN,NaN,50
1658901600,1.01462,1.01586,1.01342,1.01353,2797,1255,-819802,-816579.6,22.688455262633518,44.5779376608848,52.86758859057956,NaN,NaN,50
1658903400,1.01353,1.01389,1.01276,1.01312,2231,1338.6,-822033,-817833.2,22.725082305866625,41.656259776865866,52.736848574752,NaN,NaN,50
1658905200,1.01312,1.01527,1.01312,1.01421,3414,1490.2,-818619,-818611.6,21.481420056306,50.874475825697594,52.843489960497685,NaN,NaN,50
1658907000,1.01421,1.0147,1.0134,1.01397,3266,1644.5,-821885,-819868.8,20.326590824571134,49.03730868289242,52.6313026576566,NaN,NaN,50
1658908800,1.01397,1.01513,1.01342,1.01401,3328,1746.85,-818557,-820179.2,19.776274059986974,49.36550119678621,52.453450853448665,NaN,NaN,50
1658910600,1.01401,1.01482,1.01372,1.01418,2599,1849.5,-815958,-819410.4,19.26526563573025,50.815209917153545,52.136878952139874,NaN,NaN,50
1658912400,1.01418,1.01506,1.01401,1.01451,2164,1919.75,-813794,-817762.6,19.087749336698625,53.59280694321604,52.253368677691974,NaN,NaN,50
1658914200,1.01451,1.0155,1.01415,1.01431,2838,2013.85,-816632,-817365.2,19.433416460571344,51.68767037194692,52.0665550525433,NaN,NaN,50
1658916000,1.01431,1.01452,1.01384,1.01444,2067,2032.9,-814565,-815901.2,19.212871541027845,52.860678383198994,51.89538628405135,NaN,NaN,50
1658917800,1.01444,1.01547,1.01425,1.01536,2104,2064.6,-812461,-814682,20.01181145496374,60.22141799285109,52.42605946566248,NaN,NaN,50
1658919600,1.01536,1.0172,1.01528,1.01596,2672,2114.05,-809789,-813448.2,21.985632772951,64.15276921226669,52.86406625756238,NaN,NaN,50
1658921400,1.01596,1.01668,1.01497,1.01506,2793,2116.9,-812582,-813205.8,23.33717916773437,55.320810614682145,52.62098083400139,NaN,NaN,50
1658923200,1.01506,1.01566,1.01436,1.01562,2635,2159.9,-809947,-811868.8,23.70466268311369,59.09439954844378,52.65499213165502,NaN,NaN,50
1658925000,1.01562,1.01564,1.01408,1.0143,3844,2273.85,-813791,-811714,23.662568397035415,48.66149291311376,52.27990993142854,NaN,NaN,50
1658926800,1.0143,1.01524,1.01398,1.01436,2937,2363.05,-810854,-811392.6,23.484438584541202,49.101365734180746,52.60301193666396,NaN,NaN,50
1658928600,1.01436,1.01518,1.01275,1.01344,4056,2507.8,-814910,-812416.8,21.82027272039887,43.01540470812666,52.7000937174683,NaN,NaN,50
1658930400,1.01344,1.01404,1.01097,1.01102,3682,2637.15,-818592,-813618.8,21.769236974550537,31.83699761277319,51.340273845116556,NaN,NaN,50
1658932200,1.01102,1.01241,1.01092,1.01202,3538,2762.15,-815054,-814640.2,21.75784439241688,38.90258193100128,50.61636479141005,NaN,NaN,50
1658934000,1.01202,1.01378,1.01128,1.01312,2876,2862.35,-812178,-814317.6,20.369620218684368,45.58447558485889,50.34629153341525,NaN,NaN,50
1658935800,1.01312,1.01358,1.01053,1.01053,2722,2928.15,-814900,-815126.8,19.67713444695838,35.68781951592783,49.26576364761341,NaN,NaN,50
1658937600,1.01053,1.0115,1.00968,1.00998,2107,2893.65,-817007,-815546.2,19.637059122551022,33.999733261544364,47.86625838463686,NaN,NaN,50
1658939400,1.00998,1.0116,1.00996,1.0111,1770,2870.6,-815237,-814875.2,19.499182680539644,40.20265805673399,47.04590036212165,NaN,NaN,50
1658941200,1.0111,1.0125,1.0111,1.01231,1759,2787.85,-813478,-814560,18.50621880994952,46.09676102050306,46.562763407643374,NaN,NaN,50
1658943000,1.01231,1.0143,1.0119,1.01301,2060,2727.55,-811418,-814408,18.152651049766906,49.21540084635869,45.77661932575105,NaN,NaN,50
1658944800,1.01301,1.0154,1.01219,1.01427,7394,2930.85,-804024,-812232.8,18.482813179382326,54.33664375702256,45.07546750751934,NaN,NaN,50
1658946600,1.01427,1.02122,1.01066,1.01996,15123,3557.05,-788901,-806611.6,20.874312450367796,69.36212501860565,46.07841853637102,NaN,NaN,50
1658948400,1.01996,1.02098,1.01872,1.02092,7593,3828.5,-781308,-799825.8,23.094990344854303,71.0905256170783,46.93528468413062,NaN,NaN,50
1658950200,1.02092,1.02209,1.02036,1.02086,3882,3880.7,-785190,-794168.2,25.421775448965654,70.82160985184157,48.51815017975404,NaN,NaN,50
1658952000,1.02086,1.02086,1.0194,1.0196,1878,3871.25,-787068,-789298.2,26.83689322722599,65.24043812728024,49.67094106497542,NaN,NaN,50
1658953800,1.0196,1.02014,1.01946,1.01996,1038,3817.95,-786030,-785699.4,28.150931164182012,66.06333496183552,51.3172217973832,NaN,NaN,50
1658955600,1.01996,1.02032,1.01968,1.02003,1029,3735.8,-785001,-784919.4,29.427320697760457,66.23074166475965,53.773917801096516,NaN,NaN,50
1658957400,1.02003,1.02026,1.01988,1.02007,224,3607.35,-784777,-785613.2,30.61253955036901,66.33294274199729,55.73322928759624,NaN,NaN,50
1658959200,1.02007,1.02028,1.01946,1.01948,1198,3535.5,-785975,-785770.2,31.32270755158824,63.29032107541951,56.997932536922,NaN,NaN,50
1658961000,1.01948,1.02026,1.01888,1.02024,1056,3396.1,-784919,-785340.4,31.452764782744815,65.48643456545744,59.12640504045985,NaN,NaN,50
1658962800,1.02024,1.02071,1.02014,1.02045,1084,3303.45,-783835,-784901.4,31.77505005145344,66.09009287032072,61.418573583943875,NaN,NaN,50
1658964600,1.02045,1.02066,1.02008,1.02055,1434,3172.35,-782401,-784381.4,32.01582299098501,66.3915428905621,63.28920821493159,NaN,NaN,50
1658966400,1.02055,1.02124,1.01862,1.01864,2495,3113,-784896,-784405.2,30.92352241653152,56.12821910219868,64.00574093505271,NaN,NaN,50
1658968200,1.01864,1.01925,1.01804,1.01864,1859,3029.05,-784896,-784189.4,29.449818420489173,56.12821910219868,64.4995136676127,NaN,NaN,50
1658970000,1.01864,1.0201,1.01838,1.01974,3150,3042.75,-781746,-783554.8,28.59406025306552,60.2341721734144,64.92076569735498,NaN,NaN,50
1658971800,1.01974,1.02147,1.01966,1.02062,3568,3085.05,-778178,-782423.4,28.518281096834748,63.2012975181828,64.48070659018192,NaN,NaN,50
1658973600,1.02062,1.0207,1.01962,1.02006,2299,3094.65,-780477,-782038.6,28.413120323881074,60.12673367528648,63.697578594339646,NaN,NaN,50
1658975400,1.02006,1.02064,1.01992,1.02053,1759,3094.1,-778718,-780803,28.315471034709805,61.806102229137565,63.05361376414651,NaN,NaN,50
1658977200,1.02053,1.02158,1.02048,1.0214,1387,3075.5,-777331,-779290,28.716116289352083,64.76446325799373,63.01961555919747,NaN,NaN,50
1658979000,1.0214,1.02142,1.02057,1.02097,1468,3045.9,-778799,-778700.6,29.08814402580563,62.20008517071643,62.74366914554611,NaN,NaN,50
1658980800,1.02097,1.02128,1.02022,1.02086,1485,2750.45,-780284,-779121.8,29.059355931314553,61.52891376215497,62.40782429536006,NaN,NaN,50
1658982600,1.02086,1.02232,1.02004,1.02023,2600,2124.3,-782884,-779603.2,29.59938145641147,57.68944302558597,61.79043145847353,NaN,NaN,50
1658984400,1.02023,1.02069,1.02016,1.02068,1458,1817.55,-781426,-780144.8,30.10083372971576,59.62736316749758,61.52879160790768,NaN,NaN,50
1658986200,1.02068,1.02258,1.02068,1.0221,2030,1724.95,-779396,-780557.8,31.426427243218136,65.06498046703285,61.49868774373449,NaN,NaN,50
1658988000,1.0221,1.02282,1.02164,1.0227,3471,1804.6,-775925,-779983,32.750185817893026,67.08240461775537,61.56956715426554,NaN,NaN,50
1658989800,1.0227,1.02346,1.02027,1.02162,4002,1952.8,-779927,-779911.6,32.53673837904675,60.32904517479834,61.13653160313957,NaN,NaN,50
1658991600,1.02162,1.02169,1.01852,1.01958,6018,2202.25,-785945,-780523.8,30.889702556644277,50.07444987248574,60.70411951530292,NaN,NaN,50
1658993400,1.01958,1.02114,1.01864,1.02101,4483,2415.2,-781462,-780531,29.360312150127694,55.75217721991673,60.67725938085421,NaN,NaN,50
1658995200,1.02101,1.02141,1.01963,1.02022,4393,2574.95,-785855,-781822.8,28.116093604656538,52.21907207943131,60.104752231283996,NaN,NaN,50
1658997000,1.02022,1.02196,1.01987,1.02176,3929,2718.6,-781926,-783023,27.315041669085222,57.82933816414502,59.72104084885273,NaN,NaN,50
1658998800,1.02176,1.02176,1.02,1.02012,4171,2872.95,-786097,-784257,26.571207728911855,50.9662528862738,59.06672079249468,NaN,NaN,50
1659000600,1.02012,1.02018,1.01521,1.01532,4118,3007.15,-790215,-785111,26.49397190044415,37.09144452789308,57.301388099548646,NaN,NaN,50
1659002400,1.01532,1.01658,1.01496,1.01584,4148,3089.8,-786067,-786032,26.528561993645628,39.027963599051326,55.46306669533847,NaN,NaN,50
1659004200,1.01584,1.01608,1.01237,1.01338,4587,3226.2,-790654,-786991.8,27.511233796993075,33.73699789607711,53.429989032864235,NaN,NaN,50
1659006000,1.01338,1.01368,1.01218,1.01286,3609,3249.15,-794263,-789459.2,28.48425308868588,32.72700518338766,51.37270984866657,NaN,NaN,50
1659007800,1.01286,1.01325,1.0114,1.01183,3757,3258.6,-798020,-791843.8,29.636036949579598,30.762505024396987,49.44935713429594,NaN,NaN,50
1659009600,1.01183,1.01324,1.01158,1.01307,4668,3377.05,-793352,-792471.2,30.705550534695185,35.7617951692791,47.74467370585175,NaN,NaN,50
1659011400,1.01307,1.0175,1.01282,1.01639,9587,3768.45,-783765,-792010.8,28.887123021337402,46.831214045602394,46.44226181860672,NaN,NaN,50
1659013200,1.01639,1.01732,1.01476,1.0169,7276,4062.9,-776489,-789177.8,27.198583187505175,48.304875708591375,45.101009753666425,NaN,NaN,50
1659015000,1.0169,1.01705,1.0126,1.01396,8567,4417.85,-785056,-787336.4,26.56449169789431,41.21333446517405,43.73560184583612,NaN,NaN,50
1659016800,1.01396,1.01654,1.0139,1.016,6526,4669.9,-778530,-783438.4,25.97569245754136,47.02484971634652,43.517773263254746,NaN,NaN,50
1659018600,1.016,1.01686,1.01486,1.01562,6169,4848.35,-784699,-781707.8,25.23323074603672,46.11042533813994,42.8290767002707,NaN,NaN,50
1659020400,1.01562,1.01672,1.01462,1.01631,4210,4985.95,-780489,-781052.6,24.654517419236452,48.08451761999827,42.53375138173976,NaN,NaN,50
1659022200,1.01631,1.01711,1.01548,1.01654,3906,5079.75,-776583,-781071.4,23.85667857879445,48.75834594573523,41.885823366139064,NaN,NaN,50
1659024000,1.01654,1.01654,1.01454,1.01472,2882,5050.3,-779465,-779953.2,23.577852004390447,43.902450098855184,41.38126602418059,NaN,NaN,50
1659025800,1.01472,1.01586,1.01422,1.0158,2544,4977.4,-776921,-779631.4,23.471480069202542,47.259092293490816,42.10752657886614,NaN,NaN,50
1659027600,1.0158,1.01666,1.01553,1.01578,2324,4792.7,-779245,-778540.6,22.7883062146894,47.20276491778941,42.691440958776006,NaN,NaN,50
1659029400,1.01578,1.01636,1.01557,1.01602,1430,4640.05,-777815,-778005.8,22.153930492641486,48.003654949994285,43.71048789119867,NaN,NaN,50
1659031200,1.01602,1.01679,1.01561,1.0166,1675,4504.15,-776140,-777917.2,21.238610506216354,49.978442384048286,44.94273340553156,NaN,NaN,50
1659033000,1.0166,1.01768,1.01626,1.01766,2214,4418.4,-773926,-776809.4,19.747885295475427,53.45748642985986,46.563803505921776,NaN,NaN,50
1659034800,1.01766,1.01884,1.01764,1.0186,1777,4298.7,-772149,-775855,19.05137026768357,56.35636674635739,48.03484433285593,NaN,NaN,50
1659036600,1.0186,1.01881,1.01834,1.01865,1361,4160.85,-770788,-774163.6,18.40460631330542,56.51152734291276,48.72629528266382,NaN,NaN,50
1659038400,1.01865,1.01938,1.0185,1.01913,846,3995.75,-769942,-772589,18.161361122516496,58.05327918148141,49.422609816441685,NaN,NaN,50
1659040200,1.01913,1.01997,1.0191,1.01964,800,3806.4,-769142,-771189.4,18.289714976560305,59.68852349435134,50.74226617566863,NaN,NaN,50
1659042000,1.01964,1.01968,1.01938,1.01958,120,3631.95,-769262,-770256.6,18.40890069817241,59.39516310807133,51.625859989363256,NaN,NaN,50
1659043800,1.01958,1.01971,1.0193,1.01955,261,3457.15,-769523,-769731.4,18.44167508948311,59.23839108054231,52.563571828106284,NaN,NaN,50
1659045600,1.01955,1.01965,1.01912,1.01922,718,3259.65,-770241,-769622,18.28910285443384,57.44230670119379,53.23198533390597,NaN,NaN,50
1659047400,1.01922,1.0196,1.019,1.01952,824,2821.5,-769417,-769517,18.020831013786598,58.66915197905033,53.93990005057133,NaN,NaN,50
1659049200,1.01952,1.01962,1.01915,1.01931,882,2501.8,-770299,-769748.4,17.78837354000913,57.42128766278477,54.90553130513773,NaN,NaN,50
1659051000,1.01931,1.01938,1.0189,1.0192,1125,2129.7,-771424,-770180.8,17.28217124171783,56.74050447585645,55.58277503244956,NaN,NaN,50
1659052800,1.0192,1.01992,1.01894,1.01925,2140,1910.4,-769284,-770133,17.297642980403744,56.99011687772929,56.28187160101669,NaN,NaN,50
1659054600,1.01925,1.02031,1.01914,1.0198,2401,1722,-766883,-769461.4,17.641389389407777,59.74190681396853,57.12031816272914,NaN,NaN,50
1659056400,1.0198,1.02042,1.0195,1.01992,1968,1609.9,-764915,-768561,18.05346181986333,60.33814972192116,57.860297258291496,NaN,NaN,50
1659058200,1.01992,1.0203,1.0194,1.01972,1760,1502.6,-766675,-767836.2,18.294344663330637,58.7757167599252,58.24017085329616,NaN,NaN,50
1659060000,1.01972,1.01992,1.01914,1.01937,1445,1430.75,-768120,-767175.4,18.144315075591738,56.04084593346536,58.217633652375305,NaN,NaN,50
1659061800,1.01937,1.01959,1.01912,1.01958,1400,1373.55,-766720,-766662.6,17.97548320228018,57.32394183194776,58.275663258734944,NaN,NaN,50
1659063600,1.01958,1.02082,1.01916,1.0201,2221,1368.4,-764499,-766185.8,18.96559961163007,60.405783192384675,58.44369925951374,NaN,NaN,50
1659065400,1.0201,1.0225,1.01992,1.02132,2513,1422.55,-761986,-765600,20.95131968574539,66.51537970790349,58.93133184619604,NaN,NaN,50
1659067200,1.02132,1.02216,1.02125,1.0216,2100,1443.8,-759886,-764242.2,22.795202611709616,67.74551743020886,59.527785726348725,NaN,NaN,50
1659069000,1.0216,1.02165,1.02082,1.02092,1584,1412.3,-761470,-762912.2,23.8674379800276,61.80695569574916,59.711254627434926,NaN,NaN,50
1659070800,1.02092,1.02205,1.02092,1.02118,2198,1433.35,-759272,-761422.6,25.119096295534177,63.137515599089106,60.11805526299889,NaN,NaN,50
1659072600,1.02118,1.02198,1.02098,1.021,3058,1518.2,-762330,-760988.8,26.281350445647423,61.53911640516946,60.32305272200739,NaN,NaN,50
1659074400,1.021,1.02508,1.02098,1.02496,4660,1708.9,-757670,-760125.6,28.789104740762628,75.95891493088303,61.64716895544297,NaN,NaN,50
1659076200,1.02496,1.02543,1.02323,1.02422,4817,1909.75,-762487,-760645.8,31.227597850953426,70.62986797884157,62.63926634851334,NaN,NaN,50
1659078000,1.02422,1.02528,1.02246,1.02348,5663,2186.9,-768150,-761981.8,32.48824704863647,65.6683817316322,63.2591424095064,NaN,NaN,50
1659079800,1.02348,1.02434,1.02222,1.02364,4353,2391.5,-763797,-762886.8,33.35967051287323,66.22089721592826,63.721927438217804,NaN,NaN,50
1659081600,1.02364,1.0237,1.02086,1.02118,4692,2590.2,-768489,-764118.6,32.65446005765928,52.28773189449026,63.14689759340131,NaN,NaN,50
1659083400,1.02118,1.02234,1.0203,1.02214,4087,2753.35,-764402,-765465,31.461453677795376,56.163939722658405,62.9603420907394,NaN,NaN,50
1659085200,1.02214,1.02302,1.01912,1.01991,4323,2925.4,-768725,-766712.6,29.34640426661419,46.67750650652569,62.291532131672284,NaN,NaN,50
1659087000,1.01991,1.02078,1.01856,1.02029,3263,3032.3,-765462,-766175,27.543758992346756,48.28061228954832,61.64558002150089,NaN,NaN,50
1659088800,1.02029,1.0219,1.01972,1.02139,3152,3082.9,-762310,-765877.6,26.115187500889103,52.71252900650371,61.096061865366536,NaN,NaN,50
1659090600,1.02139,1.02458,1.02134,1.02411,3540,3139.85,-758770,-763933.8,26.267079004019152,61.498285916491106,60.737698023122796,NaN,NaN,50
1659092400,1.02411,1.02411,1.02152,1.02212,3450,3213.95,-762220,-763497.4,26.40812111406848,53.64531876465183,59.730540975583004,NaN,NaN,50
1659094200,1.02212,1.0227,1.02056,1.02092,3821,3317,-766041,-762960.6,25.75966094035292,49.53744380749997,58.854147269279494,NaN,NaN,50
1659096000,1.02092,1.02108,1.01862,1.01988,4987,3494.1,-771028,-764073.8,23.991292606919,46.233171377974955,57.64669411062848,NaN,NaN,50
1659097800,1.01988,1.01994,1.01744,1.01773,7878,3818,-778906,-767393,23.005758576675493,40.25519741939285,56.12641418307301,NaN,NaN,50
1659099600,1.01773,1.01774,1.0146,1.01596,5817,3997.8,-784723,-772583.6,23.33486361733086,36.11511637925876,53.28042857224271,NaN,NaN,50
1659101400,1.01596,1.01671,1.01478,1.01658,6141,4179.2,-778582,-775856,23.640461155082278,38.50104646688552,50.98551274996014,NaN,NaN,50
1659103200,1.01658,1.01729,1.01526,1.01695,6508,4399.6,-772074,-777062.6,23.52385570291447,39.94256783107291,49.1479546142059,NaN,NaN,50
1659105000,1.01695,1.01981,1.0163,1.01954,6900,4665.4,-765174,-775891.8,21.929843579152593,48.961126963046915,47.91511388185723,NaN,NaN,50
1659106800,1.01954,1.0213,1.01927,1.02018,6319,4871.45,-758855,-771881.6,20.985075689073067,50.922315540057795,47.81758414225492,NaN,NaN,50
1659108600,1.02018,1.02114,1.01922,1.02016,3709,4904,-762564,-767449.8,20.080410655428906,50.856549774948974,47.43848486027567,NaN,NaN,50
1659110400,1.02016,1.02108,1.01866,1.01882,2867,4814.35,-765431,-764819.6,18.924703584352272,46.521401016618334,47.42733446813943,NaN,NaN,50
1659112200,1.01882,1.01974,1.01772,1.01972,2296,4688.3,-763135,-763031.8,17.804074852686284,49.62721518551174,47.523520389279675,NaN,NaN,50
1659114000,1.01972,1.02017,1.01937,1.01964,1826,4496.45,-764961,-762989.2,16.542564441458456,49.35284318881414,47.28354283087328,NaN,NaN,50
1659115800,1.01964,1.02141,1.01943,1.021,1909,4374.25,-763052,-763828.6,16.029249696162662,54.008014246215,46.748523425853556,NaN,NaN,50
1659117600,1.021,1.02138,1.02068,1.02089,1489,4214.1,-764541,-764224,15.552600289816567,53.57905691084212,46.743790436295725,NaN,NaN,50
1659119400,1.02089,1.02206,1.02066,1.02198,1913,4105.4,-762628,-763663.4,15.468865671046093,57.20612723895185,47.29155353854229,NaN,NaN,50
1659121200,1.02198,1.0223,1.02128,1.02136,1720,3975.25,-764348,-763906,15.51729575595338,54.59318204449084,47.88869715757914,NaN,NaN,50
1659123000,1.02136,1.02222,1.02127,1.02211,1781,3901.15,-762567,-763427.2,15.554592781974478,57.14330259372681,49.09499038431728,NaN,NaN,50
1659124800,1.02211,1.0227,1.02172,1.02262,1262,3806.65,-761305,-763077.8,15.862889956171816,58.83626761373416,50.71792975820838,NaN,NaN,50
1659126600,1.02262,1.0227,1.02246,1.02266,531,3656.2,-760774,-762324.4,16.14916590364077,58.97315766154845,52.18022341497001,NaN,NaN,50
1659301200,1.02266,1.02266,1.02152,1.02204,203,3493.85,-760977,-761994.2,15.6109406905322,55.87170311578263,53.31801879244928,NaN,NaN,50
1659303000,1.02204,1.02232,1.02194,1.02194,199,3312.75,-761176,-761359.8,15.111160135502812,55.365940512437064,53.775505474548574,NaN,NaN,50
1659304800,1.02194,1.02253,1.0208,1.02152,1418,3134.3,-762594,-761365.2,14.32166515130657,53.188209920901826,53.93735507318029,NaN,NaN,50
1659306600,1.02152,1.02182,1.02127,1.02152,804,2780.6,-762594,-761623,13.588562665981488,53.18820992090184,54.103902226462644,NaN,NaN,50
1659308400,1.02152,1.0217,1.02082,1.02094,1007,2540.1,-763601,-762188.4,13.255301435873115,50.036157094311704,54.354956232012164,NaN,NaN,50
1659310200,1.02094,1.02118,1.02056,1.02104,989,2282.5,-762612,-762515.4,13.144812342241835,50.579955506451356,54.423009112079285,NaN,NaN,50
1659312000,1.02104,1.02263,1.02079,1.02238,2647,2089.45,-759965,-762273.2,12.607809994457709,57.28834116151848,54.989830395843875,NaN,NaN,50
1659313800,1.02238,1.02242,1.02154,1.02205,2802,1884.55,-762767,-762307.8,12.109164957229591,55.29759911129275,55.08194360049229,NaN,NaN,50
1659315600,1.02205,1.02348,1.02158,1.0233,3210,1729.1,-759557,-761700.4,12.429911503865512,60.84754219997758,55.60112112114482,NaN,NaN,50
1659317400,1.0233,1.02406,1.02307,1.02328,2491,1668.2,-762048,-761389.8,13.109724320096092,60.71765172243248,55.85194429853629,NaN,NaN,50
1659319200,1.02328,1.02393,1.02318,1.02388,1985,1624.1,-760063,-760880,13.740979078024484,63.25204160958355,56.47043426747148,NaN,NaN,50
1659321000,1.02388,1.02415,1.02372,1.02399,1414,1580,-758649,-760616.8,14.480090954164043,63.71425040194656,56.939787682344324,NaN,NaN,50
1659322800,1.02399,1.02406,1.02248,1.02279,1943,1585.85,-760592,-760181.8,13.90116073813568,55.5114720767324,56.702302286844194,NaN,NaN,50
1659324600,1.02279,1.02291,1.02238,1.02258,1203,1550.55,-761795,-760629.4,13.27053707393609,54.19649456283772,56.36111206550772,NaN,NaN,50
1659326400,1.02258,1.02296,1.02208,1.0228,1265,1539.35,-760530,-760325.8,12.399330542359307,55.388746610234804,56.3266151722543,NaN,NaN,50
1659328200,1.0228,1.02316,1.02224,1.02241,1067,1497.05,-761597,-760632.6,11.778288807399052,52.7666108667091,56.140948768988004,NaN,NaN,50
1659330000,1.02241,1.02258,1.02217,1.02238,955,1458.8,-762552,-761413.2,11.12808529741814,52.560484133265966,56.09611121272831,NaN,NaN,50
1659331800,1.02238,1.02248,1.02136,1.02162,1529,1446.2,-764081,-762111,10.949375913454416,47.49838143508838,55.689694892313064,NaN,NaN,50
1659333600,1.02162,1.02231,1.02132,1.0218,2504,1508.3,-761577,-762067.4,10.821414708113272,48.757157294165445,55.598337763731195,NaN,NaN,50
1659335400,1.0218,1.0241,1.02158,1.02334,3377,1650.6,-758200,-761601.4,11.102114770162741,58.02885789946742,56.130402220375196,NaN,NaN,50
1659337200,1.02334,1.02407,1.0227,1.0228,3586,1819.75,-761786,-761639.2,11.362764827780104,54.31757324419157,55.91820451199471,NaN,NaN,50
1659339000,1.0228,1.02408,1.02246,1.02301,3644,1992,-758142,-760757.2,11.334824239747174,55.509254595953664,55.93332276089906,NaN,NaN,50
1659340800,1.02301,1.02466,1.02272,1.02398,3388,2090.5,-754754,-758891.8,11.810960751060174,60.619370531732734,55.91702478459586,NaN,NaN,50
1659342600,1.02398,1.02678,1.02398,1.0256,3664,2233.5,-751090,-756794.4,13.641808863544004,67.3617848456426,56.39160572196801,NaN,NaN,50
1659344400,1.0256,1.02648,1.02516,1.02562,3085,2337.4,-748005,-754755.4,15.341882110850413,67.43591098468904,56.690453534475544,NaN,NaN,50
1659346200,1.02562,1.02702,1.02558,1.02641,3244,2450.15,-744761,-751350.4,17.213009879292006,70.30479557206141,57.161206760912314,NaN,NaN,50
1659348000,1.02641,1.02675,1.02534,1.02574,2793,2457.45,-747554,-749232.8,18.643365740573863,65.0690224298387,57.84388892899134,NaN,NaN,50
1659349800,1.02574,1.02627,1.02463,1.02518,2886,2461.65,-750440,-748370,19.106542240235154,60.98122008720276,58.3285121807317,NaN,NaN,50
1659351600,1.02518,1.02543,1.02348,1.02429,3212,2461.75,-753652,-748882.4,18.34443466355868,55.06089523502502,58.305094225359575,NaN,NaN,50
1659353400,1.02429,1.02469,1.02291,1.02332,3420,2508.2,-757072,-750695.8,17.121933585052787,49.42849827839154,58.066657611908326,NaN,NaN,50
1659355200,1.02332,1.02411,1.02252,1.0232,3879,2602.9,-760951,-753933.8,16.14872183199544,48.76392505774375,57.79547482079959,NaN,NaN,50
1659357000,1.0232,1.02408,1.0227,1.02362,4322,2748.3,-756629,-755748.8,15.245025204156477,51.235219121149825,58.06239179837541,NaN,NaN,50
1659358800,1.02362,1.02627,1.02266,1.02497,5168,2909.55,-751461,-755953,15.630047191526833,58.21219600592231,58.73775170635804,NaN,NaN,50
1659360600,1.02497,1.02572,1.02398,1.02542,5223,3110.55,-746238,-754470.2,15.987567608370737,60.25356993101566,58.89665970861149,NaN,NaN,50
1659362400,1.02542,1.02703,1.02341,1.02605,7965,3445.55,-738273,-750710.4,17.108866832171845,62.98016246794256,59.515416081736554,NaN,NaN,50
1659364200,1.02605,1.0275,1.02583,1.02726,5471,3665.75,-732802,-745080.6,18.399182011650776,67.58020533027897,60.37762684847407,NaN,NaN,50
1659366000,1.02726,1.02748,1.02666,1.02724,3824,3809.2,-736626,-741080,19.59733182116692,67.43105759957243,60.86417592474834,NaN,NaN,50
1659367800,1.02724,1.02754,1.02667,1.02684,2355,3850.5,-738981,-738584,20.744635863065323,64.37118512492108,60.65056165898251,NaN,NaN,50
1659369600,1.02684,1.02742,1.02627,1.02648,2425,3846.55,-741406,-737617.6,21.31477663549132,61.659312862656705,60.23794750740878,NaN,NaN,50
1659371400,1.02648,1.0275,1.0263,1.0274,1928,3774.1,-739478,-737858.6,21.899621080168195,65.64281707917218,59.90494904363097,NaN,NaN,50
1659373200,1.0274,1.02744,1.02565,1.0257,2189,3704.25,-741667,-739631.6,21.638111717825577,54.39624678542203,59.14260792617264,NaN,NaN,50
1659375000,1.0257,1.02597,1.02532,1.02595,1980,3621.05,-739687,-740243.8,21.01187702232818,55.600956131958945,58.75830335794094,NaN,NaN,50
1659376800,1.02595,1.02624,1.02504,1.0252,1897,3546.5,-741584,-740764.4,20.10926081018188,51.22874294029368,58.484578194031556,NaN,NaN,50
1659378600,1.0252,1.02568,1.02456,1.02539,2524,3489.5,-739060,-740295.2,18.74089372599493,52.25307669274227,58.68633379505661,NaN,NaN,50
1659380400,1.02539,1.02596,1.02494,1.02542,2188,3444.65,-736872,-739774,17.76213026532137,52.42298985292495,58.947695566140986,NaN,NaN,50
1659382200,1.02542,1.02596,1.02534,1.02584,1676,3366.25,-735196,-738479.8,16.85327848041021,54.84565764592971,59.20558403219669,NaN,NaN,50
1659384000,1.02584,1.02613,1.02558,1.02577,822,3267.7,-736018,-737746,16.20081761999441,54.34892680512173,58.92963623213951,NaN,NaN,50
1659385800,1.02577,1.02607,1.02563,1.02602,549,3150.85,-735469,-736523,15.594961106751168,55.885615009833124,58.61763945205504,NaN,NaN,50
1659387600,1.02602,1.02618,1.02562,1.02602,129,2996.7,-735469,-735804.8,15.169115438681121,55.885615009833124,58.11088606219008,NaN,NaN,50
1659389400,1.02602,1.02604,1.02584,1.02588,201,2835.75,-735670,-735564.4,14.773687318330367,54.68997649468597,57.19015543107629,NaN,NaN,50
1659391200,1.02588,1.02623,1.02584,1.026,730,2678.3,-734940,-735513.2,14.664032407166507,55.56745987066035,56.34275559329685,NaN,NaN,50
1659393000,1.026,1.02637,1.02594,1.02623,797,2502.05,-734143,-735138.2,14.752390270739385,57.275329083040994,55.83590873316256,NaN,NaN,50
1659394800,1.02623,1.02688,1.02616,1.0265,1294,2308.35,-732849,-734614.2,15.479922251503526,59.25524083931267,55.664189302923695,NaN,NaN,50
1659396600,1.0265,1.02654,1.02594,1.02632,1405,2117.45,-734254,-734371.2,15.731189240285042,57.347263418802925,55.07164975575447,NaN,NaN,50
1659398400,1.02632,1.02726,1.02563,1.0271,3272,1882.8,-730982,-733433.6,16.794906092209555,62.91915733367793,55.680429080629885,NaN,NaN,50
1659400200,1.0271,1.0294,1.02672,1.02866,3938,1806.15,-727044,-731854.4,19.34254360464597,71.0614598842997,56.78475077722565,NaN,NaN,50
1659402000,1.02866,1.02868,1.02652,1.02732,3745,1802.2,-730789,-731183.6,21.37378181799217,59.064090164559786,57.344418436101805,NaN,NaN,50
1659403800,1.02732,1.02833,1.02656,1.02682,4324,1900.65,-735113,-731636.4,23.25993158752793,55.31161241677365,57.562885273532615,NaN,NaN,50
1659405600,1.02682,1.02719,1.02611,1.02682,2748,1916.8,-735113,-731808.2,24.228238141812856,55.31161241677365,57.76921545666466,NaN,NaN,50
1659407400,1.02682,1.02766,1.02672,1.02748,2578,1949.3,-732535,-732118.8,25.474980140676205,59.27277547316484,58.08543815861003,NaN,NaN,50
1659409200,1.02748,1.02826,1.02653,1.02767,3076,1993.65,-729459,-732601.8,27.031510250432007,60.362040776847,58.514946299447544,NaN,NaN,50
1659411000,1.02767,1.0277,1.02706,1.02737,1947,1992,-731406,-732725.2,28.476859638062386,57.736309872594774,58.647138789644806,NaN,NaN,50
1659412800,1.02737,1.0276,1.02705,1.02716,1752,1984.75,-733158,-732334.2,29.799537639643546,55.90312971772832,58.64838984020874,NaN,NaN,50
1659414600,1.02716,1.02797,1.02684,1.02712,3319,2024.5,-736477,-732607,31.287323538773876,55.54138830109293,58.70920496923782,NaN,NaN,50
1659416400,1.02712,1.02761,1.02696,1.02747,2983,2064.25,-733494,-732798.8,32.66883901653775,58.09647370242774,58.88984881436405,NaN,NaN,50
1659418200,1.02747,1.02767,1.02654,1.02677,2161,2088.5,-735655,-734038,33.06093509372214,51.69719293724446,58.49141051823573,NaN,NaN,50
1659420000,1.02677,1.02677,1.02516,1.02548,3987,2246.75,-739642,-735685.2,31.18911284285811,42.42329796234598,57.289128884166686,NaN,NaN,50
1659421800,1.02548,1.02548,1.0236,1.02417,3293,2383.95,-742935,-737640.6,30.12175666906608,35.46555688212932,55.72614984583286,NaN,NaN,50
1659423600,1.02417,1.02485,1.02346,1.02404,4218,2588.4,-747153,-739775.8,29.25308172680325,34.85464131227417,53.72154155858972,NaN,NaN,50
1659425400,1.02404,1.02404,1.02152,1.02248,5081,2832.4,-752234,-743523.8,29.81750383337573,28.508440619608407,50.68204018254035,NaN,NaN,50
1659427200,1.02248,1.02446,1.02194,1.0235,4591,3025.45,-747643,-745921.4,29.83484593680206,36.632614830439415,49.079791944388894,NaN,NaN,50
1659429000,1.0235,1.02414,1.02286,1.02408,4148,3193,-743495,-746692,29.85094931855508,40.75535588255325,48.04005933480172,NaN,NaN,50
1659430800,1.02408,1.02434,1.02322,1.02352,3004,3278.5,-746499,-747404.8,29.607880743982268,38.17297111247133,46.8158706702087,NaN,NaN,50
1659432600,1.02352,1.02456,1.02313,1.0238,3299,3373.2,-743200,-746614.2,29.094472875513222,40.21282464667261,45.45444561117354,NaN,NaN,50
1659434400,1.0238,1.02392,1.02304,1.02341,2599,3339.55,-745799,-745327.2,28.694425636104526,38.316562366992095,43.87976858189819,NaN,NaN,50
1659436200,1.02341,1.02374,1.02215,1.02268,2888,3287.05,-748687,-745536,29.02489835475969,34.99052432017224,42.25506961386801,NaN,NaN,50
1659438000,1.02268,1.02428,1.02238,1.0238,2983,3248.95,-745704,-745977.8,28.594384670753303,43.14488738611474,41.34376659018132,NaN,NaN,50
1659439800,1.0238,1.02409,1.02192,1.02238,3806,3223.05,-749510,-746580,28.559411406207403,36.83614790080603,40.00767799016082,NaN,NaN,50
1659441600,1.02238,1.02329,1.02101,1.02166,4574,3314.35,-754084,-748756.8,29.162718005192023,34.11247285030571,38.29453507215211,NaN,NaN,50
1659443400,1.02166,1.02186,1.02069,1.02119,4250,3397.95,-758334,-751263.8,29.92444454986674,32.42694045648989,36.91808846638393,NaN,NaN,50
1659445200,1.02119,1.02314,1.02119,1.02246,4848,3486.55,-753486,-752223.6,29.016560126121867,40.92155202088878,36.81082089913698,NaN,NaN,50
1659447000,1.02246,1.0236,1.02024,1.02071,7260,3752.2,-760746,-755232,28.850382117438635,34.487923275769674,36.74098992725415,NaN,NaN,50
1659448800,1.02071,1.021,1.01812,1.02073,6609,3995.05,-754137,-756157.4,29.825769936562214,34.61444419819007,36.72383299053386,NaN,NaN,50
1659450600,1.02073,1.0212,1.01932,1.01998,6588,4158.5,-760725,-757485.6,30.513166953562237,32.110075533772886,36.98109262725989,NaN,NaN,50
1659452400,1.01998,1.02044,1.01912,1.02006,5060,4262.35,-755665,-756951.8,31.24910869812304,32.669659313584404,36.69802437605596,NaN,NaN,50
1659454200,1.02006,1.02132,1.01914,1.0196,3649,4336.75,-759314,-758117.4,30.960451627438605,31.083168357297524,36.0071538385377,NaN,NaN,50
1659456000,1.0196,1.02106,1.01922,1.02068,3353,4305.05,-755961,-757160.4,30.692412918945916,38.6197167262834,36.03906423952427,NaN,NaN,50
1659457800,1.02068,1.02068,1.01933,1.01952,2446,4262.7,-758407,-758014.4,30.443519832488423,34.283142993931705,35.61551555004278,NaN,NaN,50
1659459600,1.01952,1.01962,1.01727,1.01754,2984,4201,-761391,-758147.6,31.35785463893083,28.41750249183434,34.90843984467437,NaN,NaN,50
1659461400,1.01754,1.01846,1.01711,1.0184,3380,4115.95,-758011,-758616.8,32.280231411502214,33.72175009209255,34.81781311409724,NaN,NaN,50
1659463200,1.0184,1.01872,1.01742,1.01864,2888,4030.8,-755123,-757778.6,32.82043913888846,35.16559304747872,34.247863518480386,NaN,NaN,50
1659465000,1.01864,1.01896,1.01723,1.01728,2740,3960.4,-757863,-758159,33.026320334255594,31.03918991734001,33.83379509108996,NaN,NaN,50
1659466800,1.01728,1.01776,1.01712,1.01757,1861,3903.25,-756002,-757678,33.28364527696152,32.848663073761514,33.74352296419395,NaN,NaN,50
1659468600,1.01757,1.01807,1.01682,1.0169,1956,3836.1,-757958,-756991.4,33.113847661618266,30.83557259068182,33.629853830921945,NaN,NaN,50
1659470400,1.0169,1.01698,1.01636,1.0165,941,3753.2,-758899,-757169,33.26577031276204,29.66665459619331,32.825932586300844,NaN,NaN,50
1659472200,1.0165,1.01672,1.01636,1.0166,478,3632.7,-758421,-757828.6,33.406841345966974,30.377226512166146,32.53231138890059,NaN,NaN,50
1659474000,1.0166,1.01662,1.01642,1.01646,116,3489.35,-758537,-757963.4,33.53783587680013,29.921460153247722,32.19709824283328,NaN,NaN,50
1659475800,1.01646,1.01646,1.01635,1.0164,152,3306.65,-758689,-758500.8,33.71397420061138,29.71568742028589,32.02607052044135,NaN,NaN,50
1659477600,1.0164,1.01728,1.0164,1.01691,1307,3143.3,-757382,-758385.6,32.62043740240962,33.87817980496963,32.112393412683154,NaN,NaN,50
1659479400,1.01691,1.0172,1.01631,1.01642,1269,2994.25,-758651,-758336,31.69281231783167,31.922055343785075,32.17231391171798,NaN,NaN,50
1659481200,1.01642,1.01661,1.01568,1.0158,1635,2833.6,-760286,-758709,31.416880913086427,29.593666630883206,31.52759604776082,NaN,NaN,50
1659483000,1.0158,1.01612,1.01548,1.01566,1712,2556.2,-761998,-759401.2,31.334339921408066,29.077905289930044,31.15579335461785,NaN,NaN,50
1659484800,1.01566,1.01643,1.01506,1.0151,2515,2351.5,-764513,-760566,31.61037495499493,27.04733005790156,31.057923895051214,NaN,NaN,50
1659486600,1.0151,1.01582,1.015,1.01582,1799,2112.05,-762714,-761632.4,31.91656693596294,33.479271967156876,31.04060402898438,NaN,NaN,50
1659488400,1.01582,1.0167,1.01568,1.01612,2645,1991.3,-760069,-761916,30.78913425128705,36.0107904890052,31.100975274807702,NaN,NaN,50
1659490200,1.01612,1.01712,1.01588,1.01709,2120,1914.85,-757949,-761448.6,29.16527291576857,43.49804739353143,31.99089366596423,NaN,NaN,50
1659492000,1.01709,1.01774,1.01687,1.0173,1796,1837,-756153,-760279.6,27.27512894920566,44.99850163155806,32.858739277235415,NaN,NaN,50
1659493800,1.0173,1.01823,1.0173,1.01805,2138,1821.6,-754015,-758180,26.06291228986935,50.09561888464979,34.23445686966169,NaN,NaN,50
1659495600,1.01805,1.019,1.01788,1.01792,1963,1770.55,-755978,-756832.8,25.685387706665562,49.243759181984814,35.63282148293252,NaN,NaN,50
1659497400,1.01792,1.0194,1.01774,1.01914,1545,1678.8,-754433,-755705.6,25.68181400314956,56.687375658968314,37.512117850561246,NaN,NaN,50
1659499200,1.01914,1.01933,1.01872,1.0189,2060,1637.4,-756493,-755414.4,25.678495564170422,54.97921327185998,39.30195735903355,NaN,NaN,50
1659501000,1.0189,1.01908,1.01813,1.0186,1704,1585.6,-758197,-755823.2,24.82346266094475,52.83599032140861,40.9534075662566,NaN,NaN,50
1659502800,1.0186,1.0187,1.01756,1.01786,1647,1574.9,-759844,-756989,23.29938450372491,47.87805892056785,41.953398931656466,NaN,NaN,50
1659504600,1.01786,1.01831,1.01744,1.01764,1947,1574.45,-761791,-758151.6,21.736525531789177,46.48160246502354,42.993366583173504,NaN,NaN,50
1659506400,1.01764,1.01802,1.01674,1.01746,2935,1674.15,-764726,-760210.2,20.89017298021356,45.316976947172094,44.116460177194135,NaN,NaN,50
1659508200,1.01746,1.01782,1.01542,1.01598,3299,1815.2,-768025,-762516.6,21.29252454446744,37.08851681493932,44.6886467146948,NaN,NaN,50
1659510000,1.01598,1.01914,1.01594,1.01845,4564,2037.6,-763461,-763569.4,20.167391390156805,52.5677995377604,46.511537391827574,NaN,NaN,50
1659511800,1.01845,1.01876,1.01754,1.0178,3691,2214.55,-767152,-765031,19.1226248897255,49.14116754153475,47.63024421856885,NaN,NaN,50
1659513600,1.0178,1.01891,1.0178,1.01878,3470,2322.7,-763682,-765409.2,17.99124382453157,54.00882060606362,48.91581779835873,NaN,NaN,50
1659515400,1.01878,1.0189,1.01814,1.01881,3021,2410.3,-760661,-764596.2,16.940675692565772,54.15347761858507,49.67691995729114,NaN,NaN,50
1659517200,1.01881,1.0198,1.01848,1.01854,3147,2485.9,-763808,-763752.8,16.451865268096107,52.551425506016166,50.21641451975243,NaN,NaN,50
1659519000,1.01854,1.01906,1.01812,1.01863,2366,2518.6,-761442,-763349,15.582293885204482,53.05002187403099,50.42744330470823,NaN,NaN,50
1659520800,1.01863,1.02005,1.01798,1.01813,3478,2566.75,-764920,-762902.6,15.700273073846342,49.91208752142412,50.47518104323961,NaN,NaN,50
1659522600,1.01813,1.01919,1.01787,1.01878,3021,2627.85,-761899,-762546,15.676364466277825,53.74268682594465,50.26484612659506,NaN,NaN,50
1659524400,1.01878,1.02104,1.0187,1.02075,2923,2641.75,-758976,-762209,17.00832761805605,62.982759500246395,50.83652800005124,NaN,NaN,50
1659526200,1.02075,1.02098,1.01802,1.01842,3748,2723.15,-762724,-761992.2,17.463697188978873,50.20824501615351,50.64883190681873,NaN,NaN,50
1659528000,1.01842,1.01969,1.01832,1.01862,3734,2820.05,-758990,-761501.8,17.88654036197864,51.124616682985746,50.88072888984858,NaN,NaN,50
1659529800,1.01862,1.01937,1.018,1.01862,3975,2911.9,-758990,-760315.8,17.90409597053225,51.124616682985746,51.212372762560165,NaN,NaN,50
1659531600,1.01862,1.01876,1.01658,1.01729,3247,2976.1,-762237,-760383.4,16.756194263786377,44.76996198558166,51.1733002653037,NaN,NaN,50
1659533400,1.01729,1.01787,1.01656,1.017,4244,3111.05,-766481,-761884.4,15.70821501234419,43.50030833025541,51.63128537354057,NaN,NaN,50
1659535200,1.017,1.01702,1.01274,1.01397,9022,3459.15,-775503,-764440.2,17.14572629210446,32.9772442212404,50.23195999378915,NaN,NaN,50
1659537000,1.01397,1.0145,1.01252,1.01304,6585,3703.2,-782088,-769059.8,18.576486539425275,30.53560541198391,48.9029912702498,NaN,NaN,50
1659538800,1.01304,1.01402,1.01228,1.01368,4292,3835.45,-777796,-772821,20.012741855546853,34.14896649701451,47.48443026246058,NaN,NaN,50
1659540600,1.01368,1.01466,1.01346,1.01446,3673,3921.75,-774123,-775198.2,20.707708468795325,38.35748072463731,46.356144770035726,NaN,NaN,50
1659542400,1.01446,1.01666,1.01402,1.01565,3937,3971.85,-770186,-775939.2,19.70069159165174,44.21508492114714,45.76069187111652,NaN,NaN,50
1659544200,1.01565,1.01608,1.0146,1.01501,2263,3920.05,-772449,-775328.4,18.76560449144698,41.90855030394476,44.96487247325321,NaN,NaN,50
1659546000,1.01501,1.01565,1.01486,1.01564,1661,3774.9,-770788,-773068.4,17.897309326971133,44.95273181299368,44.610632779793896,NaN,NaN,50
1659547800,1.01564,1.01601,1.01508,1.01578,1424,3661.55,-769364,-771382,16.797559273990085,45.63452659447246,44.031478477545875,NaN,NaN,50
1659549600,1.01578,1.01604,1.01529,1.01584,1558,3565.95,-767806,-770118.6,15.751127523759505,45.94353722734181,42.81439117233841,NaN,NaN,50
1659551400,1.01584,1.01605,1.01494,1.0155,1807,3505.25,-769613,-770004,15.069557553281566,44.403333484500585,42.3997546343632,NaN,NaN,50
1659553200,1.0155,1.01663,1.01542,1.01656,1688,3432.3,-767925,-769099.2,14.072855909284826,50.02794563845658,42.32142098832541,NaN,NaN,50
1659555000,1.01656,1.0174,1.01644,1.01684,1642,3396.1,-766283,-768198.2,13.781282464028784,51.42587636728838,42.34293953720417,NaN,NaN,50
1659556800,1.01684,1.01724,1.01679,1.01698,1068,3275.6,-765215,-767368.4,13.510535693433889,52.14669347755631,42.869848929488064,NaN,NaN,50
1659558600,1.01698,1.01722,1.01676,1.01692,1079,3178.5,-766294,-767066,13.227394597767631,51.79196958760269,43.46211044787002,NaN,NaN,50
1659560400,1.01692,1.01694,1.0166,1.01688,116,3038.15,-766410,-766425.4,12.787066325399918,51.540257731137864,44.78803998429127,NaN,NaN,50
1659562200,1.01688,1.01702,1.01687,1.01696,92,2855.35,-766318,-766104,12.458257776751823,52.04227024238379,46.324230329319825,NaN,NaN,50
1659564000,1.01696,1.0171,1.01564,1.01602,1289,2733.1,-767607,-766368.8,12.270163721203593,46.01089103375631,47.17151065337281,NaN,NaN,50
1659565800,1.01602,1.0165,1.01602,1.01618,666,2567.65,-766941,-766714,12.09550495533738,47.13397916136473,47.79840339885334,NaN,NaN,50
1659567600,1.01618,1.01626,1.01571,1.01578,632,2436.9,-767573,-766969.8,12.232183957647665,44.634208284594,47.82834078195668,NaN,NaN,50
1659569400,1.01578,1.01602,1.01565,1.01566,726,2261,-768299,-767347.6,12.417934614052887,43.88230587434877,47.969323322699836,NaN,NaN,50
1659571200,1.01566,1.01616,1.01542,1.01593,1823,1901.05,-766476,-767379.2,12.821821156012827,46.083130861771316,48.05006611189823,NaN,NaN,50
1659573000,1.01593,1.01664,1.01584,1.01652,1761,1659.85,-764715,-766800.8,12.532630404589682,50.63872466424828,48.40750883116794,NaN,NaN,50
1659574800,1.01652,1.01718,1.01614,1.01709,1805,1535.5,-762910,-765994.6,11.687569402588515,54.627339505370855,49.02778042245573,NaN,NaN,50
1659576600,1.01709,1.01762,1.01686,1.01692,1682,1435.95,-764592,-765398.4,11.406513139700694,53.245438645083695,49.659359362497376,NaN,NaN,50
1659578400,1.01692,1.0173,1.01652,1.01662,1155,1296.85,-765747,-764888,10.716106939375159,50.80305607299293,49.71472439353569,NaN,NaN,50
1659580200,1.01662,1.01666,1.01616,1.01648,1091,1238.25,-766838,-764960.4,10.261012482799217,49.65829577662208,49.58846863705953,NaN,NaN,50
1659582000,1.01648,1.01707,1.01636,1.01652,854,1197.9,-765984,-765214.2,9.727155639108997,50.004927702424524,49.43548536740725,NaN,NaN,50
1659583800,1.01652,1.01658,1.01603,1.01628,1034,1178.4,-767018,-766035.8,9.243922665355639,47.87490371829471,49.15569494817097,NaN,NaN,50
1659585600,1.01628,1.01662,1.01626,1.01634,851,1143.05,-766167,-766350.8,8.741901413546536,48.46590851548373,48.93609857562425,NaN,NaN,50
1659587400,1.01634,1.01674,1.0161,1.01642,1097,1107.55,-765070,-766215.4,8.487210714356449,49.29146841650819,48.73961273091885,NaN,NaN,50
1659589200,1.01642,1.0174,1.01625,1.01724,1177,1082,-763893,-765626.4,8.401896741974403,56.911009788719326,49.51819264198764,NaN,NaN,50
1659591000,1.01724,1.01727,1.01618,1.0163,1944,1097.1,-765837,-765597,8.220287066925357,48.0058685267693,49.580470453802256,NaN,NaN,50
1659592800,1.0163,1.01678,1.01566,1.01612,2766,1182,-768603,-765914,7.94473279433614,46.50523146987681,49.71411496703674,NaN,NaN,50
1659594600,1.01612,1.01726,1.01576,1.0168,2335,1244.8,-766268,-765934.2,7.718524564148711,52.540857383005935,50.33258293194082,NaN,NaN,50
1659596400,1.0168,1.01864,1.01664,1.01845,3970,1437.5,-762298,-765379.8,8.959406613873613,63.34718349164941,51.56572954836069,NaN,NaN,50
1659598200,1.01845,1.01864,1.01738,1.01792,2983,1582.05,-765281,-765657.4,10.111654231475304,58.72193423208765,52.14310166034921,NaN,NaN,50
1659600000,1.01792,1.01876,1.01749,1.0176,2821,1658.65,-768102,-766110.4,11.294284793031203,56.06045405970425,52.245466985658744,NaN,NaN,50
1659601800,1.0176,1.01942,1.01746,1.01917,2536,1752.15,-765566,-765503,12.973369028803566,64.54982678724896,53.052923281527704,NaN,NaN,50
1659603600,1.01917,1.01941,1.01858,1.01914,2453,1843.2,-768019,-765853.2,14.532518676306475,64.29420483212047,54.01657676432253,NaN,NaN,50
1659605400,1.01914,1.0198,1.01875,1.01886,2487,1931.25,-770506,-767494.8,16.309261328635632,61.833015860303625,54.88619962744264,NaN,NaN,50
1659607200,1.01886,1.01944,1.01868,1.01936,2279,1954.05,-768227,-768084,17.824965883516004,64.45004659535098,55.91799383408024,NaN,NaN,50
1659609000,1.01936,1.01962,1.01854,1.01923,2402,1986.1,-770629,-768589.4,19.392865800980246,63.23597793282668,57.01521342083253,NaN,NaN,50
1659610800,1.01923,1.01958,1.01728,1.0185,5613,2176.5,-776242,-770724.6,18.71950790399878,56.76907927325996,57.60829704638798,NaN,NaN,50
1659612600,1.0185,1.01866,1.01604,1.0176,5285,2356.65,-781527,-773426.2,18.118630643077672,49.98245601316225,57.65765330329184,NaN,NaN,50
1659614400,1.0176,1.0182,1.01655,1.01783,5197,2558.75,-776330,-774591,17.560673186508073,51.57567501051519,57.27655796199154,NaN,NaN,50
1659616200,1.01783,1.01953,1.0176,1.01881,5318,2770.1,-771012,-775148,17.03994403821789,57.75090884644932,57.972632270540124,NaN,NaN,50
1659618000,1.01881,1.01903,1.01742,1.01834,4303,2942.55,-775315,-776085.2,16.34792286230926,54.18226310007091,58.52099167269684,NaN,NaN,50
1659619800,1.01834,1.01966,1.01733,1.01916,5465,3164.1,-769850,-774806.8,16.305686891117865,58.94848720691997,58.97867951726213,NaN,NaN,50
1659621600,1.01916,1.02022,1.01862,1.01932,4822,3362.65,-765028,-771507,16.74727610350427,59.82663942237881,58.7272120837428,NaN,NaN,50
1659623400,1.01932,1.02123,1.01902,1.02118,5118,3563.7,-759910,-768223,17.90114282824902,68.31265974613132,59.41226390617449,NaN,NaN,50
1659625200,1.02118,1.02339,1.02062,1.02284,4418,3725.75,-755492,-765119,20.10512378123339,73.66024239967498,60.669391644743826,NaN,NaN,50
1659627000,1.02284,1.02298,1.02097,1.02222,3207,3788.9,-758699,-761795.8,22.151677523290306,68.97803323565256,60.98569210534408,NaN,NaN,50
1659628800,1.02222,1.02328,1.02181,1.02314,2693,3785.25,-756006,-759027,24.18625931224427,71.8386038326415,61.524577748238436,NaN,NaN,50
1659630600,1.02314,1.02396,1.02314,1.02368,2970,3817,-753036,-756628.6,26.365185125913086,73.38964939192445,62.35005157192564,NaN,NaN,50
1659632400,1.02368,1.02394,1.02306,1.02374,1824,3709.7,-751212,-754889,28.274650913448706,73.56387434406794,63.001039268262566,NaN,NaN,50
1659634200,1.02374,1.02426,1.02353,1.02375,1712,3646.15,-749500,-753690.6,30.1900721223351,73.59490428410106,63.74096257906789,NaN,NaN,50
1659636000,1.02375,1.02458,1.02366,1.02452,1565,3583.35,-747935,-751537.8,32.10903711846201,75.93701803015063,65.11010106170293,NaN,NaN,50
1659637800,1.02452,1.02504,1.02434,1.025,1732,3543.15,-746203,-749577.2,34.08553162844996,77.28935494221551,67.0605938423496,NaN,NaN,50
1659639600,1.025,1.02538,1.02466,1.02513,1453,3493.15,-744750,-747920,36.05894553166113,77.6556159136438,68.92344676400164,NaN,NaN,50
1659641400,1.02513,1.02516,1.02442,1.02455,1514,3444.5,-746264,-746930.4,37.48419021138653,72.07102701604218,69.946312347544,NaN,NaN,50
1659643200,1.02455,1.02473,1.02438,1.02448,697,3365.4,-746961,-746422.6,38.737562542443584,71.40361614482157,71.1764089935976,NaN,NaN,50
1659645000,1.02448,1.0247,1.02425,1.02468,517,3271.15,-746444,-746124.4,39.66295590960496,72.19585963083905,72.1226498810204,NaN,NaN,50
1659646800,1.02468,1.02478,1.0246,1.02472,139,2997.45,-746305,-746144.8,40.57079747731477,72.36078518019289,73.01794600657854,NaN,NaN,50
1659648600,1.02472,1.02481,1.02452,1.02459,204,2743.4,-746509,-746496.6,41.251342998347326,70.88906329166602,73.20197483125959,NaN,NaN,50
1659650400,1.02459,1.02484,1.02428,1.0245,994,2533.25,-747503,-746744.4,41.39005687143583,69.83017667393584,72.92839870799251,NaN,NaN,50
1659652200,1.0245,1.02482,1.02444,1.02482,517,2293.2,-746986,-746749.4,41.5188626107323,71.46240085493301,73.10585353794112,NaN,NaN,50
1659654000,1.02482,1.02523,1.02472,1.02498,819,2119,-746167,-746694,41.97740899573114,72.2702091748984,73.13668249095947,NaN,NaN,50
1659655800,1.02498,1.02502,1.0246,1.02474,1042,1897.85,-747209,-746874.8,42.13211949208722,69.1100564026709,72.83099727744136,NaN,NaN,50
1659657600,1.02474,1.02484,1.02366,1.02373,1680,1740.75,-748889,-747350.8,40.444030608270644,57.67955056442223,71.69640272175238,NaN,NaN,50
1659659400,1.02373,1.02389,1.02316,1.02324,1804,1575.05,-750693,-747988.8,38.09369335596196,53.09169066419155,70.23188746318742,NaN,NaN,50
1659661200,1.02324,1.02388,1.02296,1.02352,2062,1457.25,-748631,-748317.8,35.61693323067959,55.28061493747193,68.75643009942465,NaN,NaN,50
1659663000,1.02352,1.0238,1.02304,1.02332,1811,1387.45,-750442,-749172.8,33.31708454291739,53.365060022869216,67.04755189089992,NaN,NaN,50
1659664800,1.02332,1.02367,1.02296,1.02316,1591,1332.35,-752033,-750137.6,31.052505443822533,51.81810413047645,65.20201533495938,NaN,NaN,50
1659666600,1.02316,1.02352,1.02313,1.02341,1177,1242.7,-750856,-750531,28.949681994663024,54.05902167883365,63.915443525158786,NaN,NaN,50
1659668400,1.02341,1.02374,1.02334,1.02356,1160,1209.5,-749696,-750331.6,27.367832597579994,55.399373730913496,62.772283352736785,NaN,NaN,50
1659670200,1.02356,1.02397,1.02346,1.02366,770,1162.4,-748926,-750390.6,26.272220552386745,56.31443469404101,61.637895857251216,NaN,NaN,50
1659672000,1.02366,1.0239,1.02338,1.02356,792,1123.75,-749718,-750245.8,25.09025855830235,55.097065730176524,60.40477303939291,NaN,NaN,50
1659673800,1.02356,1.02382,1.0234,1.0235,1125,1093.4,-750843,-750007.8,23.992722420938264,54.338064300868396,59.2225588257645,NaN,NaN,50
1659675600,1.0235,1.02352,1.02296,1.0231,1041,1072.8,-751884,-750213.4,22.493430621747184,49.44757261987672,57.76665853618885,NaN,NaN,50
1659677400,1.0231,1.02369,1.02277,1.02315,1729,1083.55,-750155,-750305.2,21.455828755408387,50.05271138550695,56.237395002658424,NaN,NaN,50
1659679200,1.02315,1.02318,1.02226,1.0226,2220,1159.7,-752375,-750995,21.33956684777306,43.836494647284134,54.20641539354312,NaN,NaN,50
1659681000,1.0226,1.02373,1.02237,1.02358,2597,1263.7,-749778,-751007,20.117276345820827,54.64512337907282,53.173205891857535,NaN,NaN,50
1659682800,1.02358,1.02374,1.02278,1.02326,2513,1382.4,-752291,-751296.6,18.96336212958643,51.181445268090776,52.70905551354815,NaN,NaN,50
1659684600,1.02326,1.02392,1.02265,1.02336,2556,1500,-749735,-750866.8,17.67462967616868,52.20106685756105,52.64543952736026,NaN,NaN,50
1659686400,1.02336,1.02378,1.02183,1.02272,2995,1600.05,-752730,-751381.8,17.696494083243888,45.63220383571652,51.9562673058063,NaN,NaN,50
1659688200,1.02272,1.02317,1.02207,1.02238,2099,1679.15,-754829,-751872.6,17.71679674695658,42.56760475682322,51.18502050108873,NaN,NaN,50
1659690000,1.02238,1.02316,1.02231,1.02288,2230,1749.7,-752599,-752436.8,17.735649220404078,48.08886844865165,50.918646523815525,NaN,NaN,50
1659691800,1.02288,1.02296,1.02224,1.02288,1910,1793.1,-752599,-752498.4,17.867854476014895,48.08886844865165,50.492207007373956,NaN,NaN,50
1659693600,1.02288,1.02345,1.02258,1.02334,1816,1799.9,-750783,-752708,16.892057118463192,52.918248309982786,50.314983763021765,NaN,NaN,50
1659695400,1.02334,1.02364,1.02273,1.02361,2056,1812.5,-748727,-751907.4,15.764371243191725,55.533164140463896,50.259178723480545,NaN,NaN,50
1659697200,1.02361,1.02382,1.02288,1.02348,1924,1805.6,-750651,-751071.8,15.066398432547903,53.9786614289897,50.1792927019672,NaN,NaN,50
1659699000,1.02348,1.02388,1.02297,1.02312,2147,1822.4,-752798,-751111.6,14.53534908354148,49.819707849403756,49.856552955434005,NaN,NaN,50
1659700800,1.02312,1.02366,1.02272,1.0233,2739,1879.8,-750059,-750603.6,13.509789365507327,51.81862962063627,50.02591416977397,NaN,NaN,50
1659702600,1.0233,1.0233,1.01542,1.01581,11202,2381.05,-761261,-752699.2,17.514871096783175,18.605825281134003,47.779708019461616,NaN,NaN,50
1659704400,1.01581,1.01692,1.01416,1.01552,6821,2664.1,-768082,-756570.2,21.482542377603643,18.12152444784671,45.94292443378752,NaN,NaN,50
1659706200,1.01552,1.01782,1.01486,1.01754,7249,2988.05,-760833,-758606.6,24.16660586031945,31.497120905053038,44.289495685643246,NaN,NaN,50
1659708000,1.01754,1.01859,1.01638,1.0171,7075,3302.2,-767908,-761628.6,25.870723349830875,30.334685326212437,42.800441404080516,NaN,NaN,50
1659709800,1.0171,1.01768,1.01611,1.01667,5699,3530.9,-773607,-766338.2,27.547898673403047,29.200488026970746,41.157542916181214,NaN,NaN,50
1659711600,1.01667,1.01682,1.01514,1.0152,4147,3686.2,-777754,-769636.8,29.430492018212785,25.667327790695694,39.73148034153686,NaN,NaN,50
1659713400,1.0152,1.01706,1.01513,1.01689,3489,3774.2,-774265,-770873.4,30.92145781478404,35.35195045058093,39.21607646251955,NaN,NaN,50
1659715200,1.01689,1.01772,1.01666,1.01711,3377,3832.05,-770888,-772884.4,31.61034990862696,36.51157702035902,38.38912707478437,NaN,NaN,50
1659717000,1.01711,1.01877,1.01694,1.0183,3256,3865,-767632,-772829.2,31.24687753142488,42.517845390457325,37.991196856341915,NaN,NaN,50
1659718800,1.0183,1.0193,1.01814,1.01864,3111,3894.9,-764521,-771012,30.44382768597516,44.14376289903425,37.364447898417026,NaN,NaN,50
1659720600,1.01864,1.01867,1.0179,1.01815,2625,3898.35,-767146,-768890.4,29.83816297127196,42.287336861700936,36.418317378505385,NaN,NaN,50
1659722400,1.01815,1.01836,1.01723,1.01796,2548,3876,-769694,-767976.2,29.65823630869064,41.557542733262245,35.531094614524854,NaN,NaN,50
1659724200,1.01796,1.01842,1.01732,1.01766,2235,3882.8,-771929,-768184.4,29.431375083847065,40.372780962221526,34.856314122583264,NaN,NaN,50
1659726000,1.01766,1.01846,1.01736,1.0178,2467,3894.65,-769462,-768550.4,29.178277116460144,41.21502696738602,34.09891393306539,NaN,NaN,50
1659727800,1.0178,1.01851,1.01776,1.01778,1806,3889.45,-771268,-769899.8,28.8867510322888,41.12565652812957,35.70747330785078,NaN,NaN,50
1659729600,1.01778,1.01834,1.0177,1.0181,985,3847.9,-770283,-770527.2,28.659147259598555,43.246156393740755,37.50208987541465,NaN,NaN,50
1659731400,1.0181,1.01814,1.01762,1.01814,747,3782.45,-769536,-770495.6,28.50848620238659,43.51999934180206,38.36086690661101,NaN,NaN,50
1659906000,1.01814,1.01814,1.01754,1.01776,98,3691.15,-769634,-770036.6,28.432406856402054,41.472720060309996,39.1564408161894,NaN,NaN,50
1659907800,1.01776,1.01799,1.01766,1.01785,73,3587.45,-769561,-770056.4,28.361761749416413,42.16664136580984,40.082594626106484,NaN,NaN,50
1659909600,1.01785,1.01786,1.01694,1.01706,1118,3506.4,-770679,-769938.6,28.880067260106024,37.91697506214942,40.957569431210324,NaN,NaN,50
1659911400,1.01706,1.01764,1.01706,1.01732,836,2988.1,-769843,-769850.6,29.361350948603516,40.05812501060757,41.29372475692651,NaN,NaN,50
1659913200,1.01732,1.0176,1.0172,1.01736,1062,2700.15,-768781,-769699.6,29.808257230779756,40.39869104929102,41.571375758993085,NaN,NaN,50
1659915000,1.01736,1.0175,1.01704,1.01722,1248,2400.1,-770029,-769778.6,30.36268502724787,39.55168076079816,41.359506856874575,NaN,NaN,50
1659916800,1.01722,1.01742,1.01597,1.01604,2745,2183.6,-772774,-770421.2,31.676777212205625,33.22806958767305,40.57981447749163,NaN,NaN,50
1659918600,1.01604,1.01668,1.01592,1.01664,2389,2018.1,-770385,-770362.4,32.92972319541559,38.60332372360667,40.316670681913465,NaN,NaN,50
1659920400,1.01664,1.01728,1.01644,1.01711,2226,1922.05,-768159,-770025.6,32.98939906156218,42.50765267745655,40.38453567792734,NaN,NaN,50
1659922200,1.01711,1.01772,1.0171,1.01758,1901,1842.65,-766258,-769521,32.3224632053225,46.19257575608607,40.80023530606053,NaN,NaN,50
1659924000,1.01758,1.01827,1.01726,1.01822,1534,1750.5,-764724,-768460,30.887317406610666,50.8154675939951,41.485981065104035,NaN,NaN,50
1659925800,1.01822,1.01832,1.01797,1.01802,1274,1651.4,-765998,-767104.8,29.482836456289736,49.387484260173565,42.07611161739289,NaN,NaN,50
1659927600,1.01802,1.01822,1.01782,1.01804,1447,1568.2,-764551,-765938,28.3571153424352,49.5401907520903,42.52568550013215,NaN,NaN,50
1659929400,1.01804,1.0186,1.01797,1.01858,1198,1496.85,-763353,-764976.8,26.73264170529965,53.60998570942054,43.246398812104886,NaN,NaN,50
1659931200,1.01858,1.01858,1.01804,1.01804,1239,1431.4,-764592,-764643.6,25.22420189938806,49.32564154441207,43.80732177525504,NaN,NaN,50
1659933000,1.01804,1.01858,1.01797,1.01857,912,1365.25,-763680,-764434.8,23.924660121481658,53.272721634468624,44.600613223016374,NaN,NaN,50
1659934800,1.01857,1.01862,1.01822,1.01836,1198,1301.8,-764878,-764210.8,22.648001451886923,51.559076401658444,45.57504903298131,NaN,NaN,50
1659936600,1.01836,1.0189,1.01816,1.01866,1879,1305.45,-762999,-763900.4,21.086762440191496,53.84329405019806,46.559703964380624,NaN,NaN,50
1659938400,1.01866,1.01886,1.01784,1.01799,2859,1399.15,-765858,-764401.4,20.05370052926069,48.358774538271845,47.12828135645069,NaN,NaN,50
1659940200,1.01799,1.01832,1.01712,1.01778,2849,1504.25,-768707,-765224.4,20.10345326233327,46.75135106580528,47.642543521094055,NaN,NaN,50
1659942000,1.01778,1.01968,1.01748,1.0194,3646,1681.65,-765061,-765500.6,19.214992808401725,58.27378888681319,49.431523471032634,NaN,NaN,50
1659943800,1.0194,1.02152,1.01932,1.02094,3516,1853.8,-761545,-764834,20.07395454810795,65.84093535338556,51.37706715887399,NaN,NaN,50
1659945600,1.02094,1.02094,1.01872,1.01902,2750,1935.4,-764295,-765093.2,20.100197814723572,52.94833099717955,52.12282989599705,NaN,NaN,50
1659947400,1.01902,1.01939,1.0183,1.0192,2594,2023.3,-761701,-764261.8,19.6220929956512,53.86049628664725,52.67053850532285,NaN,NaN,50
1659949200,1.0192,1.0192,1.0173,1.01807,2669,2103.65,-764370,-763394.4,18.318016349882992,47.619245413888336,52.44223692102951,NaN,NaN,50
1659951000,1.01807,1.01892,1.01768,1.01876,2579,2170.2,-761791,-762740.4,17.10708803595537,51.328061224526714,52.58084956134046,NaN,NaN,50
1659952800,1.01876,1.0191,1.01826,1.01844,2128,2139.35,-763919,-763215.2,15.97931710211878,49.57494258980789,52.58333183546314,NaN,NaN,50
1659954600,1.01844,1.01934,1.01806,1.0192,2279,2133.85,-761640,-762684.2,15.19021650239926,53.62609353174325,52.584482394200485,NaN,NaN,50
1659956400,1.0192,1.02002,1.01903,1.01928,2309,2138,-759331,-762210.2,15.139965182626922,54.04462624051702,52.92155272963655,NaN,NaN,50
1659958200,1.01928,1.02015,1.01842,1.02012,2616,2173.75,-756715,-760679.2,14.369575634252744,58.30024938893436,53.28066185495553,NaN,NaN,50
1659960000,1.02012,1.02024,1.01879,1.01917,3119,2253,-759834,-760287.8,13.74895044029332,52.391241711809,53.340102234252,NaN,NaN,50
1659961800,1.01917,1.01994,1.0184,1.01987,2553,2316.95,-757281,-758960.2,12.819909707943783,55.93524880228687,53.489527573686914,NaN,NaN,50
1659963600,1.01987,1.0201,1.0191,1.01976,2828,2386,-760109,-758654,12.03935380023623,55.239366573138746,53.980998433320266,NaN,NaN,50
1659965400,1.01976,1.02148,1.01949,1.02016,3971,2524.65,-756138,-758015.4,12.6840767745055,57.31877151829443,54.735814179926635,NaN,NaN,50
1659967200,1.02016,1.02132,1.01955,1.02088,3943,2659.85,-752195,-757111.4,13.282748107755541,60.84482731849319,54.91945978218949,NaN,NaN,50
1659969000,1.02088,1.02194,1.02022,1.02171,4054,2816.95,-748141,-754772.8,14.359732413553909,64.4870713308791,54.82275520915332,NaN,NaN,50
1659970800,1.02171,1.0222,1.02086,1.02188,2932,2903.65,-745209,-752358.4,15.564808112088475,65.20107627473558,55.697951300407325,NaN,NaN,50
1659972600,1.02188,1.02197,1.02052,1.02064,2631,2941.25,-747840,-749904.6,16.183162564586542,56.30817221116521,55.87278529501574,NaN,NaN,50
1659974400,1.02064,1.02126,1.0201,1.02012,2307,2913.65,-750147,-748706.4,16.168727764750056,53.04103641584898,56.26005608087008,NaN,NaN,50
1659976200,1.02012,1.0202,1.01948,1.01961,1970,2869.7,-752117,-748690.8,15.364993497274288,49.978172886429554,56.163635485291714,NaN,NaN,50
1659978000,1.01961,1.02053,1.01942,1.01999,1884,2781.6,-750233,-749109.2,14.970805924736148,52.19331882703592,56.35066235937943,NaN,NaN,50
1659979800,1.01999,1.02049,1.01936,1.02021,1736,2692.6,-748497,-749766.8,14.525919957286023,53.47779729973036,56.3400697713785,NaN,NaN,50
1659981600,1.02021,1.02056,1.019,1.0193,2574,2683.8,-751071,-750413,13.639167891260959,47.76144381471004,55.891271026678005,NaN,NaN,50
1659983400,1.0193,1.01958,1.01854,1.01868,2342,2671.2,-753413,-751066.2,13.078770050869021,44.287953005973975,54.8903927136094,NaN,NaN,50
1659985200,1.01868,1.01928,1.01862,1.01918,1647,2620.1,-751766,-750996,12.558400627647934,47.59775202747502,54.54800059329983,NaN,NaN,50
1659987000,1.01918,1.01931,1.01878,1.01922,1731,2577.7,-750035,-750956.4,12.03121027722194,47.86459754273699,53.97152550333198,NaN,NaN,50
1659988800,1.01922,1.01962,1.01916,1.01946,816,2512.1,-749219,-751100.8,11.259072048749495,49.525403077639744,53.56338525365349,NaN,NaN,50
1659990600,1.01946,1.01962,1.01933,1.01936,447,2420.5,-749666,-750819.8,10.542086550882226,48.82745425879165,52.956862592260435,NaN,NaN,50
1659992400,1.01936,1.01967,1.0192,1.0194,172,2313.65,-749494,-750036,9.909634043103067,49.13623396195763,52.12053449536504,NaN,NaN,50
1659994200,1.0194,1.01948,1.01936,1.0194,84,2187.05,-749494,-749581.6,9.322356714450988,49.13623396195763,51.024046111870646,NaN,NaN,50
1659996000,1.0194,1.01954,1.01931,1.01947,428,2052.5,-749066,-749387.8,8.666984447882479,49.75161099068959,49.92051287729594,NaN,NaN,50
1659997800,1.01947,1.01958,1.01938,1.01948,533,1951.5,-748533,-749250.6,8.114375041593194,49.84496520903898,49.45885523428693,NaN,NaN,50
1659999600,1.01948,1.01998,1.01948,1.01976,549,1837.55,-747984,-748914.2,8.336086595097981,52.50566763852268,49.42061460733505,NaN,NaN,50
1660001400,1.01976,1.01996,1.01967,1.0198,582,1668.1,-747402,-748495.8,8.541961609066712,52.89015326146652,49.62861320555197,NaN,NaN,50
1660003200,1.0198,1.0201,1.0192,1.01924,1715,1556.7,-749117,-748420.4,8.115341142314282,47.13691697883842,49.26744164496643,NaN,NaN,50
1660005000,1.01924,1.0193,1.01889,1.01916,1636,1435.8,-750753,-748757.8,8.282413014144515,46.36106752958613,48.75910380424184,NaN,NaN,50
1660006800,1.01916,1.01938,1.01887,1.01923,1609,1369.65,-749144,-748880,8.264003946084923,47.18029589796709,48.71759323876021,NaN,NaN,50
1660008600,1.01923,1.01942,1.01906,1.01914,1223,1299.25,-750367,-749356.6,8.15658671882665,46.20322451062561,48.85439834623532,NaN,NaN,50
1660010400,1.01914,1.01932,1.01891,1.01924,1216,1244.7,-749151,-749706.4,8.357472650462377,47.504092587387234,48.84770838622905,NaN,NaN,50
1660012200,1.01924,1.01943,1.01914,1.01936,641,1178.25,-748510,-749585,8.271170403330162,49.094852508151476,48.935583740901514,NaN,NaN,50
1660014000,1.01936,1.01978,1.01929,1.01967,893,1128.7,-747617,-748957.8,7.977193545700513,53.052665452327034,49.187531053379175,NaN,NaN,50
1660015800,1.01967,1.01973,1.01951,1.01962,774,1080.6,-748391,-748807.2,7.7042150350444105,52.34574918080651,49.438837833523095,NaN,NaN,50
1660017600,1.01962,1.01963,1.01918,1.01934,723,988.05,-749114,-748556.6,7.626617368453245,48.452189074709636,49.38997748443395,NaN,NaN,50
1660019400,1.01934,1.01948,1.01924,1.01942,577,899.8,-748537,-748433.8,7.554562392332875,49.605548905457475,49.423499980398226,NaN,NaN,50
1660021200,1.01942,1.01956,1.01929,1.01952,959,865.4,-747578,-748247.4,7.272442502861377,51.07902928460666,49.518315572820875,NaN,NaN,50
1660023000,1.01952,1.02012,1.01942,1.02,1271,842.4,-746307,-747985.4,7.795140360231458,57.502258358954684,50.06526508352914,NaN,NaN,50
1660024800,1.02,1.02097,1.01985,1.02036,2079,905.55,-744228,-747152.8,9.641216265527195,61.576961698612244,50.71321465924982,NaN,NaN,50
1660026600,1.02036,1.02082,1.02004,1.02058,1804,973.4,-742424,-745814.8,11.355429606158953,63.857578172397936,51.496602152887775,NaN,NaN,50
1660028400,1.02058,1.02071,1.01956,1.02017,2804,1105,-745228,-745153,11.730524421397991,57.06022420044271,52.2054098115738,NaN,NaN,50
1660030200,1.02017,1.02152,1.02017,1.02148,2515,1226.55,-742713,-744180,13.19908100875259,68.57149533278697,53.79186894037387,NaN,NaN,50
1660032000,1.02148,1.02309,1.02136,1.02304,3246,1367.45,-739467,-742812,15.926130172599803,76.612155322158,55.894144613530365,NaN,NaN,50
1660033800,1.02304,1.02448,1.023,1.02394,3007,1491.15,-736460,-741258.4,19.19411851925796,79.81986236627694,58.295333031791166,NaN,NaN,50
1660035600,1.02394,1.02474,1.02356,1.02376,3091,1618.25,-739551,-740683.8,22.3407070435621,77.52959240660383,60.44001159030664,NaN,NaN,50
1660037400,1.02376,1.02404,1.02311,1.02379,2339,1706.1,-737212,-739080.6,24.436085677900063,77.64472259055064,62.47928802476372,NaN,NaN,50
1660039200,1.02379,1.02404,1.02296,1.02306,2235,1732.1,-739447,-738427.4,26.11298541414534,68.4537442049681,63.57936507852379,NaN,NaN,50
1660041000,1.02306,1.02338,1.02246,1.02252,2096,1755.1,-741543,-738842.6,26.806052321630126,62.55490256619556,64.3085903203373,NaN,NaN,50
1660042800,1.02252,1.02299,1.02206,1.02238,2277,1788.5,-743820,-740314.6,26.81107047750103,61.08521640261497,65.21094941518767,NaN,NaN,50
1660044600,1.02238,1.02309,1.02148,1.02201,2911,1872.9,-746731,-741750.6,25.971067496118454,57.256555998921534,65.75744992186368,NaN,NaN,50
1660046400,1.02201,1.02372,1.02201,1.02358,3028,1963.5,-743703,-743048.8,25.787573206513276,66.77316653806335,66.87845972568202,NaN,NaN,50
1660048200,1.02358,1.02428,1.02335,1.02375,2708,2066.85,-740995,-743358.4,26.087781112942626,67.61398879401946,67.6007261853295,NaN,NaN,50
1660050000,1.02375,1.02438,1.0234,1.02404,2535,2148.95,-738460,-742741.8,26.447914801742005,69.05269411981149,68.13470707255803,NaN,NaN,50
1660051800,1.02404,1.02442,1.02344,1.02395,3512,2285.85,-741972,-742372.2,26.816565656573644,68.04245642731257,68.43362694790906,NaN,NaN,50
1660053600,1.02395,1.02409,1.0226,1.02274,3130,2406.2,-745102,-742046.4,25.880343136846225,56.14889999519055,68.36853236181962,NaN,NaN,50
1660055400,1.02274,1.0238,1.02194,1.02228,4122,2583.45,-749224,-743150.6,24.172753945674224,52.399062758368956,67.21335860650406,NaN,NaN,50
1660057200,1.02228,1.02303,1.02194,1.02234,2505,2660.75,-746719,-744295.4,22.587135411014504,52.84145718202909,65.51545159649484,NaN,NaN,50
1660059000,1.02234,1.02286,1.02206,1.02254,1992,2696.8,-744727,-745548.8,21.114775343116197,54.36398515857664,63.697174653087686,NaN,NaN,50
1660060800,1.02254,1.02319,1.0223,1.0223,1625,2674.1,-746352,-746424.8,20.17153056221512,52.186626091714274,61.88696277345271,NaN,NaN,50
1660062600,1.0223,1.02234,1.02147,1.02185,1897,2678.75,-748249,-747054.2,19.25174105038012,48.28191245956503,59.789619192668034,NaN,NaN,50
1660064400,1.02185,1.02204,1.02158,1.02166,1284,2602.75,-749533,-747116,18.397650789390475,46.6933270874518,58.23530368427401,NaN,NaN,50
1660066200,1.02166,1.0217,1.02114,1.02144,1258,2539.9,-750791,-747930.4,18.13244803675267,44.853096322283704,56.97088895256603,NaN,NaN,50
1660068000,1.02144,1.02174,1.02044,1.02052,1662,2460.7,-752453,-749475.6,18.618484382812326,38.09221221077092,55.32853151029145,NaN,NaN,50
1660069800,1.02052,1.02082,1.02035,1.02051,1538,2387.25,-753991,-751003.4,19.15755423600097,38.02511901155461,53.95485743976524,NaN,NaN,50
1660071600,1.02051,1.02122,1.02026,1.02104,1230,2294.2,-752761,-751905.8,19.003464790037324,43.68641705102073,52.30580390497648,NaN,NaN,50
1660073400,1.02104,1.02121,1.02042,1.02082,1102,2232.35,-753863,-752771.8,18.86038173307108,41.972474025525436,50.474267135798335,NaN,NaN,50
1660075200,1.02082,1.02148,1.02079,1.02142,694,2155.3,-753169,-753247.4,18.277831550435135,47.96807968752146,48.96822324777762,NaN,NaN,50
1660077000,1.02142,1.02156,1.02124,1.02129,552,2078.1,-753721,-753501,17.603414875116133,46.8388506904241,47.45367998085701,NaN,NaN,50
1660078800,1.02129,1.02136,1.02104,1.02128,197,1974.1,-753918,-753486.4,17.26023682732298,46.74768506206513,46.78216462849091,NaN,NaN,50
1660080600,1.02128,1.02158,1.02124,1.02132,304,1843.75,-753614,-753657,16.546987729063495,47.19045891623887,46.410121496910186,NaN,NaN,50
1660082400,1.02132,1.02145,1.02112,1.02132,572,1720.95,-753614,-753607.2,16.069892336620825,47.190458916238875,46.00647876363946,NaN,NaN,50
1660084200,1.02132,1.02136,1.02054,1.02064,692,1620.15,-754306,-753834.6,16.44488271820265,40.54402586597203,45.0193388141677,NaN,NaN,50
1660086000,1.02064,1.02098,1.02054,1.02088,657,1526.25,-753649,-753820.2,16.79308807252863,43.56515165650182,44.40351921165252,NaN,NaN,50
1660087800,1.02088,1.02096,1.02054,1.0208,595,1380.4,-754244,-753885.4,17.116421615831324,42.78473666884409,44.010863798029604,NaN,NaN,50
1660089600,1.0208,1.02086,1.02034,1.02038,1407,1294.25,-755651,-754292.8,17.708241710966824,38.84995303777074,43.45062279448096,NaN,NaN,50
1660091400,1.02038,1.02098,1.02028,1.02078,1321,1154.2,-754330,-754436,17.967243456040087,44.120768393344626,43.39831365669959,NaN,NaN,50
1660093200,1.02078,1.02108,1.02054,1.02082,1099,1083.9,-753231,-754221,17.96259325005653,44.63469767963016,43.86563404733239,NaN,NaN,50
1660095000,1.02082,1.02164,1.0207,1.0212,1519,1060.25,-751712,-753833.6,16.731001509641352,49.396203608886445,44.677854375713245,NaN,NaN,50
1660096800,1.0212,1.02154,1.02108,1.02146,1103,1034.15,-750609,-753106.6,15.587380607827257,52.411846700211086,45.30109935065541,NaN,NaN,50
1660098600,1.02146,1.02192,1.02146,1.02182,853,981.95,-749756,-751927.6,15.162745398593366,56.29547027237626,46.32417051114476,NaN,NaN,50
1660100400,1.02182,1.02185,1.0214,1.02146,721,953.8,-750477,-751157,14.633783681621965,51.74755086591701,46.594132738173016,NaN,NaN,50
1660102200,1.02146,1.02148,1.02122,1.02139,676,924.7,-751153,-750741.4,13.737539099552794,50.886707994999526,46.88326540278554,NaN,NaN,50
1660104000,1.02139,1.0215,1.02118,1.02131,556,869.4,-751709,-750740.8,12.814616988094485,49.86573802442651,47.10598347152564,NaN,NaN,50
1660105800,1.02131,1.02166,1.02128,1.02132,677,826.35,-751032,-750825.4,12.317891432379719,50.00077930392931,47.30672064207496,NaN,NaN,50
1660107600,1.02132,1.02153,1.0213,1.02138,780,803.85,-750252,-750924.6,11.856646273501722,50.85611643422288,47.56855332193096,NaN,NaN,50
1660109400,1.02138,1.02186,1.02113,1.02117,1041,800.8,-751293,-751087.8,12.157593955051677,47.77553711268701,48.08508983955346,NaN,NaN,50
1660111200,1.02117,1.02144,1.0207,1.02074,1488,840.5,-752781,-751413.4,11.341981721981185,42.14592311441407,47.983716372261476,NaN,NaN,50
1660113000,1.02074,1.0212,1.02052,1.02116,1479,886.85,-751302,-751332,10.883430591079694,48.526007367245754,48.39380713643302,NaN,NaN,50
1660114800,1.02116,1.02182,1.02083,1.0212,2969,1025.45,-748333,-750792.2,11.04724529089965,49.10170057043236,49.126074817337425,NaN,NaN,50
1660116600,1.0212,1.02156,1.0209,1.02106,2194,1119.95,-750527,-750847.2,11.199358940732466,47.115514588025086,49.33998525981459,NaN,NaN,50
1660118400,1.02106,1.02145,1.02019,1.02139,2373,1210,-748154,-750219.4,10.965043855158699,52.040126337250115,49.86894444964459,NaN,NaN,50
1660120200,1.02139,1.02259,1.02116,1.02224,2534,1302.1,-745620,-748787.2,11.495100794823822,61.885345180738646,50.76102599049118,NaN,NaN,50
1660122000,1.02224,1.02276,1.02172,1.02274,2014,1369.95,-743606,-747248,12.206894121947268,66.2714658255178,51.750998785155936,NaN,NaN,50
1660123800,1.02274,1.02309,1.02217,1.02275,1893,1434.85,-741713,-745924,13.277371090507495,66.35485806291976,52.46952648448047,NaN,NaN,50
1660125600,1.02275,1.02306,1.02226,1.02266,1510,1440,-743223,-744463.2,14.271385418456278,64.80195809682945,53.40198414383136,NaN,NaN,50
1660127400,1.02266,1.02454,1.02252,1.02418,1867,1467.3,-741356,-743103.6,16.625581053805906,75.31094727755433,55.14657266401384,NaN,NaN,50
1660129200,1.02418,1.02506,1.02342,1.02488,2134,1519.05,-739222,-741824,19.167101405025065,78.49526038650878,57.19153854701972,NaN,NaN,50
1660131000,1.02488,1.0261,1.02436,1.02584,2274,1556.8,-736948,-740492.4,22.103451027893215,81.93620851282792,59.472640633369615,NaN,NaN,50
1660132800,1.02584,1.02591,1.02429,1.02432,3368,1670.05,-740316,-740213,24.691651093624646,64.37297244476832,60.43813034840857,NaN,NaN,50
1660134600,1.02432,1.03463,1.02428,1.03241,11889,2221.85,-728427,-737253.8,28.93583682443337,84.01387612878705,63.02658313527286,NaN,NaN,50
1660136400,1.03241,1.0335,1.03096,1.03203,6909,2531.25,-735336,-736049.8,32.876866431612896,81.73454570323025,65.85434189161688,NaN,NaN,50
1660138200,1.03203,1.03253,1.03052,1.03222,7521,2873.5,-727815,-733768.4,36.07696084230071,81.99753789751547,68.24516550092186,NaN,NaN,50
1660140000,1.03222,1.03436,1.0318,1.0343,7675,3229.45,-720140,-730406.8,39.26421136448926,84.60997643901598,70.7814709201064,NaN,NaN,50
1660141800,1.0343,1.03569,1.0338,1.03554,7121,3551.65,-713019,-724947.4,42.3558243199235,85.92160359569833,73.55333442065448,NaN,NaN,50
1660143600,1.03554,1.03688,1.03428,1.03508,6168,3821.05,-719187,-723099.4,45.331921065856534,83.09246900349399,75.77135889681475,NaN,NaN,50
1660145400,1.03508,1.03522,1.03287,1.03336,4548,3996.4,-723735,-720779.2,46.816430084882334,73.36508701669483,76.59134045652591,NaN,NaN,50
1660147200,1.03336,1.03358,1.03174,1.0322,4184,4131.2,-727919,-720800,47.275644614092286,67.6160106648166,76.68737937361868,NaN,NaN,50
1660149000,1.0322,1.03264,1.0317,1.03251,3107,4212.6,-724812,-721734.4,47.66982504653988,68.33024661956405,76.82847855623613,NaN,NaN,50
1660150800,1.03251,1.03284,1.03188,1.03192,3245,4226.4,-728057,-724742,48.088479580186714,65.37497177799986,76.86940810489115,NaN,NaN,50
1660152600,1.03192,1.0326,1.03164,1.03166,2550,4244.2,-730607,-727026,48.26039720151884,64.0601144878506,76.06577719134089,NaN,NaN,50
1660154400,1.03166,1.0319,1.03022,1.03024,3916,4321.35,-734523,-729183.6,47.21726794420963,57.283729532865244,74.55066784465207,NaN,NaN,50
1660156200,1.03024,1.0314,1.03024,1.03038,4103,4399.8,-730420,-729683.8,46.24864791956536,57.758165390702885,72.8236647645003,NaN,NaN,50
1660158000,1.03038,1.03042,1.02947,1.03024,2866,4442.4,-733286,-731378.6,44.72160682352976,57.07548337910059,72.30241554552401,NaN,NaN,50
1660159800,1.03024,1.03056,1.02978,1.03036,2302,4462.85,-730984,-731964,43.371839187874315,57.538754989606765,70.41133546415399,NaN,NaN,50
1660161600,1.03036,1.03037,1.03,1.03004,1236,4449.15,-732220,-732286.6,42.118483526194254,55.808987102961844,68.5595098498491,NaN,NaN,50
1660163400,1.03004,1.0302,1.02958,1.02996,1507,4431.15,-733727,-732127.4,40.57408534675916,55.36090741046653,66.65689338648846,NaN,NaN,50
1660165200,1.02996,1.03006,1.02986,1.02991,948,4371.85,-734675,-732978.4,39.14000132299801,55.06334476540962,64.54641969551658,NaN,NaN,50
1660167000,1.02991,1.03013,1.02981,1.03001,1862,4351.25,-732813,-732883.8,37.85445471214734,55.577615436408564,62.37899196985303,NaN,NaN,50
1660168800,1.03001,1.03049,1.02978,1.02992,779,4221.8,-733592,-733405.4,36.9031009783081,54.9678997757664,60.37009416787249,NaN,NaN,50
1660170600,1.02992,1.03025,1.02982,1.0302,672,3660.95,-732920,-733545.4,36.01970108260025,56.56441591035372,59.170046231705264,NaN,NaN,50
1660172400,1.0302,1.03026,1.02998,1.03016,1144,3372.7,-734064,-733612.8,35.20686291069053,56.257571136327805,58.3587291225275,NaN,NaN,50
1660174200,1.03016,1.03024,1.02982,1.02988,1160,3054.65,-735224,-733722.6,34.24467846631884,54.04736552500955,57.338523330059324,NaN,NaN,50
1660176000,1.02988,1.03028,1.02938,1.02964,1503,2746.05,-736727,-734505.4,32.79001002069432,52.15592266627228,56.39430553636449,NaN,NaN,50
1660177800,1.02964,1.03039,1.0294,1.02983,2484,2514.2,-734243,-734635.6,31.54431120520619,53.54205822271281,55.643015803140365,NaN,NaN,50
1660179600,1.02983,1.02983,1.02884,1.02894,2234,2317.5,-736477,-735347,29.682128329530364,46.71470708860182,54.88808562855012,NaN,NaN,50
1660181400,1.02894,1.029,1.02839,1.02884,2238,2202,-738715,-736277.2,27.690710126632766,46.00487486956324,54.048564877040135,NaN,NaN,50
1660183200,1.02884,1.02886,1.02843,1.0288,1676,2076.6,-740391,-737310.6,25.841536081085,45.70570547037877,53.236437883560015,NaN,NaN,50
1660185000,1.0288,1.0288,1.02821,1.02834,1826,2012.55,-742217,-738408.6,24.38846758404429,42.29906278337589,52.14788844025781,NaN,NaN,50
1660186800,1.02834,1.02866,1.02814,1.02866,1316,1916.1,-740901,-739740.2,23.12514462526145,45.3505981668432,51.40086065910648,NaN,NaN,50
1660188600,1.02866,1.02918,1.02853,1.02885,1656,1871.4,-739245,-740293.8,21.699272852302524,47.1381801113822,50.81352299488616,NaN,NaN,50
1660190400,1.02885,1.02934,1.02858,1.02863,1076,1729.4,-740321,-740615,20.580852150063222,45.29084888800329,50.11548757507143,NaN,NaN,50
1660192200,1.02863,1.02884,1.02832,1.02832,1095,1579,-741416,-740820,19.16779583142179,42.74860284060568,49.19912953251407,NaN,NaN,50
1660194000,1.02832,1.02853,1.02755,1.0276,1148,1493.1,-742564,-740889.4,18.722418909762567,37.48566941012903,47.95039879211141,NaN,NaN,50
1660195800,1.0276,1.02852,1.0276,1.0282,1960,1476,-740604,-740830,18.308854625364717,43.70545871920035,47.031901849886175,NaN,NaN,50
1660197600,1.0282,1.0302,1.02785,1.02976,3357,1582.05,-737247,-740430.4,18.145061257716975,55.971137461699,47.0114423016984,NaN,NaN,50
1660199400,1.02976,1.0314,1.02903,1.0312,3231,1668.25,-734016,-739169.4,18.98099940492315,63.80975390905806,47.708755757701866,NaN,NaN,50
1660201200,1.0312,1.03246,1.03076,1.03214,4018,1821.75,-729998,-736885.8,20.435975563845183,67.83535515497667,48.82871522118075,NaN,NaN,50
1660203000,1.03214,1.03324,1.03204,1.03259,3460,1901.65,-726538,-733680.6,22.206964800403277,69.5798508428349,49.97427183690376,NaN,NaN,50
1660204800,1.03259,1.03301,1.03186,1.03224,3528,2039.1,-730066,-731573,23.607426013099754,66.55627836633293,51.391526928170265,NaN,NaN,50
1660206600,1.03224,1.03414,1.03195,1.03412,3133,2162.15,-726933,-729510.2,25.478150655500777,73.27428849410083,53.33934218706581,NaN,NaN,50
1660208400,1.03412,1.03415,1.03254,1.03324,3243,2267.1,-730176,-728742.2,27.21993529293868,66.53680797039496,54.827278079924106,NaN,NaN,50
1660210200,1.03324,1.0339,1.03248,1.03362,2348,2326.5,-727828,-728308.2,28.74772950254488,67.90899963238817,56.65655928342498,NaN,NaN,50
1660212000,1.03362,1.0343,1.03325,1.03353,2547,2378.7,-730375,-729075.6,30.374434464768115,67.20608977406317,58.217665826797834,NaN,NaN,50
1660213800,1.03353,1.03404,1.03281,1.03372,2520,2380.5,-727855,-728633.4,31.204036383393984,67.96006945515188,59.704943637067096,NaN,NaN,50
1660215600,1.03372,1.03404,1.03303,1.03346,2592,2398.4,-730447,-729336.2,31.97438102211801,65.73289801429999,61.165090003231136,NaN,NaN,50
1660217400,1.03346,1.03392,1.03222,1.03248,3845,2478.75,-734292,-730159.4,31.488723274617588,58.015337098922316,62.25557102168233,NaN,NaN,50
1660219200,1.03248,1.03462,1.03236,1.03408,4560,2622.95,-729732,-730540.2,31.568298174680574,65.19929692074943,64.2351158438695,NaN,NaN,50
1660221000,1.03408,1.0352,1.03276,1.03472,6221,2842.7,-723511,-729167.4,32.03390624209557,67.58831536906291,65.94103417600255,NaN,NaN,50
1660222800,1.03472,1.03556,1.0339,1.03448,4539,3003.85,-728050,-729206.4,32.69438093696361,65.76507978744587,66.64060148498446,NaN,NaN,50
1660224600,1.03448,1.03644,1.0338,1.0359,5368,3189.45,-722682,-727653.4,33.80913808835576,70.78640111510789,67.13893342827373,NaN,NaN,50
1660226400,1.0359,1.03612,1.03444,1.03512,4481,3359.7,-727163,-726227.6,34.84426972893419,65.13502490497666,66.94605269613088,NaN,NaN,50
1660228200,1.03512,1.03548,1.03303,1.03444,5651,3587.5,-732814,-726844,33.87983939611283,60.59323034320697,66.30415123187173,NaN,NaN,50
1660230000,1.03444,1.03464,1.03238,1.03274,4567,3758.45,-737381,-729618,32.26684406644168,51.015924513957074,65.19412595670202,NaN,NaN,50
1660231800,1.03274,1.0342,1.03269,1.03375,3563,3838.6,-733818,-730771.6,30.769062688889896,55.51468672735126,63.92558297336278,NaN,NaN,50
1660233600,1.03375,1.03396,1.03316,1.03347,3133,3827.4,-736951,-733625.4,29.378265695448956,54.03312566716042,63.03246280884603,NaN,NaN,50
1660235400,1.03347,1.03356,1.03271,1.033,2216,3776.65,-739167,-736026.2,27.555805995283144,51.54636376213966,61.86370310382828,NaN,NaN,50
1660237200,1.033,1.03326,1.03228,1.03228,2994,3725.45,-742161,-737895.6,25.788687209115206,47.908814675381,60.48532631106526,NaN,NaN,50
1660239000,1.03228,1.03259,1.03176,1.03221,2368,3670.85,-744529,-739325.2,24.68428342280485,47.55743271822344,59.02799511557037,NaN,NaN,50
1660240800,1.03221,1.03221,1.03158,1.03173,2439,3616.4,-746968,-741955.2,23.83813540488424,45.11398472225605,57.555215594710084,NaN,NaN,50
1660242600,1.03173,1.0325,1.03096,1.03246,2649,3592.2,-744319,-743428.8,23.63829084416148,49.374121806214454,56.93798593094524,NaN,NaN,50
1660244400,1.03246,1.03264,1.03168,1.03236,1612,3510.65,-745931,-744781.6,23.259303355328193,48.81516473518637,55.76769077483359,NaN,NaN,50
1660246200,1.03236,1.0325,1.03119,1.0317,1559,3471.2,-747490,-745847.4,23.361024247570146,45.179768984457155,54.167080318790326,NaN,NaN,50
1660248000,1.0317,1.03256,1.03161,1.03254,854,3386.55,-746636,-746268.8,23.365077497728063,50.25723358809483,53.059377018836685,NaN,NaN,50
1660249800,1.03254,1.03256,1.03216,1.0324,840,3302.55,-747476,-746370.4,23.368841230017555,49.435411834844636,51.53430635596073,NaN,NaN,50
1660251600,1.0324,1.0324,1.03191,1.0322,329,3189.4,-747805,-747067.6,23.628111049448556,48.222265183285614,50.32625209012566,NaN,NaN,50
1660253400,1.0322,1.03234,1.03209,1.0323,140,3004.15,-747665,-747414.4,23.868861596063056,48.897526324230796,49.49084466019878,NaN,NaN,50
1660255200,1.0323,1.03274,1.03212,1.0326,731,2812.7,-746934,-747303.2,23.368175789401086,50.96363389111564,49.487109615710104,NaN,NaN,50
1660257000,1.0326,1.03272,1.03216,1.03216,1175,2560.4,-748109,-747597.8,22.903253254643538,47.90446731562512,48.94352251487253,NaN,NaN,50
1660258800,1.03216,1.03236,1.0319,1.03198,934,2380.15,-749043,-747911.2,22.808669981620096,46.67026178762248,48.4176036663341,NaN,NaN,50
1660260600,1.03198,1.03224,1.03182,1.03204,863,2154.9,-748180,-747986.2,22.82426722833379,47.158966139996934,48.10421812189533,NaN,NaN,50
1660262400,1.03204,1.03254,1.03084,1.03107,2241,2042.9,-750421,-748537.4,23.91565517976392,40.670250145580404,47.587177798338146,NaN,NaN,50
1660264200,1.03107,1.03144,1.03066,1.0313,2268,1873.75,-748153,-748781.2,25.093989102298607,42.684025207920925,47.23907726188797,NaN,NaN,50
1660266000,1.0313,1.0316,1.03098,1.03146,1813,1736.05,-746340,-748427.4,25.84240529986257,44.105325044591794,47.167030142054806,NaN,NaN,50
1660267800,1.03146,1.03148,1.0305,1.03064,1625,1639.15,-747965,-748211.8,26.998552236008727,38.79561057456076,46.41142219693669,NaN,NaN,50
1660269600,1.03064,1.03094,1.03056,1.03061,1265,1545.75,-749230,-748421.8,28.07211724814444,38.612463604534874,45.68265783046159,NaN,NaN,50
1660271400,1.03061,1.03132,1.03058,1.03113,1433,1506.6,-747797,-747897,28.214202176375498,43.58395356988716,45.56867101513516,NaN,NaN,50
1660273200,1.03113,1.03176,1.03084,1.03155,1122,1413,-746675,-747601.4,27.462853870743935,47.296536385908425,45.35719264355041,NaN,NaN,50
1660275000,1.03155,1.03178,1.03142,1.03174,1093,1349.25,-745582,-747449.8,26.726227823905635,48.93371754876383,45.32135733740178,NaN,NaN,50
1660276800,1.03174,1.03218,1.03164,1.03207,1228,1288.7,-744354,-746727.6,25.283029512625927,51.737915572577265,45.57247522235118,NaN,NaN,50
1660278600,1.03207,1.03212,1.03142,1.03178,1031,1207.8,-745385,-745958.6,24.28342971414802,49.1819840069057,45.59279362825653,NaN,NaN,50
1660280400,1.03178,1.0323,1.03137,1.03198,1420,1198.2,-743965,-745192.2,23.013393982509125,50.98054613072191,45.59400164537127,NaN,NaN,50
1660282200,1.03198,1.03244,1.03147,1.03153,1805,1210.5,-745770,-745011.2,21.56959022944558,46.95387314162187,45.526102061513896,NaN,NaN,50
1660284000,1.03153,1.03232,1.03132,1.03132,2828,1309.2,-748598,-745614.4,20.496690987854695,45.16120911670532,45.41831258501981,NaN,NaN,50
1660285800,1.03132,1.03182,1.03098,1.03115,2487,1391.55,-751085,-746960.6,20.074790009409654,43.706462201050414,45.171705160809346,NaN,NaN,50
1660287600,1.03115,1.03166,1.02986,1.03042,3007,1525.45,-754092,-748702,21.10975222858676,38.03989758645409,44.98382283515746,NaN,NaN,50
1660289400,1.03042,1.03078,1.02912,1.02974,2974,1667.15,-757066,-751322.2,22.737591865299166,33.661828324981784,44.339380200661815,NaN,NaN,50
1660291200,1.02974,1.02976,1.02881,1.02916,3012,1781.2,-760078,-754183.8,24.49146925510084,30.44342436037074,43.36353015178888,NaN,NaN,50
1660293000,1.02916,1.0304,1.02915,1.03022,2493,1847.1,-757585,-755981.2,24.873239764204104,41.45939170267956,43.55380023236879,NaN,NaN,50
1660294800,1.03022,1.03039,1.02949,1.03038,2574,1929.1,-755011,-756766.4,25.227740951228565,42.92866069041326,43.86210002421724,NaN,NaN,50
1660296600,1.03038,1.03086,1.02973,1.02982,2781,2025,-757792,-757506.4,24.7066644283263,39.21853849128998,43.5502846614603,NaN,NaN,50
1660298400,1.02982,1.02988,1.02873,1.02936,2887,2057.3,-760679,-758229,25.240460503666363,36.43311241753652,42.77432580657659,NaN,NaN,50
1660300200,1.02936,1.02939,1.02852,1.02918,2716,2079.7,-763395,-758892.4,25.919135286782364,35.37437475983421,41.80580132165305,NaN,NaN,50
1660302000,1.02918,1.02976,1.02809,1.02852,3445,2161.3,-766840,-760743.4,26.90778133447303,31.73304546964519,40.37688202858647,NaN,NaN,50
1660303800,1.02852,1.02892,1.02778,1.0278,3231,2241.6,-770071,-763755.4,28.06823020540329,28.30949630804831,38.88599005009665,NaN,NaN,50
1660305600,1.0278,1.0291,1.0277,1.02884,3465,2351.6,-766606,-765518.2,28.797814946674293,38.61181812595631,38.00250947832768,NaN,NaN,50
1660307400,1.02884,1.02896,1.0269,1.02706,4054,2482.65,-770660,-767514.4,30.092761665599266,30.52613603547968,36.829099685031814,NaN,NaN,50
1660309200,1.02706,1.02804,1.02683,1.02754,3844,2618.75,-766816,-768198.6,31.344595679358545,34.508900384176926,36.068220489851214,NaN,NaN,50
1660311000,1.02754,1.02843,1.0269,1.02808,4789,2803.55,-762027,-767236,31.742619294995006,38.76214474377908,35.715054957188975,NaN,NaN,50
1660312800,1.02808,1.02808,1.0256,1.02586,7659,3125.1,-769686,-767159,33.04267918911379,30.105837488670772,35.14833637877588,NaN,NaN,50
1660314600,1.02586,1.0269,1.02384,1.02448,6032,3375.15,-775718,-768981.4,35.07725100519408,26.19041963644578,34.61466432959474,NaN,NaN,50
1660316400,1.02448,1.02584,1.0244,1.02527,3727,3490.5,-771991,-769247.6,36.966496262982915,31.669114823181673,34.70221364836696,NaN,NaN,50
1660318200,1.02527,1.02594,1.02468,1.02548,2613,3530.9,-769378,-769760,38.54750709729067,33.09087594294084,34.104462522671334,NaN,NaN,50
1660320000,1.02548,1.02618,1.02518,1.02529,2194,3499.2,-771572,-771669,39.59091733556136,32.43333888169596,33.35479667919152,NaN,NaN,50
1660321800,1.02529,1.02613,1.02513,1.02565,1843,3467,-769729,-771677.6,40.587618411982795,35.066132557921165,33.058196255379464,NaN,NaN,50
1660323600,1.02565,1.0268,1.02565,1.02644,1823,3407.8,-767906,-770115.2,40.33819712233485,40.54143444290762,33.35164782862025,NaN,NaN,50
1660325400,1.02644,1.02664,1.02601,1.02608,1458,3332,-769364,-769589.8,40.106591639090325,38.93046791915501,33.60565448285745,NaN,NaN,50
1660327200,1.02608,1.02674,1.02597,1.02662,1136,3238.2,-768228,-769359.8,39.713244078303795,42.614038612786466,34.38286827879612,NaN,NaN,50
1660329000,1.02662,1.02662,1.02612,1.02654,1011,3164.1,-769239,-768893.2,39.34799277185916,42.20785850993999,35.375608436074096,NaN,NaN,50
1660330800,1.02654,1.02664,1.02602,1.02628,915,3081.15,-770154,-768978.2,39.105428374852394,40.84523646997965,35.53513831779004,NaN,NaN,50
1660332600,1.02628,1.02668,1.02602,1.02606,1192,3001.7,-771346,-769666.2,38.79445352775346,39.67798164028312,36.18884157527601,NaN,NaN,50
1660334400,1.02606,1.02622,1.02562,1.02578,945,2904.6,-772291,-770251.6,38.910348082610355,38.182408627297875,36.451235021213215,NaN,NaN,50
1660336200,1.02578,1.02616,1.02547,1.0259,673,2802.45,-771618,-770929.6,39.16213931875851,39.23943960850616,36.485327511550864,NaN,NaN,50
1660510800,1.0259,1.02633,1.02562,1.02605,68,2633.6,-771550,-771391.8,38.99199122488697,40.60656631467708,37.23537957055131,NaN,NaN,50
1660512600,1.02605,1.02606,1.02566,1.02606,193,2481.7,-771357,-771632.4,38.83399656629196,40.70235580458942,38.271946439704436,NaN,NaN,50
1660514400,1.02606,1.02612,1.02588,1.0261,726,2344.75,-770631,-771489.4,38.53104187860855,41.11147960433456,38.94640106692964,NaN,NaN,50
1660516200,1.0261,1.02626,1.02566,1.02599,727,2178.4,-771358,-771302.8,38.52723312349054,40.28826466536794,39.460500261388724,NaN,NaN,50
1660518000,1.02599,1.02618,1.02581,1.02584,703,2021.35,-772061,-771391.4,38.523696422309534,39.13739714864856,39.939361566171044,NaN,NaN,50
1660519800,1.02584,1.02633,1.02538,1.02538,794,1821.6,-772855,-771652.4,39.041887775182374,35.763455971380395,39.98917038141814,NaN,NaN,50
1660521600,1.02538,1.02632,1.02536,1.02622,1599,1518.6,-771256,-771632.2,39.545950221436634,45.075001274959995,40.312996583707594,NaN,NaN,50
1660523400,1.02622,1.02676,1.02604,1.02664,1660,1300,-769596,-771425.2,38.73248871130424,49.051710940799055,41.03594251382503,NaN,NaN,50
1660525200,1.02664,1.02683,1.02552,1.02554,1772,1202.25,-771368,-771427.2,38.670760678792114,40.73344105023887,40.9016141165002,NaN,NaN,50
1660527000,1.02554,1.02602,1.02532,1.02574,1769,1160.05,-769599,-770934.8,38.84873637318362,42.638130337180826,40.93234781844597,NaN,NaN,50
1660528800,1.02574,1.02576,1.02452,1.02466,1693,1135,-771292,-770622.2,39.79538066182788,35.92415904248348,40.58084228791053,NaN,NaN,50
1660530600,1.02466,1.02477,1.02398,1.02454,1674,1126.55,-772966,-770964.2,41.081752040398996,35.25979925632747,40.265257831913694,NaN,NaN,50
1660532400,1.02454,1.0249,1.02422,1.02484,983,1084.55,-771983,-771441.6,41.938724618277334,38.33032725644631,40.275823448281436,NaN,NaN,50
1660534200,1.02484,1.02532,1.02468,1.02522,1190,1071.15,-770793,-771326.6,41.702816062630184,42.077740121838055,40.478559199233715,NaN,NaN,50
1660536000,1.02522,1.02559,1.02506,1.0253,992,1063.95,-769801,-771367,40.87657671087693,42.86488393684978,40.63986760081748,NaN,NaN,50
1660537800,1.0253,1.02559,1.02501,1.02506,946,1060.7,-770747,-771258,40.169639794605075,41.062052265189315,40.66556020514605,NaN,NaN,50
1660539600,1.02506,1.02524,1.0246,1.02488,1057,1067.8,-771804,-771025.6,39.988435002200085,39.7129898037296,40.565668076531416,NaN,NaN,50
1660541400,1.02488,1.02494,1.02398,1.02406,1405,1078.45,-773209,-771270.8,40.42461396947946,34.20047711786357,40.13082610885253,NaN,NaN,50
1660543200,1.02406,1.02476,1.02405,1.02408,2470,1154.7,-770739,-771260,40.829637296238886,34.43951130908118,39.79526283459772,NaN,NaN,50
1660545000,1.02408,1.02408,1.02324,1.02362,2186,1230.35,-772925,-771884.8,41.862317195742406,31.596438788838995,39.49761875013048,NaN,NaN,50
1660546800,1.02362,1.02447,1.023,1.02355,3040,1378.95,-775965,-772928.4,41.92014966148595,31.174686024981142,38.5047390894177,NaN,NaN,50
1660548600,1.02355,1.02445,1.02334,1.02342,2867,1512.65,-778832,-774334,41.97385123681923,30.364079825098116,37.169908295439065,NaN,NaN,50
1660550400,1.02342,1.02366,1.02279,1.02319,2378,1595.25,-781210,-775934.2,42.50398600091473,28.930779701595753,36.32686105625027,NaN,NaN,50
1660552200,1.02319,1.02324,1.02001,1.02072,3419,1729.85,-784629,-778712.2,44.40471201947146,18.714252444939433,34.618012635375884,NaN,NaN,50
1660554000,1.02072,1.02112,1.01912,1.01929,3551,1872.25,-788180,-781763.2,46.43094932682912,15.337358022445883,33.147526848230335,NaN,NaN,50
1660555800,1.01929,1.01996,1.01868,1.01995,2489,1957,-785691,-783708.4,48.42781380912907,22.305659992419393,32.22223118652262,NaN,NaN,50
1660557600,1.01995,1.02069,1.01872,1.01877,2391,1996.6,-788082,-785558.4,49.08845128090665,19.254347383287765,30.85966119558272,NaN,NaN,50
1660559400,1.01877,1.02063,1.01859,1.0204,2596,2043.4,-785486,-786413.6,49.75645328608418,32.90757670038228,30.204649522621594,NaN,NaN,50
1660561200,1.0204,1.02088,1.01988,1.02012,2303,2069.95,-787789,-787045.6,49.96903045030173,31.909438876710198,29.42211773261162,NaN,NaN,50
1660563000,1.02012,1.02013,1.01896,1.01956,2515,2107.25,-790304,-787470.4,50.58823705255088,29.95264758604928,28.628588826958765,NaN,NaN,50
1660564800,1.01956,1.02073,1.01906,1.02023,3954,2220.3,-786350,-787602.2,50.24913244690607,35.08199334131322,28.297803365357595,NaN,NaN,50
1660566600,1.02023,1.02148,1.01968,1.02008,6024,2437.8,-792374,-788460.6,48.913827566174476,34.47336101274223,28.31729507213464,NaN,NaN,50
1660568400,1.02008,1.02234,1.01967,1.02223,4139,2595.6,-788235,-789010.4,46.65990017959608,48.314488226507294,29.30836485195079,NaN,NaN,50
1660570200,1.02223,1.02223,1.01938,1.01984,3627,2717.45,-791862,-789825,44.78956418821583,38.56304294493336,29.805979434528968,NaN,NaN,50
1660572000,1.01984,1.02008,1.01888,1.01948,3117,2823.7,-794979,-790760,43.42452186770166,37.340508469114724,30.246395323395653,NaN,NaN,50
1660573800,1.01948,1.02004,1.01852,1.01943,3325,2942.65,-798304,-793150.8,42.41332610222105,37.16428336780887,30.732124147874995,NaN,NaN,50
1660575600,1.01943,1.01962,1.01814,1.01894,2650,3022.3,-800954,-794866.8,41.73725580245547,35.40103202435587,31.19428502807214,NaN,NaN,50
1660577400,1.01894,1.01935,1.0183,1.01852,1983,3051.2,-802937,-797807.2,41.10947623838743,33.915688221491024,32.2801018692544,NaN,NaN,50
1660579200,1.01852,1.01854,1.0173,1.01752,1663,3010.85,-804600,-800354.8,41.182911658117796,30.62133214491496,33.371814306573626,NaN,NaN,50
1660581000,1.01752,1.01798,1.01716,1.01758,1184,2960.75,-803416,-802042.2,41.33477150363319,31.05405968656821,33.996699999012826,NaN,NaN,50
1660582800,1.01758,1.01785,1.01686,1.01691,1264,2871.95,-804680,-803317.4,41.65651625067932,28.887332387734148,34.68477035647328,NaN,NaN,50
1660584600,1.01691,1.01698,1.01637,1.01647,1057,2781.45,-805737,-804274,42.236885469182084,27.52890220706435,34.300579321236285,NaN,NaN,50
1660586400,1.01647,1.01656,1.01556,1.01589,1515,2738.3,-807252,-805137,43.18730326250188,25.806186121382694,33.86463269585575,NaN,NaN,50
1660588200,1.01589,1.016,1.01544,1.01563,1082,2621.45,-808334,-805883.8,44.126910669568,25.049435481836184,33.51440325984053,NaN,NaN,50
1660590000,1.01563,1.01618,1.01562,1.01618,1117,2499.75,-807217,-806644,44.684312017513925,29.74289672590251,33.13303921588262,NaN,NaN,50
1660591800,1.01618,1.01644,1.01578,1.01608,997,2425.15,-808214,-807350.8,44.74561348925503,29.382624398450048,32.76941517200461,NaN,NaN,50
1660593600,1.01608,1.01642,1.01579,1.01602,975,2354.35,-809189,-808041.2,44.80253628444319,29.154438784017913,31.400840211826797,NaN,NaN,50
1660595400,1.01602,1.01608,1.01562,1.01596,459,2247.5,-809648,-808520.4,44.97558179054943,28.91263116681941,30.711525084818657,NaN,NaN,50
1660597200,1.01596,1.01622,1.01596,1.0161,174,2141.05,-809474,-808748.4,44.855781039561435,30.363943642288888,30.213199025759668,NaN,NaN,50
1660599000,1.0161,1.01632,1.01607,1.01608,423,2036.45,-809897,-809284.4,44.5387558718942,30.268871918675444,29.720669636535852,NaN,NaN,50
1660600800,1.01608,1.01671,1.01542,1.01544,1294,1903.45,-811191,-809879.8,44.76942353188267,27.32090298982419,29.143517562640735,NaN,NaN,50
1660602600,1.01544,1.01674,1.01537,1.01628,995,1652,-810196,-810081.2,45.021358336853815,36.11532588026168,29.30063453826721,NaN,NaN,50
1660604400,1.01628,1.01636,1.01591,1.01622,839,1487,-811035,-810358.6,45.25529779861274,35.78226600874309,29.669272671397795,NaN,NaN,50
1660606200,1.01622,1.0163,1.01607,1.01616,806,1345.95,-811841,-810832,45.47252729881745,35.43038861113038,29.9818675945808,NaN,NaN,50
1660608000,1.01616,1.01618,1.01534,1.01546,1689,1274.55,-813530,-811558.6,46.24942299528802,31.534225155014397,30.170931363672253,NaN,NaN,50
1660609800,1.01546,1.01567,1.01476,1.01538,1797,1198.15,-815327,-812385.8,47.337465602286436,31.11312871605871,30.426947542886133,NaN,NaN,50
1660611600,1.01538,1.0158,1.01491,1.0151,2075,1169.4,-817402,-813827,48.0294337556703,29.622158938796673,30.69951702984428,NaN,NaN,50
1660613400,1.0151,1.01588,1.01504,1.0157,2202,1180.35,-815200,-814660,48.470501871766395,36.63003662309855,31.526702825648734,NaN,NaN,50
1660615200,1.0157,1.01676,1.01568,1.01656,1714,1182.9,-813486,-814989,46.94748538908327,45.07255231085584,32.62167822457397,NaN,NaN,50
1660617000,1.01656,1.0169,1.01633,1.0169,1362,1191.8,-812124,-814707.8,45.26821154725067,48.020923306321656,33.95298528942194,NaN,NaN,50
1660618800,1.0169,1.01698,1.01656,1.01668,1259,1191.55,-813383,-814319,43.55333515486217,46.289498505996455,35.17691812670613,NaN,NaN,50
1660620600,1.01668,1.0167,1.01609,1.01624,1151,1196.25,-814534,-813745.4,42.5256995130936,42.953781418428,36.17985743039245,NaN,NaN,50
1660622400,1.01624,1.01624,1.01578,1.01596,911,1166.05,-815445,-813794.4,41.90830892683577,40.93233030790863,36.93474219222243,NaN,NaN,50
1660624200,1.01596,1.01637,1.01588,1.0159,770,1150.45,-816215,-814340.2,41.05588424455812,40.49257094615275,37.66500640847081,NaN,NaN,50
1660626000,1.0159,1.01604,1.01552,1.01592,1097,1149.45,-815118,-814939,40.66488245177523,40.72118953115807,38.62216973285181,NaN,NaN,50
1660627800,1.01592,1.01654,1.01586,1.01642,1530,1176.1,-813588,-814980,39.265935000401,46.27790289122192,39.34806809077754,NaN,NaN,50
1660629600,1.01642,1.01688,1.0157,1.01659,2291,1241.9,-811297,-814332.6,37.33868258443188,48.06060588542694,40.22509236768353,NaN,NaN,50
1660631400,1.01659,1.01662,1.01514,1.01542,3378,1387.85,-814675,-814178.6,36.264218742163976,38.57344811905671,40.44959661824969,NaN,NaN,50
1660633200,1.01542,1.01578,1.01341,1.01398,4885,1623.4,-819560,-814847.6,36.79405783865522,30.57399372124854,40.38100865869499,NaN,NaN,50
1660635000,1.01398,1.0163,1.01392,1.01597,3472,1775.85,-816088,-815041.6,36.44652276913985,46.947826573533376,41.512058505657464,NaN,NaN,50
1660636800,1.01597,1.01606,1.01424,1.01452,3116,1866.95,-819204,-816164.8,36.12381163316129,39.61619633154832,42.22591831942544,NaN,NaN,50
1660638600,1.01452,1.01506,1.01352,1.0139,3483,1991.35,-822687,-818442.8,36.388693189429496,36.958486226170145,42.249379005359124,NaN,NaN,50
1660640400,1.0139,1.01422,1.01248,1.01353,3796,2139.2,-826483,-820804.4,37.29212223201138,35.43087976514781,41.56068810923712,NaN,NaN,50
1660642200,1.01353,1.01394,1.01289,1.0134,3019,2249.85,-829502,-822792.8,38.13102062869455,34.88529031376477,40.62242860976877,NaN,NaN,50
1660644000,1.0134,1.01425,1.01327,1.01328,2761,2303.45,-832263,-826027.8,38.37528595073569,34.359332007917146,39.77027385990596,NaN,NaN,50
1660645800,1.01328,1.01348,1.01259,1.01336,2285,2327.85,-829978,-828182.6,39.044938053232755,35.06224195836276,39.2065924699013,NaN,NaN,50
1660647600,1.01336,1.0136,1.01247,1.01268,2914,2369.8,-832892,-830223.6,39.66675786269432,31.932140992703467,38.56372180452951,NaN,NaN,50
1660649400,1.01268,1.01309,1.01226,1.0128,3347,2427.05,-829545,-830836,40.380755963668896,33.067704430815226,38.03337419629111,NaN,NaN,50
1660651200,1.0128,1.01398,1.01249,1.01379,2583,2470.5,-826962,-830328,39.51361690438621,41.707797268591015,38.10384617753632,NaN,NaN,50
1660653000,1.01379,1.01465,1.01306,1.01438,4525,2628.65,-822437,-828362.8,37.755988635897644,46.16771648002159,38.09597571959345,NaN,NaN,50
1660654800,1.01438,1.01621,1.01431,1.0158,3819,2756.65,-818618,-826090.8,35.69169869324346,55.07637538342639,38.59710211230769,NaN,NaN,50
1660656600,1.0158,1.01782,1.01554,1.01762,4001,2899.15,-814617,-822435.8,34.99156649612164,63.429800515937046,40.372555854942,NaN,NaN,50
1660658400,1.01762,1.01873,1.01652,1.01853,4019,3054.55,-810598,-818646.4,34.882129246894465,66.75815519874519,42.957138817620326,NaN,NaN,50
1660660200,1.01853,1.01949,1.01752,1.01788,4334,3232.75,-814932,-816240.4,35.18039956971092,62.3902270595895,44.0601674237672,NaN,NaN,50
1660662000,1.01788,1.01838,1.01712,1.01777,2585,3307.15,-817517,-815256.4,35.00524935753739,61.65503013081689,45.634369838000666,NaN,NaN,50
1660663800,1.01777,1.01793,1.01718,1.01732,2241,3342.7,-819758,-815484.4,34.84260987480482,58.61218704689241,47.18106275376653,NaN,NaN,50
1660665600,1.01732,1.01738,1.01652,1.01656,1919,3324.1,-821677,-816896.4,33.93196174298826,53.784348716753435,48.49202482173837,NaN,NaN,50
1660667400,1.01656,1.01702,1.01632,1.01658,1296,3220,-820381,-818853,32.86413657046203,53.89198094771318,49.84964558130611,NaN,NaN,50
1660669200,1.01658,1.01743,1.01658,1.01702,1056,3028.55,-819325,-819731.6,32.180794075079575,56.30306107505005,51.41705480038703,NaN,NaN,50
1660671000,1.01702,1.01788,1.01696,1.01761,1101,2910,-818224,-819873,31.87073345551531,59.37105662929815,53.15339870545385,NaN,NaN,50
1660672800,1.01761,1.01808,1.01735,1.01768,1449,2826.65,-816775,-819276.4,31.724897758813338,59.732292878483506,55.13912384015242,NaN,NaN,50
1660674600,1.01768,1.01796,1.01625,1.01682,2194,2762.2,-818969,-818734.8,30.2879071960301,53.44520360866866,56.59465949571338,NaN,NaN,50
1660676400,1.01682,1.01712,1.0163,1.01649,1961,2670.45,-820930,-818844.6,28.953558816302806,51.21749222932432,57.27392342148005,NaN,NaN,50
1660678200,1.01649,1.01705,1.01621,1.01702,1622,2600.6,-819308,-818841.2,27.60974518375431,54.497902881626814,57.868936735880425,NaN,NaN,50
1660680000,1.01702,1.01728,1.01682,1.01708,646,2494.85,-818662,-818928.8,26.585983008822815,54.867909595600516,57.85404632246429,NaN,NaN,50
1660681800,1.01708,1.01712,1.01686,1.01709,609,2411.05,-818053,-819184.4,25.635346703529287,54.933685022028705,57.24718093004227,NaN,NaN,50
1660683600,1.01709,1.01709,1.01661,1.01688,1967,2363.7,-820020,-819394.6,24.411554940715146,53.180863934991464,56.27737441120272,NaN,NaN,50
1660685400,1.01688,1.01711,1.01674,1.01683,154,2204.05,-820174,-819243.4,23.298825016667283,52.74929427759131,55.5887363553457,NaN,NaN,50
1660687200,1.01683,1.01734,1.0168,1.01731,629,2106.35,-819545,-819290.8,22.544873249511223,56.40668475000098,55.213854542430276,NaN,NaN,50
1660689000,1.01731,1.01734,1.01688,1.01707,476,1903.9,-820021,-819562.6,21.844775180009172,54.14977409595104,54.89511076022018,NaN,NaN,50
1660690800,1.01707,1.0175,1.01704,1.0172,599,1742.9,-819422,-819836.4,21.403141002295982,55.19551024564858,54.995908012284126,NaN,NaN,50
1660692600,1.0172,1.01739,1.01696,1.01696,703,1578,-820125,-819857.4,20.846897810195824,52.801218020748124,54.91799637464376,NaN,NaN,50
1660694400,1.01696,1.01714,1.01662,1.01672,1556,1454.85,-821681,-820158.8,19.722503450856518,50.44468515074544,54.49954095147915,NaN,NaN,50
1660696200,1.01672,1.01738,1.01666,1.01708,1560,1316.15,-820121,-820274,19.043588005056307,53.77712599289384,54.09997447745026,NaN,NaN,50
1660698000,1.01708,1.01765,1.01692,1.01758,1535,1263.65,-818586,-819987,18.80609718382813,58.001463000453896,53.97634377187672,NaN,NaN,50
1660699800,1.01758,1.01759,1.01666,1.01718,2170,1260.1,-820756,-820253.8,18.091749433488648,53.767960266879626,53.999397818891794,NaN,NaN,50
1660701600,1.01718,1.01796,1.01715,1.01744,2161,1272.2,-818595,-819947.8,17.974814168611207,56.01525982935027,54.342095504607926,NaN,NaN,50
1660703400,1.01744,1.01748,1.01689,1.01738,1051,1259.95,-819646,-819540.8,17.36973507193386,55.34665139857587,54.40272039867572,NaN,NaN,50
1660705200,1.01738,1.01768,1.01683,1.01698,1386,1276.45,-821032,-819723,17.112434850580406,50.978052627028966,54.12487347234917,NaN,NaN,50
1660707000,1.01698,1.01754,1.01693,1.01733,1305,1286.65,-819727,-819951.2,16.87351321646648,54.371780880236464,54.084737462221156,NaN,NaN,50
1660708800,1.01733,1.01744,1.0169,1.01744,764,1252.4,-818963,-819592.6,16.585591973262638,55.4164305347385,54.24442079077452,NaN,NaN,50
1660710600,1.01744,1.0184,1.0174,1.01818,1151,1200.25,-817812,-819436,17.680709336782968,61.75931157628187,54.8879934549667,NaN,NaN,50
1660712400,1.01818,1.01854,1.01784,1.01784,1255,1164.95,-819067,-819320.2,18.859198301042547,57.69766746286906,54.980206505885846,NaN,NaN,50
1660714200,1.01784,1.01828,1.01764,1.01823,1496,1158.65,-817571,-818628,19.48737755711826,60.87609280230836,55.460657842054225,NaN,NaN,50
1660716000,1.01823,1.01866,1.01651,1.017,3082,1280.45,-820653,-818813.2,18.202291472513334,48.499294616270305,54.98235672567006,NaN,NaN,50
1660717800,1.017,1.01715,1.01568,1.01635,2740,1387,-823393,-819699.2,18.08546064920316,43.469615628910134,54.31581369768163,NaN,NaN,50
1660719600,1.01635,1.01677,1.01495,1.0161,3795,1478.4,-827188,-821574.4,18.73127334922979,41.679272354061034,53.68971278363274,NaN,NaN,50
1660721400,1.0161,1.0167,1.01528,1.01666,3830,1662.2,-823358,-822432.6,19.330956570683092,46.94997818176415,53.20205936855205,NaN,NaN,50
1660723200,1.01666,1.0175,1.01518,1.0173,3682,1814.85,-819676,-822853.6,18.629474822335546,52.260094442782695,52.79196161443268,NaN,NaN,50
1660725000,1.0173,1.01841,1.0172,1.0174,3105,1946.3,-816571,-822037.2,17.754647576582762,53.050865495257504,52.74074055931681,NaN,NaN,50
1660726800,1.0174,1.0179,1.01686,1.01742,2699,2051.3,-813872,-820133,16.523087602099128,53.2177687545554,52.54091976826003,NaN,NaN,50
1660728600,1.01742,1.0184,1.01712,1.01814,2280,2130.15,-811592,-817013.8,15.950499973770722,58.88446985548182,52.79362108661046,NaN,NaN,50
1660730400,1.01814,1.01824,1.01752,1.01754,2373,2171,-813965,-815135.2,15.418811461751487,53.11099535151179,52.94597413835923,NaN,NaN,50
1660732200,1.01754,1.01774,1.01656,1.01746,2359,2210.95,-816324,-814464.8,14.88612245694772,52.3736469900278,52.80325028905862,NaN,NaN,50
1660734000,1.01746,1.01747,1.01594,1.01598,3272,2297.8,-819596,-815069.8,15.019181313732636,41.02603992497149,51.775365245503835,NaN,NaN,50
1660735800,1.01598,1.01679,1.01542,1.01676,3119,2345.25,-816477,-815590.8,15.614843256644825,47.48407053783557,50.75570517132909,NaN,NaN,50
1660737600,1.01676,1.01708,1.0156,1.0162,2972,2385.8,-819449,-817162.2,15.766934673937097,43.777526729589,49.76140940466623,NaN,NaN,50
1660739400,1.0162,1.01692,1.01454,1.01584,5837,2625.1,-825286,-819426.4,16.800831324681553,41.5330545549602,48.37976381556994,NaN,NaN,50
1660741200,1.01584,1.01697,1.0153,1.01656,4816,2796.6,-820470,-820255.6,17.68962857701903,47.34735989678981,48.29748276417847,NaN,NaN,50
1660743000,1.01656,1.0174,1.01568,1.01669,4375,2950.1,-816095,-819555.4,17.903484937633912,48.34617580214065,48.645808490837794,NaN,NaN,50
1660744800,1.01669,1.01986,1.01668,1.01823,4559,3139.85,-811536,-818567.2,17.64547980711984,58.41099316125677,49.840931405637484,NaN,NaN,50
1660746600,1.01823,1.01838,1.01614,1.01622,3841,3274.35,-815377,-817752.8,16.882471757832285,45.852751412888956,49.76255806500354,NaN,NaN,50
1660748400,1.01622,1.01726,1.01612,1.01679,2662,3344.7,-812715,-815238.6,16.15447511571401,49.188978874612644,49.543192667277104,NaN,NaN,50
1660750200,1.01679,1.01734,1.01612,1.01615,2253,3382.55,-814968,-814138.2,15.550918918025816,45.77838850361172,49.02373002501669,NaN,NaN,50
1660752000,1.01615,1.01682,1.0161,1.0163,1574,3307.15,-813394,-813598,14.96802745773262,46.71098845317382,48.55896000348944,NaN,NaN,50
1660753800,1.0163,1.0171,1.01607,1.01654,1857,3263,-811537,-813598.2,14.705501739048895,48.24483300126405,47.798985942473884,NaN,NaN,50
1660755600,1.01654,1.01703,1.01632,1.01658,2095,3178,-809442,-812411.2,14.461727857414006,48.51083991402756,47.47040341122501,NaN,NaN,50
1660757400,1.01658,1.01706,1.01658,1.0169,1460,3059.5,-807982,-811464.6,14.268369364763158,50.694135115238154,47.35043827731146,NaN,NaN,50
1660759200,1.0169,1.01974,1.01687,1.01937,8601,3305.45,-799381,-808347.2,16.19296484979399,63.54397299294625,48.95886206788108,NaN,NaN,50
1660761000,1.01937,1.02031,1.01824,1.01846,3737,3337.05,-803118,-806292,18.27834840020013,57.58914998232833,49.68065345677342,NaN,NaN,50
1660762800,1.01846,1.01911,1.01795,1.01844,2524,3328.3,-805642,-805113,19.82576074194292,57.46169810533273,50.65809426932655,NaN,NaN,50
1660764600,1.01844,1.01844,1.01788,1.01803,1817,3305.15,-807459,-804716.4,21.166247028857146,54.78496247260344,51.60465912058678,NaN,NaN,50
1660766400,1.01803,1.01806,1.01756,1.01758,737,3223.35,-808196,-804759.2,21.96229512815271,51.92589530683605,51.93169736416151,NaN,NaN,50
1660768200,1.01758,1.01791,1.01754,1.01781,843,3147.55,-807353,-806353.6,22.67273891729343,53.26827329858175,52.283275756764446,NaN,NaN,50
1660770000,1.01781,1.01789,1.01768,1.0177,168,2992.35,-807521,-807234.2,23.33243672149553,52.513041403304676,51.8619934883393,NaN,NaN,50
1660771800,1.0177,1.01777,1.01767,1.01767,90,2840.9,-807611,-807628,23.928425241031455,52.29527673296244,52.32217386834454,NaN,NaN,50
1660773600,1.01767,1.01785,1.01752,1.0178,697,2727.15,-806914,-807519,24.221751635346916,53.200934696404225,52.608742141329664,NaN,NaN,50
1660775400,1.0178,1.01802,1.01778,1.01782,381,2454.35,-806533,-807186.4,24.661954885897373,53.34767433823131,53.14940541523106,NaN,NaN,50
1660777200,1.01782,1.01786,1.0174,1.01758,496,2238.35,-807029,-807121.6,24.392086057778968,51.27017449149474,53.4750615608254,NaN,NaN,50
1660779000,1.01758,1.0178,1.01728,1.01776,564,2047.8,-806465,-806910.4,23.932695968356047,52.75616687238107,53.79729969447663,NaN,NaN,50
1660780800,1.01776,1.01856,1.01742,1.01836,1314,1885.55,-805151,-806418.4,24.33577263955136,57.41755967761539,54.43349396330433,NaN,NaN,50
1660782600,1.01836,1.01932,1.01834,1.01882,1787,1782.85,-803364,-805708.4,25.37556272725057,60.62516268341032,55.14285307531663,NaN,NaN,50
1660784400,1.01882,1.01916,1.01844,1.01892,1917,1745.6,-801447,-804691.2,26.341082094399837,61.30750707898493,54.983105510033674,NaN,NaN,50
1660786200,1.01892,1.019,1.01838,1.01868,1981,1732,-803428,-803971,27.118898629255835,58.67926452147214,55.060970834258235,NaN,NaN,50
1660788000,1.01868,1.01895,1.01828,1.01829,1323,1719.45,-804751,-803628.2,27.63501774368711,54.58423477138618,54.855437738976335,NaN,NaN,50
1660789800,1.01829,1.01838,1.01802,1.01804,1083,1680.75,-805834,-803764.8,27.580642092023727,52.0754383650805,54.661900302724696,NaN,NaN,50
1660791600,1.01804,1.0181,1.01761,1.01789,938,1622.9,-806772,-804446.4,26.74817049198468,50.57348311937938,54.565299432192084,NaN,NaN,50
1660793400,1.01789,1.01792,1.01672,1.01707,1302,1615,-808074,-805771.8,25.089944121378704,43.232681211327936,53.848471425959666,NaN,NaN,50
1660795200,1.01707,1.01718,1.01644,1.0165,947,1232.3,-809021,-806890.4,23.920947160569806,38.99546672413082,52.882930377447245,NaN,NaN,50
1660797000,1.0165,1.01678,1.01631,1.0167,1174,1104.15,-807847,-807509.6,23.006270168612943,41.17406395740132,52.08855803633573,NaN,NaN,50
1660798800,1.0167,1.01727,1.01664,1.01723,1168,1036.35,-806679,-807678.6,21.393968748158745,46.614897930663616,51.618126838782835,NaN,NaN,50
1660800600,1.01723,1.01786,1.01632,1.01645,1915,1041.25,-808594,-808043,20.629940159522565,40.65529697079564,50.71152845539457,NaN,NaN,50
1660802400,1.01645,1.01673,1.01587,1.01667,2448,1126.8,-806146,-807657.4,19.260714809184226,42.87370418927577,50.11178057666465,NaN,NaN,50
1660804200,1.01667,1.01667,1.01492,1.01513,3100,1239.65,-809246,-807702.4,18.936212617409414,33.44802741704923,48.73262775842666,NaN,NaN,50
1660806000,1.01513,1.01616,1.0146,1.01538,4022,1432.35,-805224,-807177.8,18.967977954491126,35.91126993761354,47.19646420556939,NaN,NaN,50
1660807800,1.01538,1.0165,1.01535,1.01615,3369,1596.3,-801855,-806213,18.495370609923782,42.918940339570746,45.93173403815228,NaN,NaN,50
1660809600,1.01615,1.01769,1.01606,1.01666,2980,1710.45,-798875,-804269.2,17.749628162745132,47.048770432996754,44.91325284915312,NaN,NaN,50
1660811400,1.01666,1.01766,1.01616,1.01672,3481,1865.45,-795394,-802118.8,17.0571530332221,47.529741683503126,44.11685836072676,NaN,NaN,50
1660813200,1.01672,1.01726,1.01609,1.01618,2825,1981.9,-798219,-799913.4,16.31967396529014,43.68389785698292,43.33826286684081,NaN,NaN,50
1660815000,1.01618,1.01739,1.0158,1.01702,2516,2079.5,-795703,-798009.2,15.240120815823904,50.406278483121305,43.21903716098658,NaN,NaN,50
1660816800,1.01702,1.01816,1.01656,1.01688,3215,2174.55,-798918,-797421.8,15.14774136375686,49.348969237677565,43.131571883722174,NaN,NaN,50
1660818600,1.01688,1.01737,1.01647,1.01736,2075,2188.95,-796843,-797015.4,14.931947765534066,52.989853588506506,43.82851276780635,NaN,NaN,50
1660820400,1.01736,1.01808,1.01716,1.01784,2435,2214.85,-794408,-796818.2,15.481589750360447,56.36749417892225,45.06937187172003,NaN,NaN,50
1660822200,1.01784,1.01882,1.0174,1.01773,2890,2260.3,-797298,-796634,16.64556000998264,55.38539972861336,46.08446728394946,NaN,NaN,50
1660824000,1.01773,1.01868,1.01748,1.01804,3668,2377.55,-793630,-796219.4,17.726389536774672,57.62606516359063,46.87097922915853,NaN,NaN,50
1660825800,1.01804,1.01821,1.01585,1.017,5440,2595.4,-799070,-796249.8,16.54612233111157,48.775723144664525,47.45100967014917,NaN,NaN,50
1660827600,1.017,1.01722,1.01503,1.01558,3835,2740.25,-802905,-797462.2,16.085536285204654,39.78997160637687,47.23074305708496,NaN,NaN,50
1660829400,1.01558,1.01568,1.01212,1.01239,5404,2945.35,-808309,-800242.4,17.578579584807517,27.523075784637314,46.8075322261984,NaN,NaN,50
1660831200,1.01239,1.01284,1.01118,1.01238,4891,3142.55,-813200,-803422.8,19.389156294104357,27.494460356500113,46.20633154183315,NaN,NaN,50
1660833000,1.01238,1.01319,1.01222,1.01286,3177,3242.7,-810023,-806701.4,20.69865201127503,31.192446822176763,45.36872486201929,NaN,NaN,50
1660834800,1.01286,1.01398,1.0128,1.01368,2176,3293.1,-807847,-808456.8,21.114675531009432,37.094958806748565,44.657738317287276,NaN,NaN,50
1660836600,1.01368,1.01368,1.01124,1.01125,2592,3326.95,-810439,-809963.6,22.274758377879163,29.12229480579788,43.34292068316547,NaN,NaN,50
1660838400,1.01125,1.01152,1.01022,1.01052,2295,3319.3,-812734,-810848.6,23.772810126269377,27.228986602445815,42.167569879269955,NaN,NaN,50
1660840200,1.01052,1.01052,1.0089,1.00903,2122,3270.4,-814856,-811179.8,25.633623416109746,23.824390393006226,40.26886358711888,NaN,NaN,50
1660842000,1.00903,1.00935,1.00794,1.00846,4008,3269.7,-818864,-812948,27.65974501672427,22.65727172205932,38.36231376457472,NaN,NaN,50
1660843800,1.00846,1.00888,1.00806,1.00814,2309,3216.7,-821173,-815613.2,29.54114364586632,22.005516393931273,36.14914682210506,NaN,NaN,50
1660845600,1.00814,1.00872,1.0081,1.0087,1822,3158.8,-819351,-817395.6,31.288156658641082,26.016357162432698,33.98120846378438,NaN,NaN,50
1660847400,1.0087,1.00933,1.00852,1.00907,1746,3072.05,-817605,-818369.8,32.22897581583663,28.627907166713257,32.06995899507723,NaN,NaN,50
1660849200,1.00907,1.00993,1.00906,1.00959,1323,2996.95,-816282,-818655,32.46720561968485,32.247615058549016,30.257212559002827,NaN,NaN,50
1660851000,1.00959,1.00974,1.00904,1.00942,1051,2923.7,-817333,-818348.8,32.69857037019001,31.681914289956964,29.036226212238006,NaN,NaN,50
1660852800,1.00942,1.00946,1.0089,1.00912,709,2798.4,-818042,-817722.6,32.98851712483116,30.65976346256845,28.38406848768026,NaN,NaN,50
1660854600,1.00912,1.00912,1.00864,1.00876,527,2721,-818569,-817566.2,33.400832675682516,29.432611633267413,28.520463905439556,NaN,NaN,50
1660856400,1.00876,1.00904,1.00872,1.00902,642,2631.35,-817927,-817630.6,33.78369711575876,31.563081881332067,28.811079728641833,NaN,NaN,50
1660858200,1.00902,1.00902,1.0087,1.00886,157,2494.7,-818084,-817991,34.15153944017107,30.943956527621552,28.79333042188789,NaN,NaN,50
1660860000,1.00886,1.00911,1.00884,1.00898,584,2340.5,-817500,-818024.4,34.35942177460045,32.020967464199416,28.430902468848664,NaN,NaN,50
1660861800,1.00898,1.00915,1.00848,1.00866,649,2100.95,-818149,-818045.8,34.79902409620484,30.648261013353277,28.539900055102617,NaN,NaN,50
1660863600,1.00866,1.009,1.00858,1.009,533,1935.85,-817616,-817855.2,35.207226251980345,33.89103873538707,29.015760921741276,NaN,NaN,50
1660865400,1.009,1.00922,1.0089,1.00891,560,1693.65,-818176,-817905,35.210718511318454,33.44523636774683,29.70296420565132,NaN,NaN,50
1660867200,1.00891,1.00912,1.00794,1.00796,1669,1532.55,-819845,-818257.2,35.905531223455746,29.094749235452937,30.162784028036576,NaN,NaN,50
1660869000,1.00796,1.00826,1.0074,1.00793,1876,1467.5,-821721,-819101.4,36.87740375064777,28.966609560733232,30.66000496852243,NaN,NaN,50
1660870800,1.00793,1.00832,1.00792,1.00828,1391,1428.25,-820330,-819537.6,37.67475603690669,32.69114958005467,31.136775855495426,NaN,NaN,50
1660872600,1.00828,1.00834,1.007,1.0075,2545,1425.9,-822875,-820589.4,38.93398034505117,29.037098901074586,31.166003836521238,NaN,NaN,50
1660874400,1.0075,1.00838,1.00742,1.00784,1722,1397.25,-821153,-821184.8,40.0311225746888,32.57491205971007,31.189382193747026,NaN,NaN,50
1660876200,1.00784,1.00864,1.00758,1.0086,1397,1361,-819756,-821167,40.57006110083266,39.7996471339263,31.76922025403055,NaN,NaN,50
1660878000,1.0086,1.0087,1.0082,1.00833,889,1205.05,-820645,-820951.8,40.957667567177495,38.23229829638912,32.31011559930345,NaN,NaN,50
1660879800,1.00833,1.00833,1.00787,1.00801,1021,1140.65,-821666,-821219,41.547575226003545,36.402558834798036,32.80796897084135,NaN,NaN,50
1660881600,1.00801,1.00804,1.0072,1.00754,1168,1107.95,-822834,-821210.8,42.51369068210351,33.84083405199175,32.9706655544599,NaN,NaN,50
1660883400,1.00754,1.00778,1.00747,1.00762,752,1058.25,-822082,-821396.6,43.41079789133918,34.683394323375865,33.237768254156634,NaN,NaN,50
1660885200,1.00762,1.00806,1.00744,1.00762,1156,1049.9,-822082,-821861.8,43.65744815654216,34.683394323375865,33.42794160124067,NaN,NaN,50
1660887000,1.00762,1.00835,1.0074,1.00832,1784,1086.55,-820298,-821792.4,43.301602183370655,42.15866135258207,34.25011305404273,NaN,NaN,50
1660888800,1.00832,1.00863,1.00743,1.00853,2557,1178.95,-817741,-821007.4,42.42839753488412,44.221090606085546,34.98797390194976,NaN,NaN,50
1660890600,1.00853,1.009,1.00781,1.00807,3157,1310.45,-820898,-820620.2,40.940290501623764,40.79010593189266,35.51260744224589,NaN,NaN,50
1660892400,1.00807,1.00906,1.00746,1.00828,3696,1463.15,-817202,-819644.2,39.94285139707313,42.96566972074242,36.503387476909424,NaN,NaN,50
1660894200,1.00828,1.00956,1.00802,1.00901,2372,1573.9,-814830,-818193.8,38.15044476011919,49.862205758956506,37.995930062496804,NaN,NaN,50
1660896000,1.00901,1.00912,1.00779,1.00856,2596,1674.5,-817426,-817619.4,36.76082998018604,46.1570454565484,38.95777976796064,NaN,NaN,50
1660897800,1.00856,1.00896,1.00796,1.00888,2466,1765.35,-814960,-817063.2,35.47047339881954,49.05605873593445,40.387705470450626,NaN,NaN,50
1660899600,1.00888,1.00892,1.008,1.00822,2011,1839.25,-816971,-816277.8,34.272285144693505,43.81603734020892,41.19064299048625,NaN,NaN,50
1660901400,1.00822,1.00842,1.0072,1.00728,1881,1905.3,-818852,-816607.8,34.11242406978221,37.6479521126095,41.036950488963626,NaN,NaN,50
1660903200,1.00728,1.00732,1.00548,1.00625,2641,1953.9,-821493,-817940.4,35.30040391178155,32.284913227188525,40.612137269735015,NaN,NaN,50
1660905000,1.00625,1.00648,1.00576,1.00577,2523,1986.25,-824016,-819258.4,36.40352805078094,30.13079805692165,40.16415435702955,NaN,NaN,50
1660906800,1.00577,1.0061,1.0049,1.00511,2747,2054.05,-826763,-821619,37.91217538134047,27.421550531827222,39.70563410558923,NaN,NaN,50
1660908600,1.00511,1.00572,1.00456,1.00487,3424,2098,-830187,-824262.2,39.481035227335845,26.48882734589249,39.12030789291185,NaN,NaN,50
1660910400,1.00487,1.00592,1.00476,1.005,3150,2169.4,-827037,-825899.2,40.550887191164534,27.919031941910276,38.6371391513786,NaN,NaN,50
1660912200,1.005,1.00678,1.005,1.00655,3358,2267.45,-823679,-826336.4,40.04796823671267,42.3266722807775,38.64913993196399,NaN,NaN,50
1660914000,1.00655,1.00686,1.00526,1.0055,3424,2394.2,-827103,-826953.8,39.45313701210358,36.940098841010375,38.12906909160147,NaN,NaN,50
1660915800,1.0055,1.00614,1.00514,1.00538,3526,2519.45,-830629,-827727,39.0041649316404,36.37042863093376,37.81337785581869,NaN,NaN,50
1660917600,1.00538,1.00548,1.00424,1.00468,2827,2602.4,-833456,-828380.8,39.28503457717578,33.15812291377647,37.11283879817826,NaN,NaN,50
1660919400,1.00468,1.00516,1.00397,1.00414,3351,2732.35,-836807,-830334.8,39.72964497426384,30.89145829760018,35.75778540808138,NaN,NaN,50
1660921200,1.00414,1.00479,1.00351,1.00462,2619,2805.5,-834188,-832436.6,40.43991642091722,35.13602211733898,34.97056945528071,NaN,NaN,50
1660923000,1.00462,1.00509,1.00368,1.00372,2178,2825.2,-836366,-834289.2,40.55490506965288,31.259285141045424,33.69937134136007,NaN,NaN,50
1660924800,1.00372,1.00414,1.00326,1.00347,1803,2787.5,-838169,-835797.2,40.95688764742337,30.26050010169159,32.73111868146598,NaN,NaN,50
1660926600,1.00347,1.00404,1.0033,1.0036,1727,2716,-836442,-836394.4,41.330157183924534,31.486407743296226,32.29100836937217,NaN,NaN,50
1660928400,1.0036,1.00454,1.0034,1.00414,1584,2610.4,-834858,-836004.6,40.740775121386285,36.48118794469301,32.59074227776535,NaN,NaN,50
1660930200,1.00414,1.0045,1.00369,1.00434,1405,2562.05,-833453,-835857.6,40.19349177760077,38.2759825175615,33.172541167811055,NaN,NaN,50
1660932000,1.00434,1.0044,1.00352,1.00416,1258,2495.15,-834711,-835526.6,39.84849296633208,37.25567288915263,33.874978479048586,NaN,NaN,50
1660933800,1.00416,1.0046,1.00322,1.00332,1229,2433.3,-835940,-835080.8,39.809437689616395,32.85428966657409,34.32965435909727,NaN,NaN,50
1660935600,1.00332,1.00375,1.00321,1.00358,939,2379.7,-835001,-834792.6,39.78263410094672,35.39830334087206,34.86388803045168,NaN,NaN,50
1660937400,1.00358,1.00408,1.00358,1.00402,1038,2337.55,-833963,-834613.6,39.04088497239247,39.57094404468365,34.667050299302126,NaN,NaN,50
1660939200,1.00402,1.00432,1.00393,1.00416,526,2231.8,-833437,-834610.4,37.85887863725622,40.87942014223989,34.94843039224709,NaN,NaN,50
1660941000,1.00416,1.00424,1.00388,1.00416,619,2136.6,-833437,-834355.6,36.82680206785098,40.879420142239894,35.27050121448324,NaN,NaN,50
1661115600,1.00416,1.00422,1.00393,1.00412,41,2001.3,-833478,-833863.2,35.86844525340326,40.58820020740784,35.801221021171195,NaN,NaN,50
1661117400,1.00412,1.00414,1.00391,1.00408,77,1833.95,-833555,-833574,35.008405228157315,40.279183673397,36.47177283372811,NaN,NaN,50
1661119200,1.00408,1.00412,1.00331,1.0036,1190,1735.95,-834745,-833730.4,35.02547608963444,36.671136385243216,36.581423852864134,NaN,NaN,50
1661121000,1.0036,1.00406,1.00344,1.00358,916,1613.85,-835661,-834175.2,35.041327603863195,36.524329220584534,36.957498429974066,NaN,NaN,50
1661122800,1.00358,1.00368,1.00311,1.00322,914,1488.35,-836575,-834802.8,35.45973854900873,33.89404054116645,37.217037032793705,NaN,NaN,50
1661124600,1.00322,1.00368,1.00302,1.00364,1304,1377.25,-835271,-835161.4,35.953776299837465,39.37902680385674,37.78079553711945,NaN,NaN,50
1661126400,1.00364,1.00365,1.00262,1.0027,1821,1326.95,-837092,-835868.8,36.85231192031716,32.81625635944506,37.51901470960174,NaN,NaN,50
1661128200,1.0027,1.00332,1.00248,1.00261,1437,1231.25,-838529,-836625.6,37.828988395849976,32.26187178873505,37.08943537182842,NaN,NaN,50
1661130000,1.00261,1.00304,1.00235,1.003,2149,1207.75,-836380,-836769.4,38.86761512051859,37.21188465115638,37.086307640542984,NaN,NaN,50
1661131800,1.003,1.00309,1.00256,1.0028,1833,1190.5,-838213,-837097,39.66658928424715,35.768366291049404,37.29445597086265,NaN,NaN,50
1661133600,1.0028,1.0035,1.00252,1.00331,1317,1166.2,-836896,-837422,39.13984904833918,41.95211600027528,37.76258544653431,NaN,NaN,50
1661135400,1.00331,1.00456,1.00298,1.00452,1240,1141.85,-835656,-837134.8,36.37978496289139,53.411929212066326,38.75122724420449,NaN,NaN,50
1661137200,1.00452,1.00467,1.00397,1.00406,1448,1135.05,-837104,-836849.8,34.00843812289286,49.41771841819946,39.36110569248733,NaN,NaN,50
1661139000,1.00406,1.00431,1.00396,1.0043,763,1102.95,-836341,-836842,31.787075675655252,51.45736155118534,40.11667293598343,NaN,NaN,50
1661140800,1.0043,1.0043,1.00375,1.00412,815,1080.8,-837156,-836630.6,29.72170687070183,49.83431776409972,40.77710990431856,NaN,NaN,50
1661142600,1.00412,1.00413,1.00353,1.0038,814,1060.05,-837970,-836845.4,28.217373379481586,46.99634044609922,41.25690681665444,NaN,NaN,50
1661144400,1.0038,1.00392,1.00346,1.00365,1212,1073.7,-839182,-837550.6,26.9510720207262,45.68304801927097,41.90061479051356,NaN,NaN,50
1661146200,1.00365,1.00396,1.00325,1.00325,1263,1084.95,-840445,-838218.8,26.163540344729714,42.28928757697594,42.31239753025581,NaN,NaN,50
1661148000,1.00325,1.00336,1.00268,1.00314,2039,1160.6,-842484,-839447.4,26.337668240885158,41.378907986495975,42.84703091920792,NaN,NaN,50
1661149800,1.00314,1.00314,1.00221,1.00226,2473,1253.3,-844957,-841007.6,27.101517218115134,34.905151720541184,42.52746841325681,NaN,NaN,50
1661151600,1.00226,1.00277,1.00124,1.00152,3270,1414.75,-848227,-843059,28.745772770834133,30.57347660114715,42.36726985909267,NaN,NaN,50
1661153400,1.00152,1.0016,0.99997,1.00039,3153,1568.55,-851380,-845498.6,31.08014067512448,25.39159251959839,41.87653562558291,NaN,NaN,50
1661155200,1.00039,1.00049,0.99893,1.0003,3871,1702.6,-855251,-848459.8,33.706768496018924,25.027750021311547,41.00624029487971,NaN,NaN,50
1661157000,1.0003,1.00184,1.00017,1.00138,4136,1863.6,-851115,-850186,33.88103019581461,36.74178115276345,41.07576992785928,NaN,NaN,50
1661158800,1.00138,1.00152,1.00071,1.00077,3250,1980.4,-854365,-852067.6,34.04284463133918,33.55297831143389,40.47583152151346,NaN,NaN,50
1661160600,1.00077,1.00159,0.99992,1.00144,2728,2051.6,-851637,-852749.6,34.71136812906585,39.73928431742683,39.499214029039216,NaN,NaN,50
1661162400,1.00144,1.00184,1.00053,1.00134,3131,2117.1,-854768,-853427.2,34.95026494358853,39.15336893983657,38.76604620915616,NaN,NaN,50
1661164200,1.00134,1.0014,1.00039,1.00101,2542,2172.35,-857310,-853839,35.26939070824507,37.20396130686196,37.747946191704486,NaN,NaN,50
1661166000,1.00101,1.00142,0.99982,1.00003,2731,2201.45,-860041,-855624.2,35.9462458077568,32.09362868654961,36.48075411473662,NaN,NaN,50
1661167800,1.00003,1.00042,0.99955,1.0001,3074,2263.5,-856967,-856144.6,36.744197143908366,32.80363532664974,35.466989463347375,NaN,NaN,50
1661169600,1.0001,1.00062,0.99954,1.0005,3599,2377.6,-853368,-856490.8,37.137178781656345,36.865849897656744,34.837189597517785,NaN,NaN,50
1661171400,1.0005,1.00089,0.99952,1.00062,3101,2470.65,-850267,-855590.6,37.035410203914935,38.07529720036364,34.536190284902624,NaN,NaN,50
1661173200,1.00062,1.00076,0.99988,1.00036,3094,2552.95,-853361,-854800.8,36.94091081029791,36.44618328966598,34.183852806557624,NaN,NaN,50
1661175000,1.00036,1.00046,0.99696,0.99696,3542,2691.9,-856903,-854173.2,38.531624860020706,22.742513920998746,33.315092963733164,NaN,NaN,50
1661176800,0.99696,0.9976,0.99644,0.99694,3201,2811.2,-860104,-854800.6,40.19957416867332,22.688472614612664,32.751878393266416,NaN,NaN,50
1661178600,0.99694,0.99772,0.99602,0.99668,3204,2930.7,-863308,-856788.6,41.895158218033615,21.957993086026505,32.50662129086843,NaN,NaN,50
1661180400,0.99668,0.99678,0.99334,0.99347,2787,3009.45,-866095,-859954.2,44.16591842453336,15.375945815311795,31.81720670472559,NaN,NaN,50
1661182200,0.99347,0.99457,0.99276,0.99348,3208,3106.7,-862887,-861859.4,46.385877974517356,15.460962722489441,30.2971482454203,NaN,NaN,50
1661184000,0.99348,0.99472,0.99306,0.99447,2223,3115.9,-860664,-862611.6,48.2440025570972,23.639916376968884,29.589072392958514,NaN,NaN,50
1661185800,0.99447,0.99494,0.99302,0.9932,1647,3074.6,-862311,-863053,49.66145908081715,20.85278339118122,28.240036612512398,NaN,NaN,50
1661187600,0.9932,0.9935,0.99262,0.99332,1584,2990.3,-860727,-862536.8,51.084069851020644,21.79105887695438,26.999871608020815,NaN,NaN,50
1661189400,0.99332,0.99379,0.99268,0.99276,1214,2893.35,-861941,-861706,51.97913067219765,20.565789514781855,25.811430765729376,NaN,NaN,50
1661191200,0.99276,0.99368,0.99269,0.9933,1047,2752.15,-860894,-861307.4,52.8102585775763,24.948121008168172,25.3010373601307,NaN,NaN,50
1661193000,0.9933,0.99366,0.99318,0.99332,1232,2606.95,-859662,-861107,53.58202020399933,25.11290898528017,24.75169976431859,NaN,NaN,50
1661194800,0.99332,0.99458,0.9933,0.99448,870,2487.95,-858792,-860403.2,52.86946318984381,34.14458080313534,24.557323400424202,NaN,NaN,50
1661196600,0.99448,0.99462,0.99374,0.99428,1067,2404.9,-859859,-860229.6,52.14940236755143,33.39671844838915,24.2231392038546,NaN,NaN,50
1661198400,0.99428,0.99454,0.99419,0.99434,542,2275.45,-859317,-859704.8,51.48077446113708,33.86471114994235,24.03874833673148,NaN,NaN,50
1661200200,0.99434,0.99457,0.99412,0.99419,514,2174.05,-859831,-859492.2,50.90658725042584,33.23596343839856,24.788280445117184,NaN,NaN,50
1661202000,0.99419,0.99442,0.99416,0.99434,153,2045.15,-859678,-859495.4,50.37341341190825,34.54471863510726,25.635155160866795,NaN,NaN,50
1661203800,0.99434,0.99454,0.99426,0.99438,165,1899.7,-859513,-859639.6,49.65079316494026,34.91113591039584,26.56037964832175,NaN,NaN,50
1661205600,0.99438,0.9944,0.99403,0.99422,579,1748.7,-860092,-859686.2,49.166821708430355,34.089098767216214,27.897033430600636,NaN,NaN,50
1661207400,0.99422,0.99454,0.99414,0.99433,514,1619.35,-859578,-859738.4,48.43240346709711,35.2184682799662,29.308283827563262,NaN,NaN,50
1661209200,0.99433,0.99433,0.99334,0.99342,545,1491.9,-860123,-859796.8,48.39066449837037,30.554203772238196,29.802161498653927,NaN,NaN,50
1661211000,0.99342,0.99395,0.99331,0.99384,789,1354.25,-859334,-859728,48.37384016216048,34.843286835244385,30.801483173229865,NaN,NaN,50
1661212800,0.99384,0.99452,0.99302,0.99447,1788,1283.6,-857546,-859334.6,47.22036608908318,40.754168151742356,32.155990978571865,NaN,NaN,50
1661214600,0.99447,0.99501,0.99396,0.99398,2007,1223.75,-859553,-859226.8,45.294260513690595,37.87611560738838,33.39244284232947,NaN,NaN,50
1661216400,0.99398,0.99492,0.99392,0.99443,1782,1173.5,-857771,-858865.4,43.55070912324175,41.931817589920826,34.605564026740375,NaN,NaN,50
1661218200,0.99443,0.99445,0.99373,0.99404,1644,1095.3,-859415,-858723.8,42.15108497686587,39.52357397121564,35.63489724002149,NaN,NaN,50
1661220000,0.99404,0.99442,0.99356,0.99412,1382,1053.25,-858033,-858463.6,41.0472945274089,40.28123958606884,36.07323001023102,NaN,NaN,50
1661221800,0.99412,0.99452,0.9937,0.9945,1344,1038.1,-856689,-858292.2,39.82024052931688,43.87793293435343,36.8218881877999,NaN,NaN,50
1661223600,0.9945,0.99464,0.99396,0.99451,1177,1017.75,-855512,-857484,38.43264610840764,43.97356129959125,37.543948912774816,NaN,NaN,50
1661225400,0.99451,0.99454,0.99414,0.99419,829,998.5,-856341,-857198,37.14416557470619,41.53463788372802,38.13671137315549,NaN,NaN,50
1661227200,0.99419,0.9943,0.99392,0.99402,815,986.9,-857156,-856746.2,36.26776791488977,40.257217321809456,38.54474699363423,NaN,NaN,50
1661229000,0.99402,0.99426,0.99346,0.99348,793,964.95,-857949,-856729.4,36.057574104437236,36.424980625183686,38.652878758976215,NaN,NaN,50
1661230800,0.99348,0.99366,0.99151,0.99228,1724,1007.65,-859673,-857326.2,37.478248246549924,29.666525580718968,38.33698067422641,NaN,NaN,50
1661232600,0.99228,0.99238,0.99162,0.99197,1741,1041.35,-861414,-858506.6,38.79744566422598,28.21032461529923,37.836398983893055,NaN,NaN,50
1661234400,0.99197,0.99228,0.99088,0.99142,3191,1173.8,-864605,-860159.4,40.43124047971635,25.791436204474977,37.496201300481395,NaN,NaN,50
1661236200,0.99142,0.99158,0.9902,0.99062,2403,1268.25,-867008,-862129.8,42.260244092729984,22.737484609961854,36.631501141532645,NaN,NaN,50
1661238000,0.99062,0.99213,0.99006,0.99065,4362,1478.7,-862646,-863069.2,42.88795178668963,23.105189667773303,35.37085982124914,NaN,NaN,50
1661239800,0.99065,0.99498,0.99065,0.99334,5279,1734.4,-857367,-862608,39.85637510906548,47.31660672560047,36.04518061540715,NaN,NaN,50
1661241600,0.99334,0.9943,0.99252,0.99282,4336,1922.25,-861703,-862665.8,37.04133962270021,44.405892748138406,36.22190026956555,NaN,NaN,50
1661243400,0.99282,0.99419,0.99268,0.99324,3516,2072.35,-858187,-861382.2,34.42737809964674,47.22952153866484,36.77232509581192,NaN,NaN,50
1661245200,0.99324,0.99406,0.9922,0.99238,3318,2211,-861505,-860281.6,32.46825296800884,42.47264388700465,36.92885397445019,NaN,NaN,50
1661247000,0.99238,0.99314,0.99152,0.99298,2484,2295.75,-859021,-859556.6,31.255348241265065,46.51970456319685,37.11755194793901,NaN,NaN,50
1661248800,0.99298,0.99328,0.99128,0.9921,2090,2310.85,-861111,-860305.4,30.331469002255663,41.867503547674744,36.967119251373546,NaN,NaN,50
1661250600,0.9921,0.99303,0.99196,0.99243,1907,2305.85,-859204,-859805.6,29.473581137461213,44.12414048069157,37.15208372258523,NaN,NaN,50
1661252400,0.99243,0.99299,0.99206,0.99264,1682,2300.85,-857522,-859672.6,28.676970977294943,45.5720932251107,37.53171771567818,NaN,NaN,50
1661254200,0.99264,0.99352,0.9921,0.99248,2244,2330.85,-859766,-859324.8,27.221880623240498,44.623287908749276,38.11731109307572,NaN,NaN,50
1661256000,0.99248,0.99309,0.99166,0.99194,2704,2396.95,-862470,-860014.6,26.33150912071725,41.48409359981588,38.96142309443978,NaN,NaN,50
1661257800,0.99194,0.99318,0.9914,0.99238,3313,2495.4,-859157,-859623.8,25.765651084806134,44.88629367301571,40.152563741419534,NaN,NaN,50
1661259600,0.99238,0.99468,0.99206,0.99426,3294,2601.25,-855863,-858955.6,24.388617212355776,56.51888437953843,42.347381468209775,NaN,NaN,50
1661261400,0.99426,0.99984,0.99402,0.9998,7271,2923.35,-848592,-857169.6,26.034650237442115,73.96048456732564,46.006167179450024,NaN,NaN,50
1661263200,0.9998,1.00186,0.99801,0.99802,7590,3262.1,-856182,-856452.8,28.148221938248824,64.9461443902315,48.99480680248275,NaN,NaN,50
1661265000,0.99802,0.9991,0.99712,0.99872,4824,3463.65,-851358,-854230.4,29.345494469260323,66.66672453796998,50.37695807479486,NaN,NaN,50
1661266800,0.99872,1.00058,0.99836,0.99888,3599,3557.4,-847759,-851950.8,30.889168455946614,67.06465569814226,51.99544114265228,NaN,NaN,50
1661268600,0.99888,0.99938,0.99688,0.99737,2604,3600.55,-850363,-850850.8,31.182731440512484,59.80808394274487,52.89390988580085,NaN,NaN,50
1661270400,0.99737,0.99768,0.99658,0.99731,1704,3526.2,-852067,-851545.8,31.237824763677878,59.53243872962518,54.112466660273746,NaN,NaN,50
1661272200,0.99731,0.99802,0.99728,0.99792,1575,3484.8,-850492,-850407.8,31.419203733956337,61.47637055698736,55.1807999455445,NaN,NaN,50
1661274000,0.99792,0.99806,0.9967,0.9968,2175,3375.45,-852667,-850669.6,31.139369703243762,56.143664741758286,56.20052574512189,NaN,NaN,50
1661275800,0.9968,0.99713,0.99622,0.99632,1467,3184.85,-854134,-851944.6,30.514037861841565,53.98244055319155,56.90469003601475,NaN,NaN,50
1661277600,0.99632,0.99694,0.99612,0.99644,1374,3036.75,-852760,-852424,29.85536565627968,54.45447045398327,57.53914555236279,NaN,NaN,50
1661279400,0.99644,0.99644,0.99602,0.99608,1865,2954.2,-854625,-852935.6,29.161276130135626,52.707738564292484,58.11660631347302,NaN,NaN,50
1661281200,0.99608,0.99667,0.99596,0.99628,1383,2857.45,-853242,-853485.6,28.64815640553849,53.598249491580745,58.9819031628848,NaN,NaN,50
1661283000,0.99628,0.99691,0.9962,0.99688,1028,2784.65,-852214,-853395,28.31229885416185,56.2592290754258,59.79425569162837,NaN,NaN,50
1661284800,0.99688,0.99708,0.99658,0.99704,594,2709.85,-851620,-852892.2,28.103011350550506,56.96791367621733,59.826329212819715,NaN,NaN,50
1661286600,0.99704,0.99704,0.99662,0.99672,457,2637.35,-852077,-852755.6,27.90867295433997,55.04696987433152,58.47536387760585,NaN,NaN,50
1661288400,0.99672,0.99718,0.99672,0.99698,635,2585,-851442,-852119,27.822637214498297,56.335287656808184,57.860302682361336,NaN,NaN,50
1661290200,0.99698,0.99704,0.99688,0.99691,222,2483.9,-851664,-851803.4,27.74274688464532,55.87102893120957,57.08918156759273,NaN,NaN,50
1661292000,0.99691,0.99724,0.99681,0.99702,670,2382.2,-850994,-851559.4,27.81784764362392,56.47799964278971,56.33299184935327,NaN,NaN,50
1661293800,0.99702,0.99736,0.99684,0.99728,556,2244.35,-850438,-851323,27.979599037949527,57.950220620648146,56.200287326346356,NaN,NaN,50
1661295600,0.99728,0.99731,0.99656,0.99657,849,2122.1,-851287,-851165,27.725765252895414,52.706956042149464,55.712752848669524,NaN,NaN,50
1661297400,0.99657,0.99669,0.99634,0.99666,917,1804.4,-850370,-850950.6,27.174660306971187,53.28396361294646,55.12758092409517,NaN,NaN,50
1661299200,0.99666,0.9972,0.99552,0.9958,1779,1513.85,-852149,-851047.6,25.594082899743427,47.340279906563836,54.49876772158128,NaN,NaN,50
1661301000,0.9958,0.996,0.9952,0.99527,1500,1347.65,-853649,-851578.6,23.779070809334417,44.07714712475621,53.79124676240732,NaN,NaN,50
1661302800,0.99527,0.99557,0.99448,0.9948,1748,1255.1,-855397,-852570.4,22.86129394697115,41.3548410490208,52.85555894776714,NaN,NaN,50
1661304600,0.9948,0.99496,0.99428,0.99494,1369,1193.35,-854028,-853118.6,22.207579578487714,42.49417277639995,52.12601853434625,NaN,NaN,50
1661306400,0.99494,0.99552,0.9949,0.995,1317,1174,-852711,-853586.8,20.902112327049103,43.005219965316044,51.369373568184486,NaN,NaN,50
1661308200,0.995,0.99527,0.99452,0.99454,1606,1175.55,-854317,-854020.4,20.095618188899735,40.06546835377379,50.21267637378077,NaN,NaN,50
1661310000,0.99454,0.99496,0.99454,0.99487,818,1107.7,-853499,-853990.4,19.346730774903893,43.07193689016539,49.22010660334849,NaN,NaN,50
1661311800,0.99487,0.99503,0.99442,0.99478,774,1073.05,-854273,-853765.6,18.78817966261675,42.446569264912206,48.320077988389976,NaN,NaN,50
1661313600,0.99478,0.99534,0.99466,0.99523,762,1042.45,-853511,-853662.2,17.825941754972003,46.619831012557334,47.62611679951491,NaN,NaN,50
1661315400,0.99523,0.99607,0.99506,0.99575,1027,1000.55,-852484,-853616.8,17.103720502985297,51.037969651860955,47.280898279561434,NaN,NaN,50
1661317200,0.99575,0.9962,0.99552,0.99561,972,980,-853456,-853444.6,16.585887522255486,49.84188147112274,46.80688983872808,NaN,NaN,50
1661319000,0.99561,0.9958,0.99417,0.99428,1279,992.55,-854735,-853691.8,16.31271243585182,40.20282240330691,45.539218537489425,NaN,NaN,50
1661320800,0.99428,0.99455,0.99348,0.9944,1952,1060.45,-852783,-853393.8,16.693287687910363,41.305757618056305,44.72484722148277,NaN,NaN,50
1661322600,0.9944,0.99512,0.99378,0.99493,1644,1119.8,-851139,-852919.4,16.325258997361423,46.03970012012834,44.207399829138616,NaN,NaN,50
1661324400,0.99493,0.9959,0.99444,0.99528,2679,1222,-848460,-852114.6,15.203410714395533,48.96692490734686,44.32358875776597,NaN,NaN,50
1661326200,0.99528,0.99594,0.99457,0.99535,2220,1321.9,-846240,-850671.4,14.204178493620475,49.556315499320576,44.71495792737772,NaN,NaN,50
1661328000,0.99535,0.99564,0.99436,0.99472,2106,1393.7,-848346,-849393.6,13.339491754856988,44.56750532988164,44.9444339474392,NaN,NaN,50
1661329800,0.99472,0.9952,0.99418,0.99462,2059,1468.85,-850405,-848918,12.741644996159742,43.813541583973624,45.038674576551614,NaN,NaN,50
1661331600,0.99462,0.9957,0.99445,0.99524,2400,1546.4,-848005,-848291.2,12.08127124874313,49.51600167940094,45.50373041327196,NaN,NaN,50
1661333400,0.99524,0.99585,0.9945,0.99494,2328,1616.95,-850333,-848665.8,11.643119033198742,47.02881229133185,46.001112123097535,NaN,NaN,50
1661335200,0.99494,0.99498,0.99342,0.99354,2085,1632.25,-852418,-849901.4,11.631668992657653,37.54981231798447,45.60667465365604,NaN,NaN,50
1661337000,0.99354,0.99369,0.99164,0.99218,2583,1686.4,-855001,-851232.4,13.050009416008496,31.01086364146289,44.78983853769538,NaN,NaN,50
1661338800,0.99218,0.99369,0.99197,0.9932,2624,1730.2,-852377,-851626.8,14.36703980911999,39.51780860194541,44.28255122265167,NaN,NaN,50
1661340600,0.9932,0.99329,0.99239,0.99268,2958,1809.65,-855335,-853092.8,15.589996602723524,37.01213278491089,43.28070573215524,NaN,NaN,50
1661342400,0.99268,0.99401,0.99262,0.9929,3175,1902.55,-852160,-853458.2,15.763112104300243,38.78071123282891,42.490622143705686,NaN,NaN,50
1661344200,0.9929,0.9937,0.99146,0.99286,4409,2042.7,-856569,-854288.4,16.80793026899985,38.568668173607534,42.37389684158429,NaN,NaN,50
1661346000,0.99286,0.99318,0.99182,0.99232,3517,2177.65,-860086,-855305.4,17.778118564792347,35.728515324334964,41.975522392032765,NaN,NaN,50
1661347800,0.99232,0.99294,0.99162,0.99178,3582,2318.05,-863668,-857563.6,18.82470031707526,33.103310566396644,41.05149456676622,NaN,NaN,50
1661349600,0.99178,0.99397,0.99101,0.99384,3658,2462.85,-860010,-858498.6,18.474163471249195,48.61455052935018,41.026324968337896,NaN,NaN,50
1661351400,0.99384,0.99948,0.99275,0.999,6505,2736.75,-853505,-858767.6,19.7903373413992,68.38740031285279,42.37140245501876,NaN,NaN,50
1661353200,0.999,0.99994,0.99676,0.99702,4864,2931.35,-858369,-859127.6,21.18629355273382,59.00492291924974,43.40264656854505,NaN,NaN,50
1661355000,0.99702,0.99754,0.99608,0.9967,2560,2995.4,-860929,-859296.2,21.906926727617428,57.6288208840017,44.389452232832774,NaN,NaN,50
1661356800,0.9967,0.99739,0.99551,0.99558,2014,2998.5,-862943,-859151.2,22.110816877604076,52.97227642110146,44.6363290000971,NaN,NaN,50
1661358600,0.99558,0.99558,0.99446,0.99533,1807,3006.65,-864750,-860099.2,21.501548056781314,51.96296630855598,44.988768572755966,NaN,NaN,50
1661360400,0.99533,0.99642,0.99516,0.99616,1517,2948.55,-863233,-862044.8,21.378215224756307,55.026716501357825,46.23711887156834,NaN,NaN,50
1661362200,0.99616,0.99678,0.99591,0.99638,1307,2902.9,-861926,-862756.2,21.447179652057073,55.830845142964854,48.0099746931042,NaN,NaN,50
1661364000,0.99638,0.99653,0.99591,0.99632,1134,2854.3,-863060,-863182.4,21.51121804883636,55.53918058694018,49.15435840631812,NaN,NaN,50
1661365800,0.99632,0.9968,0.99598,0.99632,1194,2811.05,-863060,-863205.8,21.7209872868602,55.53918058694018,50.47771896360592,NaN,NaN,50
1661367600,0.99632,0.99696,0.99608,0.99626,845,2733.3,-863905,-863036.8,22.00750859114042,55.204712280666214,51.650861895594296,NaN,NaN,50
1661369400,0.99626,0.99758,0.99603,0.99716,1042,2669,-862863,-862962.8,22.6249497928223,59.17613040483973,53.122823483539456,NaN,NaN,50
1661371200,0.99716,0.99736,0.9968,0.99729,486,2589.05,-862377,-863053,23.198288051526905,59.73147749980426,54.83732078178726,NaN,NaN,50
1661373000,0.99729,0.99729,0.99638,0.99682,869,2503.35,-863246,-863090.2,23.269043948334094,56.72693176270461,56.52472229580927,NaN,NaN,50
1661374800,0.99682,0.9972,0.99636,0.99668,1530,2448.65,-864776,-863433.4,23.312300499615166,55.826132616069366,57.03983530200349,NaN,NaN,50
1661376600,0.99668,0.99698,0.99662,0.99681,194,2310.45,-864582,-863568.8,23.3524672972333,56.51662973291064,56.191923117721906,NaN,NaN,50
1661378400,0.99681,0.99712,0.99668,0.99684,597,2181.55,-863985,-863793.2,23.49921351915421,56.68489651468382,56.0262069459672,NaN,NaN,50
1661380200,0.99684,0.99706,0.99674,0.99689,580,1990.1,-863405,-863998.8,23.635477868080777,56.98366994932468,55.98012473634741,NaN,NaN,50
1661382000,0.99689,0.997,0.99662,0.99696,540,1841.25,-862865,-863922.6,23.586289410555253,57.426416866382255,56.29827762529605,NaN,NaN,50
1661383800,0.99696,0.99717,0.99676,0.99682,565,1690.4,-863430,-863653.4,23.700546177683766,56.180967480146165,56.59956342326678,NaN,NaN,50
1661385600,0.99682,0.99835,0.99632,0.99816,1596,1587.3,-861834,-863103.8,24.760268099032306,64.18698738428759,57.25386848633319,NaN,NaN,50
1661387400,0.99816,0.99879,0.99795,0.99826,2155,1369.8,-859679,-862242.6,26.037863890350987,64.70524293580141,57.887754042964374,NaN,NaN,50
1661389200,0.99826,0.99899,0.99764,0.99892,2068,1230,-857611,-861083.8,26.732214785567592,67.99696317244349,58.77759565621461,NaN,NaN,50
1661391000,0.99892,0.99929,0.99852,0.99854,1909,1197.45,-859520,-860414.8,27.59682013101103,64.27980035627553,59.401925639738565,NaN,NaN,50
1661392800,0.99854,0.99903,0.99812,0.99896,1429,1168.2,-858091,-859347,27.76133509662043,66.4620713526775,60.206022716310805,NaN,NaN,50
1661394600,0.99896,0.99906,0.99832,0.99832,1175,1136.6,-859266,-858833.4,27.939996305698635,60.40600931490042,60.29387120988656,NaN,NaN,50
1661396400,0.99832,0.99896,0.99824,0.99889,981,1109.8,-858285,-858554.6,27.969718049516306,63.588280568695836,60.56935714337882,NaN,NaN,50
1661398200,0.99889,0.99891,0.99836,0.99865,941,1091.5,-859226,-858877.6,27.99731681163272,61.352340674169966,60.89974349419777,NaN,NaN,50
1661400000,0.99865,0.99894,0.99851,0.99886,1157,1092.65,-858069,-858587.4,28.055311892794265,62.59182848480426,61.38300748482169,NaN,NaN,50
1661401800,0.99886,1.00088,0.99884,0.9999,1562,1111.05,-856507,-858270.6,29.664105294448067,68.05581484275388,62.20723499266764,NaN,NaN,50
1661403600,0.9999,1.00046,0.99928,0.99945,1987,1168.15,-858494,-858116.2,31.15798488169803,63.7189527447856,62.70966758053205,NaN,NaN,50
1661405400,0.99945,0.99948,0.99898,0.99938,1160,1174.05,-859654,-858390,31.98597468447959,63.0459178893719,63.142685290535425,NaN,NaN,50
1661407200,0.99938,1.00242,0.99916,1.0015,3440,1321.75,-856214,-857787.6,34.203639836250446,72.51466415983509,64.22041724006776,NaN,NaN,50
1661409000,1.0015,1.00336,1.00108,1.00108,3683,1462.45,-859897,-858153.2,36.54999385683099,68.75595689679972,65.11863076982873,NaN,NaN,50
1661410800,1.00108,1.00238,1.00034,1.00161,3770,1574.45,-856127,-858077.2,37.721678623117846,70.811982523113,65.59184470831626,NaN,NaN,50
1661412600,1.00161,1.00163,0.99954,0.99996,2937,1711.6,-859064,-858191.2,37.83219855297983,58.01290507509258,65.11382057540848,NaN,NaN,50
1661414400,0.99996,1.00111,0.99874,0.99946,3371,1850.3,-862435,-858747.4,37.06057670270223,54.78160416785096,64.16986636079473,NaN,NaN,50
1661416200,0.99946,1.00123,0.99936,1.00074,3231,1982.85,-859204,-859345.4,36.41703009584204,60.80099425723905,63.92138021086356,NaN,NaN,50
1661418000,1.00074,1.00113,0.99949,0.99952,2676,2089.65,-861880,-859742,35.819451103757565,53.49195413948897,62.99494326706438,NaN,NaN,50
1661419800,0.99952,1.00025,0.9987,0.99972,2670,2194.9,-859210,-860358.6,34.38140906686099,54.45847685278548,62.57011951977045,NaN,NaN,50
1661421600,0.99972,0.99979,0.99788,0.99862,2052,2217.7,-861262,-860798.2,32.24108998690673,48.4897550717047,61.49165341284252,NaN,NaN,50
1661423400,0.99862,0.99869,0.9974,0.99802,1948,2207.35,-863210,-860953.2,30.054186235799246,45.55675625596881,60.363397382971,NaN,NaN,50
1661425200,0.99802,0.9995,0.99762,0.9992,2227,2215.3,-860983,-861309,28.482055092148727,51.73934740411302,59.58822016292163,NaN,NaN,50
1661427000,0.9992,0.9992,0.99727,0.99766,3285,2284.1,-864268,-861786.6,26.69502795861703,44.6180302828749,57.91409269435884,NaN,NaN,50
1661428800,0.99766,0.9979,0.99646,0.99756,3007,2363,-867275,-863399.6,25.247096448386962,44.19267325276534,56.51935844492882,NaN,NaN,50
1661430600,0.99756,0.9978,0.99634,0.99695,4312,2519.85,-871587,-865464.6,24.002969584947866,41.58815506741071,54.986661100503035,NaN,NaN,50
1661432400,0.99695,0.99739,0.99555,0.99672,3306,2636.1,-874893,-867801.2,23.481241234755583,40.61617179116853,52.70819735988398,NaN,NaN,50
1661434200,0.99672,0.99678,0.99602,0.99631,2733,2725.7,-877626,-871129.8,22.99677919529132,38.872086595884014,50.573635195532866,NaN,NaN,50
1661436000,0.99631,0.99833,0.99627,0.99787,3094,2822.55,-874532,-873182.6,21.65873638061035,48.018358766792886,48.94551921293857,NaN,NaN,50
1661437800,0.99787,1.00006,0.99778,0.9981,3420,2915.45,-871112,-873950,21.63057373608209,49.22463161741668,48.317785394533146,NaN,NaN,50
1661439600,0.9981,0.99824,0.9964,0.99685,3048,2968.5,-874160,-874464.6,20.457994919193165,43.3384244299529,47.50041541325471,NaN,NaN,50
1661441400,0.99685,0.99702,0.99568,0.9957,2215,3021.25,-876375,-874761,19.144451949506845,38.747791810179116,45.92518666703615,NaN,NaN,50
1661443200,0.9957,0.9961,0.99492,0.99604,1996,2949.05,-874379,-874111.6,18.43499479994242,40.74618747539845,45.01477476245826,NaN,NaN,50
1661445000,0.99604,0.99642,0.99566,0.99608,1474,2838.6,-872905,-873786.2,17.526449676009513,40.99010909689766,44.052748494180555,NaN,NaN,50
1661446800,0.99608,0.9973,0.99587,0.99698,1925,2746.35,-870980,-873759.8,16.520309741412618,46.34231858268884,43.89936017353656,NaN,NaN,50
1661448600,0.99698,0.99752,0.99693,0.99708,1145,2656.75,-869835,-872894.8,15.74319692472845,46.91841391541574,43.996621434925636,NaN,NaN,50
1661450400,0.99708,0.99716,0.99618,0.99692,1389,2557.65,-871224,-871864.6,14.798292487477191,46.066198289767044,43.59139649818663,NaN,NaN,50
1661452200,0.99692,0.99741,0.99654,0.9969,1361,2464.15,-872585,-871505.8,13.759111466954224,45.953835469336475,43.686811154362466,NaN,NaN,50
1661454000,0.9969,0.99737,0.99676,0.99716,1164,2388.55,-871421,-871209,12.794157662182897,47.73847446243238,43.94008266933868,NaN,NaN,50
1661455800,0.99716,0.9979,0.99708,0.9977,1397,2324.9,-870024,-871017.8,12.341136518726918,51.33287357115385,44.63613399103462,NaN,NaN,50
1661457600,0.9977,0.9978,0.99727,0.99771,588,2251.7,-869436,-870938,11.920474028374937,51.39953514483565,45.406374230582266,NaN,NaN,50
1661459400,0.99771,0.99778,0.99714,0.9974,591,2183.85,-870027,-870698.6,11.39770715621406,49.1518963805694,46.14064635805979,NaN,NaN,50
1661461200,0.9974,0.9976,0.99736,0.99756,361,2090.55,-869666,-870114.8,10.912280774921818,50.35847441373836,46.307797475698756,NaN,NaN,50
1661463000,0.99756,0.99764,0.9974,0.99764,2813,2066.95,-866853,-869201.2,10.503528818103627,50.984751539755905,46.43352032729441,NaN,NaN,50
1661464800,0.99764,0.99768,0.99746,0.99751,305,1931.85,-867158,-868628,10.16863016666276,49.88342589723597,46.901020432100346,NaN,NaN,50
1661466600,0.99751,0.99772,0.99742,0.99749,560,1744.25,-867718,-868284.4,9.857652847467671,49.70553589885948,47.683716438434665,NaN,NaN,50
1661468400,0.99749,0.99749,0.9968,0.99706,698,1613.85,-868416,-867962.2,9.539174366598788,45.914416426413766,48.05287564922147,NaN,NaN,50
1661470200,0.99706,0.99724,0.99692,0.99708,758,1515.1,-867658,-867560.6,9.243444348649108,46.12025863651501,48.41931490205128,NaN,NaN,50
1661472000,0.99708,0.99718,0.99628,0.99648,1003,1410.55,-868661,-867922.2,9.729620402837517,41.070311301627065,48.042742953404016,NaN,NaN,50
1661473800,0.99648,0.99718,0.99633,0.99656,1118,1295.45,-867543,-867999.2,10.181069596012463,41.982485232450735,47.69017661890651,NaN,NaN,50
1661475600,0.99656,0.99708,0.99628,0.99658,1234,1204.75,-866309,-867717.4,10.660825640171234,42.223265666154084,47.4156814315056,NaN,NaN,50
1661477400,0.99658,0.99692,0.99645,0.99679,1413,1164.65,-864896,-867013.4,11.106313395461521,44.813100390232464,47.33420035442674,NaN,NaN,50
1661479200,0.99679,0.997,0.99657,0.99683,855,1107.6,-864041,-866290,11.366395690643882,45.31591213216916,47.16116018797936,NaN,NaN,50
1661481000,0.99683,0.99704,0.99672,0.99686,763,1072.05,-863278,-865213.4,11.527518404271914,45.7153894160214,46.75991131975561,NaN,NaN,50
1661482800,0.99686,0.99748,0.9968,0.99718,778,1014.7,-862500,-864204.8,10.832390328175043,49.91806282291936,46.65409186819017,NaN,NaN,50
1661484600,0.99718,0.99743,0.99672,0.99705,694,992.15,-863194,-863581.8,10.327018582823918,48.28268397386171,46.592005267711045,NaN,NaN,50
1661486400,0.99705,0.99715,0.99654,0.99696,1012,973.3,-864206,-863443.8,10.175089330138817,47.13147148386358,46.361505058434275,NaN,NaN,50
1661488200,0.99696,0.9971,0.99622,0.99626,937,952.1,-865143,-863664.2,10.566472195917695,39.285652657460176,45.525855138270295,NaN,NaN,50
1661490000,0.99626,0.99642,0.99598,0.99628,993,943.55,-864150,-863838.6,11.300719482377474,39.59504990454636,44.79097113879247,NaN,NaN,50
1661491800,0.99628,0.9964,0.99576,0.99599,1143,930.85,-865293,-864397.2,12.306377423890194,36.67650895838547,43.860326357330045,NaN,NaN,50
1661493600,0.99599,0.99662,0.99584,0.99647,1455,974.2,-863838,-864526,12.719851909397379,44.030217876279956,43.7257407466062,NaN,NaN,50
1661495400,0.99647,0.99687,0.99466,0.9951,1830,1036.15,-865668,-864818.4,14.5738742232082,32.44796458954032,42.74914831467943,NaN,NaN,50
1661497200,0.9951,0.99722,0.995,0.99692,2749,1155.55,-862919,-864373.6,15.559474310874306,50.91899658724045,43.45262583508038,NaN,NaN,50
1661499000,0.99692,0.99747,0.99644,0.99742,2461,1137.95,-860458,-863635.2,15.978927006992466,54.592368260841916,44.353331765679755,NaN,NaN,50
1661500800,0.99742,0.99791,0.99694,0.9975,2096,1227.5,-858362,-862249,15.56220434045444,55.170491047824484,45.27813357865621,NaN,NaN,50
1661502600,0.9975,0.99912,0.99718,0.99892,2197,1309.35,-856165,-860714.4,15.424218532742998,63.94527551812187,46.6447175163626,NaN,NaN,50
1661504400,0.99892,1.00052,0.99881,1.00052,2150,1381.95,-854015,-858383.8,16.603682020136002,70.86519335651839,48.46966617524468,NaN,NaN,50
1661506200,1.00052,1.00085,0.99986,1.00033,2104,1449.25,-856119,-857023.8,17.94711748198883,69.16750042689903,50.14481696173594,NaN,NaN,50
1661508000,1.00033,1.00173,0.99987,1.00136,1898,1494,-854221,-855776.4,19.78453421023454,72.95063312499984,51.790000554741695,NaN,NaN,50
1661509800,1.00136,1.00238,1.00116,1.00159,2027,1539.45,-852194,-854542.8,21.86218435217653,73.7258909069402,53.60737247853301,NaN,NaN,50
1661511600,1.00159,1.00159,1.0005,1.00066,1707,1563.1,-853901,-854090,22.81631489081585,65.545539364441,54.92266304143139,NaN,NaN,50
1661513400,1.00066,1.00078,0.9986,0.99974,1850,1584.95,-855751,-854437.2,21.564255284961483,58.616666152773206,56.30344971966804,NaN,NaN,50
1661515200,0.99974,1.00098,0.99966,1,2516,1668,-853235,-853860.4,20.56723576905663,59.90658597221467,57.754273724501495,NaN,NaN,50
1661517000,1,1.00331,0.99989,1.00328,7184,1989.05,-846051,-852226.4,21.19206982538174,71.83402508773045,60.26552487659756,NaN,NaN,50
1661518800,1.00328,1.00687,1.00297,1.00682,6193,2259.8,-839858,-849759.2,23.18000072127059,79.07074842363372,62.76841991569426,NaN,NaN,50
1661520600,1.00682,1.00752,1.00581,1.00635,6304,2540.3,-846162,-848211.4,25.215185092603992,76.26890431422608,65.8984870388861,NaN,NaN,50
1661522400,1.00635,1.00902,1.00165,1.00367,12756,3127.5,-858918,-848844.8,24.247670317599027,62.638954973302624,66.73562692360483,NaN,NaN,50
1661524200,1.00367,1.00508,1.00146,1.00146,7841,3472.7,-866759,-851549.6,23.247114100340568,54.059479155216906,66.69756341606018,NaN,NaN,50
1661526000,1.00146,1.00211,0.99842,1.00032,5312,3688.65,-872071,-856753.6,22.278652676185985,50.23706475571264,66.34517582376648,NaN,NaN,50
1661527800,1.00032,1.00204,0.99928,0.99972,4039,3833.45,-876110,-864004,21.37936706804244,48.30128613627536,65.22774801077743,NaN,NaN,50
1661529600,0.99972,1.0003,0.99877,0.99877,3086,3915,-879196,-870610.8,20.76349780734063,45.32338157096145,63.40333288323766,NaN,NaN,50
1661531400,0.99877,0.99925,0.99754,0.99799,2625,3954.75,-881821,-875191.4,20.69695826964489,42.980352207426066,61.532822296132444,NaN,NaN,50
1661533200,0.99799,0.99832,0.9961,0.99633,2402,3937.4,-884223,-878684.2,21.166325334160657,38.42738589770998,59.066876065611744,NaN,NaN,50
1661535000,0.99633,0.99703,0.99588,0.99698,1474,3888.05,-882749,-880819.8,21.68025896445682,41.06021671824272,56.73361362356193,NaN,NaN,50
1661536800,0.99698,0.9973,0.99588,0.9967,1776,3872.05,-884525,-882502.8,21.97887440566583,40.26156871270525,54.927615719866516,NaN,NaN,50
1661538600,0.9967,0.99734,0.99628,0.99644,1492,3836.8,-886017,-883867,22.228305887338422,39.49339638494609,53.56166787930743,NaN,NaN,50
1661540400,0.99644,0.9967,0.99564,0.99624,1434,3801,-887451,-884993,22.729722017098613,38.878894520650654,52.05968991848143,NaN,NaN,50
1661542200,0.99624,0.99674,0.99616,0.99657,1576,3774.6,-885875,-885323.4,23.163937279357892,40.523319517604435,49.823210949186716,NaN,NaN,50
1661544000,0.99657,0.99694,0.9964,0.9969,611,3710.25,-885264,-885826.4,23.40174092609185,42.19806917854289,47.18944814596593,NaN,NaN,50
1661545800,0.9969,0.99692,0.99626,0.99632,795,3648.65,-886059,-886133.2,23.692759833140105,40.06284396313307,44.603300978030724,NaN,NaN,50
1661720400,0.99632,0.99672,0.99622,0.99634,223,3574.45,-885836,-886097,23.984215933064945,40.17525750541312,42.99875115889576,NaN,NaN,50
1661722200,0.99634,0.99636,0.9957,0.9959,166,3490.25,-886002,-885807.2,24.534722729382814,38.4660022729951,41.88493138159419,NaN,NaN,50
1661724000,0.9959,0.996,0.99504,0.99526,1761,3452.5,-887763,-886184.8,25.382723438380612,36.06264774687802,40.8724730238203,NaN,NaN,50
1661725800,0.99526,0.99552,0.99462,0.99484,877,3137.15,-888640,-886860,26.375336575473135,34.53758822631271,39.88935174453725,NaN,NaN,50
1661727600,0.99484,0.99522,0.99354,0.99399,1826,2918.8,-890466,-887741.4,27.779264222124283,31.622942456637432,38.910748950656966,NaN,NaN,50
1661729400,0.99399,0.99408,0.99349,0.99358,1803,2693.75,-892269,-889028,29.104162568612637,30.294897212696867,38.00464502246202,NaN,NaN,50
1661731200,0.99358,0.99455,0.9934,0.994,2409,2176.4,-889860,-889799.6,29.781978770073415,33.38132894248339,37.64421238280298,NaN,NaN,50
1661733000,0.994,0.99423,0.99286,0.99302,1944,1881.55,-891804,-890607.8,30.680623050384508,30.039070271902872,36.85698763663585,NaN,NaN,50
1661734800,0.99302,0.99378,0.9926,0.99294,1870,1709.45,-893674,-891614.6,31.642074278345973,29.776971158897624,36.10808781136388,NaN,NaN,50
1661736600,0.99294,0.99316,0.99182,0.99304,2121,1613.55,-891553,-891832,32.89645097666651,30.592204645675864,35.472288401416,NaN,NaN,50
1661738400,0.99304,0.99336,0.99243,0.99304,1343,1526.4,-891553,-891688.8,33.80103405217312,30.592204645675864,34.88038198177495,NaN,NaN,50
1661740200,0.99304,0.9935,0.99263,0.99278,1350,1462.65,-892903,-892297.4,34.45310395009861,29.557508132334505,34.09710973996995,NaN,NaN,50
1661742000,0.99278,0.99291,0.99234,0.99235,1028,1393.95,-893931,-892722.8,35.21656964934009,27.8781404093382,33.074257685026765,NaN,NaN,50
1661743800,0.99235,0.99274,0.99216,0.99241,989,1369.7,-892942,-892576.4,36.02444131667832,28.488688957031243,32.24753232744806,NaN,NaN,50
1661745600,0.99241,0.99282,0.99194,0.99221,1026,1332.2,-893968,-893059.4,36.897464315141754,27.648478744482006,31.352762415952984,NaN,NaN,50
1661747400,0.99221,0.99222,0.99148,0.99166,1177,1316.45,-895145,-893777.8,37.9577894534895,25.427537012065997,30.421443468743764,NaN,NaN,50
1661749200,0.99166,0.99218,0.99143,0.9919,1446,1317.05,-893699,-893937,38.96941412584917,28.140135729431776,29.855549753211893,NaN,NaN,50
1661751000,0.9919,0.9925,0.99168,0.99238,1636,1320.05,-892063,-893563.4,39.35149552814981,33.36108709377439,29.771513958030585,NaN,NaN,50
1661752800,0.99238,0.99356,0.99212,0.99336,2434,1411.2,-889629,-892900.8,38.111943477731444,42.540130289039624,30.55131308891645,NaN,NaN,50
1661754600,0.99336,0.9944,0.99326,0.99366,1831,1463,-887798,-891666.8,35.944854893341386,45.03603184389774,31.60425127685937,NaN,NaN,50
1661756400,0.99366,0.99508,0.99319,0.99443,3082,1605.95,-884716,-889581,33.53249028165237,50.92788294850014,32.85757656300343,NaN,NaN,50
1661758200,0.99443,0.9947,0.99338,0.99433,2862,1740.75,-887578,-888356.8,31.29243742794115,50.175635840725626,34.295902675062194,NaN,NaN,50
1661760000,0.99433,0.9944,0.9925,0.99252,2478,1776.6,-890056,-887955.4,29.78988534823107,38.95873243486019,34.95174276620237,NaN,NaN,50
1661761800,0.99252,0.99384,0.992,0.99384,2497,1857.6,-887559,-887541.4,28.838730594301936,48.07534957039172,36.20053883225351,NaN,NaN,50
1661763600,0.99384,0.99634,0.9938,0.99562,2810,1906.8,-884749,-886931.6,27.862378453338827,57.33006218749498,38.1103857995263,NaN,NaN,50
1661765400,0.99562,0.99664,0.99516,0.99626,2571,1945.2,-882178,-886424,27.161288068684154,60.08475283068419,40.29090327797985,NaN,NaN,50
1661767200,0.99626,0.99833,0.996,0.99829,2492,1949.35,-879686,-884845.6,27.50925749241995,67.29657228296443,43.106505554667436,NaN,NaN,50
1661769000,0.99829,0.99954,0.99802,0.99846,2727,1988.5,-876959,-882226.2,28.396904165676663,67.82091742389011,45.91595044515736,NaN,NaN,50
1661770800,0.99846,0.99889,0.99696,0.99704,2338,2011.9,-879297,-880573.8,28.23300830300783,59.27223156465758,48.174789932312756,NaN,NaN,50
1661772600,0.99704,1,0.9969,0.99976,2539,2032.8,-876758,-878975.6,28.610258794807848,67.67679804336314,51.19259429169112,NaN,NaN,50
1661774400,0.99976,1.00198,0.99838,1.0019,3564,2143.85,-873194,-877178.8,29.727774011277557,72.48727239103668,54.36024691037719,NaN,NaN,50
1661776200,1.0019,1.00292,1.00079,1.00086,5201,2336.4,-878395,-876920.6,31.06925492603874,67.24927381877637,56.780831676448756,NaN,NaN,50
1661778000,1.00086,1.00136,0.99952,1.0004,4281,2499.05,-882676,-878064,31.255020212173086,65.01156579326762,58.385934212465045,NaN,NaN,50
1661779800,1.0004,1.00184,1.00008,1.00113,4399,2669.55,-878277,-877860,31.612669903774236,66.8942150692109,59.947233014273124,NaN,NaN,50
1661781600,1.00113,1.00272,1.0007,1.0021,3375,2787,-874902,-877488.8,32.27088469447584,69.26104762167537,61.25674477664279,NaN,NaN,50
1661783400,1.0021,1.0021,0.99812,0.99826,4139,2935.1,-879041,-878658.2,31.026713766804694,53.08193883713977,61.46433784781522,NaN,NaN,50
1661785200,0.99826,0.9994,0.99812,0.99916,2240,2974.8,-876801,-878339.4,29.871412191110064,55.69423121951746,62.65973061814788,NaN,NaN,50
1661787000,0.99916,1.00026,0.99911,0.99972,1817,2983.85,-874984,-876801,29.203440643003052,57.2877754381321,63.3177610372722,NaN,NaN,50
1661788800,0.99972,1.0007,0.99948,1.00014,2298,2977.05,-872686,-875682.8,28.784013732774632,58.49354800884807,63.40086716736885,NaN,NaN,50
1661790600,1.00014,1.00147,0.99979,1.00146,1892,2980.1,-870794,-874861.2,28.736828608207965,62.11353202213572,63.545779966758246,NaN,NaN,50
1661792400,1.00146,1.00226,1.00064,1.00074,1856,2918.8,-872650,-873583,29.024659871118295,59.08646326734562,62.959343608499765,NaN,NaN,50
1661794200,1.00074,1.00124,1.00053,1.00072,1284,2839.9,-873934,-873009.6,29.200953098444998,59.00044839393717,62.32931010636027,NaN,NaN,50
1661796000,1.00072,1.00104,0.99968,0.99987,1999,2815.95,-875933,-873199.4,28.670258674272546,55.314906475396846,62.04664402855594,NaN,NaN,50
1661797800,0.99987,1.00037,0.99898,0.99914,1676,2774.9,-877609,-874184,27.64225149127344,52.2936761601838,60.947849608328845,NaN,NaN,50
1661799600,0.99914,0.99988,0.99904,0.99934,1407,2704.75,-876202,-875265.6,26.68767339277427,53.05027646086962,59.55949275617405,NaN,NaN,50
1661801400,0.99934,0.99974,0.99927,0.9996,945,2623.45,-875257,-875787,25.801279444167896,54.07007487147807,58.6181214027956,NaN,NaN,50
1661803200,0.9996,0.99986,0.99929,0.99976,499,2523.8,-874758,-875951.8,25.057821057877828,54.7218551774116,57.8831420730916,NaN,NaN,50
1661805000,0.99976,1,0.99962,0.99982,432,2409.05,-874326,-875630.4,24.464616282520726,54.97986027455287,57.03211673061602,NaN,NaN,50
1661806800,0.99982,0.9999,0.99982,0.99982,78,2296.05,-874326,-874973.8,23.913783276831985,54.97986027455287,56.012031920107276,NaN,NaN,50
1661808600,0.99982,0.99998,0.99974,0.99998,100,2174.1,-874226,-874578.6,23.402295485835296,55.75950675215467,56.20328677117976,NaN,NaN,50
1661810400,0.99998,1.00018,0.99982,0.99996,482,2020,-874708,-874468.8,23.093139579389106,55.629820709158345,56.19868602043982,NaN,NaN,50
1661812200,0.99996,1.00026,0.99986,1.0001,621,1791,-874087,-874334.6,22.87467109123813,56.394359818100845,56.134870619009014,NaN,NaN,50
1661814000,1.0001,1.0002,0.99971,1.00008,721,1613,-874808,-874431,22.471141167241406,56.245258636917406,55.97427852101397,NaN,NaN,50
1661815800,1.00008,1.00118,1.00006,1.00108,788,1432.45,-874020,-874369.8,22.93238891470596,61.698073134161795,55.94460288615869,NaN,NaN,50
1661817600,1.00108,1.00134,1.00032,1.00068,1515,1339.45,-875535,-874631.6,23.483828840429634,58.55465809604539,55.90661680249439,NaN,NaN,50
1661819400,1.00068,1.00087,1.00012,1.00057,1561,1210.55,-877096,-875109.2,23.70078844672073,57.684285871740315,55.81260519376604,NaN,NaN,50
1661821200,1.00057,1.00107,0.99996,1.00072,1953,1196.2,-875143,-875320.4,24.075090385604398,58.58824840646937,56.04641533169979,NaN,NaN,50
1661823000,1.00072,1.00072,0.99898,0.99908,1894,1200.05,-877037,-875766.2,23.059116779910923,46.81338073938049,55.654965658785265,NaN,NaN,50
1661824800,0.99908,0.9992,0.9982,0.99845,1906,1180.45,-878943,-876750.8,21.591951270786666,43.2199355847203,54.95279845334603,NaN,NaN,50
1661826600,0.99845,0.99928,0.9983,0.99908,1259,1148.8,-877684,-877180.6,20.139621100403275,47.55531562983934,54.48745850751469,NaN,NaN,50
1661828400,0.99908,0.99938,0.99885,0.99922,1454,1128.7,-876230,-877007.4,18.728793852813972,48.49642657723247,54.04278503607332,NaN,NaN,50
1661830200,0.99922,1.00008,0.99913,0.99986,981,1113.55,-875249,-877028.6,18.196025705838824,52.67710953717642,53.878302840546425,NaN,NaN,50
1661832000,0.99986,1.00061,0.99973,1.00026,1221,1074.65,-874028,-876426.8,18.219687243730753,55.12867485102636,53.88893245315167,NaN,NaN,50
1661833800,1.00026,1.00079,0.99966,0.99996,1583,1070,-875611,-875760.4,18.41068949111464,52.9145932956654,53.68572434911672,NaN,NaN,50
1661835600,0.99996,1.00019,0.99966,0.99994,1030,1051.15,-876641,-875551.8,18.588048720828244,52.76245642060116,53.48091261421978,NaN,NaN,50
1661837400,0.99994,1.00064,0.99993,1.00017,1605,1084.15,-875036,-875313,19.191632300985876,54.386634590375216,53.33750366938224,NaN,NaN,50
1661839200,1.00017,1.00072,0.99948,1.00008,2679,1193.15,-877715,-875806.2,19.05165132377713,53.60986814062403,53.14926149107556,NaN,NaN,50
1661841000,1.00008,1.00026,0.99871,0.99918,2970,1320.05,-880685,-877137.6,17.878887360462983,46.46336461185801,52.061068025196725,NaN,NaN,50
1661842800,0.99918,0.99986,0.99825,0.99962,3841,1508.2,-876844,-877384.2,16.95752564327251,49.97440621935964,51.44819289114775,NaN,NaN,50
1661844600,0.99962,1.0034,0.99948,1.00292,4682,1737.3,-872162,-876488.4,18.245292663521536,67.29714399642089,52.134825614339206,NaN,NaN,50
1661846400,1.00292,1.00329,1.00206,1.00302,4062,1916.3,-868100,-875101.2,19.441076325181346,67.662570895133,52.782991506386615,NaN,NaN,50
1661848200,1.00302,1.00344,1.00214,1.0025,2902,2030.35,-871002,-873758.6,20.63673139409011,63.67790749453812,53.98760056032644,NaN,NaN,50
1661850000,1.0025,1.0055,1.0024,1.00432,3948,2191.7,-867054,-871032.4,22.720682654049565,70.27581010215812,55.92016302585772,NaN,NaN,50
1661851800,1.00432,1.00471,1.00285,1.00327,2972,2300.9,-870026,-869668.8,24.655780252583344,63.14886838273987,57.03398822249346,NaN,NaN,50
1661853600,1.00327,1.00488,1.00282,1.00487,2467,2348.5,-867559,-868748.2,26.52447434469541,68.40671070595934,58.45615137454538,NaN,NaN,50
1661855400,1.00487,1.00499,1.00252,1.00316,3331,2437,-870890,-869306.2,27.864584696734156,58.757708784574525,58.890479892216675,NaN,NaN,50
1661857200,1.00316,1.00436,1.00226,1.00226,3181,2498.4,-874071,-869920,28.765490650842153,54.40783911572545,58.83899162540946,NaN,NaN,50
1661859000,1.00226,1.00316,1.0017,1.0025,3568,2582.1,-870503,-870609.8,28.886625063593158,55.35695366341892,59.01344593739186,NaN,NaN,50
1661860800,1.0025,1.00368,1.00216,1.00252,4205,2697.05,-866298,-869864.2,29.329682848646403,55.44020191198009,59.20471347249036,NaN,NaN,50
1661862600,1.00252,1.00256,1.00086,1.00116,4400,2854.1,-870698,-870492,28.274837962364348,48.77906512865128,58.804172796652935,NaN,NaN,50
1661864400,1.00116,1.0034,1.00106,1.00296,4672,3015,-866026,-869519.2,27.878929298299838,56.268310865330456,58.99406156270339,NaN,NaN,50
1661866200,1.00296,1.00416,1.00201,1.00282,4944,3213.15,-870970,-868899,27.98171804947748,55.587528714268316,59.64578757001841,NaN,NaN,50
1661868000,1.00282,1.00282,0.99966,1.00063,5981,3451.15,-876951,-870188.6,26.035065670704988,46.17597870416986,59.37447131893343,NaN,NaN,50
1661869800,1.00063,1.00065,0.99824,0.99903,4710,3607.5,-881661,-873261.2,25.02827837237087,40.747862121779704,57.47809404217334,NaN,NaN,50
1661871600,0.99903,1.00254,0.9988,1.00248,5503,3831.15,-876158,-874353.2,23.60894725526711,53.45367030680385,56.463172571578404,NaN,NaN,50
1661873400,1.00248,1.00308,1.0014,1.00184,4506,3976.2,-880664,-877280.8,22.595083649406874,51.25781402032189,55.576023037705816,NaN,NaN,50
1661875200,1.00184,1.00354,1.00175,1.00218,4127,4048.6,-876537,-878394.2,21.909542000859396,52.37706168429186,54.29754100785823,NaN,NaN,50
1661877000,1.00218,1.00295,1.00172,1.00236,2903,4045.25,-873634,-877730.8,21.250609720106528,52.99247494748604,53.572084333911526,NaN,NaN,50
1661878800,1.00236,1.00274,1.00185,1.00205,2373,3971.85,-876007,-876600,20.638744030836012,51.75210131777644,52.38246937761276,NaN,NaN,50
1661880600,1.00205,1.00267,1.00104,1.00174,2499,3862.7,-878506,-877069.6,19.42814188079846,50.47965524697996,51.79117983921314,NaN,NaN,50
1661882400,1.00174,1.00285,1.0015,1.00266,2811,3800.15,-875695,-876075.8,18.43295315449848,54.08754092507815,51.76830139702405,NaN,NaN,50
1661884200,1.00266,1.00316,1.00162,1.00212,2349,3772.5,-878044,-876377.2,17.73563160021855,51.70630079785275,51.507540478055034,NaN,NaN,50
1661886000,1.00212,1.0031,1.00206,1.0023,2259,3688.05,-875785,-876807.4,17.088118728387187,52.45766396512405,51.2945020532796,NaN,NaN,50
1661887800,1.0023,1.00238,1.0015,1.00178,2094,3644.15,-877879,-877181.8,15.97644141380867,50.03576780194566,51.38426652994348,NaN,NaN,50
1661889600,1.00178,1.0023,1.00177,1.00218,729,3557.25,-877150,-876910.6,14.944169621700048,51.876314265796616,51.070552487119635,NaN,NaN,50
1661891400,1.00218,1.00218,1.00144,1.0016,800,3430.7,-877950,-877361.6,14.079706340043,49.05455725066907,50.60391166829111,NaN,NaN,50
1661893200,1.0016,1.00166,1.00135,1.00164,78,3275.55,-877872,-877327.2,13.363558529149842,49.259542006503274,50.824166189886355,NaN,NaN,50
1661895000,1.00164,1.0018,1.0016,1.00163,73,3100.8,-877945,-877759.2,12.546431080662785,49.206237849721425,51.42833588473933,NaN,NaN,50
1661896800,1.00163,1.002,1.00152,1.00198,567,2918.9,-877378,-877659,11.73510594225242,51.19678235498667,51.26712960246668,NaN,NaN,50
1661898600,1.00198,1.00204,1.00171,1.00172,414,2719.6,-877792,-877787.4,11.02783953050172,49.64050259929046,51.15160735810729,NaN,NaN,50
1661900400,1.00172,1.00226,1.00154,1.00218,626,2517.3,-877166,-877630.6,10.63229628763138,52.39754544479762,51.1530704838577,NaN,NaN,50
1661902200,1.00218,1.00261,1.00212,1.00236,548,2297.5,-876618,-877379.8,10.67000493203361,53.47100372177588,51.18725111059269,NaN,NaN,50
1661904000,1.00236,1.00328,1.00196,1.00308,1684,2082.65,-874934,-876777.6,11.403467414339213,57.590668888051,51.60429165132659,NaN,NaN,50
1661905800,1.00308,1.00346,1.00268,1.00274,1470,1920.65,-876404,-876582.8,12.258824470309348,55.109284137577575,51.934979429226416,NaN,NaN,50
1661907600,1.00274,1.00331,1.00266,1.00278,1714,1731.2,-874690,-875962.4,13.020659971167238,55.35300905846857,52.02537001018288,NaN,NaN,50
1661909400,1.00278,1.003,1.0017,1.00204,1594,1585.6,-876284,-875786,12.324995470960456,49.950004314162044,51.89992026134784,NaN,NaN,50
1661911200,1.00204,1.00234,1.00166,1.00222,1184,1438.45,-875100,-875482.4,11.626499771277107,51.1978434345789,51.809933080594604,NaN,NaN,50
1661913000,1.00222,1.00298,1.00219,1.00256,1368,1361.7,-873732,-875242,11.738514044093614,53.55343117002912,52.06119474974343,NaN,NaN,50
1661914800,1.00256,1.00276,1.00202,1.00262,1426,1314.35,-872306,-874422.4,11.597463238007347,53.97561855051072,52.21114505579443,NaN,NaN,50
1661916600,1.00262,1.00328,1.00254,1.00324,963,1237.55,-871343,-873753,12.051604131249446,58.203445614867796,52.864637081808624,NaN,NaN,50
1661918400,1.00324,1.00384,1.00318,1.00362,920,1143,-870423,-872580.8,13.031528811570112,60.592804431128066,53.67415582642468,NaN,NaN,50
1661920200,1.00362,1.00448,1.00356,1.00402,1454,1098.25,-868969,-871354.6,14.497830914133791,62.9911282274778,54.65879085340727,NaN,NaN,50
1661922000,1.00402,1.00462,1.00376,1.00412,1351,1052.85,-867618,-870131.8,15.97388193311926,63.587757295106684,55.543860491987274,NaN,NaN,50
1661923800,1.00412,1.00426,1.00356,1.00394,2088,1052.55,-869706,-869611.8,16.999012476128055,61.66083090865529,56.402455371227624,NaN,NaN,50
1661925600,1.00394,1.00426,1.00253,1.00278,2153,1123.75,-871859,-869715,16.409320325266023,50.9462741121186,56.298793133179124,NaN,NaN,50
1661927400,1.00278,1.0029,1.00143,1.00158,2558,1211.65,-874417,-870513.8,15.855408890296333,42.68338965482985,55.5282492712544,NaN,NaN,50
1661929200,1.00158,1.00216,1.00071,1.00155,4255,1420.5,-878672,-872454.4,16.00231793266839,42.49781845278553,54.45018852587829,NaN,NaN,50
1661931000,1.00155,1.0017,0.99992,1.00016,3071,1570.4,-881743,-875279.4,16.765806321307384,34.9220077690665,53.00824021384178,NaN,NaN,50
1661932800,1.00016,1.00272,0.99996,1.0013,3733,1728.7,-878010,-876940.2,16.303280351267446,43.774587750850074,52.18121012044047,NaN,NaN,50
1661934600,1.0013,1.00147,0.99742,0.99796,3601,1888.05,-881611,-878890.6,17.52508771904678,30.62868608986294,50.801115961561955,NaN,NaN,50
1661936400,0.99796,0.99972,0.99785,0.99885,3586,2036.05,-878025,-879612.2,18.659623131984734,36.13264832842769,49.725030596836866,NaN,NaN,50
1661938200,0.99885,0.9995,0.99774,0.99804,2781,2147.7,-880806,-880039,19.773898473822396,33.52558497222037,48.29447015413624,NaN,NaN,50
1661940000,0.99804,0.99912,0.99754,0.99854,2987,2212.85,-877819,-879254.2,20.923200602479255,36.56807625657247,47.0510742759978,NaN,NaN,50
1661941800,0.99854,0.99858,0.99713,0.99779,2939,2286.3,-880758,-879803.8,22.22465165285227,34.05054523117418,45.32586710573396,NaN,NaN,50
1661943600,0.99779,0.9999,0.9977,0.99988,2807,2340.95,-877951,-879071.8,21.936490731459816,45.34299686268393,44.23659513655939,NaN,NaN,50
1661945400,0.99988,1.00059,0.99893,1.00014,2535,2388,-875416,-878550,21.00918956236652,46.5686978423985,43.063564394768,NaN,NaN,50
1661947200,1.00014,1.00184,0.99902,0.99936,4376,2547.6,-879792,-878347.2,19.898483785172626,43.42267933403064,41.623201683262565,NaN,NaN,50
1661949000,0.99936,1.00108,0.99821,1.00084,4683,2713.35,-875109,-877805.2,18.723854595721864,50.28549167637373,40.81067745238532,NaN,NaN,50
1661950800,1.00084,1.00247,1.0001,1.0001,4428,2863.45,-879537,-877561,18.13800015294909,47.202452798841485,40.54326164429409,NaN,NaN,50
1661952600,1.0001,1.0016,0.99952,1.00062,5382,3084.4,-874155,-876801.8,17.14219139965914,49.543497728790065,41.03326936386268,NaN,NaN,50
1661954400,1.00062,1.00329,0.99993,1.00278,5191,3297.95,-868964,-875511.4,17.259334042686238,57.89500257987436,42.1330682300833,NaN,NaN,50
1661956200,1.00278,1.006,1.00196,1.00546,7615,3606,-861349,-871822.8,18.575808975816784,65.52058776065888,44.31868108662561,NaN,NaN,50
1661958000,1.00546,1.00768,1.00413,1.00638,5824,3829.65,-855525,-867906,20.358773535958825,67.68425944260697,46.02651477889396,NaN,NaN,50
1661959800,1.00638,1.00792,1.00598,1.00631,3956,3923.05,-859481,-863894.8,22.088700125367055,67.33801190519456,48.64860947998908,NaN,NaN,50
1661961600,1.00631,1.0064,1.00532,1.00566,2610,3945.9,-862091,-861482,23.160659712791958,64.06089443009506,50.643484201536744,NaN,NaN,50
1661963400,1.00566,1.00642,1.00498,1.00534,2241,3930.05,-864332,-860555.6,23.8827642886661,62.449571860971275,52.70948326501895,NaN,NaN,50
1661965200,1.00534,1.00572,1.00447,1.00472,1926,3813.6,-866258,-861537.4,24.14265912248806,59.33548730932779,54.33572691164433,NaN,NaN,50
1661967000,1.00472,1.00504,1.00356,1.00488,2349,3777.5,-863909,-863214.2,23.686764986852975,59.89133034500088,56.18149727691766,NaN,NaN,50
1661968800,1.00488,1.00573,1.00453,1.00518,2303,3706,-861606,-863639.2,23.609003318368313,60.968629580776586,57.29761389963857,NaN,NaN,50
1661970600,1.00518,1.00544,1.00436,1.00448,2011,3626.5,-863617,-863944.4,23.402211940774457,57.113837944355986,58.050838192635524,NaN,NaN,50
1661972400,1.00448,1.00528,1.00408,1.00478,2020,3548.2,-861597,-863397.4,22.981378385098562,58.329821586640946,59.11563406782198,NaN,NaN,50
1661974200,1.00478,1.00508,1.00414,1.0049,2669,3542.6,-858928,-861931.4,22.590604369113805,58.83263664755374,59.72614442290626,NaN,NaN,50
1661976000,1.0049,1.00524,1.00433,1.00524,1263,3456.4,-857665,-860682.6,22.329574175780902,60.29452974705108,60.6612927763498,NaN,NaN,50
1661977800,1.00524,1.00552,1.00512,1.00544,1077,3363.3,-856588,-859679,22.26983619182541,61.16807861505439,61.491619982511544,NaN,NaN,50
1661979600,1.00544,1.00567,1.00472,1.00494,2260,3335.95,-858848,-858725.2,21.812718413205694,57.7475359543947,61.48108665212014,NaN,NaN,50
1661981400,1.00494,1.00524,1.00494,1.0051,295,3223.95,-858553,-858116.4,21.388251904487383,58.546389553170805,60.982929637299556,NaN,NaN,50
1661983200,1.0051,1.00545,1.00508,1.00515,617,3036,-857936,-857918,21.158807392584126,58.808483890090976,60.34894566926271,NaN,NaN,50
1661985000,1.00515,1.00526,1.00483,1.00511,738,2838.75,-858674,-858119.8,20.659210127235188,58.48988029045263,59.716936268209714,NaN,NaN,50
1661986800,1.00511,1.00511,1.00434,1.0044,940,2664.35,-859614,-858725,19.65007271993293,53.00106825278893,58.92694868411642,NaN,NaN,50
1661988600,1.0044,1.00444,1.00352,1.00382,1223,2456.4,-860837,-859122.8,18.598279083249373,48.95916463222447,57.96334816777736,NaN,NaN,50
1661990400,1.00382,1.00382,1.00234,1.00261,2339,2313.8,-863176,-860047.4,18.591708295749683,41.79778554066408,56.71065518430138,NaN,NaN,50
1661992200,1.00261,1.00293,1.00202,1.00234,1894,2027.75,-865070,-861474.2,18.818723895249974,40.378480598634056,55.316880202418034,NaN,NaN,50
1661994000,1.00234,1.0032,1.00234,1.00248,1964,1834.75,-863106,-862360.6,18.724126630482463,41.487953463719094,53.92540333691393,NaN,NaN,50
1661995800,1.00248,1.0027,1.00206,1.00242,1842,1729.05,-864948,-863427.4,18.85865995119717,41.13466495795245,52.784033837885104,NaN,NaN,50
1661997600,1.00242,1.00296,1.0023,1.00272,1509,1674,-863439,-863947.8,18.670335633884932,43.71544743524966,51.74014996992859,NaN,NaN,50
1661999400,1.00272,1.00303,1.00211,1.00228,1137,1618.8,-864576,-864227.8,18.661940308066917,40.8842880119301,50.45812506738404,NaN,NaN,50
1662001200,1.00228,1.00268,1.00217,1.00254,1128,1578.9,-863448,-863903.4,18.65414464837876,43.22419219795991,49.23881524244895,NaN,NaN,50
1662003000,1.00254,1.00268,1.00106,1.00164,1780,1550.45,-865228,-864327.8,19.569571290121253,37.66639103451472,47.56012327241041,NaN,NaN,50
1662004800,1.00164,1.00179,1.0012,1.00123,1379,1504.25,-866607,-864659.6,20.419610314596426,35.43132894444575,45.96610848598549,NaN,NaN,50
1662006600,1.00123,1.00165,1.00092,1.00144,1027,1455.05,-865580,-865087.8,21.425980152208624,37.47772858303281,44.461204130975624,NaN,NaN,50
1662008400,1.00144,1.00171,1.00078,1.00168,1622,1435.15,-863958,-864964.2,22.469551672854358,39.82498970804676,43.10524026082961,NaN,NaN,50
1662010200,1.00168,1.00206,1.00146,1.00178,2195,1411.45,-861763,-864627.2,22.864575304651996,40.82191137329515,41.84324248103265,NaN,NaN,50
1662012000,1.00178,1.00226,1.00093,1.00149,2812,1488.9,-864575,-864496.6,23.683286654210274,38.813686085852645,40.8298580405372,NaN,NaN,50
1662013800,1.00149,1.00264,1.00114,1.00206,3155,1592.8,-861420,-863459.2,23.83390071641091,44.584197012024006,40.51736035338003,NaN,NaN,50
1662015600,1.00206,1.00325,1.0013,1.00256,3952,1677.4,-857468,-861836.8,23.084515313423903,49.11743773939973,41.04019265328971,NaN,NaN,50
1662017400,1.00256,1.00331,1.00182,1.00301,3317,1828.5,-854151,-859875.4,22.304665666693566,52.855395111791616,41.93140083280097,NaN,NaN,50
1662019200,1.00301,1.00489,1.00238,1.00336,4084,2001.85,-850067,-857536.2,21.663775844802778,55.588172348291806,42.93855932455616,NaN,NaN,50
1662021000,1.00336,1.00395,1.0025,1.00372,4040,2166.95,-846027,-853826.6,21.068663867332763,58.26773158811154,44.16234979813895,NaN,NaN,50
1662022800,1.00372,1.00469,1.00268,1.003,3304,2285.15,-849331,-851408.8,21.196460202925962,51.566603447710854,44.723146656171885,NaN,NaN,50
1662024600,1.003,1.00336,1.0022,1.00288,3011,2374.55,-852342,-850383.6,20.689410968466422,50.52368990820017,45.411675363048325,NaN,NaN,50
1662026400,1.00288,1.00296,1.0015,1.00158,2864,2400.8,-855206,-850594.6,19.397856579233743,40.878307063252485,45.24411213914065,NaN,NaN,50
1662028200,1.00158,1.00228,1.00024,1.00192,2998,2456,-852208,-851022.8,19.023083111414095,43.895099654207606,45.68901989769014,NaN,NaN,50
1662030000,1.00192,1.0022,1.00085,1.00122,2745,2495.05,-854953,-852808,18.675079177010137,39.43371110666635,45.97490433784875,NaN,NaN,50
1662031800,1.00122,1.00188,1.00012,1.00041,3601,2583,-858554,-854652.6,18.958341970373986,35.0006675495212,45.79797140688363,NaN,NaN,50
1662033600,1.00041,1.00068,0.99986,1.00032,2838,2649.45,-861392,-856462.6,19.423305806085807,34.536099003071925,45.420193499385434,NaN,NaN,50
1662035400,1.00032,1.0005,0.99859,0.99884,4540,2819.6,-865932,-858607.8,20.713464592524,27.96311085957217,44.501707748405224,NaN,NaN,50
1662037200,0.99884,0.99998,0.99792,0.99857,3737,2950.05,-869669,-862100,22.28619962686162,26.9552073054719,43.654673549806596,NaN,NaN,50
1662039000,0.99857,0.99882,0.99728,0.99818,4250,3073.55,-873919,-865893.2,24.071669374731446,25.524108558402872,42.29323866026222,NaN,NaN,50
1662040800,0.99818,0.99836,0.9933,0.99508,6406,3324.9,-880325,-870247.4,27.037549271736466,17.54869109772511,40.038328185856884,NaN,NaN,50
1662042600,0.99508,0.99544,0.99108,0.9932,6028,3574.95,-886353,-875239.6,30.215833442483746,14.574451792818635,37.30397509164453,NaN,NaN,50
1662044400,0.9932,0.99489,0.9932,0.99346,4436,3715.65,-881917,-878436.6,33.167097315320504,16.677709841712357,34.52465634117457,NaN,NaN,50
1662046200,0.99346,0.99488,0.99317,0.99488,3441,3777.95,-878476,-880198,35.91304303628321,27.2174887544122,32.30678185305319,NaN,NaN,50
1662048000,0.99488,0.99601,0.99477,0.99554,3097,3792.2,-875379,-880490,37.25355727168099,31.551354332462566,30.877121201964023,NaN,NaN,50
1662049800,0.99554,0.99583,0.99367,0.99368,2407,3754.8,-877786,-879982.2,38.801732382684364,26.72216969568268,29.177012615355633,NaN,NaN,50
1662051600,0.99368,0.99513,0.99356,0.99497,2048,3659.6,-875738,-877859.2,40.26864016558186,34.23979090760274,28.702832889952077,NaN,NaN,50
1662053400,0.99497,0.99544,0.99478,0.99529,1507,3569.1,-874231,-876322,41.29575205065207,35.993969013947975,28.138466415647823,NaN,NaN,50
1662055200,0.99529,0.99602,0.99523,0.99576,2685,3499.15,-871546,-874936,41.63102836321782,38.585257121249306,28.077862559546606,NaN,NaN,50
1662057000,0.99576,0.99584,0.99442,0.99442,2102,3402.25,-873648,-874589.8,42.241983494870745,34.31922693024276,28.02918822959814,NaN,NaN,50
1662058800,0.99442,0.99564,0.99442,0.99485,1955,3334.8,-871693,-873371.2,42.80929897426274,36.73638403150695,28.18635144591493,NaN,NaN,50
1662060600,0.99485,0.9951,0.99422,0.99442,1632,3265.85,-873325,-872888.6,43.41350787646508,35.335933184539456,28.712981611984016,NaN,NaN,50
1662062400,0.99442,0.9949,0.99432,0.99444,538,3149.55,-872787,-872599.8,43.97455899993869,35.45917333258629,29.3204077567779,NaN,NaN,50
1662064200,0.99444,0.99481,0.9944,0.9947,622,3030.75,-872165,-872723.6,44.495535043164175,37.1364929952901,30.149863787984128,NaN,NaN,50
1662066000,0.9947,0.995,0.9944,0.99476,674,2927.2,-871491,-872292.2,44.70739083241256,37.53990289832887,31.577807488027254,NaN,NaN,50
1662067800,0.99476,0.99478,0.9945,0.99456,1035,2798.9,-872526,-872458.8,44.90411406528606,36.69459775859458,33.15781791415411,NaN,NaN,50
1662069600,0.99456,0.9949,0.9943,0.99454,508,2682.4,-873034,-872400.6,45.198640683392114,36.60582998927902,34.58125506755172,NaN,NaN,50
1662071400,0.99454,0.99474,0.99448,0.99452,373,2474.05,-873407,-872524.6,45.47212968591916,36.51071298309123,35.24505679817165,NaN,NaN,50
1662073200,0.99452,0.99487,0.99434,0.99483,511,2312.75,-872896,-872670.8,45.812103417799186,39.14998984628235,35.78781647773021,NaN,NaN,50
1662075000,0.99483,0.99533,0.99466,0.99517,684,2134.45,-872212,-872815,45.29991011111952,41.997924008423254,36.878941785783105,NaN,NaN,50
1662076800,0.99517,0.99584,0.99503,0.99582,1448,1886.55,-870764,-872462.6,43.98902850610818,47.0956854168697,37.79721996501646,NaN,NaN,50
1662078600,0.99582,0.99588,0.99522,0.99562,1231,1646.7,-871995,-872254.8,42.70763795261835,45.762928043976444,38.495002752875635,NaN,NaN,50
1662080400,0.99562,0.99598,0.99543,0.99588,1603,1505.05,-870392,-871651.8,41.349507916418155,47.82983175421761,39.15532951237337,NaN,NaN,50
1662082200,0.99588,0.99627,0.99558,0.99566,1708,1418.4,-872100,-871492.6,39.60113601985796,46.22462341551132,40.00571497560684,NaN,NaN,50
1662084000,0.99566,0.99576,0.99536,0.99562,1106,1318.85,-873206,-871691.4,38.23363658369329,45.92284834162402,40.66189099775806,NaN,NaN,50
1662085800,0.99562,0.99626,0.99562,0.99582,869,1241.95,-872337,-872006,36.142576896088144,47.759276134964416,41.549272637074125,NaN,NaN,50
1662087600,0.99582,0.9961,0.99579,0.99586,684,1173.75,-871653,-871937.6,34.20087861474052,48.138607627687485,42.45494651529564,NaN,NaN,50
1662089400,0.99586,0.99626,0.99582,0.99618,615,1129.15,-871038,-872066.8,32.13161409010664,51.19195222739208,43.45890788901721,NaN,NaN,50
1662091200,0.99618,0.9966,0.99609,0.99641,706,1030.2,-870332,-871713.2,30.00859358611569,53.31926747285802,44.58600535862644,NaN,NaN,50
1662093000,0.99641,0.99674,0.99582,0.99668,1256,987.9,-869076,-870887.2,28.120684935597957,55.75710396663345,45.94761294491492,NaN,NaN,50
1662094800,0.99668,0.99741,0.99668,0.99719,1634,971.85,-867442,-869908.2,26.856208868788023,60.00579433714745,47.61903896976268,NaN,NaN,50
1662096600,0.99719,0.99758,0.99675,0.99714,1570,968.75,-869012,-869380,25.9098970946451,59.40350095968235,49.25423811094775,NaN,NaN,50
1662098400,0.99714,0.99748,0.9965,0.99652,2237,1053.7,-871249,-869422.2,24.597990651094854,52.382379445272086,50.19940879658987,NaN,NaN,50
1662100200,0.99652,0.99788,0.9964,0.99742,2386,1141.9,-868863,-869128.4,23.936075877980443,59.80853133986245,51.471595034549814,NaN,NaN,50
1662102000,0.99742,0.99908,0.99721,0.99902,3072,1261.8,-865791,-868471.4,24.61519693020086,69.0496387331566,53.03973455714174,NaN,NaN,50
1662103800,0.99902,0.99962,0.9986,0.99884,2557,1337.9,-868348,-868652.6,25.692364918346623,67.17828344276963,54.56940279991268,NaN,NaN,50
1662105600,0.99884,0.999,0.99821,0.99838,1710,1398,-870058,-868861.8,26.01322988708797,62.51542694434436,55.61837388492173,NaN,NaN,50
1662107400,0.99838,0.99844,0.99718,0.99729,1753,1467,-871811,-868974.2,24.802622823164015,53.10863319733737,56.11008886933788,NaN,NaN,50
1662109200,0.99729,0.99821,0.9968,0.99806,1989,1540.9,-869822,-869166,23.206762299045767,57.92507862577454,56.96739103249149,NaN,NaN,50
1662111000,0.99806,1.00078,0.99806,1.00044,2345,1623.95,-867477,-869503.2,23.857183404689053,68.64536555067329,58.45925456218498,NaN,NaN,50
1662112800,1.00044,1.00178,1.00012,1.00015,2860,1694.55,-870337,-869901,25.010713785125322,66.42452549897236,59.76539155299104,NaN,NaN,50
1662114600,1.00015,1.00022,0.9994,0.99974,1938,1729.9,-872275,-870344.4,25.27182868730049,63.30619041484317,60.63069428066613,NaN,NaN,50
1662116400,0.99974,0.99998,0.99852,0.99857,1873,1743.4,-874148,-870811.8,24.62886827996627,55.324441738355496,60.77392101391594,NaN,NaN,50
1662118200,0.99857,1.00041,0.99857,0.99912,2666,1791.3,-871482,-871143.8,24.320408458840944,58.00491712086961,60.93447909636138,NaN,NaN,50
1662120000,0.99912,1.00118,0.99867,1.00041,3300,1901,-868182,-871284.8,24.51854190425599,63.5316630265288,61.18632685988862,NaN,NaN,50
1662121800,1.00041,1.00298,0.99777,1.00106,11084,2411.75,-857098,-868637,25.621585861228695,65.96240182035505,61.6548197785081,NaN,NaN,50
1662123600,1.00106,1.00171,1.0001,1.0008,6443,2699.7,-863541,-866890.2,26.645840964131924,64.12133494906618,62.49331660020768,NaN,NaN,50
1662125400,1.0008,1.0011,0.99941,0.99994,6311,2984.5,-869852,-866031,26.869603530577958,58.322763861931875,62.38719035178407,NaN,NaN,50
1662127200,0.99994,1.00086,0.99898,1.00046,5290,3213.7,-864562,-864647,26.64583617012843,60.64046767638703,61.78653527630053,NaN,NaN,50
1662129000,1.00046,1.003,1.00043,1.00258,4911,3396.45,-859651,-862940.8,27.525807151466186,68.36459786259141,61.87127202057353,NaN,NaN,50
1662130800,1.00258,1.00336,1.00188,1.00273,3937,3511.6,-855714,-862664,28.49512923285439,68.83068487010914,62.32236187241386,NaN,NaN,50
1662132600,1.00273,1.00309,1.0017,1.00304,3088,3587.5,-852626,-860481,29.20924605658527,69.8202941477592,63.51605194030113,NaN,NaN,50
1662134400,1.00304,1.00306,0.99784,0.9986,3968,3674.05,-856594,-857829.4,27.32927335723746,46.868256199457,62.72627890984988,NaN,NaN,50
1662136200,0.9986,0.99926,0.99619,0.99697,5179,3813.7,-861773,-857271.6,26.42234074507048,41.47759032004164,60.785723536233334,NaN,NaN,50
1662138000,0.99697,0.99731,0.99464,0.9953,3873,3853.75,-865646,-858470.6,26.244813480960556,36.80665818510931,58.67016158524312,NaN,NaN,50
1662139800,0.9953,0.99621,0.99505,0.99607,2608,3856.3,-863038,-859935.4,26.079966735715626,40.15315369612821,57.01637324819205,NaN,NaN,50
1662141600,0.99607,0.99672,0.99582,0.99664,2398,3890.7,-860640,-861538.2,25.573391827570262,42.57736705462762,56.10586791364006,NaN,NaN,50
1662143400,0.99664,0.99682,0.99622,0.99656,1897,3897.9,-862537,-862726.8,25.031934672782786,42.3182730750026,54.985393338935275,NaN,NaN,50
1662145200,0.99656,0.99685,0.99552,0.99554,1765,3886.7,-864302,-863232.6,24.876486643038447,39.055023488586905,53.237061943368,NaN,NaN,50
1662147000,0.99554,0.99574,0.99452,0.99531,2101,3874.5,-866403,-863384,25.192793573419074,38.33713927180263,51.26382890418568,NaN,NaN,50
1662148800,0.99531,0.9961,0.99518,0.99572,1058,3784.4,-865345,-863845.4,25.196560638755493,40.43888898159722,49.57222562079504,NaN,NaN,50
1662150600,0.99572,0.99602,0.99542,0.99564,747,3724.85,-866092,-864935.8,25.20005862799645,40.15131610211401,48.274265066522325,NaN,NaN,50
1662325200,0.99564,0.99564,0.9925,0.99308,361,3649.25,-866453,-865719,26.420657681990317,32.24833900885628,46.24625587598441,NaN,NaN,50
1662327000,0.99308,0.99318,0.9916,0.99224,623,3547.1,-867076,-866273.8,27.84407561508323,30.15123465219817,43.5167299323849,NaN,NaN,50
1662328800,0.99224,0.99348,0.99032,0.99095,2352,3499.7,-869428,-866878.8,29.53858461947724,27.223377981730707,40.544779440357864,NaN,NaN,50
1662330600,0.99095,0.99264,0.99095,0.99222,1895,3040.25,-867533,-867316.4,31.11205726641454,34.01663244216088,37.98737503281513,NaN,NaN,50
1662332400,0.99222,0.99263,0.99163,0.99191,1124,2774.3,-868657,-867829.4,32.57313900999917,33.201942896131925,37.01120979686334,NaN,NaN,50
1662334200,0.99191,0.99196,0.99062,0.9908,1100,2513.75,-869757,-868490.2,34.232480229565596,30.394909088713405,36.21958970891133,NaN,NaN,50
1662336000,0.9908,0.9929,0.99076,0.99182,2243,2361.4,-867514,-868577.8,34.87621625194784,35.768836664663326,36.14545960030804,NaN,NaN,50
1662337800,0.99182,0.99221,0.99128,0.99157,2021,2216.9,-869535,-868599.2,35.47397112987421,35.054473950574604,35.78126818991135,NaN,NaN,50
1662339600,0.99157,0.99246,0.99152,0.99188,2011,2120.6,-867524,-868597.4,35.780803095229494,36.741565959768096,35.364425254564246,NaN,NaN,50
1662341400,0.99188,0.99242,0.99167,0.99196,2201,2076.25,-865323,-867930.6,36.06571849163083,37.19498196957593,34.99847588989091,NaN,NaN,50
1662343200,0.99196,0.99218,0.99011,0.99086,2423,1999,-867746,-867528.4,36.97280731018205,33.62602488682221,34.61069027547915,NaN,NaN,50
1662345000,0.99086,0.99138,0.99043,0.99136,1702,1825.15,-866044,-867234.4,37.81510407026532,36.603736517709784,34.48687579304394,NaN,NaN,50
1662346800,0.99136,0.9918,0.99109,0.99146,1315,1697.25,-864729,-866273.2,38.12378662608712,37.21045444544237,34.25627332617574,NaN,NaN,50
1662348600,0.99146,0.99186,0.99126,0.9913,1272,1630.45,-866001,-865968.6,38.34130109290035,36.60679836517014,34.0030934878226,NaN,NaN,50
1662350400,0.9913,0.99138,0.9906,0.99106,809,1551,-866810,-866266,38.85689067271914,35.67197889290907,34.24763919382637,NaN,NaN,50
1662352200,0.99106,0.99106,0.9901,0.99052,1135,1512.9,-867945,-866305.8,39.558829425773276,33.59330691123543,34.49350149804332,NaN,NaN,50
1662354000,0.99052,0.99052,0.98802,0.98823,2690,1559.15,-870635,-867224,40.96032015195719,26.532384386540528,34.44414481267259,NaN,NaN,50
1662355800,0.98823,0.98895,0.98802,0.98847,2065,1557.35,-868570,-867992.2,42.2617043976994,28.234866770072614,34.03116155038057,NaN,NaN,50
1662357600,0.98847,0.99031,0.9878,0.98991,3553,1682.1,-865017,-867795.4,41.943467588994395,37.58113953031589,34.34396130996514,NaN,NaN,50
1662359400,0.98991,0.9914,0.9891,0.99072,3485,1819,-861532,-866739.8,40.625669335026785,42.14539650104899,35.18328183941768,NaN,NaN,50
1662361200,0.99072,0.99118,0.98938,0.99114,5202,2061.05,-856330,-864416.8,39.40199952777115,44.41505434847869,35.800868816833066,NaN,NaN,50
1662363000,0.99114,0.99371,0.99094,0.99112,4914,2275.6,-861244,-862538.6,36.836713105931004,44.32587891793561,36.46311202878742,NaN,NaN,50
1662364800,0.99112,0.99286,0.99043,0.9923,3887,2352.35,-857357,-860296,34.291113212321825,50.62472812988864,37.45476646951032,NaN,NaN,50
1662366600,0.9923,0.9923,0.99076,0.99112,2296,2372.4,-859653,-859223.2,31.927341882541878,45.126483960585695,38.02130232601102,NaN,NaN,50
1662368400,0.99112,0.99208,0.99072,0.99143,2835,2457.95,-856818,-858280.4,29.761361511451216,46.76233840999837,38.95961043480931,NaN,NaN,50
1662370200,0.99143,0.99282,0.99116,0.99237,2810,2543.45,-854008,-857816,28.069325767736192,51.48521725608451,40.02257334469322,NaN,NaN,50
1662372000,0.99237,0.99444,0.99216,0.99374,2695,2566.05,-851313,-855829.8,27.512512042861815,57.414797460105454,41.465740702883444,NaN,NaN,50
1662373800,0.99374,0.99402,0.99306,0.99338,2803,2605.15,-854116,-855181.6,26.99547072690704,55.4953635006843,42.81492392684874,NaN,NaN,50
1662375600,0.99338,0.99364,0.99126,0.99128,2599,2634.55,-856715,-854594,25.11450299990754,45.86335906218101,43.54287965322531,NaN,NaN,50
1662377400,0.99128,0.99228,0.99126,0.99172,2318,2640.4,-854397,-854109.8,23.367890110550864,47.90361941531296,44.56504483208799,NaN,NaN,50
1662379200,0.99172,0.99254,0.99142,0.99144,3123,2675.4,-857520,-854812.2,21.93470595319016,46.697533446247164,46.005412622067034,NaN,NaN,50
1662381000,0.99144,0.99276,0.99144,0.99236,2816,2731.1,-854704,-855490.4,20.767286363964633,51.057752654311614,47.63561875665554,NaN,NaN,50
1662382800,0.99236,0.99326,0.99222,0.99257,2415,2786.1,-852289,-855125,20.052338909585316,52.02250259127615,48.66714468958127,NaN,NaN,50
1662384600,0.99257,0.99318,0.99232,0.99256,2030,2824,-854319,-854645.8,19.388459130518807,51.96996759739591,49.36889976789177,NaN,NaN,50
1662386400,0.99256,0.99288,0.99206,0.99272,1520,2859.55,-852799,-854326.2,18.519211213316364,52.79142119857957,49.96721168575612,NaN,NaN,50
1662388200,0.99272,0.99349,0.99192,0.992,1951,2900.35,-854750,-853772.2,18.207118734193493,48.75079171524814,50.28327688556415,NaN,NaN,50
1662390000,0.992,0.99266,0.9918,0.99208,1393,2835.5,-853357,-853502.8,17.79029139039229,49.21590162724982,50.18264642108995,NaN,NaN,50
1662391800,0.99208,0.99323,0.99188,0.99294,1300,2797.25,-852057,-853456.4,17.865239313724405,54.044278597581986,50.81963175230398,NaN,NaN,50
1662393600,0.99294,0.99321,0.99272,0.99302,934,2666.3,-851123,-852817.2,17.93483381396137,54.47786164849838,51.37074055505398,NaN,NaN,50
1662395400,0.99302,0.99328,0.99282,0.99294,515,2517.8,-851638,-852585,18.059767879039697,53.929903942143675,51.54536103262963,NaN,NaN,50
1662397200,0.99294,0.99326,0.99288,0.9932,203,2267.85,-851435,-851922,18.175778082326715,55.496612099790454,51.40834779260713,NaN,NaN,50
1662399000,0.9932,0.99322,0.99296,0.99303,195,2031.9,-851630,-851576.6,18.283501842521808,54.19877929075868,51.3157346347553,NaN,NaN,50
1662400800,0.99303,0.9936,0.99303,0.99328,188,1846.95,-851442,-851453.6,18.761529269370175,55.8345074354862,52.02795951856281,NaN,NaN,50
1662402600,0.99328,0.99328,0.99278,0.99288,254,1744.85,-851696,-851568.2,18.807268536926074,52.597779828614,52.363256690941455,NaN,NaN,50
1662404400,0.99288,0.99326,0.99279,0.99306,201,1613.15,-851495,-851539.6,18.84974071394227,53.89306940767708,52.87722354532931,NaN,NaN,50
1662406200,0.99306,0.99309,0.99288,0.99309,275,1486.4,-851220,-851496.6,18.88917916402874,54.11810074872245,53.09581983778723,NaN,NaN,50
1662408000,0.99309,0.99314,0.9928,0.9929,374,1370.35,-851594,-851489.4,18.776433452465792,52.37462949904715,53.120971759770875,NaN,NaN,50
1662409800,0.9929,0.99308,0.99284,0.99302,883,1274.35,-850711,-851343.2,18.671741006014482,53.395826158268164,53.222818799833185,NaN,NaN,50
1662411600,0.99302,0.99316,0.99268,0.99303,108,1149.8,-850603,-851124.6,18.24742126575434,53.48533467408605,53.272384048083644,NaN,NaN,50
1662413400,0.99303,0.99318,0.99294,0.99304,1464,1107.1,-849139,-850653.4,17.885995772857598,53.5813447428158,53.61742355005276,NaN,NaN,50
1662415200,0.99304,0.99494,0.99304,0.99466,924,997.15,-848215,-850052.4,19.604659455131543,65.87121723284592,54.80708895045249,NaN,NaN,50
1662417000,0.99466,0.99472,0.99405,0.99417,744,893.55,-848959,-849525.4,21.200561445814493,60.64136365611596,55.27830931177634,NaN,NaN,50
1662418800,0.99417,0.99478,0.994,0.99449,933,819.45,-848026,-848988.4,22.73608152919985,62.722857072233786,55.86723755632887,NaN,NaN,50
1662420600,0.99449,0.9952,0.99424,0.995,1357,785.8,-846669,-848201.6,24.52541428519858,65.82491224631343,56.7168810066267,NaN,NaN,50
1662422400,0.995,0.99688,0.99458,0.996,2940,856.8,-843729,-847119.6,27.218906879130593,70.93263254685915,57.81945389570304,NaN,NaN,50
1662424200,0.996,0.99692,0.99598,0.99685,2412,879.85,-841317,-845740,29.739011291384156,74.43078315988978,59.2645970292124,NaN,NaN,50
1662426000,0.99685,0.99704,0.99613,0.99674,2211,920.75,-843528,-844653.8,32.13871697599125,73.20300430007609,60.505203948111685,NaN,NaN,50
1662427800,0.99674,0.9971,0.99618,0.99642,1807,946.1,-845335,-844115.6,34.398026222706434,69.6058798239208,61.72006823349074,NaN,NaN,50
1662429600,0.99642,0.99643,0.99494,0.99533,2057,1002.25,-847392,-844260.2,34.056112076197074,58.97527987747847,62.08308326704798,NaN,NaN,50
1662431400,0.99533,0.99612,0.99499,0.99588,1765,1064.75,-845627,-844639.8,33.73862036872409,62.119068730632335,62.654580980041544,NaN,NaN,50
1662433200,0.99588,0.99591,0.99516,0.99552,1163,1112.75,-846790,-845734.4,33.44380664035633,58.935534916181076,63.123217081265395,NaN,NaN,50
1662435000,0.99552,0.99552,0.99428,0.99443,1059,1155.95,-847849,-846598.6,31.725555677613475,50.49713755822496,62.91616789554803,NaN,NaN,50
1662436800,0.99443,0.99548,0.99442,0.99542,1182,1205.65,-846667,-846865,30.130036926495112,56.5782550520861,63.13709077969089,NaN,NaN,50
1662438600,0.99542,0.99552,0.99448,0.99464,2127,1299.3,-848794,-847145.4,28.701285385409115,51.23769550004003,62.96968726234976,NaN,NaN,50
1662440400,0.99464,0.99571,0.99448,0.99558,2132,1395.85,-846662,-847352.4,27.63175242640895,56.55940225729262,62.304557621238814,NaN,NaN,50
1662442200,0.99558,0.99654,0.99552,0.99595,2419,1503.05,-844243,-846843,27.615806518946247,58.48019529838187,62.15018845282924,NaN,NaN,50
1662444000,0.99595,0.9961,0.99494,0.99574,2850,1626.85,-847093,-846691.8,26.63075417809712,56.9412815743075,61.73721877440594,NaN,NaN,50
1662445800,0.99574,0.99794,0.99523,0.99697,2632,1714.3,-844461,-846250.6,27.359481838861537,63.07103608232204,61.54051333412084,NaN,NaN,50
1662447600,0.99697,0.99764,0.99646,0.99732,4602,1939,-839859,-844463.6,28.03615752385707,64.61469907178972,61.08923237161588,NaN,NaN,50
1662449400,0.99732,0.99866,0.99674,0.99758,3826,2057.1,-836033,-842337.8,29.32551435448511,65.75971805693717,60.469870578547834,NaN,NaN,50
1662451200,0.99758,0.99764,0.99534,0.9956,3193,2170.55,-839226,-841334.4,28.665334270384257,51.96840272037238,58.95311332285472,NaN,NaN,50
1662453000,0.9956,0.9963,0.99471,0.9958,3371,2301.9,-835855,-839086.8,27.37115449884366,53.03973881880526,57.76981753677503,NaN,NaN,50
1662454800,0.9958,0.9958,0.9936,0.99478,3129,2411.7,-838984,-837991.4,25.69673364954396,47.25123014594024,56.93238541309373,NaN,NaN,50
1662456600,0.99478,0.99604,0.99454,0.99528,2817,2484.7,-836167,-837253,23.922258270524026,50.12469188710871,56.0756442099849,NaN,NaN,50
1662458400,0.99528,0.99571,0.99338,0.9938,3695,2522.45,-839862,-838018.8,23.21967923273982,42.708458710748154,54.916567338168264,NaN,NaN,50
1662460200,0.9938,0.99384,0.9922,0.99258,2820,2542.85,-842682,-838710,23.35005526724685,37.750154264964266,54.00606853150679,NaN,NaN,50
1662462000,0.99258,0.99374,0.99252,0.99298,2597,2562.15,-840085,-839556,23.471118727860524,40.20144500391376,52.83629638520877,NaN,NaN,50
1662463800,0.99298,0.99317,0.9918,0.9924,3361,2639.85,-843446,-840448.4,24.02679648704618,37.87263148995004,51.881648955916624,NaN,NaN,50
1662465600,0.9924,0.99299,0.99152,0.99229,3467,2710.35,-846913,-842597.6,24.707347049890984,37.42977839942813,50.51524725178344,NaN,NaN,50
1662467400,0.99229,0.9928,0.98992,0.99004,3451,2794.65,-850364,-844698,26.150715058033843,29.76338591279162,48.46404658138414,NaN,NaN,50
1662469200,0.99004,0.99034,0.98862,0.98965,4208,2946.9,-854572,-847076,28.003002582950316,28.667341905096734,46.444479462154796,NaN,NaN,50
1662471000,0.98965,0.99062,0.98816,0.98848,5383,3163.1,-859955,-851050,29.88468744298936,25.619313043187518,43.769356387930905,NaN,NaN,50
1662472800,0.98848,0.99082,0.9864,0.98996,6666,3437.3,-853289,-853018.6,32.16333140253484,35.029691974724315,41.65614159528337,NaN,NaN,50
1662474600,0.98996,0.99078,0.98908,0.99042,4231,3542.5,-849058,-853447.6,34.279215079255636,37.669243384237255,39.64967911866195,NaN,NaN,50
1662476400,0.99042,0.99292,0.98994,0.99106,4038,3637.8,-845020,-852378.8,34.08471932467671,41.24576769144248,38.88377661659553,NaN,NaN,50
1662478200,0.99106,0.99184,0.99066,0.9912,3353,3684.5,-841667,-849797.8,33.90411612399629,42.029376837400775,38.09732218935236,NaN,NaN,50
1662480000,0.9912,0.99166,0.99052,0.99107,2794,3681.7,-844461,-846699,33.80475164914362,41.476205891257464,37.68482045687501,NaN,NaN,50
1662481800,0.99107,0.99127,0.99034,0.99086,2788,3689.5,-847249,-845491,33.804012978655116,40.5478074297762,37.000757281351255,NaN,NaN,50
1662483600,0.99086,0.99106,0.99015,0.99052,2795,3599.15,-850044,-845688.2,33.90324006312234,39.0247380309999,36.737634375654956,NaN,NaN,50
1662485400,0.99052,0.99062,0.98984,0.98992,1924,3504.05,-851968,-847077.8,34.161074829063914,36.42455685052246,36.64294884605197,NaN,NaN,50
1662487200,0.98992,0.99058,0.98954,0.99005,1847,3436.75,-850121,-848768.6,34.561008623194574,37.39781906534006,36.44268985043956,NaN,NaN,50
1662489000,0.99005,0.99119,0.99,0.99094,1766,3356.5,-848355,-849547.4,34.20361739979928,43.746997236920684,36.86228740379461,NaN,NaN,50
1662490800,0.99094,0.99114,0.99037,0.9906,1759,3288,-850114,-850120.4,33.87175412093221,41.99474511527471,37.18835645492651,NaN,NaN,50
1662492600,0.9906,0.99062,0.98998,0.9904,1370,3215.65,-851484,-850408.4,33.82196709405307,40.95555052823211,37.98779678460083,NaN,NaN,50
1662494400,0.9904,0.9905,0.99006,0.99022,441,3052.95,-851925,-850399.8,33.77573628337958,39.99626356881096,38.79700547486613,NaN,NaN,50
1662496200,0.99022,0.99064,0.99017,0.99059,402,2932.05,-851523,-850680.2,33.533704362353305,42.954099724231746,40.03520452351215,NaN,NaN,50
1662498000,0.99059,0.99091,0.99034,0.99053,408,2822.6,-851931,-851395.4,32.920960461653124,42.58748322695399,40.57504675581426,NaN,NaN,50
1662499800,0.99053,0.99069,0.99042,0.99045,328,2670.95,-852259,-851824.4,32.35198398243153,42.071871678601404,40.889520205411706,NaN,NaN,50
1662501600,0.99045,0.9906,0.99024,0.99032,448,2520,-852707,-852069,31.990921816742507,41.19897051390843,40.88617754987356,NaN,NaN,50
1662503400,0.99032,0.99035,0.9896,0.98968,680,2381.45,-853387,-852361.4,32.20993115174414,37.11617390202636,40.5352344830611,NaN,NaN,50
1662505200,0.98968,0.98968,0.98904,0.9894,906,2216.35,-854293,-852915.4,32.83721592664669,35.460484796159264,40.105540119125514,NaN,NaN,50
1662507000,0.9894,0.98996,0.9893,0.98972,820,1988.2,-853473,-853223.8,32.94737255054004,38.81945067925087,39.98208606551656,NaN,NaN,50
1662508800,0.98972,0.9904,0.9886,0.98884,2413,1775.55,-855886,-853949.2,33.57515361026485,33.635145261661165,39.59711515342094,NaN,NaN,50
1662510600,0.98884,0.98957,0.9883,0.98908,2470,1687.5,-853416,-854091,34.36284242441404,36.140004523443,39.57678998720098,NaN,NaN,50
1662512400,0.98908,0.98931,0.98816,0.98908,2232,1597.2,-853416,-854096.8,35.189744170664696,36.140004523443,39.486946091351186,NaN,NaN,50
1662514200,0.98908,0.98914,0.98808,0.98896,2014,1530.25,-855430,-854324.2,36.0140796298332,35.36595291587305,38.88830006841921,NaN,NaN,50
1662516000,0.98896,0.98899,0.98778,0.9889,2374,1509.25,-857804,-855190.4,36.991817757029985,34.962733182647426,38.386013501802985,NaN,NaN,50
1662517800,0.9889,0.98928,0.98844,0.98846,1544,1447.05,-859348,-855882.8,37.31275625904482,32.07468201999552,37.75166575121466,NaN,NaN,50
1662519600,0.98846,0.98866,0.98789,0.98815,1959,1405.25,-861307,-857461,38.03212579101599,30.182969360071723,37.050716164876135,NaN,NaN,50
1662521400,0.98815,0.98868,0.98772,0.98866,1610,1389.55,-859697,-858717.2,38.822133138170535,36.78814694174055,36.610290966126776,NaN,NaN,50
1662523200,0.98866,0.98866,0.98798,0.98813,1631,1378.75,-861328,-859896.8,39.555711389099756,33.26595149760486,35.94446727117327,NaN,NaN,50
1662525000,0.98813,0.98966,0.98813,0.98925,2105,1395.7,-859223,-860180.6,38.305808699182464,45.20508102797794,36.16826793898588,NaN,NaN,50
1662526800,0.98925,0.99028,0.98921,0.9895,1636,1389.55,-857587,-859828.4,36.20361840415165,47.46443994302319,36.615801469636935,NaN,NaN,50
1662528600,0.9895,0.98958,0.98878,0.9893,1351,1388.6,-858938,-859354.6,34.73742736015001,45.836164482810695,37.23865793969296,NaN,NaN,50
1662530400,0.9893,0.98994,0.98874,0.98972,2656,1499.35,-856282,-858671.6,32.85496327231833,49.73578543878136,38.25832227130882,NaN,NaN,50
1662532200,0.98972,0.99132,0.98918,0.99067,2434,1600.95,-853848,-857175.6,31.508362894692432,57.23565643469046,39.57376553955451,NaN,NaN,50
1662534000,0.99067,0.99103,0.98925,0.98948,3072,1734.15,-856920,-856715,30.257948258325523,47.64551600064094,40.57450630662449,NaN,NaN,50
1662535800,0.98948,0.99285,0.9892,0.99238,2826,1859.05,-854094,-856016.4,30.571528663664125,63.636103793030124,42.53851339730928,NaN,NaN,50
1662537600,0.99238,0.99303,0.99128,0.9916,2947,1984,-857041,-855637,30.97909390419532,58.46385637522061,44.13307424386483,NaN,NaN,50
1662539400,0.9916,0.99186,0.99058,0.99076,2370,2068.5,-859411,-856262.8,30.437237838879476,53.42756913604546,45.42318968816286,NaN,NaN,50
1662541200,0.99076,0.99143,0.98956,0.99,3267,2186.55,-862678,-858028.8,28.79538774557688,49.290390430120134,46.44659377726805,NaN,NaN,50
1662543000,0.99,0.9914,0.99,0.99094,2393,2265.2,-860285,-858701.8,27.270812658938752,54.031679624729634,48.014950749034774,NaN,NaN,50
1662544800,0.99094,0.99106,0.98938,0.99058,2694,2279.25,-862979,-860478.8,25.431330264648743,52.02544681547041,49.57512771013468,NaN,NaN,50
1662546600,0.99058,0.99065,0.98946,0.98974,2853,2298.4,-865832,-862237,23.723239469950876,47.58558230569759,50.346373093274465,NaN,NaN,50
1662548400,0.98974,0.99026,0.9887,0.98963,3382,2355.9,-869214,-864197.6,22.8833788348731,47.01969263521347,51.328783174532234,NaN,NaN,50
1662550200,0.98963,0.9897,0.98771,0.98784,3971,2453.75,-873185,-866299,22.918068163129178,38.91064521748512,50.87918061663988,NaN,NaN,50
1662552000,0.98784,0.98952,0.98756,0.98932,3602,2515.15,-869583,-868158.6,23.06357965149352,47.04284545717837,50.84906672479383,NaN,NaN,50
1662553800,0.98932,0.9895,0.98812,0.9893,3452,2610.55,-873035,-870169.8,23.19869746211755,46.951885859673276,50.92876110885544,NaN,NaN,50
1662555600,0.9893,0.99084,0.98834,0.9903,3641,2694.65,-869394,-870882.2,21.748072820737125,51.95413847633158,51.08721489725188,NaN,NaN,50
1662557400,0.9903,0.99207,0.99004,0.99016,3773,2802.8,-873167,-871672.8,21.080434495219322,51.225859713819965,50.65794370290399,NaN,NaN,50
1662559200,0.99016,0.99393,0.98992,0.99361,4476,2945.05,-868691,-870774,21.67975072540946,64.45056368999668,51.85830425214368,NaN,NaN,50
1662561000,0.99361,0.995,0.99359,0.99486,4916,3085.6,-863775,-869612.4,22.77891705453603,67.85174187198243,52.15942125778314,NaN,NaN,50
1662562800,0.99486,0.99544,0.99386,0.9945,3004,3154,-866779,-868361.2,24.0042369899474,65.89634391774567,52.69031322510635,NaN,NaN,50
1662564600,0.9945,0.99506,0.99382,0.99396,1836,3178.25,-868615,-868205.4,25.09767776149016,62.96511266489817,53.37156633431012,NaN,NaN,50
1662566400,0.99396,0.99532,0.99389,0.99524,1995,3145.2,-866620,-866896,26.24361655677881,66.7416232378196,54.61808296343151,NaN,NaN,50
1662568200,0.99524,0.99757,0.99508,0.99736,2751,3161.05,-863869,-865931.6,28.229381042411656,71.85982144691656,55.891521665016285,NaN,NaN,50
1662570000,0.99736,0.99988,0.99715,0.99936,2820,3148.45,-861049,-865386.4,30.71372103850657,75.66463010830113,57.58003475736133,NaN,NaN,50
1662571800,0.99936,1.0003,0.99888,0.99972,2361,3125.2,-858688,-863768.2,33.11782605882089,76.28616422037535,59.63007632269546,NaN,NaN,50
1662573600,0.99972,0.99984,0.99876,0.99892,1855,3070.6,-860543,-862153.8,35.21877262725298,71.89196692026286,61.40666734305613,NaN,NaN,50
1662575400,0.99892,0.9992,0.99818,0.99824,1407,3022.45,-861950,-861219.8,36.53041459240881,68.2911439436113,63.505274394922274,NaN,NaN,50
1662577200,0.99824,1.00013,0.99816,0.99959,1574,2937.8,-860376,-860521.2,38.03624526213251,71.35826084852548,65.2420897800185,NaN,NaN,50
1662579000,0.99959,1.001,0.99958,1.00086,1751,2905.7,-858625,-860036.4,39.67805328649789,73.9145111199274,67.16799158432237,NaN,NaN,50
1662580800,1.00086,1.0011,1.00054,1.00068,899,2815.95,-859524,-860203.6,41.23003720626642,72.92114141348364,68.6656346512618,NaN,NaN,50
1662582600,1.00068,1.00096,1.00058,1.00072,757,2711.15,-858767,-859848.4,42.67116513176576,73.00795529157045,70.22149862110112,NaN,NaN,50
1662584400,1.00072,1.00108,1.00068,1.00094,359,2560,-858408,-859140,44.04666651226633,73.51096039163953,70.8686698140756,NaN,NaN,50
1662586200,1.00094,1.00094,1.00072,1.00086,255,2374.2,-858663,-858797.4,45.323917794159705,72.97838287404014,71.23485845707974,NaN,NaN,50
1662588000,1.00086,1.00132,1.0007,1.00086,1171,2252.65,-858663,-858805,46.63870969457234,72.97838287404014,71.74071838252932,NaN,NaN,50
1662589800,1.00086,1.00106,1.00044,1.00058,900,2125.05,-859563,-858812.8,47.46528391696903,70.8935331128208,72.30703412880952,NaN,NaN,50
1662591600,1.00058,1.00058,0.99938,0.9994,932,1989.6,-860495,-859158.4,46.775678983072936,62.75680153739963,72.02240400735094,NaN,NaN,50
1662593400,0.9994,0.99982,0.99936,0.9998,674,1834.65,-859821,-859441,46.10960861125346,64.25451002266463,71.47916747704724,NaN,NaN,50
1662595200,0.9998,1.00008,0.9991,0.99914,1765,1699.1,-861586,-860025.6,45.49111469456396,59.96924645797936,70.3580686448814,NaN,NaN,50
1662597000,0.99914,0.99916,0.99829,0.99854,1585,1532.55,-863171,-860927.2,43.843479617148574,56.293669824991255,68.9300333309254,NaN,NaN,50
1662598800,0.99854,0.99912,0.99852,0.99901,1919,1478.3,-861252,-861265,42.31353275954857,58.442384743249306,67.96934888971013,NaN,NaN,50
1662600600,0.99901,0.99916,0.99846,0.99848,1864,1479.7,-863116,-861789.2,40.81150514590382,55.14977043669165,67.03067935350158,NaN,NaN,50
1662602400,0.99848,0.99894,0.99843,0.99892,1475,1453.7,-861641,-862153.2,39.373578544433066,57.300553781266956,66.02655742012597,NaN,NaN,50
1662604200,0.99892,0.99903,0.99852,0.99875,1219,1377.1,-862860,-862408,38.128163613080126,56.17959023426494,64.75977735686436,NaN,NaN,50
1662606000,0.99875,0.9991,0.99794,0.99876,2096,1340.9,-860764,-861926.6,36.10854307822054,56.233828649169304,63.56782644512763,NaN,NaN,50
1662607800,0.99876,0.99886,0.99818,0.99863,1385,1292.1,-862149,-862106,34.23318115299378,55.27598401023318,62.30125706788925,NaN,NaN,50
1662609600,0.99863,0.99947,0.99862,0.99946,1192,1258.95,-860957,-861674.2,33.186183825732876,59.96475801813205,61.33367118406729,NaN,NaN,50
1662611400,0.99946,0.99946,0.99867,0.99899,924,1234.8,-861881,-861722.2,32.21397202184776,56.36142094912869,60.1467453322879,NaN,NaN,50
1662613200,0.99899,0.99968,0.99897,0.99953,1099,1211.05,-860782,-861306.6,31.55915034739623,59.38146737614172,59.175537082438005,NaN,NaN,50
1662615000,0.99953,1.0001,0.99922,0.99978,1699,1208.45,-859083,-860970.4,31.399108470035213,60.73623826642192,58.45001602198095,NaN,NaN,50
1662616800,0.99978,1.0015,0.99972,1.00108,3205,1323.75,-855878,-859716.2,32.393289060495746,66.91571146643705,58.7470810169122,NaN,NaN,50
1662618600,1.00108,1.0011,0.99944,0.99984,2440,1407.9,-858318,-859188.4,32.83393036042558,57.60315655888883,58.271984340928206,NaN,NaN,50
1662620400,0.99984,1.0004,0.99826,0.99884,3677,1573.8,-861995,-859211.2,31.51876985206425,51.39165819030083,57.65929946466546,NaN,NaN,50
1662622200,0.99884,0.99934,0.99762,0.99818,3254,1723.75,-865249,-860104.6,29.542669297697582,47.73319087959869,57.0478366828517,NaN,NaN,50
1662624000,0.99818,0.9993,0.99812,0.99848,3550,1842.7,-861699,-860627.8,27.707718782928538,49.49321365064872,56.40861017623737,NaN,NaN,50
1662625800,0.99848,0.99979,0.99785,0.99978,2999,1947.65,-858700,-861192.2,26.52437926544889,56.35222047965608,56.49449946502055,NaN,NaN,50
1662627600,0.99978,1.00021,0.99954,1.00004,2037,2002.9,-856663,-860861.2,25.84060595812107,57.59263673433372,56.515362533096756,NaN,NaN,50
1662629400,1.00004,1.00044,0.9996,0.99984,2613,2099.85,-859276,-860317.4,25.425941855301847,56.26796629920712,56.52167510916405,NaN,NaN,50
1662631200,0.99984,1.00165,0.99926,1.0011,2301,2126.65,-856975,-858662.6,26.03365036989912,62.17118474433258,56.945771973104286,NaN,NaN,50
1662633000,1.0011,1.00174,1.00073,1.001,3110,2202.9,-860085,-858339.8,26.662748792452735,61.462079707889735,57.38763595150832,NaN,NaN,50
1662634800,1.001,1.00219,1.00052,1.00178,3182,2266.05,-856903,-857980.4,27.567339573833323,64.8314955454257,57.73526006060073,NaN,NaN,50
1662636600,1.00178,1.00294,1.00137,1.00198,4116,2378.65,-852787,-857205.2,28.883949942585414,65.6605438357197,58.399483123928654,NaN,NaN,50
1662638400,1.00198,1.00302,0.99851,1.001,8297,2719.75,-861084,-857566.8,26.8618683418582,58.3962760702128,58.3291123163623,NaN,NaN,50
1662640200,1.001,1.00272,0.99936,1.00003,10057,3161.65,-871141,-860400,24.984221141182932,52.23615925393111,57.7219638154701,NaN,NaN,50
1662642000,1.00003,1.00017,0.99306,0.99624,9677,3540.7,-880818,-864546.6,26.339983241858807,36.177878417388776,55.52640431196665,NaN,NaN,50
1662643800,0.99624,0.999,0.99504,0.99648,9183,3930.6,-871635,-867493,27.598905192486406,37.4884028492458,54.089636189849294,NaN,NaN,50
1662645600,0.99648,0.99666,0.9942,0.99658,7020,4222,-864615,-869858.6,29.024430388667266,38.05912491401221,53.137312384400104,NaN,NaN,50
1662647400,0.99658,0.9977,0.99556,0.99564,5625,4457.05,-870240,-871689.8,29.51836556050505,34.839206552626905,52.21631350390212,NaN,NaN,50
1662649200,0.99564,0.99712,0.99534,0.99597,3786,4591.4,-866454,-870752.4,30.05763960939601,36.85882573175591,51.31385722398121,NaN,NaN,50
1662651000,0.99597,0.99626,0.9949,0.99536,3194,4666.15,-869648,-868518.4,30.7227409414474,34.716806017349526,49.7684704766736,NaN,NaN,50
1662652800,0.99536,0.99611,0.99444,0.99578,5196,4765.7,-864452,-867081.8,31.511555870223813,37.4137089924908,48.32711849511339,NaN,NaN,50
1662654600,0.99578,0.99724,0.99554,0.99688,2982,4792.8,-861470,-866452.8,31.285203724271014,43.94509871434629,47.44691366762333,NaN,NaN,50
1662656400,0.99688,0.99938,0.99645,0.99927,3384,4778.15,-858086,-864022,29.591221124516586,54.94643507692988,46.93086011995171,NaN,NaN,50
1662658200,0.99927,1,0.99901,0.99942,2730,4751.95,-855356,-861802.4,27.648869237200437,55.536250299857976,46.50758659080658,NaN,NaN,50
1662660000,0.99942,0.99998,0.99907,0.99961,2566,4702.75,-852790,-858430.8,25.845256770406866,56.31635467596465,45.89936224298794,NaN,NaN,50
1662661800,0.99961,0.99987,0.9991,0.99918,2537,4679.65,-855327,-856605.8,24.170473765527124,54.006971529155535,45.066964221090494,NaN,NaN,50
1662663600,0.99918,0.99986,0.99912,0.99946,1895,4672.55,-853432,-854998.2,22.615318118138795,55.29259898751989,44.845273000898146,NaN,NaN,50
1662665400,0.99946,0.99992,0.99926,0.99992,1325,4608.15,-852107,-853802.4,21.12576168242712,57.399399137854324,45.21407584974981,NaN,NaN,50
1662667200,0.99992,0.99998,0.99968,0.99992,850,4535.6,-852107,-853152.6,19.69424849699097,57.39939913785433,46.72989875835449,NaN,NaN,50
1662669000,0.99992,0.99998,0.99966,0.99992,452,4402.7,-852107,-853016,18.381818307174886,57.399399137854324,48.152112778969375,NaN,NaN,50
1662670800,0.99992,0.99992,0.99966,0.9999,113,4249.25,-852220,-852394.6,17.16313313091709,57.25288904699077,49.52309593132499,NaN,NaN,50
1662672600,0.9999,0.99994,0.99971,0.99974,893,4088.1,-853113,-852330.8,16.01155619846944,56.020960795627374,51.0360783772536,NaN,NaN,50
1662674400,0.99974,1.0004,0.99966,1.00023,664,3706.45,-852449,-852399.2,15.25459941560849,58.93515805003261,52.612959257130505,NaN,NaN,50
1662676200,1.00023,1.00039,1.00008,1.00037,560,3231.6,-851889,-852355.6,14.55171097438047,59.75568784444167,54.40145081620852,NaN,NaN,50
1662678000,1.00037,1.00077,1.00016,1.00068,594,2777.45,-851295,-852193.2,14.288706677185797,61.58602779498705,56.12804501638682,NaN,NaN,50
1662679800,1.00068,1.00102,1.00053,1.001,906,2363.6,-850389,-851827,14.294437734762441,63.43473827975754,57.52016212820191,NaN,NaN,50
1662681600,1.001,1.00357,1.00084,1.00328,2159,2120.55,-848230,-850850.4,16.142753690273658,73.29588512589334,58.830837131699305,NaN,NaN,50
1662683400,1.00328,1.0051,1.0031,1.00442,2402,1959.4,-845828,-849526.2,18.55548756319452,76.68202068326654,60.34124930194277,NaN,NaN,50
1662685200,1.00442,1.00541,1.0044,1.00498,2011,1870.65,-843817,-847911.8,20.918713910209842,78.1478651235875,61.9006429053444,NaN,NaN,50
1662687000,1.00498,1.00546,1.00465,1.00518,2150,1818.45,-841667,-845986.2,23.133618940699453,78.66373714753246,63.66184044951417,NaN,NaN,50
1662688800,1.00518,1.00682,1.00504,1.00677,1970,1657.15,-839697,-843847.8,25.698433982396647,82.25107287145867,65.58744572693838,NaN,NaN,50
1662690600,1.00677,1.0073,1.00666,1.00676,1640,1590.05,-841337,-842469.2,28.235837355287146,82.15751323752485,67.35588244834341,NaN,NaN,50
1662692400,1.00676,1.00844,1.0066,1.00828,2128,1527.25,-839209,-841145.4,30.924020747211244,84.9582570021648,69.32437229579416,NaN,NaN,50
1662694200,1.00828,1.00832,1.00636,1.00694,2375,1509.5,-841584,-840698.8,33.10671923798091,73.93932794060726,70.50579578170509,NaN,NaN,50
1662696000,1.00694,1.00842,1.00665,1.00787,2338,1498.1,-839246,-840214.6,35.16579142334894,76.24235971184439,71.86218654348035,NaN,NaN,50
1662697800,1.00787,1.00806,1.00722,1.00726,2114,1476.95,-841360,-840547.2,37.07778702404783,71.76270356159138,72.98659674104921,NaN,NaN,50
1662699600,1.00726,1.00737,1.00646,1.00647,2005,1482.45,-843365,-840952.8,37.769139084312556,66.32740625696363,73.5146144701157,NaN,NaN,50
1662701400,1.00647,1.00677,1.00616,1.00674,2129,1522.65,-841236,-841358.2,38.009462392722156,67.24063862465539,74.04925381155954,NaN,NaN,50
1662703200,1.00674,1.0071,1.00584,1.00668,3380,1649.15,-844616,-841964.6,38.41518258317982,66.80702886136376,74.42218245915788,NaN,NaN,50
1662705000,1.00668,1.00696,1.00614,1.00692,2709,1762,-841907,-842496.8,38.79192276003337,67.70416512807552,74.72714151975201,NaN,NaN,50
1662706800,1.00692,1.011,1.00624,1.01092,5693,2041,-836214,-841467.6,40.67567824618143,78.25366370552058,75.08126856115396,NaN,NaN,50
1662708600,1.01092,1.01105,1.00887,1.00964,4519,2222.3,-840733,-840941.2,42.43746347748876,70.33599051986901,74.62798069233986,NaN,NaN,50
1662710400,1.00964,1.01092,1.00962,1.01044,3445,2361.35,-837288,-840151.6,44.07340690655986,72.22735339698615,74.20508699758263,NaN,NaN,50
1662712200,1.01044,1.01136,1.00944,1.01068,3951,2530.9,-833337,-837895.8,45.71400455854266,72.78790161962976,73.78538445987529,NaN,NaN,50
1662714000,1.01068,1.01072,1.00871,1.00885,3728,2687.6,-837065,-836927.4,46.27545908850318,62.43936949297638,72.3702627899837,NaN,NaN,50
1662715800,1.00885,1.00924,1.00762,1.00873,2565,2770.55,-839630,-837610.6,45.53789334227413,61.818708686361774,70.9174910363292,NaN,NaN,50
1662717600,1.00873,1.00975,1.00816,1.00884,3079,2816.55,-836551,-836774.2,45.1031109903754,62.18973241528339,69.29116785155195,NaN,NaN,50
1662719400,1.00884,1.00944,1.00736,1.0074,3228,2857.85,-839779,-837272.4,43.857297732780445,54.696562253347736,67.91668458817627,NaN,NaN,50
1662721200,1.0074,1.00762,1.00566,1.00606,4167,2965.65,-843946,-839394.2,41.22228442996932,48.803695691639035,65.95678001530446,NaN,NaN,50
1662723000,1.00606,1.00632,1.00363,1.00372,5068,3111.55,-849014,-841784,39.09819073051963,40.58145899157082,63.72954826030299,NaN,NaN,50
1662724800,1.00372,1.00503,1.00346,1.00402,3842,3205.15,-845172,-842892.4,37.22267194850023,41.93217152730286,61.987031493898655,NaN,NaN,50
1662726600,1.00402,1.00612,1.00396,1.00446,4717,3359,-840455,-843673.2,34.71010579601222,43.94484181080394,60.32304600719498,NaN,NaN,50
1662728400,1.00446,1.00627,1.00336,1.00488,5079,3506.55,-835376,-842792.6,32.75247325211869,45.87338433529247,58.827785683904175,NaN,NaN,50
1662730200,1.00488,1.0057,1.00436,1.00498,5560,3665.8,-829816,-839966.6,30.934671604217556,46.346694156442965,57.30225204307328,NaN,NaN,50
1662732000,1.00498,1.00616,1.00408,1.00455,4998,3798.8,-834814,-837126.6,28.897656353937162,44.542982647138686,54.894346253188864,NaN,NaN,50
1662733800,1.00455,1.00542,1.0035,1.00418,4068,3896.5,-838882,-835868.6,27.41207626256915,42.992527372622234,52.94124174267124,NaN,NaN,50
1662735600,1.00418,1.00504,1.00337,1.0036,3652,3978.85,-842534,-836284.4,26.123607508920248,40.60644272461681,50.68260526607343,NaN,NaN,50
1662737400,1.0036,1.00464,1.00323,1.00452,2402,3992.5,-840132,-837235.6,25.02959916631977,45.74971387063245,48.75130614114505,NaN,NaN,50
1662739200,1.00452,1.00512,1.0037,1.00442,3154,3981.2,-843286,-839929.6,23.576849728006906,45.2906161170999,47.5263951857253,NaN,NaN,50
1662741000,1.00442,1.00544,1.00392,1.0054,2506,3971.05,-840780,-841122.8,21.942817367993943,50.52988256883694,46.720050463044956,NaN,NaN,50
1662742800,1.0054,1.00554,1.00473,1.00493,2008,3786.8,-842788,-841904,20.416549966645885,48.148402193291325,45.71709830433124,NaN,NaN,50
1662744600,1.00493,1.00542,1.00424,1.00434,1311,3626.4,-844099,-842217,19.367222395377542,45.26440788560616,45.0433729923497,NaN,NaN,50
1662746400,1.00434,1.00453,1.00384,1.00444,1702,3539.25,-842397,-842670,18.74436694048828,45.85636817632626,44.83284959839879,NaN,NaN,50
1662748200,1.00444,1.00455,1.0037,1.00439,2131,3448.25,-844528,-842918.4,18.289157438503427,45.59087378075208,45.19066494048316,NaN,NaN,50
1662750000,1.00439,1.00482,1.00426,1.00458,1604,3342.05,-842924,-843347.2,17.557177527815174,46.8501642285926,45.54195013343243,NaN,NaN,50
1662751800,1.00458,1.00489,1.00433,1.00456,1097,3268.65,-844021,-843593.8,16.79533987466979,46.72756481741938,45.74071606247639,NaN,NaN,50
1662753600,1.00456,1.00464,1.00426,1.00435,645,3146.95,-844666,-843707.2,16.163289349117786,45.384614638627575,45.705803941286035,NaN,NaN,50
1662755400,1.00435,1.0048,1.00379,1.00467,978,3034.45,-843688,-843965.4,16.074384708653003,47.844431657925206,45.81278519139192,NaN,NaN,50
1662930000,1.00467,1.0102,1.00467,1.00887,389,2845.55,-843299,-843719.6,17.831621242505065,68.13190317660914,47.49770808635416,NaN,NaN,50
1662931800,1.00887,1.00926,1.00874,1.00917,197,2602,-843102,-843755.2,19.46334088108198,69.05774304186744,49.35950920558595,NaN,NaN,50
1662933600,1.00917,1.00956,1.00598,1.0068,2332,2526.5,-845434,-844037.8,18.73918572104349,55.371662620207054,50.414167769556684,NaN,NaN,50
1662935400,1.0068,1.00718,1.00632,1.00677,1235,2352.4,-846669,-844438.4,18.06675592957918,55.22247247159788,51.09079338391136,NaN,NaN,50
1662937200,1.00677,1.00707,1.00622,1.00696,1052,2151.05,-845617,-844824.2,17.36990821288412,56.03049083281639,51.857927292176825,NaN,NaN,50
1662939000,1.00696,1.00752,1.0069,1.00704,1109,1928.5,-844508,-845066,17.00462489594242,56.38734821352913,52.27631769536912,NaN,NaN,50
1662940800,1.00704,1.00754,1.00632,1.00662,1966,1776.9,-846474,-845740.4,16.21355167267052,53.91343720332832,52.68810591037176,NaN,NaN,50
1662942600,1.00662,1.00734,1.00648,1.00704,1496,1648.3,-844978,-845649.2,15.478983679632325,55.99271109398845,53.454413282399074,NaN,NaN,50
1662944400,1.00704,1.00806,1.00691,1.00792,1758,1553.6,-843220,-844959.4,15.301152997913842,60.058797320607624,54.4688725069906,NaN,NaN,50
1662946200,1.00792,1.009,1.00782,1.00885,1940,1530.5,-841280,-844092,15.729217653185874,63.8592401896488,55.77375582191179,NaN,NaN,50
1662948000,1.00885,1.00952,1.00878,1.00916,1791,1462.35,-839489,-843088.2,16.429170261174146,65.05291879036025,57.07395257632377,NaN,NaN,50
1662949800,1.00916,1.00924,1.00804,1.00818,1800,1427.05,-841289,-842051.2,16.396138924885857,58.477437747916674,57.91322921421643,NaN,NaN,50
1662951600,1.00818,1.00848,1.00789,1.00844,1353,1394.3,-839936,-841042.8,16.229983704679054,59.64293765738354,58.93168085841329,NaN,NaN,50
1662953400,1.00844,1.00845,1.0078,1.00813,1420,1399.75,-841356,-840670,15.9904861002617,57.56810505904493,59.62622895849326,NaN,NaN,50
1662955200,1.00813,1.00818,1.00736,1.00743,1775,1403.4,-843131,-841040.2,15.347325118423703,53.07797031971215,58.550948040143474,NaN,NaN,50
1662957000,1.00743,1.00804,1.00736,1.0078,1673,1380.5,-841458,-841434,14.75010420671699,55.072665154237406,57.55201390531276,NaN,NaN,50
1662958800,1.0078,1.00896,1.00778,1.00876,1754,1388,-839704,-841117,14.941887161598139,59.84266877050513,57.87137148747691,NaN,NaN,50
1662960600,1.00876,1.00914,1.0082,1.00914,1933,1429.8,-837771,-840684,15.256334709593805,61.58145430998984,58.32558447593347,NaN,NaN,50
1662962400,1.00914,1.00958,1.00825,1.0095,3280,1561.55,-834491,-839311,15.878874733957451,63.20682359002842,58.83817967287719,NaN,NaN,50
1662964200,1.0095,1.01452,1.00943,1.01442,4463,1735.8,-830028,-836690.4,18.68124820730028,77.32554299786189,60.333765014615246,NaN,NaN,50
1662966000,1.01442,1.0196,1.01374,1.01952,8068,2119.75,-821960,-832790.8,22.28397365002018,84.12562792391779,62.491778637514486,NaN,NaN,50
1662967800,1.01952,1.01978,1.01738,1.0175,6062,2413,-828022,-830454.4,25.65531742709751,74.58465228099801,63.819774436586606,NaN,NaN,50
1662969600,1.0175,1.01835,1.01681,1.01804,4417,2517.25,-823605,-827621.2,28.318788406549082,75.38824165301709,64.91473474604443,NaN,NaN,50
1662971400,1.01804,1.01957,1.01802,1.01917,4084,2659.7,-819521,-824627.2,31.008173185121457,77.02527602374884,65.85516587705156,NaN,NaN,50
1662973200,1.01917,1.01918,1.0167,1.01732,3742,2794.2,-823263,-823274.2,32.47537843775142,68.94050733513595,66.13285077310697,NaN,NaN,50
1662975000,1.01732,1.01734,1.0147,1.01471,3521,2914.8,-826784,-824239,32.49361606325581,59.458472512686846,66.20292468487627,NaN,NaN,50
1662976800,1.01471,1.01476,1.01294,1.01358,4903,3061.65,-831687,-824972,31.512340501240782,55.875285730692745,65.93380669011263,NaN,NaN,50
1662978600,1.01358,1.01458,1.01309,1.0137,4445,3209.1,-827242,-825699.4,30.601156050798256,56.17731025946478,65.83446420442834,NaN,NaN,50
1662980400,1.0137,1.01413,1.01302,1.0134,3159,3279.15,-830401,-827875.4,29.714058828739926,55.160791286814856,65.98323713064995,NaN,NaN,50
1662982200,1.0134,1.01464,1.013,1.0144,3528,3358.55,-826873,-828597.4,29.103848175634422,57.895709417021266,66.18488314942024,NaN,NaN,50
1662984000,1.0144,1.0163,1.0139,1.0139,5584,3548.2,-832457,-829732,29.17646698641149,56.05471189961565,65.91431480149956,NaN,NaN,50
1662985800,1.0139,1.01474,1.01339,1.01416,4546,3685.5,-827911,-828976.8,28.90741909597977,56.82356197449722,65.57446534896437,NaN,NaN,50
1662987600,1.01416,1.01438,1.01096,1.0122,5275,3881.6,-833186,-830165.6,27.254235774772344,49.75639063676862,64.61372013801724,NaN,NaN,50
1662989400,1.0122,1.01251,1.01044,1.01236,4825,4051.85,-828361,-829757.6,25.45589968418171,50.299796015118545,62.68330963924986,NaN,NaN,50
1662991200,1.01236,1.01392,1.01206,1.01274,4046,4165.4,-824315,-829246,24.43198749722715,51.63762026011674,60.36273766326408,NaN,NaN,50
1662993000,1.01274,1.01312,1.01186,1.01288,3804,4271.95,-820511,-826856.8,23.3707941080709,52.14867099567397,58.76016757145522,NaN,NaN,50
1662994800,1.01288,1.01368,1.01278,1.01298,2612,4314.85,-817899,-824854.4,22.645431865170806,52.53449664290539,57.1277572135901,NaN,NaN,50
1662996600,1.01298,1.01323,1.01206,1.01258,1855,4310.95,-819754,-822168,21.544892528672317,50.77106732350524,55.252456592144135,NaN,NaN,50
1662998400,1.01258,1.01348,1.0125,1.01294,2309,4262.4,-817445,-819984.8,20.651249781723397,52.322227448902254,54.065436600270296,NaN,NaN,50
1663000200,1.01294,1.01444,1.01294,1.01438,1608,4119.65,-815837,-818289.2,20.303115194084334,58.020210387641214,53.96270359133847,NaN,NaN,50
1663002000,1.01438,1.01444,1.0131,1.01322,1722,3802.35,-817559,-817698.8,19.979847362705204,52.56988541142692,53.72660356853377,NaN,NaN,50
1663003800,1.01322,1.0138,1.01307,1.01328,1140,3556.25,-816419,-817402.8,19.657510911388183,52.81677833042423,53.4865655736023,NaN,NaN,50
1663005600,1.01328,1.01332,1.0112,1.01124,2151,3442.95,-818570,-817166,18.405964534526483,44.361559273673926,52.71519185837794,NaN,NaN,50
1663007400,1.01124,1.01182,1.0111,1.01182,2164,3346.95,-816406,-816958.2,17.304651723166938,46.96129029546162,51.93416192112368,NaN,NaN,50
1663009200,1.01182,1.01208,1.01123,1.01133,1456,3232.65,-817862,-817363.2,16.107005894389545,45.04630514581068,51.14784715299476,NaN,NaN,50
1663011000,1.01133,1.012,1.0113,1.01153,1058,3109.5,-816804,-817212.2,14.99490619623911,46.01397090298443,50.37573350502955,NaN,NaN,50
1663012800,1.01153,1.01208,1.0115,1.01203,780,2903.35,-816024,-817133.2,13.94589015928285,48.457506079891395,50.28295603668118,NaN,NaN,50
1663014600,1.01203,1.01246,1.01197,1.01222,433,2702.75,-815591,-816537.4,13.265765066644414,49.39485262924955,50.21831722340482,NaN,NaN,50
1663016400,1.01222,1.01273,1.01214,1.0125,1051,2597.35,-814540,-816164.2,12.843265150652257,50.81443797853293,50.15951848900597,NaN,NaN,50
1663018200,1.0125,1.01252,1.0118,1.01194,405,2441.2,-814945,-815580.8,12.145222226014381,47.919157340327864,49.857410370766964,NaN,NaN,50
1663020000,1.01194,1.01233,1.01194,1.01232,579,2190.95,-814366,-815093.2,11.497039510279208,50.000987148157755,49.67644540685642,NaN,NaN,50
1663021800,1.01232,1.01238,1.01216,1.0123,374,1982.35,-814740,-814836.4,10.941917596690198,49.887957071458686,49.6133661031388,NaN,NaN,50
1663023600,1.0123,1.0126,1.0123,1.01253,505,1743.85,-814235,-814565.2,10.639705678966559,51.252692911089966,49.53697077900936,NaN,NaN,50
1663025400,1.01253,1.01298,1.01248,1.01292,570,1531.1,-813665,-814390.2,10.722504520035846,53.56210010386741,49.21853433016837,NaN,NaN,50
1663027200,1.01292,1.01465,1.01242,1.01334,2320,1444.8,-811345,-813670.2,12.091950775286861,55.980691309495086,49.46216332288753,NaN,NaN,50
1663029000,1.01334,1.01393,1.01332,1.01352,1845,1346.85,-809500,-812697,13.363579440877087,57.013987799310556,49.76196399923655,NaN,NaN,50
1663030800,1.01352,1.01382,1.0125,1.01257,2038,1318.15,-811538,-812056.6,13.573763284893586,50.30265973445867,50.186328317864024,NaN,NaN,50
1663032600,1.01257,1.0136,1.0125,1.01353,2155,1333.15,-809383,-811086.2,13.76893399719462,55.9460975859417,50.828100267184034,NaN,NaN,50
1663034400,1.01353,1.01353,1.01242,1.01283,1503,1292.85,-810886,-810530.4,13.852980379292825,51.365776260813114,51.27949106111278,NaN,NaN,50
1663036200,1.01283,1.01336,1.01277,1.01311,1245,1274.7,-809641,-810189.6,13.931023448384018,53.02253916397096,51.780103079754674,NaN,NaN,50
1663038000,1.01311,1.01338,1.01276,1.01321,1279,1252.55,-808362,-809962,14.02402848474831,53.630088143335335,52.14957322714353,NaN,NaN,50
1663039800,1.01321,1.01323,1.01264,1.01304,1107,1250.9,-809469,-809548.2,13.934452824215734,52.389661869266675,52.363488172859036,NaN,NaN,50
1663041600,1.01304,1.01306,1.01273,1.01296,865,1186.6,-810334,-809738.4,13.85127542514977,51.78268414480315,52.43264861330691,NaN,NaN,50
1663043400,1.01296,1.013,1.01198,1.01286,1400,1148.4,-811734,-809908,13.030358629932087,50.987467799635006,52.65181364611457,NaN,NaN,50
1663045200,1.01286,1.01398,1.0127,1.01382,1357,1143.45,-810377,-810055.2,13.092191536921705,57.70281032118545,53.2019438727594,NaN,NaN,50
1663047000,1.01382,1.01396,1.01328,1.01382,1666,1173.85,-810377,-810458.2,13.149607807697777,57.70281032118546,53.76014767631131,NaN,NaN,50
1663048800,1.01382,1.01503,1.01374,1.01417,3441,1306.9,-806936,-809951.6,14.232592823708256,60.01903396242888,54.386314894264096,NaN,NaN,50
1663050600,1.01417,1.01484,1.01342,1.01389,2656,1418.05,-809592,-809803.2,14.769318704094992,57.3150011752455,54.654379256505386,NaN,NaN,50
1663052400,1.01389,1.01552,1.01272,1.01463,3677,1549.35,-805915,-808639.4,14.332330932470661,62.16632092318893,55.09620994319781,NaN,NaN,50
1663054200,1.01463,1.01486,1.01398,1.01472,2787,1668.45,-803128,-807189.6,13.926556573105211,62.721254984781865,55.50387188501719,NaN,NaN,50
1663056000,1.01472,1.0149,1.01326,1.01377,2605,1769.75,-805733,-806260.8,13.19639017942855,53.75789496677816,55.750674401611434,NaN,NaN,50
1663057800,1.01377,1.01562,1.01368,1.0155,2108,1856.45,-803625,-805598.6,12.797390535250603,63.880731583512265,56.317433972866475,NaN,NaN,50
1663059600,1.0155,1.01628,1.01433,1.0159,3245,1993.45,-800380,-803756.2,13.068558751890203,65.74776511013887,57.34471889067547,NaN,NaN,50
1663061400,1.0159,1.01666,1.01584,1.01656,2288,2079.35,-798092,-802191.6,13.659112890580442,68.62919138642057,58.459479763707584,NaN,NaN,50
1663063200,1.01656,1.01694,1.01602,1.01632,2008,2063.75,-800100,-801586,14.450064153345105,66.44040753494114,59.374502577393706,NaN,NaN,50
1663065000,1.01632,1.01804,1.01608,1.01792,2603,2101.65,-797497,-799938.8,16.014847016848726,72.6930150617745,60.82474209114427,NaN,NaN,50
1663066800,1.01792,1.01872,1.01738,1.0181,2631,2131.3,-794866,-798187,17.89168728365774,73.29579847508056,62.36139311473551,NaN,NaN,50
1663068600,1.0181,1.01844,1.01746,1.01772,2887,2167.9,-797753,-797661.6,19.634467531408966,69.79315335127212,63.704656368423876,NaN,NaN,50
1663070400,1.01772,1.01798,1.01628,1.01676,3706,2278.05,-801459,-798335,19.647023545613802,61.76309946158253,63.99467702130938,NaN,NaN,50
1663072200,1.01676,1.01681,1.00304,1.00374,13975,2914.55,-815434,-801401.8,22.444712509346854,23.041914663114895,61.51889876001862,NaN,NaN,50
1663074000,1.00374,1.00384,1.0005,1.00225,8696,3285.4,-824130,-806728.4,25.39379793688303,21.389284129275808,58.7596309147934,NaN,NaN,50
1663075800,1.00225,1.00428,1.00154,1.00324,7818,3620.95,-816312,-811017.6,27.877421888421495,25.226687382673788,56.467608501038285,NaN,NaN,50
1663077600,1.00324,1.00413,1.00182,1.00344,7050,3930.2,-809262,-813319.4,30.183644129135782,26.01245439642227,53.8851894634121,NaN,NaN,50
1663079400,1.00344,1.00376,1.00105,1.0015,5205,4120.45,-814467,-815921,32.44563219484552,23.439394060679305,51.079342254547626,NaN,NaN,50
1663081200,1.0015,1.00184,1.00012,1.00038,4373,4271.25,-818840,-816602.2,34.688305881922375,22.081404863889134,48.81673581862698,NaN,NaN,50
1663083000,1.00038,1.0007,0.99956,0.99968,3644,4370.15,-822484,-816273,36.8553584488466,21.252646996772285,45.77187263385984,NaN,NaN,50
1663084800,0.99968,1.00089,0.99895,0.99952,3206,4358.4,-825690,-818148.6,38.96003021449578,21.058099004789412,42.57975362633488,NaN,NaN,50
1663086600,0.99952,1.00004,0.99894,0.99984,2342,4342.7,-823348,-820965.8,40.91593833409277,22.58445755610201,39.290844067026406,NaN,NaN,50
1663088400,0.99984,1.00064,0.99972,1.00014,2621,4289.9,-820727,-822217.8,42.25135208584535,24.06676016763049,36.264154969361364,NaN,NaN,50
1663090200,1.00014,1.00029,0.99832,0.99879,2515,4276.3,-823242,-823098.2,43.75764136107886,22.023204721409257,32.64488280219241,NaN,NaN,50
1663092000,0.99879,0.9993,0.99819,0.9989,2219,4257,-821023,-822806,45.18028624902591,22.599909913861467,29.023747904962477,NaN,NaN,50
1663093800,0.9989,0.99896,0.9974,0.99775,1651,4234.15,-822674,-822202.8,46.647834050310706,20.862712806734265,25.52871643749549,NaN,NaN,50
1663095600,0.99775,0.99798,0.99745,0.9979,1708,4157.3,-820966,-821726.4,48.01055700864659,21.708064681589264,22.66764252463883,NaN,NaN,50
1663097400,0.9979,0.99792,0.99702,0.99732,1756,4130.7,-822722,-822125.4,49.36020868054733,20.783583225335093,22.506333136225987,NaN,NaN,50
1663099200,0.99732,0.99748,0.99702,0.99704,765,4068.55,-823487,-822174.4,50.61345666159801,20.333387308626854,22.430911934751062,NaN,NaN,50
1663101000,0.99704,0.99729,0.9967,0.99674,777,3977.25,-824264,-822822.6,51.845385902896105,19.83757465339157,22.0459753112309,NaN,NaN,50
1663102800,0.99674,0.997,0.99644,0.99662,528,3872.1,-824792,-823246.2,53.045845737676764,19.631367793535176,21.59018341102468,NaN,NaN,50
1663104600,0.99662,0.99696,0.99637,0.99652,396,3747.55,-825188,-824090.6,54.176430649419984,19.44992658150099,21.30522144822623,NaN,NaN,50
1663106400,0.99652,0.99776,0.99556,0.9974,1663,3645.4,-823525,-824251.2,55.406709799188214,25.93707170168601,21.580626222354578,NaN,NaN,50
1663108200,0.9974,0.9974,0.99675,0.99696,880,2990.65,-824405,-824434.8,56.54911186683014,24.85905146401761,21.838226541443532,NaN,NaN,50
1663110000,0.99696,0.99708,0.99646,0.99695,1001,2605.9,-825406,-824663.2,57.67651513263575,24.83378869450992,22.107918662137852,NaN,NaN,50
1663111800,0.99695,0.9981,0.99692,0.99782,1545,2292.25,-823861,-824477,57.37036084015632,31.368464654671115,22.73534774060707,NaN,NaN,50
1663113600,0.99782,0.99834,0.99688,0.99783,2085,2044,-821776,-823794.6,56.78918015786033,31.44224206947196,23.26216787645289,NaN,NaN,50
1663115400,0.99783,0.99815,0.99694,0.99789,2565,1912,-819211,-822931.8,56.249512381442635,31.91516031709429,23.968736133287532,NaN,NaN,50
1663117200,0.99789,0.99815,0.99718,0.99772,2454,1816.05,-821665,-822383.8,55.74839230334049,31.25725609903688,24.587118003657206,NaN,NaN,50
1663119000,0.99772,0.99858,0.99722,0.99804,2120,1739.85,-819545,-821211.6,54.67364802538799,34.01465057766731,25.526542130152425,NaN,NaN,50
1663120800,0.99804,0.99904,0.99801,0.99874,1636,1661.35,-817909,-820021.2,53.05462966202143,39.711554191674736,26.812505666587104,NaN,NaN,50
1663122600,0.99874,0.99886,0.9983,0.99864,1191,1603.8,-819100,-819486,51.551255467466774,39.19100190280997,28.127321286406737,NaN,NaN,50
1663124400,0.99864,0.99882,0.99822,0.99854,1012,1523.35,-820112,-819666.2,50.2150517899158,38.64545687068184,29.435326255124952,NaN,NaN,50
1663126200,0.99854,0.99899,0.99844,0.99889,1284,1461.8,-818828,-819098.8,48.714297013828514,41.704141289743724,30.997223872007247,NaN,NaN,50
1663128000,0.99889,0.99896,0.99857,0.99885,1085,1405.1,-819913,-819172.4,47.32073900746175,41.449817377271934,32.555684556559875,NaN,NaN,50
1663129800,0.99885,1.0001,0.99885,0.99954,2827,1463.9,-817086,-819007.8,44.40555140805987,47.40784807949573,34.55267894927378,NaN,NaN,50
1663131600,0.99954,1.00024,0.99922,0.99942,1766,1466.8,-818852,-818958.2,41.52586169746241,46.52121812559158,36.022975122409896,NaN,NaN,50
1663133400,0.99942,0.99975,0.99807,0.99826,1829,1470.45,-820681,-819072,39.997681622683515,38.93984601440297,37.028746161723134,NaN,NaN,50
1663135200,0.99826,0.99866,0.99722,0.99774,2842,1574.3,-823523,-820011,39.24893140741566,36.09976245770599,37.83345857337999,NaN,NaN,50
1663137000,0.99774,0.99815,0.99596,0.99668,2827,1676.8,-826350,-821298.4,39.34881943348732,31.1174783526466,37.81553098037825,NaN,NaN,50
1663138800,0.99668,0.99914,0.99648,0.99748,4984,1899.6,-821366,-822154.4,38.25726961794378,38.06498824708649,38.28858427877928,NaN,NaN,50
1663140600,0.99748,0.99936,0.99735,0.99882,3820,2070.8,-817546,-821893.2,37.00053583835526,47.59869397419114,39.408836682857626,NaN,NaN,50
1663142400,0.99882,1.00038,0.99812,0.99956,4021,2188.7,-813525,-820462,34.795089649223854,51.99347641347736,40.889995276746234,NaN,NaN,50
1663144200,0.99956,1.001,0.99852,0.99916,3897,2339.55,-817422,-819241.8,32.42644859818862,49.57325202007809,42.00132395120414,NaN,NaN,50
1663146000,0.99916,1.00038,0.99827,1.00014,3375,2458.25,-814047,-816781.2,30.216923462236462,55.089066237758516,43.09971766878156,NaN,NaN,50
1663147800,1.00014,1.00146,1.00007,1.00122,3544,2558.2,-810503,-814608.6,28.85972601087236,60.24936769247263,44.60388665375746,NaN,NaN,50
1663149600,1.00122,1.00239,1.00062,1.00213,3765,2642.2,-806738,-812447,28.25928347552998,64.00252953651264,46.41510612988823,NaN,NaN,50
1663151400,1.00213,1.00232,1.0008,1.00082,3328,2680.35,-810066,-811755.2,27.70172969271205,55.8303452537337,47.424120698744666,NaN,NaN,50
1663153200,1.00082,1.001,0.99926,0.99952,3413,2728.3,-813479,-810966.6,25.751153901873884,49.12664131301465,47.97246526558342,NaN,NaN,50
1663155000,0.99952,0.99994,0.99862,0.99926,4254,2835,-817733,-811703.8,24.38107211353959,47.88816588197365,48.00677368004614,NaN,NaN,50
1663156800,0.99926,1.00026,0.9984,0.9992,5001,3003.25,-822734,-814150,22.83477870531551,47.59000636868273,48.08311569740979,NaN,NaN,50
1663158600,0.9992,1.00098,0.99804,0.9998,7804,3333.9,-814930,-815788.4,21.597333737947626,50.88332754678559,48.93622152115141,NaN,NaN,50
1663160400,0.9998,1.00078,0.9987,0.99887,5314,3549,-820244,-817824,20.448277696820302,46.05282175607363,49.64715432817767,NaN,NaN,50
1663162200,0.99887,0.99954,0.99817,0.99918,4967,3733.15,-815277,-818183.6,19.077253624997176,47.83067436768822,50.840954043537785,NaN,NaN,50
1663164000,0.99918,0.99944,0.99708,0.99712,4801,3918.95,-820078,-818652.6,18.681164371996456,38.70297070904445,50.88652421939192,NaN,NaN,50
1663165800,0.99712,0.99984,0.9971,0.99974,5546,4054.9,-814532,-817012.2,17.9335405699015,51.40482050268654,51.15839039999874,NaN,NaN,50
1663167600,0.99974,1.00052,0.9992,0.99924,3813,4157.25,-818345,-817695.2,16.676287286202772,49.30504761275969,50.96635977137605,NaN,NaN,50
1663169400,0.99924,1.00022,0.99904,0.99937,2939,4212.75,-815406,-816727.6,15.602015128626928,49.878308390613796,50.988149512128594,NaN,NaN,50
1663171200,0.99937,1.00024,0.99872,0.99982,2063,4173.8,-813343,-816340.8,14.889339267328452,51.90568798295464,50.760765351071164,NaN,NaN,50
1663173000,0.99982,1.00085,0.99956,0.99974,2349,4149.9,-815692,-815463.6,14.003768830163857,51.506813558602225,50.13629719865185,NaN,NaN,50
1663174800,0.99974,1,0.99934,0.99956,1550,3978.2,-817242,-816005.6,13.037693189241068,50.56526924626439,49.17649289220555,NaN,NaN,50
1663176600,0.99956,0.99974,0.99856,0.99875,1795,3876.95,-819037,-816144,12.84880907480955,46.450341713712085,48.50649263934686,NaN,NaN,50
1663178400,0.99875,0.99895,0.99826,0.99848,1838,3767.8,-820875,-817237.8,12.927059358912029,45.13191186342087,48.22115482151874,NaN,NaN,50
1663180200,0.99848,0.99892,0.99792,0.99792,1370,3641.45,-822245,-819018.2,13.283309971407528,42.441214440384165,47.83208686140521,NaN,NaN,50
1663182000,0.99792,0.99795,0.99714,0.99732,1888,3567.1,-824133,-820706.4,14.21404160255235,39.70956968839395,47.26919852709886,NaN,NaN,50
1663183800,0.99732,0.998,0.99693,0.99796,1480,3463.9,-822653,-821788.6,15.229939107000847,43.8602590129582,46.76755077468261,NaN,NaN,50
1663185600,0.99796,0.99802,0.99768,0.99777,534,3302.35,-823187,-822618.6,16.146242377100307,42.915663270364995,46.543468025703426,NaN,NaN,50
1663187400,0.99777,0.9979,0.99769,0.9979,369,3154.4,-822818,-823007.2,16.997095413621235,43.807383221010795,46.25609008665504,NaN,NaN,50
1663189200,0.9979,0.99812,0.99758,0.99792,1146,3041.05,-821672,-822892.6,17.455810464664204,43.952440510266456,46.63105221531375,NaN,NaN,50
1663191000,0.99792,0.99816,0.9978,0.99812,410,2848.85,-821262,-822318.4,17.819668810155147,45.46841911516923,46.20702354477681,NaN,NaN,50
1663192800,0.99812,0.9984,0.99802,0.99818,570,2627.3,-820692,-821926.2,17.77649877037395,45.9408211376112,45.966721653694776,NaN,NaN,50
1663194600,0.99818,0.99848,0.99816,0.99824,757,2274.95,-819935,-821275.8,17.607596236280866,46.44049302299476,45.721163413150556,NaN,NaN,50
1663196400,0.99824,0.9984,0.99796,0.99827,635,2041,-819300,-820572.2,17.691079813416472,46.705740091432354,45.349738563756105,NaN,NaN,50
1663198200,0.99827,0.99834,0.99812,0.99822,545,1819.9,-819845,-820206.8,17.768600277899534,46.29423579456543,44.97741158061062,NaN,NaN,50
1663200000,0.99822,0.99822,0.99726,0.99766,1382,1648.95,-821227,-820199.8,18.800906184765267,41.847175918420334,44.35469062862176,NaN,NaN,50
1663201800,0.99766,0.99774,0.99717,0.99756,1200,1431.65,-822427,-820546.8,19.848136896954923,41.088145374469796,43.97167660439017,NaN,NaN,50
1663203600,0.99756,0.99762,0.99705,0.99752,1444,1313.2,-823871,-821334,20.94233984839153,40.76959787489635,43.66008274806699,NaN,NaN,50
1663205400,0.99752,0.99823,0.99722,0.99813,1707,1251.6,-822164,-821906.8,20.770743748971892,47.459317261055745,44.01851866382924,NaN,NaN,50
1663207200,0.99813,0.99826,0.99692,0.99751,1157,1206.3,-823321,-822602,20.96730150825851,42.237646675643404,44.19909559148992,NaN,NaN,50
1663209000,0.99751,0.9978,0.9973,0.99742,898,1133.75,-824219,-823200.4,21.149819427596086,41.52345146623492,44.03218076672397,NaN,NaN,50
1663210800,0.99742,0.99742,0.99695,0.99722,1081,1110.3,-825300,-823775,21.736839258258335,39.9085167294429,43.81738458522954,NaN,NaN,50
1663212600,0.99722,0.9976,0.99711,0.99742,635,1052.3,-824665,-823933.8,21.906633615034494,42.32419919798525,43.71144286929914,NaN,NaN,50
1663214400,0.99742,0.99761,0.99701,0.99733,633,992.05,-825298,-824560.6,22.19288575342877,41.515413453230614,43.53736950808229,NaN,NaN,50
1663216200,0.99733,0.99748,0.99663,0.99682,698,958.45,-825996,-825095.6,22.926961984824207,37.17967856489802,42.94531661163435,NaN,NaN,50
1663218000,0.99682,0.99686,0.99621,0.99626,1289,928.5,-827285,-825708.8,24.0682447943001,33.09281954099299,42.0276022118759,NaN,NaN,50
1663219800,0.99626,0.99652,0.99592,0.99624,1389,923.95,-828674,-826383.6,25.416762371616734,32.95349993891969,41.0642455630134,NaN,NaN,50
1663221600,0.99624,0.99682,0.99558,0.99631,2389,1016.7,-826285,-826707.6,26.983165029521714,34.000796972154234,40.1567496259221,NaN,NaN,50
1663223400,0.99631,0.99659,0.99586,0.99628,2039,1100.2,-828324,-827312.8,28.437681783290632,33.75742477216251,39.2612631243219,NaN,NaN,50
1663225200,0.99628,0.99703,0.99566,0.99684,2769,1181.35,-825555,-827224.6,28.696690495429078,42.0901282875949,39.27861686497723,NaN,NaN,50
1663227000,0.99684,0.9979,0.99684,0.99776,2084,1265.05,-823471,-826461.8,27.230722347387076,52.63201046097471,40.10317865687044,NaN,NaN,50
1663228800,0.99776,0.99856,0.99742,0.99826,2254,1349.25,-821217,-824970.4,25.696780404557636,57.192887362421494,41.276270763122234,NaN,NaN,50
1663230600,0.99826,0.99955,0.99796,0.99924,2733,1448.05,-818484,-823410.2,25.431520953508198,64.42339314637974,42.48799046921681,NaN,NaN,50
1663232400,0.99924,0.99932,0.99847,0.99914,2677,1550.15,-821161,-821977.6,25.185208606105146,63.249394165031035,43.98882957560164,NaN,NaN,50
1663234200,0.99914,1.00006,0.99894,0.99944,1851,1615.45,-819310,-820728.6,25.68026572707826,65.29277783710812,45.68663860209259,NaN,NaN,50
1663236000,0.99944,0.99963,0.99837,0.99846,1463,1619.5,-820773,-820189,25.222133090323535,54.61076325124716,46.73679906793575,NaN,NaN,50
1663237800,0.99846,0.99846,0.99693,0.99797,3147,1716.85,-823920,-820729.6,23.82692269755116,50.18941389215726,47.29860011751947,NaN,NaN,50
1663239600,0.99797,0.99868,0.99717,0.99864,2025,1745.9,-821895,-821411.8,22.280125143074372,55.495168429106336,48.29715404436774,NaN,NaN,50
1663241400,0.99864,0.99938,0.99822,0.9985,2345,1777.8,-824240,-822027.6,21.280625248275996,54.19610167809921,49.51261283816782,NaN,NaN,50
1663243200,0.9985,0.99934,0.99803,0.99809,3001,1870,-827241,-823613.8,20.127799587554023,50.47003674572404,50.75384263850575,NaN,NaN,50
1663245000,0.99809,1.00178,0.9978,1.00078,7024,2176.3,-820217,-823502.6,20.99943369630473,66.6638949610398,53.16172799722862,NaN,NaN,50
1663246800,1.00078,1.00138,0.99832,0.9985,4806,2362.55,-825023,-823723.2,21.808808225858964,51.34173157995273,54.40036618349994,NaN,NaN,50
1663248600,0.9985,1.00024,0.99815,0.99986,4157,2538.65,-820866,-823517.4,22.346405735517987,57.601630298165276,56.10352372107156,NaN,NaN,50
1663250400,0.99986,1.00048,0.9987,0.99878,3970,2705.5,-824836,-823636.6,23.013536600060206,51.89232441166487,56.80368058707656,NaN,NaN,50
1663252200,0.99878,1.00006,0.99832,0.99968,4043,2872.75,-820793,-822347,23.12804441671045,55.82201101426345,57.031537769454324,NaN,NaN,50
1663254000,0.99968,1.00046,0.99902,0.99931,3157,2966.15,-823950,-823093.6,23.543264166460034,53.873674202459696,56.79445111517134,NaN,NaN,50
1663255800,0.99931,0.99974,0.99874,0.99907,2241,3008.75,-826191,-823327.2,23.547041521678103,52.59143866184149,55.94931150913289,NaN,NaN,50
1663257600,0.99907,1.00015,0.99876,0.99966,2095,2994.05,-824096,-823973.2,23.885400571251928,55.40162856025928,55.38875682307777,NaN,NaN,50
1663259400,0.99966,1.00066,0.99948,1.00057,1986,2991.4,-822110,-823428,24.58865313315184,59.39912720895418,54.967781778209634,NaN,NaN,50
1663261200,1.00057,1.00154,1.00057,1.00094,2074,2956.65,-820036,-823276.6,25.827103346172432,60.93243955727265,55.41933008578288,NaN,NaN,50
1663263000,1.00094,1.00106,0.99934,0.99978,1532,2929.05,-821568,-822800.2,25.38601716450032,54.04170874238843,55.69449400365654,NaN,NaN,50
1663264800,0.99978,0.99981,0.9991,0.99976,1836,2908.15,-823404,-822242.8,24.70357415720415,53.92847091856916,55.582587038618165,NaN,NaN,50
1663266600,0.99976,0.99999,0.99922,0.99922,1662,2854.6,-825066,-822436.8,24.221010946334747,50.83145504621558,55.34225513634077,NaN,NaN,50
1663268400,0.99922,0.9995,0.99879,0.99922,1703,2805.9,-825066,-823028,23.261154937583918,50.83145504621557,55.36807072923302,NaN,NaN,50
1663270200,0.99922,0.99998,0.99914,0.99946,1495,2788.1,-823571,-823735,22.80354457030714,52.24506764599003,54.33815449244374,NaN,NaN,50
1663272000,0.99946,0.9999,0.99943,0.9998,757,2752.8,-822814,-823984.2,22.378620657835842,54.25171133056214,54.546010188915844,NaN,NaN,50
1663273800,0.9998,0.99995,0.99946,0.99972,676,2629.25,-823490,-824001.4,22.032477593323502,53.680151739936335,54.26590457761379,NaN,NaN,50
1663275600,0.99972,1.0001,0.99958,0.99966,778,2566.9,-824268,-823841.8,21.862263021119922,53.22722511944553,54.36125462816955,NaN,NaN,50
1663277400,0.99966,0.99998,0.99962,0.99968,519,2475.6,-823749,-823578.4,21.70420663264517,53.36846497104863,54.18600133936848,NaN,NaN,50
1663279200,0.99968,0.99975,0.99902,0.99955,492,2350.15,-824241,-823712.4,20.648029214031556,52.26371889936688,54.071004532004714,NaN,NaN,50
1663281000,0.99955,0.99959,0.99909,0.99938,388,2018.35,-824629,-824075.4,19.66729303960463,50.783285740876934,53.94185075193581,NaN,NaN,50
1663282800,0.99938,0.99938,0.99874,0.99887,792,1817.65,-825421,-824461.6,18.28121883173909,46.52548492433789,53.307840492227136,NaN,NaN,50
1663284600,0.99887,0.99906,0.99872,0.99876,885,1654.05,-826306,-824869.2,17.023469686493407,45.63672149904027,52.32481151294757,NaN,NaN,50
1663286400,0.99876,1.00032,0.99862,1.00005,1441,1527.6,-824865,-825092.4,17.329062871800623,56.20298596684369,51.98699339934551,NaN,NaN,50
1663288200,1.00005,1.00108,0.99988,1.00058,1789,1414.9,-823076,-824859.4,18.310878681885242,59.671171231729126,52.38909786286984,NaN,NaN,50
1663290000,1.00058,1.00124,1.00056,1.0007,1588,1336.45,-821488,-824231.2,19.35737877191526,60.43510872059984,52.85385770587203,NaN,NaN,50
1663291800,1.0007,1.00094,0.99975,0.99982,1828,1315.8,-823316,-823810.2,19.09545064664856,52.570605382997606,52.97808272992789,NaN,NaN,50
1663293600,0.99982,1.00004,0.9991,0.99915,1623,1292.2,-824939,-823536.8,18.018205562581745,47.50218747609501,52.74027790349071,NaN,NaN,50
1663295400,0.99915,0.99958,0.99911,0.99945,1131,1249.45,-823808,-823325.4,17.017906555948276,49.834392105504854,52.568086793456054,NaN,NaN,50
1663297200,0.99945,1.00008,0.9993,1.00007,1032,1197.35,-822776,-823265.4,16.655392850794396,54.34815647148504,52.5749757320934,NaN,NaN,50
1663299000,1.00007,1.00031,0.99952,0.99974,1305,1186,-824081,-823784,16.56603437096158,51.682622155866746,52.432295047517,NaN,NaN,50
1663300800,0.99974,1.00022,0.99966,0.99982,850,1136.7,-823231,-823767,16.483058639688256,52.29347690845149,52.3655987467317,NaN,NaN,50
1663302600,0.99982,1.00016,0.99955,0.99958,757,1091.45,-823988,-823576.8,16.230104199185043,50.24136078962356,52.1422341623442,NaN,NaN,50
1663304400,0.99958,0.99959,0.99846,0.99901,1156,1064.1,-825144,-823844,15.642744032415592,45.6586180962437,51.6704412478354,NaN,NaN,50
1663306200,0.99901,0.99902,0.9981,0.99824,1264,1052.55,-826408,-824570.4,15.504010857265099,40.30961028449158,50.9223215723793,NaN,NaN,50
1663308000,0.99824,0.99955,0.99762,0.99846,3182,1173.8,-823226,-824399.4,14.649483446639907,42.386398138941175,50.62667251627954,NaN,NaN,50
1663309800,0.99846,0.99938,0.99825,0.99925,3231,1301.55,-819995,-823752.2,13.855993708202227,49.21888835500555,50.88254157741991,NaN,NaN,50
1663311600,0.99925,0.99987,0.99829,0.99853,3758,1450.55,-823753,-823705.2,13.260016858563468,44.087238914504844,50.017131073681426,NaN,NaN,50
1663313400,0.99853,0.99904,0.99452,0.99561,4542,1651.7,-828295,-824335.4,15.085299031050905,30.292896123323146,47.91868285165243,NaN,NaN,50
1663315200,0.99561,0.99684,0.99555,0.99684,3469,1800.55,-824826,-824019,16.780203905503523,38.9571271012846,46.38454130741563,NaN,NaN,50
1663317000,0.99684,0.99693,0.99491,0.99554,2710,1916.65,-827536,-824881,18.687914341612426,34.128797658547754,45.06726932709778,NaN,NaN,50
1663318800,0.99554,0.99796,0.99552,0.99789,2497,2001.9,-825039,-825889.8,19.261012704740907,46.932790367923666,45.02659810508555,NaN,NaN,50
1663320600,0.99789,0.99876,0.99674,0.99674,1998,2057.55,-827037,-826546.6,18.986875369470525,42.57178747833618,44.507840631716356,NaN,NaN,50
1663322400,0.99674,0.99744,0.99652,0.99741,1864,2078.7,-825173,-825922.2,18.887608407324635,45.735434172622014,43.892646181797566,NaN,NaN,50
1663324200,0.99741,0.99892,0.99741,0.99854,2136,2096.05,-823037,-825564.4,17.600243476803264,50.671169069057854,43.82039953273979,NaN,NaN,50
1663326000,0.99854,0.99872,0.99702,0.99818,2164,2124.85,-825201,-825097.4,16.588618397279696,49.1377546564053,43.59499080045078,NaN,NaN,50
1663327800,0.99818,0.99818,0.99678,0.99694,2560,2161.45,-827761,-825641.8,15.838851943623602,44.17853038196556,43.16193148561806,NaN,NaN,50
1663329600,0.99694,0.99707,0.99533,0.99598,3280,2244.3,-831041,-826442.6,16.160325851662545,40.749619260998294,42.81128871167196,NaN,NaN,50
1663331400,0.99598,0.99704,0.99545,0.99554,3113,2343.4,-834154,-828238.8,16.45883733769871,39.24610466715142,42.73532402471909,NaN,NaN,50
1663333200,0.99554,0.99694,0.99537,0.9969,3968,2490.2,-830186,-829668.6,16.790734365890682,45.8914956432966,42.985688132173046,NaN,NaN,50
1663335000,0.9969,0.99768,0.99626,0.99741,4380,2643.95,-825806,-829789.6,16.342833810166184,48.18054522131347,42.91152076548075,NaN,NaN,50
1663336800,0.99741,1.00022,0.99714,0.99972,5305,2866.7,-820501,-828337.6,16.351791809951504,57.044625259415845,43.83704836154583,NaN,NaN,50
1663338600,0.99972,1.00364,0.99971,1.00304,7264,3192.05,-813237,-824776.8,17.920340441259015,66.03672603084226,46.39017906922577,NaN,NaN,50
1663340400,1.00304,1.00324,1.00164,1.00192,5516,3410.05,-818753,-821696.6,19.376849884615986,61.36947976235103,47.991061402159076,NaN,NaN,50
1663342200,1.00192,1.0023,1.00005,1.00121,3986,3546.15,-822739,-820207.2,19.50850254176881,58.54468023942393,49.73505301507881,NaN,NaN,50
1663344000,1.00121,1.00198,1.00015,1.0003,2529,3513.5,-825268,-820099.6,19.630751437696432,55.047329630423036,50.31466296240019,NaN,NaN,50
1663345800,1.0003,1.00073,1.0001,1.0007,1723,3438.1,-823545,-820708.4,19.705421296032455,56.28356109782759,51.29407536379244,NaN,NaN,50
1663347600,1.0007,1.00111,1.00028,1.0006,1796,3340,-825341,-823129.2,19.975446523899784,55.8698979159013,52.01796563116953,NaN,NaN,50
1663349400,1.0006,1.00098,0.99932,0.99936,1540,3189.9,-826881,-824754.8,19.45091319686639,50.87657621991066,52.03263757051616,NaN,NaN,50
1663351200,0.99936,1.00042,0.99932,1.0003,1526,3092.75,-825355,-825278,18.96384653604967,54.217037282675676,52.39544347239261,NaN,NaN,50
1663353000,1.0003,1.00079,1.00004,1.00028,1723,3043.4,-827078,-825640,18.747483906188613,54.132691333382056,53.10645496892236,NaN,NaN,50
1663354800,1.00028,1.0013,1.00024,1.00068,2176,3027.35,-824902,-825911.4,18.865625636510597,55.619765802736104,54.16860829333219,NaN,NaN,50
1663356600,1.00068,1.00144,1.00044,1.00129,2602,3057.55,-822300,-825303.2,19.06325542585197,57.863357941310895,55.498412098629295,NaN,NaN,50
1663358400,1.00129,1.00133,1.00084,1.00113,604,2994.55,-822904,-824507.8,19.246768801668956,57.04870072517789,56.295355318763676,NaN,NaN,50
1663360200,1.00113,1.00174,1.00092,1.0017,941,2934.8,-821963,-823829.4,19.696521653164616,59.249804548423015,57.086016699271504,NaN,NaN,50
1663534800,1.0017,1.00174,1.0012,1.00131,98,2831.5,-822061,-822826,20.114149300982014,57.09390555661422,57.08953672049996,NaN,NaN,50
1663536600,1.00131,1.00158,1.00128,1.00158,69,2706.95,-821992,-822244,20.50194640252674,58.22713942183167,56.531709105570634,NaN,NaN,50
1663538400,1.00158,1.00165,1.00054,1.00122,970,2591.45,-822962,-822376.4,19.955256322653668,56.099571073628034,56.15528705637614,NaN,NaN,50
1663540200,1.00122,1.00232,1.00104,1.00206,881,2479.85,-822081,-822211.8,20.00631317269467,59.79137600675682,56.24433675404277,NaN,NaN,50
1663542000,1.00206,1.00232,1.00168,1.00195,1185,2340.7,-823266,-822472.4,20.0537231048756,59.090588453527104,56.53314095569306,NaN,NaN,50
1663543800,1.00195,1.00288,1.00186,1.00222,1090,2176.2,-822176,-822495.4,20.55126169396538,60.319939511770976,56.82145369954616,NaN,NaN,50
1663545600,1.00222,1.00294,1.00172,1.00173,1744,1998.15,-823920,-822881,20.82188467165024,56.97379396969312,56.900303417674145,NaN,NaN,50
1663547400,1.00173,1.00188,1.00102,1.00112,1276,1698.75,-825196,-823327.8,20.167310504084853,53.029917365996354,57.054113499537415,NaN,NaN,50
1663549200,1.00112,1.0013,1.00062,1.00083,1269,1486.4,-826465,-824204.6,19.088458340020505,51.21483312662368,56.8396703455337,NaN,NaN,50
1663551000,1.00083,1.0011,1.00066,1.00082,1199,1347.05,-827664,-825084.2,18.086667044817897,51.14981916605578,56.626608047867535,NaN,NaN,50
1663552800,1.00082,1.00082,0.99948,0.99977,1251,1283.15,-828915,-826432,17.69456746419867,44.72921210315379,55.84871135504022,NaN,NaN,50
1663554600,0.99977,1.00034,0.99963,1.00031,762,1235.1,-828153,-827278.6,17.33047499648082,48.32196327632364,55.167183164684,NaN,NaN,50
1663556400,1.00031,1.00034,0.99974,0.9998,832,1186.9,-828985,-828036.4,16.992389133599957,45.32533025361688,54.32979955957249,NaN,NaN,50
1663558200,0.9998,0.99986,0.99945,0.9998,537,1136.75,-828985,-828540.4,16.984770596211384,45.32533025361689,53.335194252800626,NaN,NaN,50
1663560000,0.9998,0.99997,0.9996,0.99966,421,1081.5,-829406,-828888.8,16.81364839260399,44.447791304706314,52.43190037766435,NaN,NaN,50
1663561800,0.99966,0.99986,0.99906,0.99923,489,1019.8,-829895,-829084.8,17.228848872902887,41.77267415348216,51.256581429925085,NaN,NaN,50
1663563600,0.99923,0.99938,0.99902,0.9992,1016,961.8,-830911,-829636.4,17.655570553758302,41.584628659529805,50.21979982891808,NaN,NaN,50
1663565400,0.9992,0.99926,0.99764,0.9981,1303,896.85,-832214,-830282.2,19.24111633555856,35.3083258021761,48.471010528590874,NaN,NaN,50
1663567200,0.9981,0.99871,0.9975,0.99799,2037,968.5,-834251,-831335.4,20.81281821756167,34.743609042399726,46.73194057065321,NaN,NaN,50
1663569000,0.99799,0.99837,0.99689,0.9971,1911,1017,-836162,-832686.6,22.68329330599336,30.493991625995733,44.601515721669266,NaN,NaN,50
1663570800,0.9971,0.99779,0.9966,0.99746,2802,1152.2,-833360,-833379.6,24.60093064144577,34.010002374541955,42.96124489344418,NaN,NaN,50
1663572600,0.99746,0.99822,0.99726,0.99796,2047,1251.1,-831313,-833460,25.624913471916273,38.6517568304899,41.93423342662229,NaN,NaN,50
1663574400,0.99796,0.99822,0.997,0.99792,2581,1331.65,-833894,-833796,26.768093518922516,38.418934817255824,41.02024069023887,NaN,NaN,50
1663576200,0.99792,0.99817,0.99722,0.9976,2125,1393.85,-836019,-834149.6,27.829617848285455,36.52352901479592,39.9755056794346,NaN,NaN,50
1663578000,0.9976,0.99866,0.99673,0.99742,2202,1444.7,-838221,-834561.4,28.815319011265334,35.46367076956767,39.31368129846417,NaN,NaN,50
1663579800,0.99742,0.99776,0.99694,0.99712,1838,1482.1,-840059,-835901.2,29.730612948318075,33.708006191284795,38.26982722096138,NaN,NaN,50
1663581600,0.99712,0.99777,0.99672,0.99766,1987,1494.25,-838072,-837253,30.779780178200767,39.51269917114323,37.85463928649899,NaN,NaN,50
1663583400,0.99766,1.00048,0.99741,0.99938,2912,1576.05,-835160,-837506.2,29.410834430510086,53.484075736058855,38.43740682095912,NaN,NaN,50
1663585200,0.99938,1.00021,0.99862,0.99878,2488,1637,-837648,-837832,28.139670521940168,49.213678207020884,38.7778273139816,NaN,NaN,50
1663587000,0.99878,0.9998,0.99807,0.99824,2600,1707.05,-840248,-838237.4,26.29215142330204,45.67871512757128,39.05683024070224,NaN,NaN,50
1663588800,0.99824,0.99951,0.99814,0.99888,3124,1800.7,-837124,-837650.4,24.576597974566635,50.240607396035095,39.6751144361669,NaN,NaN,50
1663590600,0.99888,0.99963,0.99822,0.9983,2284,1876.8,-839408,-837917.6,23.128328055176688,46.43476381488516,40.46986000850326,NaN,NaN,50
1663592400,0.9983,0.99888,0.99759,0.99774,2171,1943.75,-841579,-839201.4,21.950872668319484,43.04431949296572,41.06276789782941,NaN,NaN,50
1663594200,0.99774,0.99901,0.99759,0.99869,3020,2067.9,-838559,-839383.6,20.68393962686896,49.74764156552055,42.43802860779546,NaN,NaN,50
1663596000,0.99869,0.99988,0.99818,0.99948,3096,2201.65,-835463,-838426.6,19.95558876024988,54.53921492784458,43.90440093303136,NaN,NaN,50
1663597800,0.99948,1.00134,0.99918,1.00116,4497,2402.05,-830966,-837195,20.57814783214009,62.68714121533348,45.621214103377326,NaN,NaN,50
1663599600,1.00116,1.00182,1.00074,1.00088,3284,2515.45,-834250,-836163.4,21.49810490494651,60.73338191529411,47.21510318180863,NaN,NaN,50
1663601400,1.00088,1.00096,1.00016,1.00021,2176,2559.1,-836426,-835132.8,21.586839008853026,56.21824107430569,48.62186832891648,NaN,NaN,50
1663603200,1.00021,1.001,1.00009,1.00097,2051,2559.8,-834375,-834296,21.578673897542306,59.86333399612924,50.36470141652802,NaN,NaN,50
1663605000,1.00097,1.0014,1.00075,1.00124,1713,2549.9,-832662,-833735.8,21.906333395419683,61.1023408818472,52.321439608711046,NaN,NaN,50
1663606800,1.00124,1.00133,1.0007,1.00098,1314,2475.5,-833976,-834337.8,22.138661545451956,59.20694748415565,53.728171631069074,NaN,NaN,50
1663608600,1.00098,1.00102,1.0003,1.00069,1381,2442.2,-835357,-834559.2,21.77921225405196,57.08010365666553,53.98503076825527,NaN,NaN,50
1663610400,1.00069,1.00099,1.00044,1.00081,1674,2396.85,-833683,-834010.6,21.445437912037676,57.756330640372155,54.59522022778036,NaN,NaN,50
1663612200,1.00081,1.00128,1.00069,1.0012,1263,2353.75,-832420,-833619.6,21.439377178863367,59.964089258970574,55.61560409430888,NaN,NaN,50
1663614000,1.0012,1.00252,1.0012,1.00226,1663,2326.8,-830757,-833238.6,22.507459114138324,65.27594562739722,56.68955682512046,NaN,NaN,50
1663615800,1.00226,1.00248,1.00197,1.00238,1403,2305.05,-829354,-832314.2,23.49924948260793,65.82868245216042,58.07483672778297,NaN,NaN,50
1663617600,1.00238,1.00278,1.00188,1.00221,883,2249.85,-830237,-831290.2,24.65147539653113,64.26792783687536,59.59080875234795,NaN,NaN,50
1663619400,1.00221,1.00253,1.00212,1.00253,571,2132.8,-829666,-830486.8,25.72139945945981,65.9065403932602,60.745015811472214,NaN,NaN,50
1663621200,1.00253,1.0027,1.00241,1.00268,109,2013.85,-829557,-829914.2,26.854488872851416,66.67793387025517,61.61206716450154,NaN,NaN,50
1663623000,1.00268,1.00277,1.00258,1.00268,571,1912.4,-829557,-829674.2,27.96569094384805,66.67793387025517,61.89712378271023,NaN,NaN,50
1663624800,1.00268,1.0032,1.00256,1.00294,451,1778.75,-829106,-829624.6,29.349650648535036,68.12760996048532,62.42528292879531,NaN,NaN,50
1663626600,1.00294,1.003,1.00266,1.00272,427,1685.9,-829533,-829483.8,30.634756088601527,65.52977390622726,63.09039241678971,NaN,NaN,50
1663628400,1.00272,1.00326,1.00262,1.00294,716,1613.15,-828817,-829314,32.04107467740526,66.88946263981299,63.592258748481406,NaN,NaN,50
1663630200,1.00294,1.00316,1.00229,1.003,1208,1522.55,-827609,-828924.4,32.57551812484941,67.2686661283312,64.03271055180169,NaN,NaN,50
1663632000,1.003,1.00507,1.003,1.00443,2367,1486.1,-825242,-828061.4,34.407908921850385,74.70435650337173,65.13966833888855,NaN,NaN,50
1663633800,1.00443,1.00474,1.00286,1.00348,2556,1389.05,-827798,-827799.8,35.840045954542056,64.26023007229662,65.65253451143363,NaN,NaN,50
1663635600,1.00348,1.00377,1.003,1.00321,2542,1351.95,-830340,-827961.2,37.16988748489861,61.623315300842535,65.92874770146723,NaN,NaN,50
1663637400,1.00321,1.00323,1.00234,1.00242,2147,1350.5,-832487,-828695.2,37.13282239314566,54.56766284170951,65.54328867166286,NaN,NaN,50
1663639200,1.00242,1.00278,1.00202,1.00271,1443,1320.1,-831044,-829382.2,36.54420488890457,56.535037272257256,64.91893807486716,NaN,NaN,50
1663641000,1.00271,1.00337,1.00225,1.00336,1572,1313.05,-829472,-830228.2,36.51222592705255,60.6482917220962,64.54891016557686,NaN,NaN,50
1663642800,1.00336,1.00336,1.00262,1.0032,1516,1323.15,-830988,-830866.2,36.4825311767614,59.16408055868028,64.18434964570578,NaN,NaN,50
1663644600,1.0032,1.00336,1.00284,1.00296,1376,1322.9,-832364,-831271,36.45495748006247,56.91412905174739,63.54203454988344,NaN,NaN,50
1663646400,1.00296,1.00298,1.00232,1.00254,1469,1312.65,-833833,-831540.2,35.453959704860125,53.10788381340972,62.57274526010876,NaN,NaN,50
1663648200,1.00254,1.00254,1.00197,1.00224,1156,1307.3,-834989,-832329.2,33.93151055696724,50.509482432219684,61.41785587167765,NaN,NaN,50
1663650000,1.00224,1.00261,1.00212,1.00254,1429,1295.6,-833560,-833146.8,32.606075783818724,52.98663774616006,60.3363578563687,NaN,NaN,50
1663651800,1.00254,1.003,1.00168,1.0017,1834,1317.15,-835394,-834028,30.643691046490503,46.03812881782123,58.944097492911126,NaN,NaN,50
1663653600,1.0017,1.00368,1.0013,1.00362,3570,1451.5,-831824,-833920,29.693810456670498,59.20628894477462,58.39529937183695,NaN,NaN,50
1663655400,1.00362,1.00371,1.00247,1.00278,3071,1576.5,-834895,-834132.4,28.847669200013055,53.10103383979695,57.38332563694165,NaN,NaN,50
1663657200,1.00278,1.0039,1.00256,1.0035,4154,1778.75,-830741,-833282.8,28.295585076513476,57.17717472032745,56.13138408100991,NaN,NaN,50
1663659000,1.0035,1.00422,1.00208,1.00356,4599,1980.15,-826142,-831799.2,26.93744699292583,57.50860360656405,55.649125047743304,NaN,NaN,50
1663660800,1.00356,1.00357,1.00002,1.00058,4392,2177.2,-830534,-830827.2,26.779117895241395,40.671841545900136,54.15259120810456,NaN,NaN,50
1663662600,1.00058,1.00113,1.0001,1.001,3823,2347,-826711,-829804.6,26.632098018820134,43.19603208793365,53.340331868549136,NaN,NaN,50
1663664400,1.001,1.00131,1.00054,1.0013,3507,2486.55,-823204,-827466.4,26.22326752734147,44.99619033864851,52.51612851614852,NaN,NaN,50
1663666200,1.0013,1.00188,1.00012,1.00076,3557,2604,-826761,-826670.4,25.02835825767763,42.39199783343974,51.212107524101626,NaN,NaN,50
1663668000,1.00076,1.00103,1.00002,1.00078,2415,2606.4,-824346,-826311.2,24.0320807710309,42.52467606867747,50.02357863195857,NaN,NaN,50
1663669800,1.00078,1.00099,1.00022,1.00064,2258,2591.5,-826604,-825525.2,23.10696596200179,41.798962739013454,48.94392389533471,NaN,NaN,50
1663671600,1.00064,1.00137,0.99975,1.00074,3079,2618.35,-823525,-824888,22.801699251908687,42.55309474220764,48.19001039024886,NaN,NaN,50
1663673400,1.00074,1.00081,0.99856,0.99872,3267,2674.35,-826792,-825605.6,23.63180210266373,33.19604321980022,46.95333616079033,NaN,NaN,50
1663675200,0.99872,0.99888,0.99624,0.99654,3968,2800.6,-830760,-826405.4,25.74870080422384,26.439173407031888,45.057088707995455,NaN,NaN,50
1663677000,0.99654,0.99732,0.99552,0.99712,4947,2969.35,-825813,-826698.8,28.006898094869754,30.492812936380716,43.94670900217828,NaN,NaN,50
1663678800,0.99712,0.99765,0.9962,0.99646,3822,3084.65,-829635,-827305,29.63777641679331,28.56388323610865,41.75796573727356,NaN,NaN,50
1663680600,0.99646,0.99849,0.99592,0.99823,3746,3203.15,-825889,-827777.8,30.052614609901678,39.599002595210074,40.79353493408878,NaN,NaN,50
1663682400,0.99823,0.99912,0.99774,0.99825,3601,3309.75,-822288,-826877,29.70108550176562,39.712328480315264,39.546045916945054,NaN,NaN,50
1663684200,0.99825,0.99972,0.9975,0.99944,4019,3452.9,-818269,-824378.8,28.727153611218643,46.182425317455504,38.73703318200872,NaN,NaN,50
1663686000,0.99944,0.99996,0.99861,0.99864,2534,3508.15,-820803,-823376.8,27.57189670283199,42.85284397804343,38.89281907001896,NaN,NaN,50
1663687800,0.99864,0.99971,0.99826,0.99936,1962,3514.55,-818841,-821218,26.782557514165124,46.58534963873706,39.134913180790626,NaN,NaN,50
1663689600,0.99936,0.9996,0.99822,0.9984,1615,3416.8,-820456,-820131.4,26.0827121513842,42.59099131872376,38.96311325079599,NaN,NaN,50
1663691400,0.9984,0.99841,0.99728,0.998,1331,3329.8,-821787,-820031.2,26.163516048808116,41.013041873481086,38.864616396513235,NaN,NaN,50
1663693200,0.998,0.99834,0.99652,0.99665,1734,3208.8,-823521,-821081.6,26.74229806095726,36.14571397242526,38.40897624678093,NaN,NaN,50
1663695000,0.99665,0.99682,0.99602,0.99657,1803,3069,-825324,-821985.8,27.581358229668346,35.87401405956314,37.985765626820196,NaN,NaN,50
1663696800,0.99657,0.99716,0.99616,0.9966,2233,2961.05,-823091,-822835.8,27.916040986395913,36.06808760430482,37.522550831255714,NaN,NaN,50
1663698600,0.9966,0.99716,0.99604,0.9969,1998,2869.8,-821093,-822963.2,28.30805144925818,38.08601584322217,37.871834590071565,NaN,NaN,50
1663700400,0.9969,0.99728,0.99628,0.99662,1904,2789.65,-822997,-823205.2,28.502819880286978,36.914870407057805,38.62009866150199,NaN,NaN,50
1663702200,0.99662,0.99787,0.99648,0.99758,2084,2716,-820913,-822683.6,27.879140955875638,43.34715027281251,39.53826561410426,NaN,NaN,50
1663704000,0.99758,0.99787,0.99722,0.99756,716,2631.05,-821629,-821944.6,27.300010526065105,43.248215361324746,40.58714648019113,NaN,NaN,50
1663705800,0.99756,0.99764,0.99698,0.997,675,2551.9,-822304,-821787.2,26.985579509250258,40.46341380306974,40.648890137895386,NaN,NaN,50
1663707600,0.997,0.99768,0.997,0.99703,819,2438.9,-821485,-821865.6,26.63262973400898,40.68376608004089,40.7182785378758,NaN,NaN,50
1663709400,0.99703,0.9972,0.99687,0.99696,6593,2605.2,-828078,-822881.8,26.437054579985247,40.30888299433184,40.298739800509814,NaN,NaN,50
1663711200,0.99696,0.99714,0.99653,0.99686,679,2440.75,-828757,-824450.6,26.59608990459671,39.74544170576524,40.076782495347096,NaN,NaN,50
1663713000,0.99686,0.9971,0.99656,0.9971,415,2214.15,-828342,-825793.2,26.743765563164494,41.84641402411707,39.738287094302805,NaN,NaN,50
1663714800,0.9971,0.99742,0.99706,0.99722,833,2064.7,-827509,-826834.2,26.29253235062662,42.91813871609044,39.76165476554328,NaN,NaN,50
1663716600,0.99722,0.99748,0.99676,0.99712,814,1918.1,-828323,-828201.8,26.218603478471795,42.21986291339063,39.84785626839397,NaN,NaN,50
1663718400,0.99712,0.99752,0.9965,0.9965,1711,1823.6,-830034,-828593,26.436247963896044,38.08280658992551,39.98622002678684,NaN,NaN,50
1663720200,0.9965,0.99694,0.99574,0.99626,2090,1727.15,-832124,-829266.4,27.368063837138706,36.588223138212086,40.03723496097605,NaN,NaN,50
1663722000,0.99626,0.99658,0.99594,0.99616,1806,1690.75,-833930,-830384,28.23332143372118,35.95504702153035,40.029160633635016,NaN,NaN,50
1663723800,0.99616,0.9969,0.99606,0.99661,1746,1679.95,-832184,-831319,28.380404045097173,40.91057746871142,40.23091503545567,NaN,NaN,50
1663725600,0.99661,0.9971,0.99635,0.99684,1246,1661.5,-830938,-831842,28.121820686977394,43.32437885216198,40.68873706724883,NaN,NaN,50
1663727400,0.99684,0.99686,0.99618,0.99642,1171,1653.5,-832109,-832257,28.08277633959115,40.10277353322399,40.45699587156394,NaN,NaN,50
1663729200,0.99642,0.9967,0.99594,0.99599,1168,1625.2,-833277,-832487.6,28.324943902604783,37.06401429613534,40.01526722405041,NaN,NaN,50
1663731000,0.99599,0.99676,0.99596,0.99662,947,1582.4,-832330,-832167.6,28.415681994385427,43.784971011725176,40.25252131038294,NaN,NaN,50
1663732800,0.99662,0.99668,0.99628,0.99648,856,1513.55,-833186,-832368,28.499938793896025,42.693858254809356,40.396099322866405,NaN,NaN,50
1663734600,0.99648,0.99668,0.99574,0.99601,1334,1480.35,-834520,-833084.4,29.230640659131662,39.16527586436189,40.31441309929711,NaN,NaN,50
1663736400,0.99601,0.99656,0.996,0.99624,1178,1444.05,-833342,-833331,29.90914953399333,41.70440763566002,40.45433923714675,NaN,NaN,50
1663738200,0.99624,0.99686,0.99496,0.99502,2056,1442.65,-835398,-833755.2,31.52250713903144,33.67538108902893,39.8706940274976,NaN,NaN,50
1663740000,0.99502,0.99553,0.99242,0.99347,6742,1743.95,-842140,-835717.2,34.280994725659674,26.654290013989012,38.70899054877606,NaN,NaN,50
1663741800,0.99347,0.99352,0.98846,0.98978,6922,2056.3,-849062,-838892.4,37.66165216314232,17.369685715017297,36.93397789174939,NaN,NaN,50
1663743600,0.98978,0.99188,0.98958,0.99148,6444,2337.55,-842618,-840512,40.80083406937621,29.545840429081878,36.32419459454628,NaN,NaN,50
1663745400,0.99148,0.99162,0.99004,0.99104,4119,2213.85,-846737,-843191,43.715788696593386,28.380174112519768,35.7379053784254,NaN,NaN,50
1663747200,0.99104,0.99124,0.99014,0.99027,2977,2328.75,-849714,-846054.2,46.422532279009346,26.41605175996692,35.056548574028014,NaN,NaN,50
1663749000,0.99027,0.99116,0.98984,0.9902,3282,2472.1,-852996,-848225.4,48.985412513549775,26.238272652507177,34.00852680144199,NaN,NaN,50
1663750800,0.9902,0.99222,0.98996,0.99216,2754,2568.15,-850242,-848461.4,49.73290160052976,38.68183383103294,33.676916442789924,NaN,NaN,50
1663752600,0.99216,0.99379,0.99149,0.99308,2971,2676,-847271,-849392,48.52917988092294,43.499966492799196,33.919573082759584,NaN,NaN,50
1663754400,0.99308,0.99349,0.99219,0.99316,2323,2706.6,-844948,-849034.2,47.41143828414518,43.91267287273654,34.40876298108823,NaN,NaN,50
1663756200,0.99316,0.99316,0.99184,0.99216,2745,2739.35,-847693,-848630,46.57154924463379,39.981301251451136,34.137072283925804,NaN,NaN,50
1663758000,0.99216,0.99252,0.99094,0.9917,2492,2773.65,-850185,-848067.8,46.26339420167726,38.28341941543139,33.82204093825595,NaN,NaN,50
1663759800,0.9917,0.99187,0.98994,0.98996,2831,2827.9,-853016,-848622.6,46.42838586833702,32.63740194656211,33.35576422984168,NaN,NaN,50
1663761600,0.98996,0.99099,0.98956,0.99036,2720,2901.6,-850296,-849227.6,46.73897276510832,35.01025980507403,32.877610813371255,NaN,NaN,50
1663763400,0.99036,0.99204,0.99036,0.99133,2948,2990.45,-847348,-849707.6,45.809583631144676,40.48514135297349,33.36402226079587,NaN,NaN,50
1663765200,0.99133,0.99166,0.9908,0.99124,2589,3061.5,-849937,-850156.4,44.94657943532129,40.147200533835246,34.32780158364203,NaN,NaN,50
1663767000,0.99124,0.99138,0.98993,0.99028,3482,3188.25,-853419,-850803.2,44.609170734312826,36.63444434059643,35.70385577118339,NaN,NaN,50
1663768800,0.99028,0.99132,0.98982,0.99004,4450,3367.95,-857869,-851773.8,44.35209368131128,35.791313321368165,36.14996097777527,NaN,NaN,50
1663770600,0.99004,0.99012,0.9878,0.98788,4245,3513.5,-862114,-854137.4,44.98401969414595,29.263608229914226,36.21306341473202,NaN,NaN,50
1663772400,0.98788,0.98792,0.98666,0.98756,3537,3631.45,-865651,-857798,45.94378057136056,28.436171257365743,36.35735766454622,NaN,NaN,50
1663774200,0.98756,0.98858,0.98752,0.9879,2611,3659.2,-863040,-860418.6,46.099031399851086,30.678946858185185,36.6745486792375,NaN,NaN,50
1663776000,0.9879,0.9884,0.98735,0.9879,1798,3412,-863040,-862342.8,46.30886589191782,30.678946858185185,36.10291389546267,NaN,NaN,50
1663777800,0.9879,0.98791,0.98662,0.98698,1631,3147.45,-864671,-863703.2,46.7794351953846,27.93187153308486,34.99090711262593,NaN,NaN,50
1663779600,0.98698,0.98739,0.9867,0.98699,1364,2893.45,-863307,-863941.8,47.2163924057466,28.007331263589492,33.85481128340114,NaN,NaN,50
1663781400,0.98699,0.98884,0.98676,0.98745,2031,2789.05,-861276,-863066.8,45.99965189137522,31.55743309075956,33.25310641478032,NaN,NaN,50
1663783200,0.98745,0.98758,0.98131,0.98452,12752,3277.8,-874028,-865264.4,46.74256394745449,23.58099312570245,32.202933108371106,NaN,NaN,50
1663785000,0.98452,0.99104,0.9839,0.99054,15925,3909.95,-858103,-864277,45.150148204610836,50.99050140150267,33.513868783724,NaN,NaN,50
1663786800,0.99054,0.991,0.98584,0.98658,11404,4342.45,-869507,-865244.2,43.67147644339887,40.65944601008068,33.91738208408162,NaN,NaN,50
1663788600,0.98658,0.98699,0.98447,0.9851,5920,4489.9,-875427,-867668.2,42.76127337118397,37.59379450720824,33.7108573093841,NaN,NaN,50
1663790400,0.9851,0.9851,0.98374,0.98473,2133,4480.4,-877560,-870925,42.147513767244675,36.84584118681564,33.47504592745413,NaN,NaN,50
1663792200,0.98473,0.98484,0.98382,0.98382,1162,4401.25,-878722,-871863.8,41.577594135015325,35.00138673830182,33.35839895586166,NaN,NaN,50
1663794000,0.98382,0.98422,0.98368,0.98402,253,4289.3,-878469,-875937,41.09693641825038,35.76248629390355,33.35633988247133,NaN,NaN,50
1663795800,0.98402,0.98414,0.98386,0.98405,349,4165.2,-878120,-877659.6,40.650611395540075,35.883764101608435,33.829208159020915,NaN,NaN,50
1663797600,0.98405,0.98482,0.98381,0.98462,1360,4097.2,-876760,-877926.2,39.70671182016331,38.26848646206908,34.5315163879283,NaN,NaN,50
1663799400,0.98462,0.9847,0.98372,0.98387,1255,4012.55,-878015,-878017.2,38.87052698190314,36.35257231634667,34.93677534922555,NaN,NaN,50
1663801200,0.98387,0.98412,0.98298,0.98302,1491,3957.65,-879506,-878174,38.425282204682254,34.2591643655757,35.19250517118201,NaN,NaN,50
1663803000,0.98302,0.98366,0.9829,0.98314,1093,3838.2,-878413,-878162.8,38.04764982380665,34.82974254976864,35.68521024380228,NaN,NaN,50
1663804800,0.98314,0.9833,0.98139,0.98188,2507,3741.05,-880920,-878722.8,38.32453222539919,31.716981563219136,35.950185265204404,NaN,NaN,50
1663806600,0.98188,0.98218,0.98073,0.98156,2949,3676.25,-883869,-880144.6,38.82326706199305,30.960212176788502,35.907526628492185,NaN,NaN,50
1663808400,0.98156,0.98204,0.98089,0.9819,2618,3630.3,-881251,-880791.8,39.28637798168735,32.795004374884144,36.565670289148024,NaN,NaN,50
1663810200,0.9819,0.98218,0.98144,0.9821,2442,3621.85,-878809,-880652.4,39.5697825050069,33.90769416384114,35.345469772172194,NaN,NaN,50
1663812000,0.9821,0.98234,0.98117,0.9815,1990,3631.45,-880799,-881129.6,39.94848165388301,32.1860395749962,34.74022645538045,NaN,NaN,50
1663813800,0.9815,0.98384,0.98102,0.98226,4224,3761.1,-876575,-880260.6,38.79249031646811,36.578721765135,34.667721259518075,NaN,NaN,50
1663815600,0.98226,0.9826,0.98159,0.98181,2474,3816.6,-879049,-879296.6,37.719069788868566,35.12779603598537,34.545003748744485,NaN,NaN,50
1663817400,0.98181,0.98284,0.98178,0.98194,1860,3808.05,-877189,-878484.2,36.48961215403471,35.91859160479771,34.610518382065614,NaN,NaN,50
1663819200,0.98194,0.98291,0.98184,0.98266,2022,3271.55,-875167,-877755.8,35.27738587524105,40.261994534884316,34.93191182784995,NaN,NaN,50
1663821000,0.98266,0.98292,0.98232,0.98288,1819,2566.25,-873348,-876265.6,34.14099026737298,41.565292784316455,35.33773530518624,NaN,NaN,50
1663822800,0.98288,0.9836,0.98256,0.98315,2083,2100.2,-871265,-875203.6,32.36548340814191,43.203029303611764,35.69020265101072,NaN,NaN,50
1663824600,0.98315,0.98396,0.98243,0.98247,2350,1921.7,-873615,-874116.8,30.358107324756784,40.15093037757555,35.961513941098495,NaN,NaN,50
1663826400,0.98247,0.98341,0.98182,0.9821,4116,2020.85,-877731,-874225.2,29.02315775998398,38.554898838852516,36.268352117761125,NaN,NaN,50
1663828200,0.9821,0.98294,0.9813,0.98206,4510,2188.25,-882241,-875640,28.20195148951034,38.37729059620061,36.52174840679198,NaN,NaN,50
1663830000,0.98206,0.9839,0.9816,0.98386,6024,2476.8,-876217,-876213.8,26.461559163999638,49.623554434503376,37.80078932616942,NaN,NaN,50
1663831800,0.98386,0.98534,0.98294,0.98454,6101,2764.4,-870116,-875984,25.471997674502827,53.10541418680665,39.38258946974215,NaN,NaN,50
1663833600,0.98454,0.9884,0.98408,0.98692,10074,3200.1,-860042,-873269.4,26.213628426228254,62.797346942547776,41.525613938860985,NaN,NaN,50
1663835400,0.98692,0.99076,0.98676,0.98794,9451,3609.9,-850591,-867841.4,27.73139825461447,66.03702130203648,43.82056587730351,NaN,NaN,50
1663837200,0.98794,0.9887,0.98634,0.98754,5878,3829.25,-856469,-862687,28.7876978844477,63.69455029037036,46.07117378554451,NaN,NaN,50
1663839000,0.98754,0.98813,0.98558,0.98558,3448,3947,-859917,-859427,29.144369380674135,53.65181663913422,47.29068056225874,NaN,NaN,50
1663840800,0.98558,0.98706,0.98554,0.98703,2754,3959.35,-857163,-856836.4,29.44247004550383,58.82417485079341,48.98327904903075,NaN,NaN,50
1663842600,0.98703,0.98864,0.9869,0.98768,3515,3987.65,-853648,-855557.6,30.330874074591733,60.92911229769615,50.76974481280921,NaN,NaN,50
1663844400,0.98768,0.98863,0.98588,0.98598,5958,4154.65,-859606,-857360.6,30.325266149017516,53.260413733972285,51.69820332702977,NaN,NaN,50
1663846200,0.98598,0.98716,0.98569,0.98665,5696,4317.35,-853910,-856848.8,30.16957546370423,55.63064382818434,52.702871258734625,NaN,NaN,50
1663848000,0.98665,0.98872,0.9866,0.98779,6217,4528.7,-847693,-854404,30.667189268656514,59.403012934126586,53.860012946628544,NaN,NaN,50
1663849800,0.98779,0.98879,0.98681,0.98768,5739,4604.45,-853432,-853657.8,31.156245751149758,58.88278708467674,55.19800271142149,NaN,NaN,50
1663851600,0.98768,0.98774,0.98562,0.98601,5584,4759.95,-859016,-854731.4,30.636743700845354,51.507745618259605,56.1232060528077,NaN,NaN,50
1663853400,0.98601,0.98682,0.98344,0.98382,6019,4967.9,-865035,-855817.2,28.706968707873003,43.7662060776634,56.5081285871979,NaN,NaN,50
1663855200,0.98382,0.98556,0.98328,0.98479,6152,5174.4,-858883,-856811.8,26.82056722341789,47.527997691608924,56.358445962705446,NaN,NaN,50
1663857000,0.98479,0.98498,0.98122,0.98152,6016,5384.25,-864899,-860253,25.839394292948736,38.24079432850906,55.29668740139847,NaN,NaN,50
1663858800,0.98152,0.98228,0.98122,0.98204,4162,5488.2,-860737,-861714,24.928305143227377,40.240573908999295,53.685489327573585,NaN,NaN,50
1663860600,0.98204,0.98411,0.982,0.98399,3494,5545.4,-857243,-861359.4,23.296587515338178,47.15139861854568,52.33651627875282,NaN,NaN,50
1663862400,0.98399,0.98487,0.98372,0.98438,3970,5538.1,-853273,-859007,22.177250239787693,48.43575861764797,51.24660258784407,NaN,NaN,50
1663864200,0.98438,0.985,0.98365,0.98397,2551,5440.15,-855824,-858395.2,21.20594502569421,47.13877207126179,50.781385118710325,NaN,NaN,50
1663866000,0.98397,0.98522,0.98375,0.98473,2817,5279.8,-853007,-856016.8,20.424545838340734,49.82105924755589,50.13830543276479,NaN,NaN,50
1663867800,0.98473,0.98494,0.9841,0.98439,2067,5078.1,-855074,-854884.2,19.69896087865536,48.63216924268072,49.25995235740653,NaN,NaN,50
1663869600,0.98439,0.98439,0.983,0.98354,2029,4675.85,-857103,-854856.2,18.320066385617736,45.69631436232285,48.719659545145866,NaN,NaN,50
1663871400,0.98354,0.98388,0.98302,0.98306,1866,4296.6,-858969,-855995.4,17.039664356368515,44.07808291959108,47.8944766231035,NaN,NaN,50
1663873200,0.98306,0.98414,0.98302,0.98387,2607,4133.05,-856362,-856103,15.979518864425476,47.45937846851431,47.041359875559756,NaN,NaN,50
1663875000,0.98387,0.98441,0.98387,0.98395,2020,4061.65,-854342,-856370,15.191149675381569,47.79511751722225,46.24938347788443,NaN,NaN,50
1663876800,0.98395,0.984,0.98328,0.98364,625,3955.2,-854967,-856348.6,14.217419159626097,46.5537017426463,45.895523201054914,NaN,NaN,50
1663878600,0.98364,0.98378,0.98322,0.98346,619,3810.4,-855586,-856045.2,13.360626079177814,45.809678564754066,46.04148552156139,NaN,NaN,50
1663880400,0.98346,0.98416,0.9832,0.98376,1655,3595.25,-853931,-855037.6,12.568416980480185,47.32081854623443,46.02668701117749,NaN,NaN,50
1663882200,0.98376,0.98383,0.98354,0.98369,336,3327.25,-854267,-854618.6,11.832794245975242,46.99153948800138,46.65174023685552,NaN,NaN,50
1663884000,0.98369,0.98394,0.98348,0.98354,721,3052.45,-854988,-854747.8,11.251204031800059,46.248877894295894,47.08090480723384,NaN,NaN,50
1663885800,0.98354,0.98365,0.98322,0.98326,680,2799.5,-855668,-854888,10.448244159730734,44.824776598884604,46.9147175201152,NaN,NaN,50
1663887600,0.98326,0.984,0.98324,0.98386,633,2551.95,-855035,-854777.8,10.052630125251858,48.485343842247346,46.9182593218723,NaN,NaN,50
1663889400,0.98386,0.98398,0.98367,0.98386,645,2283.25,-855035,-854998.6,9.6852742360929,48.48534384224734,47.014443019799835,NaN,NaN,50
1663891200,0.98386,0.9841,0.98326,0.98347,1350,2043.15,-856385,-855422.2,9.112186458192472,46.175925448712015,46.75407631988242,NaN,NaN,50
1663893000,0.98347,0.98486,0.98347,0.98434,1476,1816.15,-854909,-855406.4,9.149714680678027,51.70250100366762,46.973385731381484,NaN,NaN,50
1663894800,0.98434,0.98521,0.98416,0.98454,1640,1690.05,-853269,-854926.6,9.52177236880474,52.89978682526839,47.48791947873474,NaN,NaN,50
1663896600,0.98454,0.98457,0.98322,0.98374,1598,1595.25,-854867,-854893,8.888321266923114,47.79582057197316,47.753472168190605,NaN,NaN,50
1663898400,0.98374,0.98374,0.9827,0.98297,1259,1459.7,-856126,-855111.2,8.81481568348694,43.450388569249526,47.46711574681455,NaN,NaN,50
1663900200,0.98297,0.98318,0.98254,0.9828,1158,1390.05,-857284,-855291,8.901028741209437,42.53101572733504,47.09110847610832,NaN,NaN,50
1663902000,0.9828,0.98328,0.9827,0.98296,911,1294.75,-856373,-855583.8,8.858868907491392,43.737639016776335,46.88996113854618,NaN,NaN,50
1663903800,0.98296,0.983,0.98207,0.98236,881,1235.45,-857254,-856380.8,9.44478587170635,40.31892278705271,46.49776429728179,NaN,NaN,50
1663905600,0.98236,0.98253,0.98185,0.98253,1137,1190.85,-856117,-856630.8,10.194116433098678,41.70916461714521,46.096931873775425,NaN,NaN,50
1663907400,0.98253,0.98288,0.9823,0.9823,949,1145,-857066,-856818.8,10.409867279851774,40.3400075531295,45.621822449856005,NaN,NaN,50
1663909200,0.9823,0.98324,0.98228,0.98284,1556,1092.45,-855510,-856464,10.137586893283084,44.91223221394226,45.526347758402174,NaN,NaN,50
1663911000,0.98284,0.98332,0.98224,0.98295,1523,1067.6,-853987,-855986.8,9.779728634751528,45.82307274117349,45.59765462570853,NaN,NaN,50
1663912800,0.98295,0.98382,0.98221,0.98229,2434,1158.05,-856421,-855820.2,9.352853017666027,41.400005847922415,45.09155905468531,NaN,NaN,50
1663914600,0.98229,0.98274,0.98084,0.98125,2724,1263.3,-859145,-856425.8,9.899250229375085,35.573133444221085,44.16925831196915,NaN,NaN,50
1663916400,0.98125,0.9814,0.97698,0.97846,6515,1506.3,-865660,-858144.6,12.648594842845554,25.289764154549488,42.6773896481004,NaN,NaN,50
1663918200,0.97846,0.97885,0.97672,0.97756,4450,1712,-870110,-861064.6,15.299985127503904,22.98184210315955,40.625914012349824,NaN,NaN,50
1663920000,0.97756,0.97806,0.97548,0.9762,3666,1859.25,-873776,-865022.4,18.19468789744166,20.010126325036154,38.27665254804752,NaN,NaN,50
1663921800,0.9762,0.97644,0.9751,0.97532,3474,1998.95,-877250,-869188.2,21.003399175255947,18.35613885551372,36.173818139728986,NaN,NaN,50
1663923600,0.97532,0.97693,0.97504,0.97531,3746,2154.6,-880996,-873558.4,23.043638285160803,18.337589593123425,34.38004678429141,NaN,NaN,50
1663925400,0.97531,0.97658,0.97364,0.97623,5749,2409.8,-875247,-875475.8,25.42237260039396,25.769495977820185,33.182795373611775,NaN,NaN,50
1663927200,0.97623,0.97696,0.97502,0.97624,5322,2608.4,-869925,-875438.8,27.208994627157573,25.848490120552853,31.904999023881526,NaN,NaN,50
1663929000,0.97624,0.97716,0.97502,0.97502,5672,2818.2,-875597,-875803,28.642573422249136,22.677773633162545,30.6449169414608,NaN,NaN,50
1663930800,0.97502,0.9766,0.97498,0.97572,5684,3020.4,-869913,-874335.6,29.99069309486596,28.12555451033306,29.674659076688503,NaN,NaN,50
1663932600,0.97572,0.97578,0.97391,0.97514,5001,3190.55,-874914,-873119.2,31.67257857037937,26.461943971085105,28.68336882082819,NaN,NaN,50
1663934400,0.97514,0.97688,0.97483,0.97636,4641,3359.65,-870273,-872124.4,31.998425387474448,35.15096075725536,27.986135145350556,NaN,NaN,50
1663936200,0.97636,0.97656,0.97478,0.97557,4203,3511.9,-874476,-873034.6,32.32598537216171,32.4751146768173,27.032709569325114,NaN,NaN,50
1663938000,0.97557,0.97748,0.97557,0.9768,3959,3664.3,-870517,-872018.6,31.673551393193698,40.11839931290949,26.941166245395625,NaN,NaN,50
1663939800,0.9768,0.97686,0.97316,0.97342,7201,3980.3,-877718,-873579.6,32.25646944274914,30.051797268132844,26.546785089960746,NaN,NaN,50
1663941600,0.97342,0.97451,0.97265,0.97435,5890,4217.95,-871828,-872962.4,32.99997638043321,34.8926332288448,27.232704309553267,NaN,NaN,50
1663943400,0.97435,0.97452,0.9703,0.97047,6929,4516.95,-878757,-874659.2,34.46563142794839,26.616489250723433,27.492321962950687,NaN,NaN,50
1663945200,0.97047,0.97263,0.97022,0.97251,4823,4680.3,-873934,-874550.8,35.84947950146887,35.30504923670176,28.58481645664109,NaN,NaN,50
1663947000,0.97251,0.97334,0.97176,0.97176,3311,4769.7,-877245,-875896.4,36.45535941016764,33.72414332152154,29.682531061355935,NaN,NaN,50
1663948800,0.97176,0.9724,0.97071,0.97101,2474,4771.7,-879719,-876296.6,37.37427434176375,32.17268131937607,30.67075189894541,NaN,NaN,50
1663950600,0.97101,0.97224,0.97052,0.97074,3253,4798.15,-882972,-878525.4,38.289680766543526,31.60891772509622,31.087853452322268,NaN,NaN,50
1663952400,0.97074,0.97187,0.97058,0.97086,2621,4603.45,-880351,-878844.2,39.13970101812475,32.177749868841985,31.53994343434292,NaN,NaN,50
1663954200,0.97086,0.9711,0.96811,0.96909,3591,4560.5,-883942,-880845.8,40.660382420520484,28.422616148564245,31.950289328300183,NaN,NaN,50
1663956000,0.96909,0.96942,0.96836,0.96843,3938,4574.1,-887880,-882972.8,42.0724437227451,27.15028689937195,31.880627356088674,NaN,NaN,50
1663957800,0.96843,0.96844,0.96682,0.96728,3801,4590.45,-891681,-885365.2,43.749412325897794,25.046413530918883,31.779518038933947,NaN,NaN,50
1663959600,0.96728,0.96883,0.96728,0.96879,3365,4571.4,-888316,-886434,44.90348448269197,32.448343419253845,31.586473943362403,NaN,NaN,50
1663961400,0.96879,0.96948,0.96836,0.9691,3562,4462.05,-884754,-887314.6,45.316548269333914,33.891714087363994,31.687659615544312,NaN,NaN,50
1663963200,0.9691,0.96964,0.96898,0.96936,1371,4264.5,-883383,-887202.8,45.53806962578813,35.143391581049286,31.332301920411442,NaN,NaN,50
1663965000,0.96936,0.96964,0.96863,0.96914,1335,4047.65,-884718,-886570.4,45.869962175436356,34.54733820201156,31.653411987117067,NaN,NaN,50
1664139600,0.96914,0.96914,0.96656,0.96838,257,3776.3,-884975,-885229.2,46.815368952260286,32.496845254435854,31.482284274659285,NaN,NaN,50
1664141400,0.96838,0.96871,0.96748,0.96755,350,3543.75,-885325,-884631,47.69324667359679,30.376390367784822,31.75084864016367,NaN,NaN,50
1664143200,0.96755,0.97098,0.96688,0.97015,2477,3435.55,-882848,-884249.8,46.400165558785794,42.937276287012835,32.296007715185894,NaN,NaN,50
1664145000,0.97015,0.97016,0.96926,0.96988,1998,3325.3,-884846,-884542.4,45.19944738074701,42.08809942911128,32.8934331514423,NaN,NaN,50
1664146800,0.96988,0.97014,0.96912,0.96952,1978,3226.25,-886824,-884963.6,44.150354165899245,40.925887875377235,33.51866219115667,NaN,NaN,50
1664148600,0.96952,0.9698,0.96814,0.96858,2573,2994.85,-889397,-885848,43.6221496262219,37.97701068168412,33.97352597377009,NaN,NaN,50
1664150400,0.96858,0.96918,0.96774,0.96812,3461,2873.4,-892858,-887354.6,43.303306743358114,36.5876723460447,34.288520436427426,NaN,NaN,50
1664152200,0.96812,0.96854,0.95514,0.95695,5590,2806.45,-898448,-890474.6,45.45436944870865,18.69884128527727,33.59396508904978,NaN,NaN,50
1664154000,0.95695,0.96593,0.95631,0.96395,12004,3165.5,-886444,-890794.2,47.45178481796272,38.87000981144234,34.43108815419767,NaN,NaN,50
1664155800,0.96395,0.96597,0.96322,0.96532,5987,3299.3,-880457,-889520.8,49.28089992466558,41.90781051510762,35.63547365306829,NaN,NaN,50
1664157600,0.96532,0.96628,0.96456,0.96618,3953,3373.25,-876504,-886942.2,50.769536648662516,43.79595444554903,36.446017297803664,NaN,NaN,50
1664159400,0.96618,0.96638,0.96492,0.96593,3113,3366.25,-879617,-884294,52.080606694804274,43.354809935361295,37.12195271551775,NaN,NaN,50
1664161200,0.96593,0.96608,0.96398,0.9644,2686,3369.5,-882303,-881065,53.42157401450105,40.65579407193925,37.515695750581315,NaN,NaN,50
1664163000,0.9644,0.96466,0.96291,0.96342,3832,3381.55,-886135,-881003.2,54.80053596982406,38.98181680851162,37.83244422247418,NaN,NaN,50
1664164800,0.96342,0.96453,0.96287,0.96423,3160,3342.65,-882975,-881506.8,56.086027297773775,41.13905434599405,38.4497448718712,NaN,NaN,50
1664166600,0.96423,0.96425,0.96243,0.96284,2648,3285,-885623,-883330.6,57.3373290846152,38.61603358296872,39.0382908158129,NaN,NaN,50
1664168400,0.96284,0.96347,0.96206,0.96233,2909,3262.2,-888532,-885113.6,58.54857004751953,37.70239276760749,38.664370564426804,NaN,NaN,50
1664170200,0.96233,0.96419,0.96218,0.96292,3977,3282.95,-884555,-885564,59.02631062953543,39.48612361072905,38.47851514882807,NaN,NaN,50
1664172000,0.96292,0.9656,0.96267,0.96478,5926,3510.7,-878629,-884062.8,58.304135006147185,44.84741536181102,38.75862425500191,NaN,NaN,50
1664173800,0.96478,0.96508,0.96302,0.96415,6081,3748,-884710,-884409.8,57.633543355858095,43.44346669161165,39.14908539856817,NaN,NaN,50
1664175600,0.96415,0.97016,0.96412,0.96907,8955,4182.9,-875755,-882436.2,53.903340783877454,55.23051677674098,40.480717143617895,NaN,NaN,50
1664177400,0.96907,0.96958,0.96711,0.96784,6593,4495.05,-882348,-881199.4,50.439581252752575,52.296134897335804,42.88052383019351,NaN,NaN,50
1664179200,0.96784,0.9688,0.96611,0.9675,6236,4683,-888584,-882005.2,47.645685990318164,51.48189839602299,43.78137301480642,NaN,NaN,50
1664181000,0.9675,0.96893,0.96692,0.96852,4659,4816.05,-883925,-883064.4,44.98235102433209,53.805579042949674,44.63121362393799,NaN,NaN,50
1664182800,0.96852,0.96976,0.96813,0.96881,4310,4932.65,-879615,-882045.4,42.065403107508374,54.473188357602105,45.39387318908464,NaN,NaN,50
1664184600,0.96881,0.96899,0.96416,0.96468,4217,5014.85,-883832,-883660.8,40.896163148183945,44.58981377620186,45.48208774914468,NaN,NaN,50
1664186400,0.96468,0.96524,0.96335,0.96514,5619,5122.75,-878213,-882833.8,40.06028731096873,45.77001060353555,45.847388929972986,NaN,NaN,50
1664188200,0.96514,0.96544,0.96402,0.96406,4078,5047.15,-882291,-881575.2,39.170031173483,43.43108647524303,46.16519390616809,NaN,NaN,50
1664190000,0.96406,0.96477,0.9619,0.96286,5068,4700.35,-887359,-882262,38.98295888138469,40.928423809885075,46.15014886787459,NaN,NaN,50
1664191800,0.96286,0.96536,0.96276,0.9638,5023,4652.15,-882336,-882806.2,38.46064236364734,43.66682539879439,46.51091971186214,NaN,NaN,50
1664193600,0.9638,0.96598,0.96294,0.96546,5980,4753.5,-876356,-881311,37.6100113510561,48.230913300344326,47.26295689277191,NaN,NaN,50
1664195400,0.96546,0.96896,0.96478,0.96696,6616,4928.65,-869740,-879616.4,35.30588840220766,52.014208997256176,48.1578201346667,NaN,NaN,50
1664197200,0.96696,0.96822,0.96542,0.96568,5355,5062.1,-875095,-878177.2,33.16634566399125,48.740831370267394,48.43592127812788,NaN,NaN,50
1664199000,0.96568,0.96774,0.9651,0.96743,6311,5186.05,-868784,-874462.2,31.317785285135813,53.087673293221755,49.12479317824289,NaN,NaN,50
1664200800,0.96743,0.96764,0.96478,0.96659,7137,5384.9,-875921,-873179.2,29.7438713136133,50.858264323087994,48.81248943155339,NaN,NaN,50
1664202600,0.96659,0.96708,0.96354,0.96478,6993,5602.15,-882914,-874490.8,28.81666015819861,46.34223266238918,48.38721070048577,NaN,NaN,50
1664204400,0.96478,0.96567,0.96363,0.96426,6652,5789.3,-889566,-878456,27.95567837102783,45.10311809602865,47.931583536200456,NaN,NaN,50
1664206200,0.96426,0.96464,0.96096,0.962,10575,6119.2,-900141,-883465.2,28.17137542274916,40.08638309858538,46.95164096874587,NaN,NaN,50
1664208000,0.962,0.96284,0.9608,0.96161,7315,6188.65,-907456,-891199.6,28.425401370001108,39.27455016650555,45.86602395509612,NaN,NaN,50
1664209800,0.96161,0.96296,0.961,0.96215,5122,6140.7,-902334,-896482.2,28.579176196363125,41.05460551595381,45.613509079364114,NaN,NaN,50
1664211600,0.96215,0.96226,0.96053,0.96106,5173,5951.6,-907507,-901400.8,28.898002020486107,38.59528868937746,45.101028942638536,NaN,NaN,50
1664213400,0.96106,0.96143,0.95998,0.96011,4719,5857.9,-912226,-905932.8,29.39886066715345,36.540761100702234,44.60886284445705,NaN,NaN,50
1664215200,0.96011,0.96122,0.95998,0.96017,4427,5767.45,-907799,-907464.4,29.863943696201694,36.769697722547,44.31181098107576,NaN,NaN,50
1664217000,0.96017,0.96188,0.9601,0.96111,3289,5698.95,-904510,-906875.2,29.749788960131635,40.39752019673309,44.078289180928515,NaN,NaN,50
1664218800,0.96111,0.96228,0.9611,0.96222,3299,5648.4,-901211,-906650.6,29.319366817986264,44.45055472740904,43.80826356857599,NaN,NaN,50
1664220600,0.96222,0.96276,0.96074,0.9609,4691,5672.1,-905902,-906329.6,28.532978824422706,40.889614932521404,43.01364970680923,NaN,NaN,50
1664222400,0.9609,0.96201,0.96065,0.96113,2770,5529.65,-903132,-904510.8,27.85386681578687,41.7650218040242,42.51537759493471,NaN,NaN,50
1664224200,0.96113,0.9612,0.96064,0.9609,1071,5379.3,-904203,-903791.6,27.22931808019745,41.10937236731735,41.65978467165583,NaN,NaN,50
1664226000,0.9609,0.96112,0.9608,0.9611,149,5133.35,-904054,-903700.4,26.649379968578707,41.9625784299454,41.02437853643136,NaN,NaN,50
1664227800,0.9611,0.96116,0.96094,0.96099,462,4905.3,-904516,-904361.4,26.069745444903226,41.605547073677705,40.686043851523394,NaN,NaN,50
1664229600,0.96099,0.9614,0.95842,0.95862,1516,4682.1,-906032,-904387.4,26.968452369636527,34.74608029796349,39.94625543737589,NaN,NaN,50
1664231400,0.95862,0.96094,0.95862,0.96074,1208,4411.7,-904824,-904725.8,27.802965942603166,43.689448284138685,40.20361723634398,NaN,NaN,50
1664233200,0.96074,0.96149,0.96072,0.96131,933,4190.6,-903891,-904663.4,27.995245778671464,45.83879506966694,40.67249187228408,NaN,NaN,50
1664235000,0.96131,0.96244,0.96096,0.96202,1728,3961.45,-902163,-904285.2,27.25439332113005,48.47686998631662,41.20265362016714,NaN,NaN,50
1664236800,0.96202,0.96362,0.96186,0.9635,2756,3742.4,-899407,-903263.4,25.587143439519117,53.555231982448774,42.27122099824366,NaN,NaN,50
1664238600,0.9635,0.96386,0.9629,0.96344,2645,3525,-902052,-902467.4,23.854199120389648,53.325758410527314,43.470149377516876,NaN,NaN,50
1664240400,0.96344,0.96414,0.96286,0.96326,2856,3335.2,-904908,-902484.2,22.27513694669156,52.597638420862474,44.60071657025369,NaN,NaN,50
1664242200,0.96326,0.9639,0.96243,0.9629,2624,2937.65,-907532,-903212.4,20.906391971614628,51.094984851798074,45.36482118847262,NaN,NaN,50
1664244000,0.9629,0.96328,0.96235,0.96292,2136,2678.7,-905396,-903859,19.701017680579366,51.17843296378516,45.845383919642344,NaN,NaN,50
1664245800,0.96292,0.96346,0.96276,0.96329,1660,2505.6,-903736,-904724.8,18.414891637209543,52.783572005067334,46.694952281967055,NaN,NaN,50
1664247600,0.96329,0.96381,0.96306,0.96376,1375,2315.7,-902361,-904786.6,17.304656547817995,54.81578176599979,47.62714942210817,NaN,NaN,50
1664249400,0.96376,0.9645,0.96358,0.96412,1688,2164.15,-900673,-903939.6,16.87760413231337,56.36495559843827,48.7168339386168,NaN,NaN,50
1664251200,0.96412,0.96459,0.9639,0.96407,1560,2020.8,-902233,-902879.8,16.55756251986415,56.07737917693376,49.72503399197311,NaN,NaN,50
1664253000,0.96407,0.96415,0.96356,0.96366,1325,1922.6,-903558,-902512.2,15.884330325753137,53.659741485411566,50.58604787852553,NaN,NaN,50
1664254800,0.96366,0.96432,0.96352,0.96429,1541,1834.7,-902017,-902168.4,15.422375989836153,56.74559448026434,52.15744174868987,NaN,NaN,50
1664256600,0.96429,0.96558,0.96398,0.96516,2701,1735.2,-899316,-901559.4,16.055402827131573,60.643216867492086,53.36842521892941,NaN,NaN,50
1664258400,0.96516,0.9671,0.96463,0.96598,4108,1802.1,-895208,-900466.4,17.593747563714018,63.94128026561478,54.661459875782825,NaN,NaN,50
1664260200,0.96598,0.9661,0.96438,0.96446,4469,1972,-899677,-899955.2,18.725491431300956,54.77783683644958,55.1115289365066,NaN,NaN,50
1664262000,0.96446,0.9656,0.96392,0.9654,6023,2265.7,-893654,-897974.4,19.23837445902307,58.71794076218056,55.4802938493446,NaN,NaN,50
1664263800,0.9654,0.96676,0.96444,0.96474,4503,2467.75,-898157,-897202.4,20.418096353122532,55.088669786959194,55.606216090518295,NaN,NaN,50
1664265600,0.96474,0.96474,0.96212,0.96368,4169,2600.4,-902326,-897804.4,19.355342619738806,49.7682316047591,55.40411560365378,NaN,NaN,50
1664267400,0.96368,0.96402,0.9621,0.96244,3840,2732,-906166,-899996,18.35295507473016,44.369739195614486,54.92374091392638,NaN,NaN,50
1664269200,0.96244,0.96284,0.96158,0.96184,3740,2872.35,-909906,-902041.8,17.072539848476122,41.99595105840202,54.26784934925615,NaN,NaN,50
1664271000,0.96184,0.96276,0.9608,0.96082,3276,2949.75,-913182,-905947.4,16.459907842793225,38.24954413399756,53.229704501322594,NaN,NaN,50
1664272800,0.96082,0.96322,0.96068,0.96282,3597,2991.8,-909585,-908233,15.51172680494724,48.03788061657153,52.74556870493486,NaN,NaN,50
1664274600,0.96282,0.96476,0.96256,0.96272,4240,3071.55,-913825,-910532.8,15.281741116287922,47.631328613118434,52.12173820598344,NaN,NaN,50
1664276400,0.96272,0.9642,0.96202,0.96368,3859,3121.7,-909966,-911292.8,14.638223396965314,51.84472261176645,51.819405594185774,NaN,NaN,50
1664278200,0.96368,0.96528,0.96331,0.96386,3506,3165.8,-906460,-910603.6,14.733630718334705,52.61454672649724,51.74474882569189,NaN,NaN,50
1664280000,0.96386,0.96478,0.96358,0.96423,4384,3278.2,-902076,-908382.4,14.822223231034856,54.23412987200346,51.5653584965304,NaN,NaN,50
1664281800,0.96423,0.96486,0.96202,0.96226,4865,3438.45,-906941,-907853.6,13.846626071700237,45.34709532212209,50.472778386146835,NaN,NaN,50
1664283600,0.96226,0.96299,0.9617,0.96209,4858,3612.6,-911799,-907448.4,13.163887376115483,44.66689422732081,49.09603652626869,NaN,NaN,50
1664285400,0.96209,0.96438,0.96168,0.96233,7466,3901.5,-904333,-906321.8,12.876958663219554,45.900643628078434,48.461951297099326,NaN,NaN,50
1664287200,0.96233,0.96234,0.95992,0.96058,8144,4230.7,-912477,-907525.2,12.46872834889703,39.061492092814085,47.05791924928743,NaN,NaN,50
1664289000,0.96058,0.9633,0.96039,0.9623,7352,4532.05,-905125,-908135,11.684175481142399,47.362879073447964,46.506077055465205,NaN,NaN,50
1664290800,0.9623,0.96276,0.95936,0.96012,5341,4722.05,-910466,-908840,11.361713973765518,39.937012413476005,45.803847113230695,NaN,NaN,50
1664292600,0.96012,0.96282,0.96008,0.96148,6320,4903,-904146,-907309.4,11.021549670404367,45.660870140473826,45.89607075214922,NaN,NaN,50
1664294400,0.96148,0.9616,0.95868,0.95904,4768,4936,-908914,-908225.6,11.492564412701535,38.560787609964386,45.65070193440368,NaN,NaN,50
1664296200,0.95904,0.95932,0.95692,0.95816,4240,4924.55,-913154,-908361,12.740213498456383,36.36457081206559,45.51606098283711,NaN,NaN,50
1664298000,0.95816,0.95842,0.9571,0.95818,4222,4834.5,-908932,-909122.4,13.8987447923716,36.45315481771856,44.68858056863333,NaN,NaN,50
1664299800,0.95818,0.9587,0.95776,0.9585,2897,4754.2,-906035,-908236.2,14.74629905005402,37.94169617134398,43.99646396564943,NaN,NaN,50
1664301600,0.9585,0.95868,0.95808,0.95826,2114,4651.45,-908149,-909036.8,15.533313717901981,37.23718211052359,42.95306821556066,NaN,NaN,50
1664303400,0.95826,0.9601,0.95814,0.95996,2543,4586.6,-905606,-908375.2,15.121534613898971,45.02413202249411,42.410895736703296,NaN,NaN,50
1664305200,0.95996,0.95996,0.95886,0.95958,2333,4516.25,-907939,-907332.2,14.739168303039033,43.7184160274097,41.659773319232315,NaN,NaN,50
1664307000,0.95958,0.95962,0.95856,0.95946,2344,4469.65,-910283,-907602.4,14.57890131179101,43.29145533543456,41.512941891611774,NaN,NaN,50
1664308800,0.95946,0.95974,0.95904,0.95918,1152,4347.4,-911435,-908682.4,14.326814306390895,42.2545049864951,41.34062837440994,NaN,NaN,50
1664310600,0.95918,0.9594,0.95896,0.95936,856,4178.2,-910579,-909168.4,14.150820869114531,43.19646036964035,41.147472427378645,NaN,NaN,50
1664312400,0.95936,0.95972,0.95907,0.95954,654,4017.95,-909925,-910032.2,13.684644781978896,44.17709969197232,41.51287297017565,NaN,NaN,50
1664314200,0.95954,0.95966,0.95926,0.95964,592,3872.25,-909333,-910311,13.251766986781524,44.747783808943495,41.32608045128247,NaN,NaN,50
1664316000,0.95964,0.95998,0.9585,0.9588,1050,3705.55,-910383,-910331,13.4733717979783,40.95982337904836,41.399138377394785,NaN,NaN,50
1664317800,0.9588,0.9593,0.95871,0.95877,825,3503.55,-911208,-910285.6,13.679147694089593,40.82689829568679,41.05385467419571,NaN,NaN,50
1664319600,0.95877,0.95908,0.95841,0.9585,1059,3313.6,-912267,-910623.2,14.117995708577476,39.581889051661314,41.12679049145979,NaN,NaN,50
1664321400,0.9585,0.95974,0.95848,0.95956,2151,3047.85,-910116,-910661.4,13.759810696124239,46.48195461125022,41.84946076283011,NaN,NaN,50
1664323200,0.95956,0.96008,0.9592,0.9593,2708,2776.05,-912824,-911359.6,13.058715050076389,45.12077695909464,42.46857663007126,NaN,NaN,50
1664325000,0.9593,0.9594,0.95678,0.95728,3134,2565.15,-915958,-912474.6,14.232929176330142,36.241143727658915,42.34710859837947,NaN,NaN,50
1664326800,0.95728,0.95764,0.95593,0.95593,4052,2500.7,-920010,-914235,15.783683382371727,31.74481240410134,41.95479647649217,NaN,NaN,50
1664328600,0.95593,0.95678,0.9555,0.95594,4425,2405.95,-915585,-914898.6,17.44075512407775,31.81229835597577,41.01109407174086,NaN,NaN,50
1664330400,0.95594,0.95644,0.9542,0.9553,3758,2355.45,-919343,-916744,19.56263623686649,29.782716034604007,40.015686929397596,NaN,NaN,50
1664332200,0.9553,0.95562,0.95461,0.95486,3514,2319.15,-922857,-918750.6,21.532954413027454,28.439366797847242,38.95482346242708,NaN,NaN,50
1664334000,0.95486,0.95644,0.95486,0.95632,3094,2262.75,-919763,-919511.6,22.425451722200606,38.372456388485645,38.67753427685498,NaN,NaN,50
1664335800,0.95632,0.95645,0.95577,0.9558,2451,2240.45,-922214,-919952.4,23.24300266262211,36.43274445938901,38.19441171183702,NaN,NaN,50
1664337600,0.9558,0.95589,0.95515,0.95566,2295,2249.5,-924509,-921737.2,24.344295434321165,35.906485013839415,37.60365352054181,NaN,NaN,50
1664339400,0.95566,0.95626,0.95432,0.95507,2471,2245.9,-926980,-923264.6,25.781192225223243,33.69739694851239,36.81434017336816,NaN,NaN,50
1664341200,0.95507,0.95544,0.95485,0.95525,3149,2286.7,-923831,-923459.4,27.115453531060886,35.01106231795583,36.3894286690044,NaN,NaN,50
1664343000,0.95525,0.95596,0.95494,0.9556,2891,2314.05,-920940,-923694.8,27.691074630129314,37.59998504756499,36.15893486556713,NaN,NaN,50
1664344800,0.9556,0.95705,0.95548,0.95663,4539,2483.4,-916401,-922532.2,27.001993098305103,44.59491170881332,36.517007912506564,NaN,NaN,50
1664346600,0.95663,0.95694,0.9536,0.95394,4785,2679.85,-921186,-921867.6,27.47754221739417,33.905227545691645,35.61867026496666,NaN,NaN,50
1664348400,0.95394,0.95587,0.95394,0.95535,6216,2957.95,-914970,-919465.6,27.919123542262586,41.78264005569327,35.3802319147237,NaN,NaN,50
1664350200,0.95535,0.95874,0.9548,0.95776,6055,3231.1,-908915,-916482.4,25.928899936671186,52.2566301592864,36.524195231268514,NaN,NaN,50
1664352000,0.95776,0.95886,0.95666,0.95666,5718,3464.5,-914633,-915221,24.161010186440716,48.01083320533812,37.686053859928286,NaN,NaN,50
1664353800,0.95666,0.95672,0.95457,0.95562,4721,3659.3,-919354,-915811.6,23.60853099072618,44.34254246905622,38.5810712965769,NaN,NaN,50
1664355600,0.95562,0.95592,0.95379,0.95486,4804,3846.55,-924158,-916406,23.485690305967964,41.82746707464306,39.441410656579684,NaN,NaN,50
1664357400,0.95486,0.95628,0.95438,0.95441,5031,3990.55,-929189,-919249.8,23.09767969223369,40.36749086719014,40.2934195186756,NaN,NaN,50
1664359200,0.95441,0.96031,0.95382,0.95788,13395,4524.9,-915794,-920625.6,22.47728962188825,53.76817317443537,41.39311357481487,NaN,NaN,50
1664361000,0.95788,0.95862,0.95567,0.95744,8170,4776.7,-923964,-922491.8,21.90121312799605,52.16732451407834,42.51701215014982,NaN,NaN,50
1664362800,0.95744,0.95752,0.95507,0.95516,7192,4933.7,-931156,-924852.2,20.99581036075318,44.734785333043675,43.147605030092976,NaN,NaN,50
1664364600,0.95516,0.95676,0.95504,0.9566,5624,4993.65,-925532,-925127,20.13608129228256,49.61718575304644,44.28473280184541,NaN,NaN,50
1664366400,0.9566,0.95888,0.95599,0.95818,7757,5193.6,-917775,-922844.2,20.354435521494672,54.379527827677066,45.66819462396836,NaN,NaN,50
1664368200,0.95818,0.95964,0.95734,0.95849,6280,5331.9,-911495,-921984.4,20.869482890338716,55.272830978274335,46.930540761876166,NaN,NaN,50
1664370000,0.95849,0.95943,0.95756,0.9587,6591,5506.75,-904904,-918172.4,21.347741161408187,55.902761665953086,47.73824433024329,NaN,NaN,50
1664371800,0.9587,0.96377,0.9577,0.9605,8297,5799.05,-896607,-911262.6,23.20834808389052,60.97605961359766,49.671875192236584,NaN,NaN,50
1664373600,0.9605,0.96192,0.95936,0.96166,7223,6045.45,-889384,-904033,24.93605451190983,63.86154405610511,51.24893976369457,NaN,NaN,50
1664375400,0.96166,0.96384,0.96132,0.96312,7356,6289.7,-882028,-896883.6,27.003145422604817,67.15351551950468,52.31300300371023,NaN,NaN,50
1664377200,0.96312,0.96471,0.96238,0.96375,6167,6440.6,-875861,-889756.8,29.109378370852205,68.48747326518863,53.775620150842414,NaN,NaN,50
1664379000,0.96375,0.96882,0.96336,0.9679,5629,6577.5,-870232,-882822.4,31.760912365732928,75.53567904327,56.003701334714826,NaN,NaN,50
1664380800,0.9679,0.97084,0.96784,0.96826,4791,6590.1,-865441,-876589.2,34.47858429893052,76.03638952968944,58.44719579578957,NaN,NaN,50
1664382600,0.96826,0.97072,0.96818,0.97022,4337,6567.7,-861104,-870933.2,37.00213680832828,78.60397480160677,61.178373219676466,NaN,NaN,50
1664384400,0.97022,0.97467,0.97009,0.97342,5376,6525.7,-855728,-865673.2,39.76318809140644,81.99574467193419,63.19462832664067,NaN,NaN,50
1664386200,0.97342,0.97426,0.97254,0.97306,3299,6387.9,-859027,-862306.4,42.3270214256933,80.45063273686915,65.21486462826859,NaN,NaN,50
1664388000,0.97306,0.97336,0.97236,0.973,2338,6218.9,-861365,-860533,44.58057330542323,80.17944807134577,67.74662625243302,NaN,NaN,50
1664389800,0.973,0.9751,0.97292,0.97446,3178,6141.75,-858187,-859082.2,46.85122436406579,81.78815148034164,70.04455237581125,NaN,NaN,50
1664391600,0.97446,0.97446,0.97241,0.97249,2957,6049.4,-861144,-859090.2,48.59130497852637,73.15974715379112,71.38599661339082,NaN,NaN,50
1664393400,0.97249,0.97371,0.97218,0.97325,2045,5900.1,-859099,-859764.4,50.03584575689517,74.28676020335256,72.74413441518212,NaN,NaN,50
1664395200,0.97325,0.97361,0.9729,0.9733,1477,5304.2,-857622,-859483.4,51.377205051094776,74.36302956998487,74.06272497975581,NaN,NaN,50
1664397000,0.9733,0.97386,0.97326,0.97368,922,4941.8,-856700,-858550.4,52.66139152772199,74.97066204653822,75.06233943925157,NaN,NaN,50
1664398800,0.97368,0.97386,0.97346,0.97384,152,4589.8,-856548,-858222.6,53.853850398875835,75.23679714870167,75.87485751729419,NaN,NaN,50
1664400600,0.97384,0.97386,0.97332,0.97336,366,4326.9,-856914,-857376.6,54.826372183075634,72.73806068916052,76.27375360084103,NaN,NaN,50
1664402400,0.97336,0.97366,0.97246,0.9726,1545,4016.3,-858459,-857248.6,54.90837012769174,68.83966480585948,76.29891013946038,NaN,NaN,50
1664404200,0.9726,0.97262,0.97188,0.97189,1158,3760.2,-859617,-857647.6,54.45548341522096,65.31770358919258,75.56905474988342,NaN,NaN,50
1664406000,0.97189,0.97244,0.97143,0.97182,1223,3491.8,-860840,-858475.6,53.629976776566636,64.96480628179638,74.77822737503392,NaN,NaN,50
1664407800,0.97182,0.97182,0.97046,0.97058,1932,3173.55,-862772,-859720.4,52.03281023583969,58.89462797398145,73.3704168873464,NaN,NaN,50
1664409600,0.97058,0.9714,0.96978,0.97034,3107,2967.75,-865879,-861513.4,50.007014816517234,57.76951467132502,71.63997188730288,NaN,NaN,50
1664411400,0.97034,0.97076,0.96893,0.96893,2857,2742.8,-868736,-863568.8,47.487383351617254,51.539957355437615,69.57492364577205,NaN,NaN,50
1664413200,0.96893,0.96968,0.96874,0.96966,2913,2580.1,-865823,-864810,45.007564435916386,54.28832026024996,67.72555737355093,NaN,NaN,50
1664415000,0.96966,0.96998,0.9684,0.96853,2906,2443.95,-868729,-866387.8,42.447858155438226,49.599063340178226,65.42633679211069,NaN,NaN,50
1664416800,0.96853,0.96872,0.96772,0.96776,2639,2336.35,-871368,-868107,39.56953767543504,46.64256900343225,63.53225263851362,NaN,NaN,50
1664418600,0.96776,0.96834,0.96744,0.96812,2058,2222.4,-869310,-868793.2,36.79176774667931,48.19729017904757,61.668719065348974,NaN,NaN,50
1664420400,0.96812,0.96864,0.96796,0.96832,1523,2029.75,-867787,-868603.4,34.338084231538474,49.08488851566389,59.86313756146891,NaN,NaN,50
1664422200,0.96832,0.96888,0.96816,0.96862,1858,1957.7,-865929,-868624.6,32.24092825505866,50.45617893609078,58.11210305357981,NaN,NaN,50
1664424000,0.96862,0.9689,0.96835,0.96878,1296,1905.6,-864633,-867805.4,30.309376412768312,51.21090426148,56.395967847349695,NaN,NaN,50
1664425800,0.96878,0.969,0.96854,0.96858,1609,1827.15,-866242,-866780.2,28.599658719632092,50.181844163533235,54.78480952409059,NaN,NaN,50
1664427600,0.96858,0.9688,0.96796,0.96852,2005,1779.55,-868247,-866567.6,26.647169417470508,49.858160720186525,53.42898780368539,NaN,NaN,50
1664429400,0.96852,0.96852,0.96545,0.96648,4153,1884.95,-872400,-867490.2,26.602472743355186,40.33254432296355,51.64433357038332,NaN,NaN,50
1664431200,0.96648,0.9669,0.96566,0.96608,4792,2050.7,-877192,-869742.8,26.560968688819536,38.76849555529597,49.77316851849042,NaN,NaN,50
1664433000,0.96608,0.96735,0.96576,0.96652,3817,2195.45,-873375,-871491.2,26.07639078751732,41.457806563569534,48.527681274889574,NaN,NaN,50
1664434800,0.96652,0.96765,0.9651,0.96515,6223,2499,-879598,-874162.4,26.042353200053885,36.136003564496164,46.98243048154466,NaN,NaN,50
1664436600,0.96515,0.96571,0.96358,0.96554,6271,2794.25,-873327,-875178.4,26.821493936395534,38.5541026206193,46.05486942905764,NaN,NaN,50
1664438400,0.96554,0.96642,0.96419,0.9647,5530,2993.5,-878857,-876469.8,26.84777420920818,35.44146196150986,44.70866526486191,NaN,NaN,50
1664440200,0.9647,0.96668,0.9645,0.96654,4888,3180,-873969,-875825.2,26.62380051697268,45.76964757455165,44.435135567317154,NaN,NaN,50
1664442000,0.96654,0.96838,0.96642,0.96764,4971,3367.4,-868998,-874949.8,24.989326156407877,50.83369182285637,44.734501482990304,NaN,NaN,50
1664443800,0.96764,0.9707,0.96738,0.96934,5542,3547.9,-863456,-871721.4,24.358088059494527,57.44709761922066,45.39520201443124,NaN,NaN,50
1664445600,0.96934,0.9697,0.96828,0.96898,5108,3647.95,-868564,-870768.8,23.771938398074983,55.737311251434235,45.87037506698626,NaN,NaN,50
1664447400,0.96898,0.97196,0.96859,0.97154,3945,3702.35,-864619,-867921.2,24.294115887601922,63.95332437988809,46.83445688440037,NaN,NaN,50
1664449200,0.97154,0.97328,0.97114,0.97288,4666,3790,-859953,-865118,25.274816939014315,67.36776574550223,47.988518418973385,NaN,NaN,50
1664451000,0.97288,0.97468,0.9721,0.97229,4914,3890.4,-864867,-864291.8,26.642205456906957,64.47203794349917,49.00924654611381,NaN,NaN,50
1664452800,0.97229,0.97282,0.96994,0.97216,5086,4012.75,-869953,-865591.2,26.40233107361174,63.82109063266497,50.00659868271942,NaN,NaN,50
1664454600,0.97216,0.9722,0.96835,0.96882,7791,4299.4,-877744,-867427.2,25.2642044673512,49.885219436565976,50.68893261940531,NaN,NaN,50
1664456400,0.96882,0.97378,0.96849,0.97324,6299,4538.2,-871445,-868792.4,24.847562992436607,61.779261337220305,52.33255874668561,NaN,NaN,50
1664458200,0.97324,0.97494,0.97252,0.97417,7734,4832,-863711,-869544,24.88277095355987,63.72981867157328,53.92341675440016,NaN,NaN,50
1664460000,0.97417,0.97601,0.97187,0.97423,7850,5159.7,-855861,-867742.8,25.27761626878634,63.85797060545894,55.903557257326085,NaN,NaN,50
1664461800,0.97423,0.97706,0.97258,0.97654,7160,5437.25,-848701,-863492.4,25.97710089480614,68.47605079139902,58.04083926952463,NaN,NaN,50
1664463600,0.97654,0.97898,0.97591,0.97724,6615,5667.75,-842086,-856360.8,27.16693051405538,69.73793146435479,60.49058709115641,NaN,NaN,50
1664465400,0.97724,0.97893,0.97704,0.97735,5113,5715.75,-836973,-849466.4,28.27177230335825,69.94155292003029,62.2171517586906,NaN,NaN,50
1664467200,0.97735,0.97978,0.97707,0.97894,4146,5683.45,-832827,-843289.6,29.52895907936348,72.7913922135014,63.78555892945095,NaN,NaN,50
1664469000,0.97894,0.9796,0.97756,0.97762,3479,5666.55,-836306,-839378.6,30.696346799939768,67.10338969953827,64.47529407804507,NaN,NaN,50
1664470800,0.97762,0.97892,0.97696,0.97818,2706,5490.7,-833600,-836358.4,31.320184495912944,68.23734347490537,65.36815352257872,NaN,NaN,50
1664472600,0.97818,0.97898,0.97766,0.97806,2913,5322.8,-836513,-835243.8,31.919941968707306,67.69882176776818,65.63568905028444,NaN,NaN,50
1664474400,0.97806,0.97882,0.97764,0.9787,2484,5170.5,-834029,-834655,32.45993030768212,69.09947421135806,65.75938251213128,NaN,NaN,50
1664476200,0.9787,0.9797,0.97837,0.97914,2644,5058.3,-831385,-834366.6,33.28297430766644,70.06066919135972,66.15857045840704,NaN,NaN,50
1664478000,0.97914,0.98023,0.97868,0.97986,2791,4949.3,-828594,-832824.2,34.2314273271008,71.61654655883348,66.71538873884764,NaN,NaN,50
1664479800,0.97986,0.98094,0.97966,0.98009,3273,4835.85,-825321,-831168.4,35.34984976490808,72.11506692338324,68.30323498790601,NaN,NaN,50
1664481600,0.98009,0.9805,0.97972,0.9805,1972,4679.05,-823349,-828535.6,36.388384885729124,73.02461573870497,69.10647458801206,NaN,NaN,50
1664483400,0.9805,0.98151,0.9802,0.9814,1406,4552.1,-821943,-826118.4,37.68623440435435,74.95573061177369,69.90832544088353,NaN,NaN,50
1664485200,0.9814,0.98256,0.98125,0.9819,404,4339,-821539,-824149.2,39.197982290803125,75.98433248172722,70.77449414633126,NaN,NaN,50
1664487000,0.9819,0.98196,0.98164,0.98182,251,4105.85,-821790,-822788.4,40.6017481853627,75.45037703221699,71.2726603063897,NaN,NaN,50
1664488800,0.98182,0.98442,0.98163,0.98274,2227,3962.9,-819563,-821636.8,42.50555956086296,77.41585070340685,71.82108310917913,NaN,NaN,50
1664490600,0.98274,0.98302,0.98182,0.98185,1369,3641.8,-820932,-821153.4,44.27338440954178,71.45584055935414,71.92924651198797,NaN,NaN,50
1664492400,0.98185,0.98226,0.98144,0.98208,1473,3400.5,-819459,-820656.6,45.493233097116686,72.0545967301544,71.87661826317746,NaN,NaN,50
1664494200,0.98208,0.98382,0.98194,0.98292,2498,3138.7,-816961,-819741,46.99860672823073,74.18445260171048,72.3824084704755,NaN,NaN,50
1664496000,0.98292,0.98302,0.98175,0.98194,3118,2902.1,-820079,-819398.8,48.189459452197134,67.7015442471288,72.34413709706288,NaN,NaN,50
1664497800,0.98194,0.98334,0.98164,0.98254,3306,2709.4,-816773,-818840.8,49.37463157879184,69.46116589650772,72.47001882054428,NaN,NaN,50
1664499600,0.98254,0.98294,0.98188,0.98209,3042,2530.75,-819815,-818617.4,50.47514855348694,66.53348488177042,72.28673386843087,NaN,NaN,50
1664501400,0.98209,0.98238,0.98094,0.981,3404,2445.3,-823219,-819369.4,50.38620303485028,59.942980014635296,71.56404178437913,NaN,NaN,50
1664503200,0.981,0.98128,0.97946,0.98038,3369,2406.45,-826588,-821294.8,48.833148745987565,56.513855720538025,70.4852781530723,NaN,NaN,50
1664505000,0.98038,0.9817,0.98026,0.98092,3015,2383.25,-823573,-821993.6,47.597217938526775,58.728393168850026,69.52908717060565,NaN,NaN,50
1664506800,0.98092,0.98128,0.9801,0.98014,2526,2374.25,-826099,-823858.8,46.29618822786653,54.41760137467603,68.20001471603216,NaN,NaN,50
1664508600,0.98014,0.98069,0.97984,0.97996,2287,2342.95,-828386,-825573,44.83139067204459,53.44270171265714,66.66336979466669,NaN,NaN,50
1664510400,0.97996,0.98067,0.97977,0.98013,1780,2307.75,-826606,-826250.4,43.39943954139126,54.27585934386961,65.112764570534,NaN,NaN,50
1664512200,0.98013,0.9808,0.9799,0.97995,1892,2270.15,-828498,-826632.4,42.15426504961927,53.190479924955646,63.52277192001534,NaN,NaN,50
1664514000,0.97995,0.98182,0.97991,0.9818,2653,2263.25,-825845,-827086.8,41.6183260003234,61.673619097569635,62.398326805312685,NaN,NaN,50
1664515800,0.9818,0.98282,0.98154,0.98242,3267,2262.95,-822578,-826382.6,41.635052993842514,64.02654982115058,61.86766318115529,NaN,NaN,50
1664517600,0.98242,0.98338,0.9807,0.98076,5529,2440.8,-828107,-826326.8,40.732080362727544,54.397350843184874,60.606431332086025,NaN,NaN,50
1664519400,0.98076,0.98112,0.97902,0.97996,4882,2614.6,-832989,-827603.4,38.38849447866191,50.45882434962851,58.91174359979446,NaN,NaN,50
1664521200,0.97996,0.98346,0.97971,0.98208,6411,2914.95,-826578,-827219.4,37.50670815609247,58.94241944153857,58.28609182796658,NaN,NaN,50
1664523000,0.98208,0.98384,0.98049,0.98328,5448,3174.8,-821130,-826276.4,36.86367658713522,62.823172581218,57.81194944830303,NaN,NaN,50
1664524800,0.98328,0.98539,0.98328,0.9836,5820,3354.45,-815310,-824822.8,36.917808160214385,63.805637410498996,57.617103200355075,NaN,NaN,50
1664526600,0.9836,0.98435,0.98298,0.98331,5791,3575.55,-821101,-823421.6,36.71355225073972,62.201367915498544,57.7784166218453,NaN,NaN,50
1664528400,0.98331,0.98382,0.98164,0.98174,5020,3752.9,-826121,-822048,35.46336024782151,54.24900184613169,57.61664134510199,NaN,NaN,50
1664530200,0.98174,0.98202,0.97966,0.97973,3737,3814.85,-829858,-822704,33.02663629430205,46.11952908085006,56.71600819595914,NaN,NaN,50
1664532000,0.97973,0.98042,0.97636,0.97642,4625,3890.2,-834483,-825374.6,32.105459098361294,36.436276901308965,55.43162787643292,NaN,NaN,50
1664533800,0.97642,0.97765,0.97548,0.97616,4421,3945.95,-838904,-830093.4,31.57738340138384,35.800426979729195,54.17146539550949,NaN,NaN,50
1664535600,0.97616,0.97675,0.97524,0.97648,3988,3993.25,-834916,-832856.4,31.176141612831476,37.251813615392564,52.955462129189705,NaN,NaN,50
1664537400,0.97648,0.97687,0.97412,0.97466,3711,4008.6,-838627,-835357.6,31.21013480502625,32.72093178409531,51.49335154769968,NaN,NaN,50
1664539200,0.97466,0.97848,0.97428,0.97654,5607,4120.5,-833020,-835990,30.2415638555435,40.73909249570798,49.99802821899529,NaN,NaN,50
1664541000,0.97654,0.97788,0.97354,0.97548,8260,4382.75,-841280,-837349.4,29.636349862645016,37.98995614541574,48.138271527871375,NaN,NaN,50
1664542800,0.97548,0.97626,0.97346,0.9744,6633,4588.1,-847913,-839151.2,29.106713132278866,35.37096285593741,46.77924381449655,NaN,NaN,50
1664544600,0.9744,0.9777,0.97432,0.97752,8633,4905.4,-839280,-840024,27.734105771523048,46.78447848719277,46.51679053860829,NaN,NaN,50
1664546400,0.97752,0.97808,0.97536,0.97713,7133,5173.05,-846413,-841581.2,26.240756305409008,45.69809160629702,45.570767121805325,NaN,NaN,50
1664548200,0.97713,0.98094,0.97667,0.97944,9108,5533.85,-837305,-842438.2,25.284956236039154,52.70364500984888,44.847943723850385,NaN,NaN,50
1664550000,0.97944,0.98183,0.97834,0.9796,6854,5743.9,-830451,-840272.4,24.759476243378547,53.15444965957382,44.0871445987843,NaN,NaN,50
1664551800,0.9796,0.98056,0.97825,0.97825,5133,5837.2,-835584,-837806.6,24.218508087253735,48.91776814132573,43.13831604348625,NaN,NaN,50
1664553600,0.97825,0.97842,0.97706,0.97816,3825,5752,-839409,-837832.4,23.027643916973293,48.639432950063615,42.73763255090995,NaN,NaN,50
1664555400,0.97816,0.97902,0.97759,0.97902,2522,5634,-836887,-835927.2,22.204191115613163,51.4803575195742,43.12054886796168,NaN,NaN,50
1664557200,0.97902,0.9798,0.97828,0.97887,2645,5445.7,-839532,-836372.6,21.796574811508272,50.950986718406504,44.15731385489722,NaN,NaN,50
1664559000,0.97887,0.98006,0.97846,0.97948,2726,5309.6,-836806,-837643.6,21.53659345625188,53.064677690826784,45.39047461997562,NaN,NaN,50
1664560800,0.97948,0.98042,0.97924,0.98012,2309,5134.05,-834497,-837426.2,21.46341306691723,55.2438843970178,46.67562253294886,NaN,NaN,50
1664562600,0.98012,0.98156,0.98012,0.9807,2586,4973.8,-831911,-835926.6,21.902864549804647,57.18404191815834,48.42298754252479,NaN,NaN,50
1664564400,0.9807,0.98126,0.97922,0.97988,3226,4884.1,-835137,-835576.6,21.667238742424036,53.64348078720309,49.344729563345865,NaN,NaN,50
1664566200,0.97988,0.9804,0.97952,0.98009,2941,4844.3,-832196,-834109.4,21.448443349856323,54.42177672790924,50.518431033523974,NaN,NaN,50
1664568000,0.98009,0.981,0.97993,0.98082,1194,4672.75,-831002,-832948.6,21.546275004573452,57.117073617205435,52.07172465932884,NaN,NaN,50
1664569800,0.98082,0.98082,0.97985,0.98016,1414,4522.4,-832416,-832532.4,21.572384829447163,54.007444424400646,52.587650797700825,NaN,NaN,50
1664744400,0.98016,0.98084,0.97927,0.97964,114,4328.7,-832530,-832656.2,21.12226659550788,51.62277546699507,53.0108425020364,NaN,NaN,50
1664746200,0.97964,0.98012,0.97948,0.97963,222,4154.25,-832752,-832179.2,20.704299663992835,51.57561259912692,52.9302687584134,NaN,NaN,50
1664748000,0.97963,0.98066,0.97923,0.98009,1657,3956.75,-831095,-831959,20.652398087464586,53.672338910937626,52.967260847796524,NaN,NaN,50
1664749800,0.98009,0.98092,0.97994,0.9801,1147,3601.1,-829948,-831748.2,20.76424068941563,53.719253165506636,53.31022406380945,NaN,NaN,50
1664751600,0.9801,0.98014,0.97932,0.97979,1712,3355.05,-831660,-831597,20.282505538173773,51.96253867664738,53.54758875856544,NaN,NaN,50
1664753400,0.97979,0.9803,0.97895,0.97936,1900,3018.4,-833560,-831803,19.498589102191826,49.54240291520705,53.40916342968206,NaN,NaN,50
1664755200,0.97936,0.97982,0.97854,0.97964,2630,2793.25,-830930,-831438.6,18.403695976445178,51.13825487567114,53.42253972662953,NaN,NaN,50
1664757000,0.97964,0.98041,0.97946,0.98014,2528,2464.25,-828402,-830900,17.851739068072522,53.93974460757909,53.48504450639756,NaN,NaN,50
1664758800,0.98014,0.98164,0.98014,0.98132,2542,2248.65,-825860,-830082.4,18.183105454079605,59.79795415014295,53.81033520304935,NaN,NaN,50
1664760600,0.98132,0.98288,0.98108,0.98258,2696,2126.8,-823164,-828383.2,19.185992593553856,64.92749576757632,54.36343904943633,NaN,NaN,50
1664762400,0.98258,0.98258,0.98163,0.98172,1804,2025.75,-824968,-826664.8,20.117244937351373,59.360269686628364,54.771781113680994,NaN,NaN,50
1664764200,0.98172,0.98198,0.98124,0.98124,1357,1967.5,-826325,-825743.8,20.568339968651088,56.45083861265945,54.91671410544886,NaN,NaN,50
1664766000,0.98124,0.98153,0.98067,0.98118,1649,1917.7,-827974,-825658.2,20.404821241635197,56.08082195634816,54.842696129673335,NaN,NaN,50
1664767800,0.98118,0.98153,0.98042,0.98056,1532,1858,-829506,-826387.4,20.003245124952375,52.268283469350614,54.71847034716976,NaN,NaN,50
1664769600,0.98056,0.98057,0.97919,0.9796,2797,1882.4,-832303,-828215.2,18.628754225243352,46.94638869503591,54.38444272060125,NaN,NaN,50
1664771400,0.9796,0.97974,0.97854,0.97854,1875,1846.85,-834178,-830057.2,17.859630523139046,41.87629888866969,53.69163459842573,NaN,NaN,50
1664773200,0.97854,0.97946,0.97844,0.9794,1834,1777.25,-832344,-831261,17.222549056357277,46.88798127513072,53.20703762443952,NaN,NaN,50
1664775000,0.9794,0.98348,0.97938,0.98258,4512,1855.8,-827832,-831232.6,17.972354318246442,60.46316070648675,53.6887453059381,NaN,NaN,50
1664776800,0.98258,0.98288,0.98074,0.98104,5499,2071.05,-833331,-831997.6,18.668602061429237,53.35140376936345,53.78794995541782,NaN,NaN,50
1664778600,0.98104,0.98168,0.97916,0.97979,4478,2224.25,-837809,-833098.8,18.101840793266376,48.377436885237344,53.70473809613427,NaN,NaN,50
1664780400,0.97979,0.98188,0.9787,0.98104,6263,2531.7,-831546,-832572.4,17.258951443675745,53.08753521094745,53.84397240579686,NaN,NaN,50
1664782200,0.98104,0.9819,0.98044,0.98122,4418,2741.5,-827128,-831529.2,16.488788986976566,53.74205669197045,53.829851840396245,NaN,NaN,50
1664784000,0.98122,0.98244,0.98052,0.98216,4702,2893.75,-822426,-830448,16.118268552058893,57.10760609911776,53.63768412246587,NaN,NaN,50
1664785800,0.98216,0.98278,0.98054,0.98112,4082,3040.5,-826508,-829083.4,15.988348747446251,52.55197197590925,52.75371813734679,NaN,NaN,50
1664787600,0.98112,0.9813,0.97877,0.97886,3181,3113.95,-829689,-827459.4,15.125511352647466,44.284601393917896,51.67688468786748,NaN,NaN,50
1664789400,0.97886,0.9789,0.97529,0.97632,3453,3191.6,-833142,-827778.6,16.05547100018451,37.20115279468768,50.30190712944092,NaN,NaN,50
1664791200,0.97632,0.97858,0.97572,0.9784,3206,3220.4,-829936,-828340.2,16.919004958611765,44.96450337066649,49.5078843733208,NaN,NaN,50
1664793000,0.9784,0.9785,0.9771,0.9779,2977,3242.85,-832913,-830437.6,17.720857920008505,43.570134183682846,48.886587995773105,NaN,NaN,50
1664794800,0.9779,0.97832,0.97622,0.97639,3273,3279.4,-836186,-832373.2,18.84412413820328,39.57843153817184,48.36030534171139,NaN,NaN,50
1664796600,0.97639,0.97695,0.97542,0.97684,3221,3305.65,-832965,-833028.4,20.207413088856235,41.30425416938835,48.319445004619865,NaN,NaN,50
1664798400,0.97684,0.97734,0.9756,0.97672,3844,3407.65,-836809,-833761.8,21.13677341613585,40.96820370272922,47.89660374944833,NaN,NaN,50
1664800200,0.97672,0.9781,0.97571,0.97658,4360,3557.8,-841169,-836008.4,21.363218238041746,40.553659126172924,46.47449649371163,NaN,NaN,50
1664802000,0.97658,0.97835,0.97616,0.97736,3923,3671.5,-837246,-836875,21.36795073694401,43.95619844465607,45.80341039908967,NaN,NaN,50
1664803800,0.97736,0.97762,0.9758,0.97672,6122,3901,-843368,-838311.4,21.566830018354363,41.84007715568658,45.33645613269318,NaN,NaN,50
1664805600,0.97672,0.98278,0.97672,0.98181,8638,4193.05,-834730,-838664.4,21.39167403481385,58.81982151399177,45.745905154339205,NaN,NaN,50
1664807400,0.98181,0.98261,0.98026,0.98138,7806,4489.6,-842536,-839809.8,21.229029192954798,57.29793710256999,45.999896612239176,NaN,NaN,50
1664809200,0.98138,0.98446,0.98127,0.98344,6460,4720.9,-836076,-838791.2,21.80924841148704,62.32684219183417,46.37269919029034,NaN,NaN,50
1664811000,0.98344,0.98372,0.98056,0.98082,4557,4723.15,-840633,-839468.6,21.888725339398178,53.66973510952934,46.452539414120345,NaN,NaN,50
1664812800,0.98082,0.98184,0.97958,0.98028,4206,4658.5,-844839,-839762.8,21.358379203671095,52.064579349885555,47.0082521252609,NaN,NaN,50
1664814600,0.98028,0.9808,0.97986,0.9808,3318,4600.5,-841521,-841121,20.865914934781664,53.506605873916236,48.17292734520579,NaN,NaN,50
1664816400,0.9808,0.98102,0.97964,0.97968,2864,4430.55,-844385,-841490.8,20.408626685098618,50.01656937731175,48.53378920282331,NaN,NaN,50
1664818200,0.97968,0.98016,0.9788,0.97946,2994,4359.35,-847379,-843751.4,19.423056618256354,49.33584009140565,48.94562533908923,NaN,NaN,50
1664820000,0.97946,0.98111,0.97894,0.98106,3015,4275,-844364,-844497.6,19.022312432306883,54.216225436465784,49.991182046110225,NaN,NaN,50
1664821800,0.98106,0.98212,0.98084,0.98169,3167,4229.25,-841197,-843769.2,19.149659506428616,56.01295735511328,51.04180370223344,NaN,NaN,50
1664823600,0.98169,0.9822,0.98054,0.98169,2566,4198.5,-841197,-843704.4,19.04963442541738,56.01295735511328,52.116428963118004,NaN,NaN,50
1664825400,0.98169,0.98286,0.9815,0.98286,2971,4174.4,-838226,-842472.6,19.28894618688896,59.441199358547216,53.46553897971618,NaN,NaN,50
1664827200,0.98286,0.9829,0.98213,0.98245,2161,4122.15,-840387,-841074.2,19.53154464345794,57.74284783608418,54.450299650532465,NaN,NaN,50
1664829000,0.98245,0.98273,0.98228,0.9825,572,4001.9,-839815,-840164.4,19.75681463884342,57.900821421204704,55.59749566949804,NaN,NaN,50
1664830800,0.9825,0.98261,0.9824,0.98242,64,3841.45,-839879,-839900.8,19.965993920272794,57.530238763594056,55.505382615898206,NaN,NaN,50
1664832600,0.98242,0.9825,0.98222,0.98228,150,3687.9,-840029,-839667.2,19.98280202195794,56.84457355824143,55.47299950558903,NaN,NaN,50
1664834400,0.98228,0.98312,0.98222,0.98265,965,3543.95,-839064,-839834.8,20.39659273766692,58.260439637045764,55.18254218024699,NaN,NaN,50
1664836200,0.98265,0.98317,0.9825,0.98292,1620,3406.95,-837444,-839246.2,20.81279886449051,59.30956131308292,55.585386909072255,NaN,NaN,50
1664838000,0.98292,0.98378,0.98288,0.9835,1588,3290.2,-835856,-838454.4,21.58615167865791,61.54556899947021,56.26260045547116,NaN,NaN,50
1664839800,0.9835,0.98364,0.98304,0.98335,1886,3078.4,-837742,-838027,22.304265006099065,60.61782276034018,56.770544518787155,NaN,NaN,50
1664841600,0.98335,0.98382,0.98217,0.9822,2876,2790.3,-840618,-838144.8,21.95290262699056,53.90846923689405,57.048537365900174,NaN,NaN,50
1664843400,0.9822,0.9827,0.982,0.98269,2334,2516.7,-838284,-837988.8,21.439835797903815,56.136233273292746,57.53427973603497,NaN,NaN,50
1664845200,0.98269,0.98297,0.98246,0.98273,2375,2312.45,-835909,-837681.8,21.18688600310709,56.32182607367048,57.6846797815496,NaN,NaN,50
1664847000,0.98273,0.98292,0.98116,0.98118,2246,2196.9,-838155,-838141.6,19.741640322621638,47.869595276098,57.10301106161994,NaN,NaN,50
1664848800,0.98118,0.98162,0.98062,0.9815,2104,2091.8,-836051,-837803.4,18.871897232225336,49.55279140694277,56.64157063675061,NaN,NaN,50
1664850600,0.9815,0.98303,0.98144,0.98286,2273,2039.55,-833778,-836435.4,18.19782177740849,56.048036224436814,56.39920184145701,NaN,NaN,50
1664852400,0.98286,0.98328,0.98266,0.98275,1916,1992.15,-835694,-835917.4,17.761392980720906,55.42643226892457,56.2337435866599,NaN,NaN,50
1664854200,0.98275,0.98456,0.98216,0.98426,4704,2077.65,-830990,-834933.6,18.22935293037993,61.70504725360892,56.5054740032602,NaN,NaN,50
1664856000,0.98426,0.98434,0.98264,0.98304,3066,2080.2,-834056,-834113.8,18.66388716934902,54.9680778835884,56.322462511831226,NaN,NaN,50
1664857800,0.98304,0.98364,0.98296,0.98335,2255,2034.6,-831801,-833263.8,19.06738324839175,56.274446521177175,56.28173915204092,NaN,NaN,50
1664859600,0.98335,0.98398,0.98305,0.98305,2487,2030.65,-834288,-833365.8,19.68047127011959,54.622998008378055,56.02192189285036,NaN,NaN,50
1664861400,0.98305,0.98495,0.9826,0.9844,3654,2064.8,-830634,-832353.8,20.866413603924588,60.27286529023035,56.090729319789475,NaN,NaN,50
1664863200,0.9844,0.98678,0.9838,0.98608,4132,2163.35,-826502,-831456.2,22.855706845485976,65.95392882561265,56.405612164513926,NaN,NaN,50
1664865000,0.98608,0.98722,0.98592,0.98706,4854,2377.45,-821648,-828974.6,24.879084795125305,68.76033334882284,56.98722006369126,NaN,NaN,50
1664866800,0.98706,0.98962,0.98636,0.98825,6032,2675.85,-815616,-825737.6,27.526045791504167,71.80007573904702,58.26519195670219,NaN,NaN,50
1664868600,0.98825,0.98886,0.98692,0.98754,5400,2938.35,-821016,-823083.2,29.98393814528454,67.57520128891736,59.08226110067538,NaN,NaN,50
1664870400,0.98754,0.98804,0.98654,0.98692,4199,3100.05,-825215,-821999.4,31.81657227507933,64.03193683074812,59.63298329760949,NaN,NaN,50
1664872200,0.98692,0.98783,0.9867,0.98748,4111,3224.6,-821104,-820919.8,33.518303967031635,65.777398289541,60.91211208428399,NaN,NaN,50
1664874000,0.98748,0.98756,0.98526,0.9865,4909,3390.65,-826013,-821792.8,33.476156961120175,60.265691714711124,61.67731924912459,NaN,NaN,50
1664875800,0.9865,0.98845,0.98612,0.98794,3345,3463.6,-822668,-823203.2,33.86115962027138,64.91749265330176,62.310851851186364,NaN,NaN,50
1664877600,0.98794,0.98999,0.98778,0.98994,3540,3496.8,-819128,-822825.6,34.83703404571965,70.1453080785897,63.3622001233053,NaN,NaN,50
1664879400,0.98994,0.99038,0.98913,0.98916,3425,3551.35,-822553,-822293.2,35.88258475488089,66.01375489354155,63.66996495472906,NaN,NaN,50
1664881200,0.98916,0.98983,0.9877,0.98834,4223,3643.75,-826776,-823427.6,35.4864690912414,61.88691617789008,64.16416769003634,NaN,NaN,50
1664883000,0.98834,0.98942,0.988,0.98907,4192,3741.05,-822584,-822741.8,35.11864740357616,64.04203797954914,64.71899565134864,NaN,NaN,50
1664884800,0.98907,0.99198,0.98859,0.99165,5456,3908.65,-817128,-821633.8,35.822053329662864,70.41028669702618,65.84665912910921,NaN,NaN,50
1664886600,0.99165,0.99347,0.99066,0.9924,5529,4071.45,-811599,-820128,36.93246222228928,71.9646657213168,66.68178773132968,NaN,NaN,50
1664888400,0.9924,0.99246,0.991,0.9913,4735,4212.4,-816334,-818884.2,37.963556194013805,66.45107780147985,66.71729837246305,NaN,NaN,50
1664890200,0.9913,0.99308,0.99114,0.99292,5764,4265.4,-810570,-815643,39.105630326292726,70.08601025545158,66.81198958007938,NaN,NaN,50
1664892000,0.99292,0.9958,0.99292,0.99386,6377,4430.95,-804193,-811964.8,40.82628651011924,71.98288521860741,66.82504740004798,NaN,NaN,50
1664893800,0.99386,0.99582,0.99346,0.9957,5875,4611.95,-798318,-808202.8,42.42821033495054,75.28639178364858,67.37584672110022,NaN,NaN,50
1664895600,0.9957,0.99785,0.99542,0.99762,4335,4704.35,-793983,-804679.6,44.30368642072501,78.177852761822,68.38626928760549,NaN,NaN,50
1664897400,0.99762,0.99798,0.9963,0.99763,3978,4720.55,-790005,-799413.8,46.06777173154023,78.19216399985675,69.27303826691376,NaN,NaN,50
1664899200,0.99763,0.9987,0.99756,0.99838,3035,4665.7,-786970,-794693.8,47.831555837745235,79.28920399563017,70.6318605726937,NaN,NaN,50
1664901000,0.99838,0.99937,0.99652,0.99704,3154,4580.7,-790124,-791880,48.479610525872644,72.29194400781945,71.15860709801639,NaN,NaN,50
1664902800,0.99704,0.99728,0.99605,0.99674,3022,4430.2,-793146,-790845.6,48.65558307664157,70.78581786522416,71.2043577970617,NaN,NaN,50
1664904600,0.99674,0.99746,0.99608,0.99746,2343,4277.35,-790803,-790209.6,48.87304529471072,72.27855466062985,71.65184349471087,NaN,NaN,50
1664906400,0.99746,0.99801,0.99674,0.99766,2252,4180,-788551,-789918.8,49.24165530919179,72.69590377290092,72.42391403721165,NaN,NaN,50
1664908200,0.99766,0.99989,0.99764,0.9998,2182,4083.55,-786369,-789798.6,50.079694926472826,76.73239305854243,73.33036797142545,NaN,NaN,50
1664910000,0.9998,0.99996,0.99783,0.99791,3020,3989.1,-789389,-789651.6,50.87465043615339,67.27326283563286,73.1062948384688,NaN,NaN,50
1664911800,0.99791,0.9995,0.99773,0.99906,4112,4027.45,-785277,-788077.8,51.50718864710859,69.71927936570283,72.94591009878208,NaN,NaN,50
1664913600,0.99906,0.99936,0.99846,0.9991,3350,4017.95,-781927,-786302.6,52.09454555728128,69.8038180621392,73.18539154597204,NaN,NaN,50
1664915400,0.9991,0.9993,0.99842,0.99879,1020,3897.7,-782947,-785181.8,52.59159918894364,68.21435119619024,73.05170161316765,NaN,NaN,50
1664917200,0.99879,0.99879,0.99841,0.99841,173,3695.2,-783120,-784532,53.04020182808401,66.2237126386966,72.64033214317402,NaN,NaN,50
1664919000,0.99841,0.99844,0.99834,0.99836,61,3488.65,-783181,-783290.4,53.36010137437401,65.95099758006833,71.97351827148971,NaN,NaN,50
1664920800,0.99836,0.99858,0.99808,0.99848,917,3261.7,-782264,-782687.8,53.28643483612184,66.30958731287984,71.1257850251367,NaN,NaN,50
1664922600,0.99848,0.99854,0.99819,0.99832,638,3017.15,-782902,-782882.8,53.21803019345911,65.32177405798416,70.20647145786009,NaN,NaN,50
1664924400,0.99832,0.99854,0.99796,0.99799,1561,2858.45,-784463,-783186,52.79873539069999,63.22960099487555,69.05935695780619,NaN,NaN,50
1664926200,0.99799,0.99842,0.99793,0.99839,1092,2624.85,-783371,-783236.2,52.36127007948935,64.70524155482245,68.51744963973496,NaN,NaN,50
1664928000,0.99839,0.999,0.9979,0.99819,2238,2417.9,-785609,-783721.8,52.28612325946106,63.336593974812246,67.98536221899126,NaN,NaN,50
1664929800,0.99819,0.99826,0.99704,0.99761,2387,2243.5,-787996,-784868.2,50.89911992975905,59.411878849329575,67.06631394675553,NaN,NaN,50
1664931600,0.99761,0.99908,0.99733,0.99883,3514,2202.45,-784482,-785184.2,50.144540344810004,64.40789293252959,66.47431317244329,NaN,NaN,50
1664933400,0.99883,0.99894,0.99653,0.99658,3935,2200.3,-788417,-785975,48.39501221669991,51.75512743602699,64.69022277083504,NaN,NaN,50
1664935200,0.99658,0.99744,0.99644,0.99724,3368,2216.95,-785049,-786310.6,46.6580988672258,54.574131533645264,63.7831419635502,NaN,NaN,50
1664937000,0.99724,0.9975,0.99604,0.99678,2867,2202.6,-787916,-786772,44.544249541435484,52.28121222284846,62.53756573906061,NaN,NaN,50
1664938800,0.99678,0.99697,0.99596,0.99654,1860,2144.5,-789776,-787128,42.48080607736494,51.07547560249768,61.19982699194337,NaN,NaN,50
1664940600,0.99654,0.99717,0.99608,0.99696,1748,2114.75,-788028,-787837.2,40.7537413871391,53.11335596046185,60.12118447510563,NaN,NaN,50
1664942400,0.99696,0.99718,0.99623,0.99642,1733,2088.8,-789761,-788106,39.15987898876504,50.21712577544164,58.97785684201598,NaN,NaN,50
1664944200,0.99642,0.99698,0.99604,0.99662,1513,2055.35,-788248,-788745.8,37.397694684155255,51.27683268019901,57.92970220631104,NaN,NaN,50
1664946000,0.99662,0.9979,0.99661,0.99718,2112,2009.95,-786136,-788389.8,36.66630419530206,54.2156053235432,57.065846349929856,NaN,NaN,50
1664947800,0.99718,0.99765,0.99629,0.99636,2332,1920.95,-788468,-788128.2,35.50959816402169,49.506848469650684,55.936208807906034,NaN,NaN,50
1664949600,0.99636,0.99798,0.99618,0.9977,3100,1908.45,-785368,-787596.2,34.74891544638475,56.20135084178495,55.434190939828135,NaN,NaN,50
1664951400,0.9977,0.99952,0.99755,0.99775,3589,2036.9,-781779,-785999.8,35.20766661617776,56.43345814186179,54.843349267473805,NaN,NaN,50
1664953200,0.99775,0.99782,0.99476,0.99542,4835,2270,-786614,-785673,32.752140554656286,44.57798011676018,53.50344827761294,NaN,NaN,50
1664955000,0.99542,0.99591,0.99363,0.99404,4613,2497.6,-791227,-786691.2,31.285663020330734,39.31054366429679,52.06763862153917,NaN,NaN,50
1664956800,0.99404,0.99478,0.99228,0.993,4214,2662.45,-795441,-788085.8,30.73122230019319,35.87056266289571,50.029257887993886,NaN,NaN,50
1664958600,0.993,0.99484,0.99289,0.99475,3559,2808.5,-791882,-789388.6,30.162343428055742,44.64803430553123,49.52160837867276,NaN,NaN,50
1664960400,0.99475,0.9952,0.99363,0.99369,2757,2868.3,-794639,-791960.6,29.300261276160693,40.988494522071115,48.5512057349889,NaN,NaN,50
1664962200,0.99369,0.99374,0.99212,0.99306,2780,2952.7,-797419,-794121.6,29.358212546994316,38.94534990723904,47.5986441410168,NaN,NaN,50
1664964000,0.99306,0.99318,0.99112,0.99176,3210,3001.3,-800629,-796002,29.88494357355082,35.06155893109735,46.45479295020249,NaN,NaN,50
1664965800,0.99176,0.99257,0.9916,0.99242,2366,3000.25,-798263,-796566.4,30.374050955353276,38.419174802059885,45.40520858174521,NaN,NaN,50
1664967600,0.99242,0.99272,0.9919,0.99218,2783,2963.7,-801046,-798399.2,30.669873280836452,37.65670360928785,44.50803556987709,NaN,NaN,50
1664969400,0.99218,0.99231,0.98998,0.99054,3179,2925.9,-804225,-800316.4,31.798990791247206,32.857904589336655,43.1923978491012,NaN,NaN,50
1664971200,0.99054,0.99217,0.98986,0.99113,4086,2961.8,-800139,-800860.4,32.89389038602276,36.016895781001935,41.89249002463396,NaN,NaN,50
1664973000,0.99113,0.99232,0.98922,0.99118,4545,3045.7,-795594,-799853.4,34.156857641685505,36.29046086341555,40.94846233847431,NaN,NaN,50
1664974800,0.99118,0.99143,0.98757,0.98784,4445,3174.95,-800039,-800208.6,35.87080656628195,27.753936363772553,38.91650416147342,NaN,NaN,50
1664976600,0.98784,0.98884,0.98656,0.98772,5105,3342.8,-805144,-801028.2,37.73667485054798,27.503615037663323,36.85008679688781,NaN,NaN,50
1664978400,0.98772,0.98774,0.98348,0.9846,7893,3650.8,-813037,-802790.6,40.098026893385175,21.95826142355115,35.23439260451574,NaN,NaN,50
1664980200,0.9846,0.98604,0.9844,0.9855,6322,3891.25,-806715,-804105.8,42.29071093316257,26.558233325698197,34.323513294615836,NaN,NaN,50
1664982000,0.9855,0.98614,0.98496,0.98537,4128,3992.05,-810843,-807155.6,44.22130073828095,26.316937880166094,33.64111152442087,NaN,NaN,50
1664983800,0.98537,0.98726,0.9853,0.98656,3534,4052.15,-807309,-808609.6,44.87190795423869,32.3738708132945,32.76438556068967,NaN,NaN,50
1664985600,0.98656,0.98762,0.986,0.98658,2836,4038.95,-804473,-808475.4,45.129371241144085,32.47433740539384,32.15623148092701,NaN,NaN,50
1664987400,0.98658,0.98712,0.98613,0.98632,2408,3979.9,-806881,-807244.2,45.36844429327052,31.81267663264444,31.646754818455967,NaN,NaN,50
1664989200,0.98632,0.98798,0.98601,0.98793,2429,3859.6,-804452,-806791.6,44.73536038623504,39.96922227010059,31.99730219981334,NaN,NaN,50
1664991000,0.98793,0.98816,0.98721,0.98754,2081,3733,-806533,-805929.6,43.97346203703544,38.75972004010675,32.02162685967384,NaN,NaN,50
1664992800,0.98754,0.98848,0.98736,0.98846,2754,3660,-803779,-805223.6,42.94955086264044,43.131522038280615,32.412685318887604,NaN,NaN,50
1664994600,0.98846,0.98956,0.98786,0.98948,2403,3602.2,-801376,-804604.2,41.00590686110764,47.598028543469766,33.4655513156114,NaN,NaN,50
1664996400,0.98948,0.9897,0.98908,0.98946,2496,3589.15,-803872,-804002.4,39.07917544522378,47.51921875438743,34.28714581371036,NaN,NaN,50
1664998200,0.98946,0.98954,0.98829,0.98854,2872,3593.75,-806744,-804460.8,37.79512539458127,43.91702838058991,34.83190063636567,NaN,NaN,50
1665000000,0.98854,0.98899,0.98826,0.98865,2769,3571.7,-803975,-803949.2,36.62168557087265,44.45915334459175,36.02513042070989,NaN,NaN,50
1665001800,0.98865,0.98876,0.98842,0.98854,635,3485.15,-804610,-804115.4,35.532062877428935,44.00109942833752,37.20352216290091,NaN,NaN,50
1665003600,0.98854,0.98879,0.98756,0.9886,333,3362.65,-804277,-804695.6,35.08349660923283,44.33796585874357,38.802072479700364,NaN,NaN,50
1665005400,0.9886,0.98861,0.98795,0.98857,483,3227.85,-804760,-804873.2,34.66697078876501,44.19481162100377,40.06182807222219,NaN,NaN,50
1665007200,0.98857,0.989,0.98848,0.98877,1282,3087.65,-803478,-804220,33.817677457883605,45.45909437386156,41.42912496462901,NaN,NaN,50
1665009000,0.98877,0.98904,0.9885,0.98895,1627,2941.75,-801851,-803795.2,32.9807873889504,46.63098218716629,42.44749006276271,NaN,NaN,50
1665010800,0.98895,0.98991,0.9888,0.98987,1628,2800.9,-800223,-802917.8,31.20784618895905,52.27524707686007,43.861840753581724,NaN,NaN,50
1665012600,0.98987,0.99122,0.98964,0.99118,1778,2634.55,-798445,-801751.4,29.602843626989095,58.935000511744455,45.79914960208887,NaN,NaN,50
1665014400,0.99118,0.99258,0.99083,0.99246,2796,2379.7,-795649,-799929.2,29.081779542922508,64.19284392978352,47.52940829206623,NaN,NaN,50
1665016200,0.99246,0.99262,0.9916,0.99168,2236,2175.4,-797885,-798810.6,28.623948315570264,59.217160704256045,48.990654053791175,NaN,NaN,50
1665018000,0.99168,0.99193,0.99058,0.9909,2931,2115.55,-800816,-798603.6,27.1994850794758,54.65490198403544,49.81375262134509,NaN,NaN,50
1665019800,0.9909,0.99133,0.9903,0.9911,3525,2115.1,-797291,-798017.2,25.623570431229897,55.59948559835057,50.38528526812229,NaN,NaN,50
1665021600,0.9911,0.99183,0.99066,0.99093,2566,2101.6,-799857,-798299.6,24.56014818631102,54.559131646392295,50.88813618897978,NaN,NaN,50
1665023400,0.99093,0.99192,0.99048,0.99154,2285,2095.45,-797572,-798684.2,23.39574242454811,57.62323720142163,51.867151104753475,NaN,NaN,50
1665025200,0.99154,0.99266,0.99134,0.99254,2172,2082.6,-795400,-798187.2,22.905035769040158,62.13132214873686,53.12944887647813,NaN,NaN,50
1665027000,0.99254,0.99254,0.99142,0.99166,1694,2063.25,-797094,-797442.8,22.44937958892563,56.44112479758464,54.018022117138635,NaN,NaN,50
1665028800,0.99166,0.9917,0.99094,0.99119,1514,2001.25,-798608,-797706.2,21.497839253474265,53.6167823671759,54.6807947248838,NaN,NaN,50
1665030600,0.99119,0.99212,0.99094,0.9921,1544,1958.3,-797064,-797147.6,20.980665986036932,57.99914251175573,55.666818359937515,NaN,NaN,50
1665032400,0.9921,0.99212,0.99124,0.99202,1637,1915.35,-798701,-797373.4,20.500433666273697,57.484939578347095,56.52580730311506,NaN,NaN,50
1665034200,0.99202,0.99262,0.9919,0.99226,2239,1883.7,-796462,-797585.8,20.497313985870694,58.66879053462271,57.385650756504795,NaN,NaN,50
1665036000,0.99226,0.99228,0.99024,0.99074,3746,1932.55,-800208,-798208.6,19.33936079889597,49.30480917389344,57.173476620578604,NaN,NaN,50
1665037800,0.99074,0.99143,0.9893,0.98966,2796,2040.6,-803004,-799087.8,19.025171022477824,43.93863442309249,56.10230761424633,NaN,NaN,50
1665039600,0.98966,0.99134,0.98941,0.99121,5743,2311.1,-797261,-799127.2,18.733423372946685,52.011143734278726,55.23218617171027,NaN,NaN,50
1665041400,0.99121,0.99205,0.99074,0.99105,4606,2517.25,-801867,-799760.4,17.73305288593627,51.191703225151294,54.65893920891707,NaN,NaN,50
1665043200,0.99105,0.9913,0.98802,0.98821,4590,2682.65,-806457,-801759.4,18.629535790607115,39.34298496081038,53.56523085011528,NaN,NaN,50
1665045000,0.98821,0.98918,0.98753,0.98886,4191,2810.85,-802266,-802171,19.708308285703392,42.616672474697616,52.63788705556864,NaN,NaN,50
1665046800,0.98886,0.99028,0.9885,0.98996,3702,2914.55,-798564,-801283,19.689712832985677,47.75546482297298,52.151910853895835,NaN,NaN,50
1665048600,0.98996,0.98998,0.98864,0.98888,3490,3000.15,-802054,-802241.6,19.672445626890653,43.62476014680498,51.15201963570893,NaN,NaN,50
1665050400,0.98888,0.98946,0.98742,0.9879,3809,3050.8,-805863,-803040.8,20.351435585433954,40.2247412382256,49.5872638563867,NaN,NaN,50
1665052200,0.9879,0.98865,0.98784,0.98854,3923,3135.15,-801940,-802137.4,20.981926261224157,43.33096460265509,48.65082384246316,NaN,NaN,50
1665054000,0.98854,0.98933,0.98729,0.98759,4211,3199.15,-806151,-802914.4,20.899071717751546,40.00757144497879,47.678737348020505,NaN,NaN,50
1665055800,0.98759,0.98768,0.9858,0.98687,4657,3255.75,-810808,-805363.2,21.65808634373941,37.65062799196409,46.22527202517825,NaN,NaN,50
1665057600,0.98687,0.98693,0.98558,0.98588,4067,3330.8,-814875,-807927.4,22.47383173289922,34.62968265462163,44.59275367348357,NaN,NaN,50
1665059400,0.98588,0.98824,0.98584,0.98684,4540,3443.55,-810335,-808821.8,22.024209920459818,39.68358541985233,43.23666759385712,NaN,NaN,50
1665061200,0.98684,0.98706,0.98307,0.9833,5514,3610.65,-815849,-811603.6,22.949684162929827,30.36194098950041,41.88360558068619,NaN,NaN,50
1665063000,0.9833,0.98504,0.98186,0.98292,6578,3854.85,-822427,-814858.8,24.25233736252753,29.55926498924829,40.85650776398303,NaN,NaN,50
1665064800,0.98292,0.98442,0.98184,0.98364,6425,4100.4,-816002,-815897.6,25.46906927917561,33.164641391389125,39.5103290252052,NaN,NaN,50
1665066600,0.98364,0.98447,0.98238,0.98408,5819,4314.15,-810183,-814959.2,26.553016359432874,35.342601025000974,38.378250296623044,NaN,NaN,50
1665068400,0.98408,0.98448,0.98223,0.98308,4467,4455.65,-814650,-815822.2,27.620902897333348,32.73195775176208,37.90603406740531,NaN,NaN,50
1665070200,0.98308,0.98338,0.9804,0.98048,4802,4583.8,-819452,-816542.8,29.28012013018062,27.12232990846755,36.799295312674595,NaN,NaN,50
1665072000,0.98048,0.98104,0.97883,0.97988,4561,4624.55,-824013,-816860,31.272417252686964,26.014335935373524,35.24635753498892,NaN,NaN,50
1665073800,0.97988,0.9806,0.97915,0.98026,3238,4646.65,-820775,-817814.6,33.12240743787142,28.01991500438372,34.13172573910168,NaN,NaN,50
1665075600,0.98026,0.98143,0.97994,0.9814,3278,4523.4,-817497,-819277.4,34.0195621251382,33.81620145200448,33.673972897228744,NaN,NaN,50
1665077400,0.9814,0.98168,0.98074,0.98164,2491,4417.65,-815006,-819348.6,34.611598784085714,35.00285204024273,33.079107714199296,NaN,NaN,50
1665079200,0.98164,0.98169,0.98064,0.98074,2706,4323.45,-817712,-819000.6,35.20205899986504,32.639488837895925,32.55281609940766,NaN,NaN,50
1665081000,0.98074,0.9812,0.97922,0.97926,2825,4255.15,-820537,-818305.4,36.285864845264015,29.153531292477055,31.945880620872874,NaN,NaN,50
1665082800,0.97926,0.98002,0.97898,0.97981,3350,4237.55,-817187,-817587.8,37.3749598295392,32.057589733788504,31.76215969795623,NaN,NaN,50
1665084600,0.97981,0.98014,0.97937,0.97968,2388,4182.45,-819575,-818003.4,38.2519646861777,31.726553609905963,31.19380028296005,NaN,NaN,50
1665086400,0.97968,0.98024,0.97942,0.97947,2445,4114.25,-822020,-819406.2,38.94860902391909,31.166672791347025,31.2512811259491,NaN,NaN,50
1665088200,0.97947,0.9795,0.979,0.97922,1139,3975.05,-823159,-820495.6,39.77170680341583,30.477144077373453,31.31684391795804,NaN,NaN,50
1665090000,0.97922,0.98001,0.97861,0.97916,2324,3880.7,-825483,-821484.8,39.90810378298815,30.303861137687747,31.11250247126509,NaN,NaN,50
1665091800,0.97916,0.97949,0.97916,0.9793,1209,3708.3,-824274,-822902.2,40.03475812116245,31.28558837353326,30.822715853303105,NaN,NaN,50
1665093600,0.9793,0.97977,0.97918,0.97934,1042,3557.05,-823232,-823633.6,39.78941454089903,31.582118200460386,30.740584456781562,NaN,NaN,50
1665095400,0.97934,0.97954,0.97928,0.97929,653,3362.7,-823885,-824006.6,39.56159550208301,31.399711450464906,31.04611170978137,NaN,NaN,50
1665097200,0.97929,0.97962,0.9789,0.9796,1036,3138.8,-822849,-823944.6,39.592024901323526,33.94694593950206,31.612726710076267,NaN,NaN,50
1665099000,0.9796,0.97972,0.97866,0.97894,1305,2875.15,-824154,-823678.8,39.7706059570147,31.28360535177569,31.845847449175693,NaN,NaN,50
1665100800,0.97894,0.97976,0.97865,0.97944,2543,2681.05,-821611,-823146.2,39.87294648843771,35.41743021314238,31.960220932114115,NaN,NaN,50
1665102600,0.97944,0.97964,0.9788,0.97932,2866,2533.4,-824477,-823395.2,39.96797698190194,34.87517464065198,31.951101117857633,NaN,NaN,50
1665104400,0.97932,0.9799,0.97866,0.97954,2551,2437.6,-821926,-823003.4,39.60205128171426,36.786022937422736,32.247282124966695,NaN,NaN,50
1665106200,0.97954,0.97991,0.97892,0.9798,2479,2321.45,-819447,-822323,39.24433195772425,39.06167318171466,32.95500654562652,NaN,NaN,50
1665108000,0.9798,0.98052,0.97938,0.98005,2146,2200.7,-817301,-820952.4,37.864538395793794,41.25164951120783,33.611725101156466,NaN,NaN,50
1665109800,0.98005,0.9812,0.98005,0.98078,1591,2118.35,-815710,-819772.2,35.59231272360033,47.21668574353613,34.718163110701475,NaN,NaN,50
1665111600,0.98078,0.98117,0.98044,0.98046,1862,2047.55,-817572,-818391.2,33.48238888513496,45.05699562979035,35.710329027733145,NaN,NaN,50
1665113400,0.98046,0.9809,0.98022,0.98048,1503,1998.15,-816069,-817219.8,31.80233918520355,45.22562687899271,36.763792084991664,NaN,NaN,50
1665115200,0.98048,0.98074,0.98033,0.98044,1348,1930.25,-817417,-816813.8,30.242293035267238,44.928622103562844,37.80841786826846,NaN,NaN,50
1665117000,0.98044,0.98058,0.97916,0.97918,1559,1866.95,-818976,-817148.8,30.106925397935974,36.743046310123134,38.19823629231059,NaN,NaN,50
1665118800,0.97918,0.98002,0.97918,0.97992,1614,1780.15,-817362,-817479.2,29.981226877556942,43.2790931820797,39.0337345052834,NaN,NaN,50
1665120600,0.97992,0.98041,0.97986,0.98013,1628,1742.15,-815734,-817111.6,29.193763805881233,45.015375747907434,40.006281955100725,NaN,NaN,50
1665122400,0.98013,0.98013,0.97724,0.97746,3392,1789.5,-819126,-817723,30.466140903111366,31.720292254503462,39.847235263315106,NaN,NaN,50
1665124200,0.97746,0.97822,0.97658,0.97818,3574,1911.25,-815552,-817350,31.972543081399724,37.11403052312448,40.263694204125734,NaN,NaN,50
1665126000,0.97818,0.97998,0.97817,0.97959,4153,2002.7,-811399,-815834.6,31.230546725677854,46.09456296210692,41.02634654333748,NaN,NaN,50
1665127800,0.97959,0.98091,0.97952,0.97988,4014,2142.95,-807385,-813839.2,29.66308755743906,47.74736223431684,41.94578851431355,NaN,NaN,50
1665129600,0.97988,0.98162,0.97933,0.98141,4052,2293.45,-803333,-811359,27.608246304619893,55.49963782580657,43.28247529205525,NaN,NaN,50
1665131400,0.98141,0.9817,0.98018,0.98018,3151,2418.35,-806484,-808830.6,25.63880081893978,49.1823762963658,44.00538265738748,NaN,NaN,50
1665133200,0.98018,0.98112,0.97924,0.98074,2757,2504.4,-803727,-806465.6,24.552198591648402,51.86855678785509,44.76373317714799,NaN,NaN,50
1665135000,0.98074,0.98111,0.97984,0.98062,2767,2577.5,-806494,-805484.6,23.54321080916355,51.24347433518543,45.05136093369437,NaN,NaN,50
1665136800,0.98062,0.98085,0.97952,0.98037,3070,2603.85,-809564,-805920.4,22.860008035959737,49.89442264343622,45.39689143466908,NaN,NaN,50
1665138600,0.98037,0.98037,0.97909,0.97968,2909,2606,-812473,-807748.4,22.55906475171473,46.273524034650436,45.47174123150177,NaN,NaN,50
1665140400,0.97968,0.98048,0.9795,0.97964,2399,2598.4,-814872,-809426,22.154777056675044,46.064820727134425,45.5528982760426,NaN,NaN,50
1665142200,0.97964,0.98028,0.97872,0.97874,3331,2641,-818203,-812321.2,22.379566439938564,41.52655555815914,45.894577508045174,NaN,NaN,50
1665144000,0.97874,0.9804,0.97873,0.98039,3436,2705.5,-814767,-813975.8,22.440829729317777,51.048260690285716,46.4495180443456,NaN,NaN,50
1665145800,0.98039,0.98039,0.97262,0.97503,11081,3180,-825848,-817232.6,25.100227429255618,32.52169957497901,45.55711260342214,NaN,NaN,50
1665147600,0.97503,0.97686,0.97417,0.9762,7199,3446.85,-818649,-818467.8,27.56966815062647,37.82600354015146,45.993234838111285,NaN,NaN,50
1665149400,0.9762,0.97692,0.97422,0.97488,8606,3802,-827255,-820944.4,29.80139915703776,34.52829579419523,45.80853950033062,NaN,NaN,50
1665151200,0.97488,0.97789,0.97442,0.97675,7051,4087.15,-820204,-821344.6,30.90273693391235,42.21420354644132,45.53137097064022,NaN,NaN,50
1665153000,0.97675,0.97912,0.97578,0.97862,7322,4375.3,-812882,-820967.6,30.839835346748103,48.69973823561616,45.59939782787588,NaN,NaN,50
1665154800,0.97862,0.97902,0.97712,0.97876,5940,4591.6,-806942,-817186.4,30.78142673009559,49.15978625299687,45.14655128696091,NaN,NaN,50
1665156600,0.97876,0.97892,0.97732,0.9784,4926,4756.5,-811868,-815830.2,30.727190157489687,47.9685462004743,45.05984913725437,NaN,NaN,50
1665158400,0.9784,0.97845,0.9765,0.97652,4122,4793,-815990,-813577.2,31.077481807075785,42.21546025999786,44.370342242407425,NaN,NaN,50
1665160200,0.97652,0.97656,0.97555,0.97612,3285,4778.55,-819275,-813391.4,31.820758788705472,41.08636938630726,43.64483474605898,NaN,NaN,50
1665162000,0.97612,0.97684,0.97576,0.9767,2424,4692.1,-816851,-814185.2,32.2274941279661,43.4482404015311,43.18439315735147,NaN,NaN,50
1665163800,0.9767,0.97694,0.97562,0.97572,2501,4616.45,-819352,-816667.2,32.67158057958441,40.49420286916464,42.771584502673925,NaN,NaN,50
1665165600,0.97572,0.97634,0.97481,0.97482,2392,4533.45,-821744,-818642.4,33.456957932555945,37.94282603521972,42.19144202468002,NaN,NaN,50
1665167400,0.97482,0.97506,0.97343,0.97354,2271,4489.45,-824015,-820247.4,34.72820169420767,34.60353434776769,41.69694050965205,NaN,NaN,50
1665169200,0.97354,0.97387,0.97308,0.9732,2571,4480.15,-826586,-821709.6,36.03218768147079,33.7537660049817,40.461619460701776,NaN,NaN,50
1665171000,0.9732,0.974,0.9731,0.97388,2475,4465.55,-824111,-823161.6,37.09010766315174,37.08167848292703,40.787332239840914,NaN,NaN,50
1665172800,0.97388,0.97402,0.97368,0.97388,1690,4396.55,-824111,-824113.4,38.04753774894031,37.08167848292703,40.73416616432488,NaN,NaN,50
1665174600,0.97388,0.97452,0.97355,0.97422,1279,4315.05,-822832,-824331,38.306347411212336,38.862648841616945,41.043762810569284,NaN,NaN,50
1665349200,0.97422,0.97422,0.9734,0.97364,99,4200.05,-822931,-824114.2,38.62412102650072,36.94163944939972,40.66715108935204,NaN,NaN,50
1665351000,0.97364,0.97376,0.97363,0.9737,262,4046.6,-822669,-823330.8,38.919196526411355,37.28699199542185,39.851954929338156,NaN,NaN,50
1665352800,0.9737,0.97396,0.97293,0.9733,1768,3963.2,-824437,-823396,39.566975809843264,35.876334828723216,38.90313697046146,NaN,NaN,50
1665354600,0.9733,0.97352,0.97299,0.97315,2128,3515.55,-826565,-823886.8,40.16848514445861,35.33644770476644,38.000844220768045,NaN,NaN,50
1665356400,0.97315,0.9737,0.97276,0.97352,1961,3253.65,-824604,-824241.2,40.85208754516381,37.822021425418676,37.68702716115524,NaN,NaN,50
1665358200,0.97352,0.97354,0.97282,0.97346,2212,2933.95,-826816,-825018.2,41.48686120296151,37.56982410890688,37.43584535562665,NaN,NaN,50
1665360000,0.97346,0.97371,0.97268,0.97282,2283,2695.55,-829099,-826304.2,41.77632260622021,34.89684653308046,36.825031507880176,NaN,NaN,50
1665361800,0.97282,0.97416,0.97247,0.97378,2485,2453.7,-826614,-826739.6,41.2754998932373,41.60783751357028,36.90457683962343,NaN,NaN,50
1665363600,0.97378,0.97457,0.97369,0.97408,2397,2276.55,-824217,-826270,40.15856958917147,43.56561413461278,37.306204561008656,NaN,NaN,50
1665365400,0.97408,0.97534,0.97395,0.97504,2684,2164.45,-821533,-825655.8,38.04033830505128,49.41083289945603,38.36386874327211,NaN,NaN,50
1665367200,0.97504,0.97506,0.97447,0.9746,1654,2041.05,-823187,-824930,36.0734092555111,47.00762468384387,39.3105729346194,NaN,NaN,50
1665369000,0.9746,0.97462,0.9741,0.97454,1658,1959.7,-824845,-824079.2,34.649139915454434,46.67425212355302,39.99575676609269,NaN,NaN,50
1665370800,0.97454,0.97462,0.97358,0.97369,1507,1913.85,-826352,-824026.8,33.847404550362455,42.11730038908041,40.35544404510364,NaN,NaN,50
1665372600,0.97369,0.9739,0.97325,0.9738,1503,1863.95,-824849,-824153.2,33.40969689015863,42.89432499734086,40.64342091336964,NaN,NaN,50
1665374400,0.9738,0.97398,0.97328,0.97342,1425,1815.6,-826274,-825101.4,32.8716051743919,40.8540142115495,40.92287625352319,NaN,NaN,50
1665376200,0.97342,0.97409,0.97339,0.97398,1223,1763.2,-825051,-825474.2,32.18383972297945,45.00551158570099,41.47419908140027,NaN,NaN,50
1665378000,0.97398,0.97436,0.9736,0.97362,1668,1718.05,-826719,-825849,31.083877119143555,42.919882043496216,41.9773095967412,NaN,NaN,50
1665379800,0.97362,0.97362,0.97161,0.9717,2692,1728.9,-829411,-826460.8,31.80859974819056,33.89747809788679,41.87452605339265,NaN,NaN,50
1665381600,0.9717,0.97337,0.9717,0.973,3023,1795.55,-826388,-826768.6,32.481556475162776,42.683112959264385,42.22174687723878,NaN,NaN,50
1665383400,0.973,0.97324,0.97166,0.97192,2474,1855.3,-828862,-827286.2,33.13499685003539,38.14703046952752,42.26297590299739,NaN,NaN,50
1665385200,0.97192,0.97331,0.97182,0.97226,4211,2060.9,-824651,-827206.2,33.61372866236472,40.2980923836941,42.64877917804123,NaN,NaN,50
1665387000,0.97226,0.97256,0.96992,0.9707,3364,2216,-828015,-827465.4,35.21874045791037,34.38875049602525,42.13313010535944,NaN,NaN,50
1665388800,0.9707,0.9709,0.96874,0.96924,3185,2286.85,-831200,-827823.2,37.1889938221847,29.960638165821834,41.161346107588656,NaN,NaN,50
1665390600,0.96924,0.96931,0.96816,0.96886,3309,2345.9,-834509,-829447.4,39.217556124243416,28.916951432723707,39.697497431393494,NaN,NaN,50
1665392400,0.96886,0.97094,0.96886,0.96962,3589,2427.3,-830920,-829859,38.91519556037344,33.878066783525625,38.759671867085046,NaN,NaN,50
1665394200,0.96962,0.97094,0.96936,0.97068,2664,2449.9,-828256,-830580,38.63443217963703,40.151999819928896,38.29379670254046,NaN,NaN,50
1665396000,0.97068,0.97096,0.96976,0.97046,2329,2452.2,-830585,-831094,38.34843156485182,39.318147985947405,38.09385724517382,NaN,NaN,50
1665397800,0.97046,0.97087,0.96884,0.96927,2492,2452.55,-833077,-831469.4,38.61983611739016,35.074998496336846,37.535333923673534,NaN,NaN,50
1665399600,0.96927,0.97067,0.96916,0.97066,2370,2451.2,-830707,-830709,38.87185463046146,42.8352549364248,37.67685111830748,NaN,NaN,50
1665401400,0.97066,0.97066,0.96872,0.96973,2894,2461.7,-833601,-831245.2,39.35365753712936,39.43869363511175,37.27922126469396,NaN,NaN,50
1665403200,0.96973,0.97143,0.96938,0.97132,3134,2535.7,-830467,-831687.4,38.744969407944666,47.15393651586361,37.581653727005914,NaN,NaN,50
1665405000,0.97132,0.97192,0.97069,0.97147,2680,2586.8,-827787,-831127.8,37.57180213129034,47.82918068550795,38.57677534040743,NaN,NaN,50
1665406800,0.97147,0.97219,0.97014,0.97014,2572,2640.05,-830359,-830584.2,36.88695213679795,42.62814642060363,38.57284915907452,NaN,NaN,50
1665408600,0.97014,0.97064,0.96942,0.97,4710,2800.4,-835069,-831456.6,36.73045346924348,42.1090674022016,38.85585179712267,NaN,NaN,50
1665410400,0.97,0.97122,0.96952,0.97089,3556,2906.95,-831513,-831039,35.86540907695209,46.56377734186347,39.3034007227062,NaN,NaN,50
1665412200,0.97089,0.97464,0.96983,0.97026,7914,3241.5,-839427,-832831,34.41172113075233,43.98368234139162,39.98875299737522,NaN,NaN,50
1665414000,0.97026,0.97038,0.96856,0.96864,3977,3356.95,-843404,-835954.4,32.12046451216658,38.13251999206168,40.57245884210664,NaN,NaN,50
1665415800,0.96864,0.9705,0.9686,0.97028,3143,3379.5,-840261,-837934.8,30.072932467310654,45.96878024705333,41.790446614558746,NaN,NaN,50
1665417600,0.97028,0.97047,0.96926,0.96939,2589,3357.8,-842850,-839491,28.171652711373007,42.80048288764887,42.42776205056755,NaN,NaN,50
1665419400,0.96939,0.97012,0.96897,0.96919,2019,3335.05,-844869,-842162.2,26.17588657783693,42.09829690708474,42.566783271078684,NaN,NaN,50
1665421200,0.96919,0.97064,0.96852,0.9702,2763,3262.65,-842106,-842698,24.727189747513165,46.841304921012494,43.104151623583334,NaN,NaN,50
1665423000,0.9702,0.97186,0.96995,0.97134,3478,3268.35,-838628,-841742.8,24.225093650643984,51.655036987060804,44.288440087206475,NaN,NaN,50
1665424800,0.97134,0.97198,0.97134,0.97153,2671,3242.65,-835957,-840882,23.83594462976225,52.428234247950606,44.973652895172606,NaN,NaN,50
1665426600,0.97153,0.9724,0.9703,0.97032,2350,3194.7,-838307,-839973.4,22.549517297880048,47.24596201180865,45.531314922079524,NaN,NaN,50
1665428400,0.97032,0.97096,0.97014,0.97061,2295,3130,-836012,-838202,21.22084564745857,48.55836457711023,45.631631212168564,NaN,NaN,50
1665430200,0.97061,0.97087,0.97019,0.97024,1709,3082.25,-837721,-837325,19.987079114924345,46.95339511594194,45.56907510005671,NaN,NaN,50
1665432000,0.97024,0.97073,0.97024,0.97072,551,2993.35,-837170,-837033.4,18.84143876328542,49.294814937168304,46.04526570838276,NaN,NaN,50
1665433800,0.97072,0.97073,0.97043,0.97046,492,2893.35,-837662,-837374.4,17.77762986533499,48.0574460871673,46.47014990016602,NaN,NaN,50
1665435600,0.97046,0.97049,0.97013,0.97048,2338,2891.75,-835324,-836777.8,16.543832450275538,48.16523160973413,46.58453949072821,NaN,NaN,50
1665437400,0.97048,0.97053,0.97008,0.97039,425,2768.3,-835749,-836725.2,15.45238572031265,47.68569425916788,46.84896891342652,NaN,NaN,50
1665439200,0.97039,0.97053,0.9701,0.97051,905,2656.85,-834844,-836149.8,14.4388994710614,48.42303459557702,47.584005670820474,NaN,NaN,50
1665441000,0.97051,0.9709,0.97036,0.97084,870,2566.35,-833974,-835510.6,13.761806145727137,50.48965565483095,47.90692534280459,NaN,NaN,50
1665442800,0.97084,0.97104,0.9708,0.97102,1077,2491.6,-832897,-834557.6,13.298923793896094,51.62817595175256,48.53747484738342,NaN,NaN,50
1665444600,0.97102,0.97114,0.97088,0.97114,1150,2313.6,-831747,-833842.2,12.991266792226977,52.41380802863812,49.27429707035152,NaN,NaN,50
1665446400,0.97114,0.97202,0.96988,0.97195,2903,2280.95,-828844,-832461.2,12.711253979160968,57.43873470985736,50.031256340983305,NaN,NaN,50
1665448200,0.97195,0.97227,0.97155,0.97203,3177,2044.1,-825667,-830625.8,12.118474983119677,57.91145295213754,50.47814319563164,NaN,NaN,50
1665450000,0.97203,0.97214,0.97134,0.97155,2998,1995.15,-828665,-829564,11.822036334364453,54.03363055679701,50.59281436054924,NaN,NaN,50
1665451800,0.97155,0.9717,0.96922,0.96971,4241,2050.05,-832906,-829565.8,13.439830184209958,42.33184954979467,50.24180632754825,NaN,NaN,50
1665453600,0.96971,0.96999,0.96812,0.96848,3834,2112.3,-836740,-830564.4,15.590851695476712,36.62225952570257,49.389227395304836,NaN,NaN,50
1665455400,0.96848,0.96914,0.96825,0.96869,2974,2160.05,-833766,-831548.8,17.588228813081553,38.155938800844844,48.76083765851219,NaN,NaN,50
1665457200,0.96869,0.96952,0.96866,0.96933,2456,2144.7,-831310,-832677.4,18.903460637886475,42.70634035992294,48.29023233156609,NaN,NaN,50
1665459000,0.96933,0.9696,0.96816,0.96822,2243,2082.95,-833553,-833655,20.441901147703252,37.54636833845107,47.539441063800645,NaN,NaN,50
1665460800,0.96822,0.96852,0.96758,0.96776,2404,2069.6,-835957,-834265.2,22.209755999849616,35.62534095507921,46.64373458846814,NaN,NaN,50
1665462600,0.96776,0.96829,0.96704,0.96772,2030,2053.6,-837987,-834514.6,24.141222577002505,35.45546354548533,45.77014668034796,NaN,NaN,50
1665464400,0.96772,0.96843,0.96762,0.96832,2374,2057.55,-835613,-834884,25.718788391903193,40.07166501159112,45.17362028149182,NaN,NaN,50
1665466200,0.96832,0.96877,0.96786,0.9686,2055,2074.85,-833558,-835333.6,26.658185454310658,42.15094512871341,44.57799810105485,NaN,NaN,50
1665468000,0.9686,0.96947,0.96748,0.96913,3838,2239.2,-829720,-834567,26.535037083221642,45.972155533282844,44.17399664259273,NaN,NaN,50
1665469800,0.96913,0.97028,0.96852,0.96908,3998,2414.5,-833718,-834119.2,25.428743166088797,45.665695686575155,43.69198861815966,NaN,NaN,50
1665471600,0.96908,0.9718,0.96894,0.97113,6093,2602.25,-827625,-832046.8,24.278289869798133,58.02156918037305,43.733619651767924,NaN,NaN,50
1665473400,0.97113,0.9725,0.96966,0.9699,4541,2808.05,-832166,-831357.4,23.750103380979308,50.58821790434532,43.21053143406848,NaN,NaN,50
1665475200,0.9699,0.972,0.9697,0.97067,3884,2957,-828282,-830302.2,23.25964449850468,54.51663898862013,43.24503203634157,NaN,NaN,50
1665477000,0.97067,0.9713,0.9699,0.97076,3817,3104.35,-824465,-829251.2,22.80421839334967,54.96730203721295,44.14756435687145,NaN,NaN,50
1665478800,0.97076,0.97191,0.97024,0.97036,3365,3218.75,-827830,-828073.6,22.875305065220783,52.47854034772288,45.280155844158614,NaN,NaN,50
1665480600,0.97036,0.97106,0.96972,0.96994,3073,3314.9,-830903,-828729.2,22.31378470306245,49.92260360452065,46.120631901564025,NaN,NaN,50
1665482400,0.96994,0.97196,0.9692,0.97068,3795,3359.5,-827108,-827717.6,22.501519292270547,54.158937138695315,46.938674528619195,NaN,NaN,50
1665484200,0.97068,0.97177,0.97027,0.97176,3338,3367.55,-823770,-826815.2,22.675844267963782,59.53871993636544,48.509556785613086,NaN,NaN,50
1665486000,0.97176,0.97381,0.97148,0.97376,4161,3425.7,-819609,-825844,24.09732379402813,67.21249917921457,50.76578237305132,NaN,NaN,50
1665487800,0.97376,0.97376,0.97156,0.97249,4062,3416.75,-823671,-825012.2,25.417269068230734,59.49607005426313,52.482968552249744,NaN,NaN,50
1665489600,0.97249,0.97281,0.97188,0.9723,4322,3441.15,-827993,-824430.2,26.642932537133156,58.41555847871975,53.79324665704464,NaN,NaN,50
1665491400,0.9723,0.97327,0.97176,0.97198,3922,3488.55,-831915,-825391.6,28.035604735048953,56.552717913243875,54.82194471308253,NaN,NaN,50
1665493200,0.97198,0.97216,0.97108,0.97155,3806,3556.05,-835721,-827781.8,28.39019840237792,54.05806126346546,55.39950940809558,NaN,NaN,50
1665495000,0.97155,0.9717,0.96992,0.9702,5677,3727.75,-841398,-832139.6,27.372669829918205,47.042004222071576,55.49781716063104,NaN,NaN,50
1665496800,0.9702,0.97082,0.96907,0.96998,5666,3890.85,-847064,-836818.2,25.607476775397824,45.99436707844453,54.638731296207574,NaN,NaN,50
1665498600,0.96998,0.972,0.96972,0.97076,5659,4072.3,-841405,-839500.6,24.877490367817792,50.22668463745473,54.612907491429674,NaN,NaN,50
1665500400,0.97076,0.9724,0.97074,0.97213,4414,4174.3,-836991,-840515.8,24.47499009641279,56.65231504763774,54.7654557813595,NaN,NaN,50
1665502200,0.97213,0.97631,0.97211,0.97562,4315,4287.3,-832676,-839906.8,25.970995211637266,67.98942176768273,55.69560719067878,NaN,NaN,50
1665504000,0.97562,0.97648,0.97436,0.9762,3867,4288.75,-828809,-837389,27.418427967917967,69.420785162823,56.90576753461449,NaN,NaN,50
1665505800,0.9762,0.97748,0.97598,0.97656,3909,4284.3,-824900,-832956.2,29.09471435199072,70.30825043369907,58.361885165270095,NaN,NaN,50
1665507600,0.97656,0.97668,0.97493,0.97516,3031,4131.2,-827931,-830261.4,29.690881052669926,62.68877554405109,58.971159337081225,NaN,NaN,50
1665509400,0.97516,0.97632,0.9749,0.97526,2694,4038.85,-825237,-827910.6,30.217620919805192,62.99724309216714,59.218196705352774,NaN,NaN,50
1665511200,0.97526,0.97532,0.9746,0.97491,2537,3971.5,-827774,-826930.2,30.426689572702642,61.09346015331185,58.781122489216855,NaN,NaN,50
1665513000,0.97491,0.97516,0.97064,0.9709,4902,4025.75,-832676,-827703.6,28.63509763130655,44.500557930278006,57.71001448036078,NaN,NaN,50
1665514800,0.9709,0.97146,0.9694,0.97107,5934,4154.2,-826742,-828072,27.572020805561742,45.180314483278835,56.764639909257866,NaN,NaN,50
1665516600,0.97107,0.97141,0.97026,0.97104,4471,4224.1,-831213,-828728.4,26.584878038798703,45.075393746522415,55.94483104020633,NaN,NaN,50
1665518400,0.97104,0.97122,0.97041,0.97085,1502,4109.45,-832715,-830224,25.668245469661592,44.37257435212614,55.25301054653922,NaN,NaN,50
1665520200,0.97085,0.97092,0.97022,0.97036,1408,4012.95,-834123,-831493.8,24.920057259530967,42.53080609019309,54.930782108547916,NaN,NaN,50
1665522000,0.97036,0.97085,0.97028,0.9707,180,3813.9,-833943,-831747.2,24.225311064409674,44.25965689717168,54.80687423845699,NaN,NaN,50
1665523800,0.9707,0.97072,0.97036,0.9704,937,3657.65,-834880,-833374.8,23.580189597511332,43.02962329272259,54.292798428118985,NaN,NaN,50
1665525600,0.9704,0.97157,0.97038,0.97154,972,3490.15,-833908,-833913.8,22.278341305595504,48.84725419999421,53.73529408185873,NaN,NaN,50
1665527400,0.97154,0.9718,0.97108,0.97134,940,3341.05,-834848,-834340.4,20.886724261145435,47.92266699219897,52.30195445503846,NaN,NaN,50
1665529200,0.97134,0.97142,0.97028,0.97033,1048,3203.15,-835896,-834695,20.173461450960836,43.44993461762914,50.44689370181033,NaN,NaN,50
1665531000,0.97033,0.97054,0.9699,0.97008,1464,2992.5,-837360,-835378.4,19.771502448891972,42.395179289101804,48.453102905767665,NaN,NaN,50
1665532800,0.97008,0.97034,0.96904,0.96958,3015,2859.95,-840375,-836477.4,19.95166955389928,40.288684602298304,46.85309640992818,NaN,NaN,50
1665534600,0.96958,0.97104,0.96944,0.97034,3377,2745.85,-836998,-837095.4,19.475843508981242,44.77995229083485,45.55186135269015,NaN,NaN,50
1665536400,0.97034,0.97122,0.96962,0.96992,3848,2717.55,-840846,-838295,18.87231773967047,42.86129261540605,44.249563671411174,NaN,NaN,50
1665538200,0.96992,0.96998,0.96832,0.96911,3162,2659.9,-844008,-839917.4,19.16670316600708,39.358804784531614,43.88229558957215,NaN,NaN,50
1665540000,0.96911,0.9693,0.96828,0.96877,2938,2613.45,-846946,-841834.6,19.464467312574342,37.956706450437856,43.36632358722637,NaN,NaN,50
1665541800,0.96877,0.96996,0.96856,0.96996,2156,2525.8,-844790,-842717.6,19.097130820406953,45.301278190709375,43.382458190382586,NaN,NaN,50
1665543600,0.96996,0.97007,0.96936,0.96996,1915,2470,-844790,-844276,18.650305329722595,45.301278190709375,43.448794178852815,NaN,NaN,50
1665545400,0.96996,0.97002,0.96934,0.96984,1624,2416.5,-846414,-845389.6,18.25113903940343,44.682671777398916,43.60249887079609,NaN,NaN,50
1665547200,0.96984,0.9735,0.9697,0.97141,5630,2571.15,-840784,-844744.8,18.610922269508116,53.608447298255214,44.27026961373063,NaN,NaN,50
1665549000,0.97141,0.97194,0.97101,0.97148,2747,2463.4,-838037,-842963,18.945006697462468,53.96510775901553,45.05137564703727,NaN,NaN,50
1665550800,0.97148,0.9718,0.97064,0.97082,2636,2298.5,-840673,-842139.6,18.919421508162984,50.057459691820895,45.13781889645346,NaN,NaN,50
1665552600,0.97082,0.97243,0.97063,0.97208,3084,2229.15,-837589,-840699.4,19.275707612738934,56.52907338262054,45.752562210055,NaN,NaN,50
1665554400,0.97208,0.9731,0.97152,0.97308,4642,2386.15,-832947,-838006,19.985033166969618,60.863557719210405,46.99639243159652,NaN,NaN,50
1665556200,0.97308,0.9733,0.97196,0.97215,4018,2516.65,-836965,-837242.2,20.754413645088327,55.33738094979712,47.92083540736047,NaN,NaN,50
1665558000,0.97215,0.97264,0.96961,0.97051,5756,2795.45,-842721,-838179,19.442524285815097,47.19887527806315,48.41442045562938,NaN,NaN,50
1665559800,0.97051,0.97224,0.97024,0.97074,5861,3041.65,-836860,-837416.4,18.224341309347096,48.34622756606185,48.669154403859885,NaN,NaN,50
1665561600,0.97074,0.97246,0.97064,0.97222,4457,3215.9,-832403,-836379.2,17.25362890235762,55.10638422721078,49.54380380470309,NaN,NaN,50
1665563400,0.97222,0.97238,0.97018,0.97038,3059,3321.85,-835462,-836882.2,16.058422006893622,46.89008050439772,50.0817520704078,NaN,NaN,50
1665565200,0.97038,0.97171,0.96976,0.97132,3027,3420.8,-832435,-835976.2,15.276907711391505,50.91637821312541,51.00744291059977,NaN,NaN,50
1665567000,0.97132,0.97145,0.97022,0.97086,3386,3516.9,-835821,-834596.2,14.551215865568112,48.960288061095454,51.26880075848449,NaN,NaN,50
1665568800,0.97086,0.9717,0.97062,0.97095,2416,3486.95,-833405,-833905.2,13.645265561928355,49.370121704898416,51.559432438069415,NaN,NaN,50
1665570600,0.97095,0.97164,0.97049,0.97163,2312,3433.7,-831093,-833643.2,12.923297001052228,52.475188066093914,52.11604074440478,NaN,NaN,50
1665572400,0.97163,0.972,0.97022,0.97105,2957,3389.15,-834050,-833360.8,12.104675984803807,49.676718019504186,51.83520293877971,NaN,NaN,50
1665574200,0.97105,0.97136,0.9702,0.97082,2372,3349.65,-836422,-834158.2,11.323647664681195,48.570542260438714,51.44987683173851,NaN,NaN,50
1665576000,0.97082,0.97118,0.97014,0.97052,3417,3373.6,-839839,-834961.8,10.53176255892053,47.09739477786887,51.23844362359908,NaN,NaN,50
1665577800,0.97052,0.97109,0.96873,0.97054,6163,3573.95,-833676,-835016,11.117396079426138,47.21234216218144,50.572962822139154,NaN,NaN,50
1665579600,0.97054,0.97087,0.96946,0.97038,3633,3659.85,-837309,-836259.2,11.661198634181348,46.344786027369196,49.535907701293354,NaN,NaN,50
1665581400,0.97038,0.9711,0.96904,0.96906,4601,3808.7,-841910,-837831.2,12.5223525344789,39.84042506609877,48.42898228102918,NaN,NaN,50
1665583200,0.96906,0.96976,0.96817,0.96866,4461,3750.25,-846371,-839821,13.97802833130777,38.09560989982312,47.77874903972632,NaN,NaN,50
1665585000,0.96866,0.97058,0.96679,0.97012,6300,3927.9,-840071,-839867.4,16.14730012109206,47.18724211761546,47.69596436483729,NaN,NaN,50
1665586800,0.97012,0.97088,0.9692,0.97062,4029,3997.55,-836042,-840340.6,17.765668817331175,49.9008826426196,47.32414282308078,NaN,NaN,50
1665588600,0.97062,0.97096,0.96894,0.96906,3075,3997.1,-839117,-840702.2,19.41969080493094,42.55414377850349,47.01443305694547,NaN,NaN,50
1665590400,0.96906,0.9695,0.96852,0.96922,2399,3884.95,-836718,-839663.8,21.195164105986667,43.47336403028693,46.48278918674272,NaN,NaN,50
1665592200,0.96922,0.96937,0.96804,0.96837,1815,3774.8,-838533,-838096.2,23.103794444715348,39.827291711690314,45.830432304642365,NaN,NaN,50
1665594000,0.96837,0.96902,0.96808,0.96892,2161,3595.05,-836372,-837356.4,24.87609404496341,43.14977399185081,45.386121753710384,NaN,NaN,50
1665595800,0.96892,0.96966,0.96868,0.96908,1318,3367.9,-835054,-837158.8,25.55256502001506,44.11646780584946,44.78907030655007,NaN,NaN,50
1665597600,0.96908,0.97205,0.96851,0.97092,7102,3500.15,-827952,-834925.8,23.860248638884404,53.837799666564486,45.08629042419723,NaN,NaN,50
1665599400,0.97092,0.97144,0.96953,0.96978,3919,3543.15,-831871,-833956.4,22.28881199926308,48.23880362373246,45.06259480728965,NaN,NaN,50
1665601200,0.96978,0.97048,0.96914,0.97,2613,3522.45,-829258,-832101.4,20.916965936320956,49.33387656563092,45.2223435064155,NaN,NaN,50
1665603000,0.97,0.97066,0.96988,0.97012,1427,3424.5,-827831,-830393.2,19.469690248313203,49.95579833160336,45.418304661374215,NaN,NaN,50
1665604800,0.97012,0.97019,0.96974,0.96979,567,3332.05,-828398,-829062,18.2630723760443,48.20347670865523,45.55106828146607,NaN,NaN,50
1665606600,0.96979,0.97038,0.96968,0.97038,504,3241.65,-827894,-829050.4,16.97596549665377,51.48041136585634,46.3824958743059,NaN,NaN,50
1665608400,0.97038,0.97054,0.96998,0.97046,190,3103.3,-827704,-828217,15.95415946669704,51.92454456449982,47.37027692178281,NaN,NaN,50
1665610200,0.97046,0.97066,0.97034,0.97066,355,3002.45,-827349,-827835.2,15.139325009699458,53.08084581152776,47.79124861420512,NaN,NaN,50
1665612000,0.97066,0.971,0.97063,0.97082,826,2872.9,-826523,-827573.6,14.761372395746195,54.03334616915283,48.08642458038606,NaN,NaN,50
1665613800,0.97082,0.97093,0.97073,0.9708,408,2585.15,-826931,-827280.2,14.410416397075304,53.88608565704674,48.895849000282006,NaN,NaN,50
1665615600,0.9708,0.9708,0.97038,0.97051,1024,2454.7,-827955,-827292.4,13.59660981450845,51.68643502755197,49.48249692865808,NaN,NaN,50
1665617400,0.97051,0.97097,0.97049,0.9705,878,2268.55,-828833,-827518.2,13.059162320705383,51.60820337649594,50.32399061900134,NaN,NaN,50
1665619200,0.9705,0.97118,0.96978,0.97118,2006,2145.8,-826827,-827413.8,12.632927895817641,56.43678359706022,51.27306273365916,NaN,NaN,50
1665621000,0.97118,0.97221,0.9711,0.97146,2466,1954.1,-824361,-826981.4,12.466296415275417,58.28264167502001,52.284932295742756,NaN,NaN,50
1665622800,0.97146,0.97148,0.97042,0.97044,2251,1865.2,-826612,-826917.6,11.65565740215817,49.975324118334534,52.009041185154906,NaN,NaN,50
1665624600,0.97044,0.97076,0.97008,0.97052,2879,1855.4,-823733,-826073.2,11.275813620266161,50.570414663102746,52.175584830824214,NaN,NaN,50
1665626400,0.97052,0.97063,0.96962,0.97014,2282,1849.55,-826015,-825509.6,11.400968118627093,47.66960890803617,52.05670856956744,NaN,NaN,50
1665628200,0.97014,0.97034,0.96976,0.96984,2008,1859.2,-828023,-825748.8,11.517183009962244,45.45291262442641,51.73507387619765,NaN,NaN,50
1665630000,0.96984,0.97032,0.96952,0.97028,1590,1830.65,-826433,-826163.2,11.882473167363832,49.18516680929447,51.80519459767189,NaN,NaN,50
1665631800,0.97028,0.97036,0.97004,0.97004,1262,1827.85,-827695,-826379.8,12.160178999597564,47.284686347508796,51.505499953504206,NaN,NaN,50
1665633600,0.97004,0.97029,0.96976,0.97026,1219,1533.7,-826476,-826928.4,12.735177195536238,49.2215748040223,51.31243068489867,NaN,NaN,50
1665635400,0.97026,0.97061,0.97022,0.97042,846,1380.05,-825630,-826851.4,12.74599822203943,50.64196498979311,51.138224911917625,NaN,NaN,50
1665637200,0.97042,0.97058,0.97004,0.97034,1503,1324.55,-827133,-826673.4,12.977509402351735,49.89051324964712,50.84230827481007,NaN,NaN,50
1665639000,0.97034,0.97071,0.96964,0.96974,1791,1342.75,-828924,-827171.6,13.66349874920961,44.551084747283845,50.175522495541294,NaN,NaN,50
1665640800,0.96974,0.97092,0.96964,0.96972,2913,1460.05,-831837,-828000,13.92844018986192,44.38058127864755,49.65367579919097,NaN,NaN,50
1665642600,0.96972,0.97048,0.96888,0.96899,2304,1550.05,-834141,-829533,15.013000179365799,38.57717582065037,48.72288811663058,NaN,NaN,50
1665644400,0.96899,0.96972,0.9687,0.9692,3553,1718.2,-830588,-830524.6,16.197166254097237,40.968586837667445,47.61801691953109,NaN,NaN,50
1665646200,0.9692,0.97068,0.96856,0.9706,3026,1851.75,-827562,-830610.4,15.724565932276215,53.86452321889581,47.30243702980793,NaN,NaN,50
1665648000,0.9706,0.9709,0.9698,0.97004,2827,1951.8,-830389,-830903.4,14.975424923608902,49.231568562457575,47.249311632959575,NaN,NaN,50
1665649800,0.97004,0.97143,0.96998,0.9714,2246,2043.7,-828143,-830164.6,14.232732154414807,58.554774920660364,47.81962307992798,NaN,NaN,50
1665651600,0.9714,0.97408,0.9711,0.97408,3766,2180.8,-824377,-828211.8,15.821602284767975,70.17727281439576,49.42731335895366,NaN,NaN,50
1665653400,0.97408,0.97442,0.97248,0.97262,3029,2288.35,-827406,-827575.4,17.49730920275193,60.262654951732785,50.4851520966184,NaN,NaN,50
1665655200,0.97262,0.97358,0.9724,0.97347,2136,2294.85,-825270,-827117,18.94325339367387,63.496127547734375,51.50736357793554,NaN,NaN,50
1665657000,0.97347,0.9735,0.97176,0.97252,2652,2304.15,-827922,-826623.6,19.429727761105127,57.83206073087921,52.260747462462,NaN,NaN,50
1665658800,0.97252,0.97406,0.9721,0.9738,3018,2342.5,-824904,-825975.8,20.283379409900387,62.664576283709984,53.22096185386825,NaN,NaN,50
1665660600,0.9738,0.97533,0.97354,0.9745,8022,2599.65,-816882,-824476.8,21.841588209765835,65.02515982619025,54.24833291361091,NaN,NaN,50
1665662400,0.9745,0.97484,0.97333,0.97382,4638,2717.45,-821520,-823299.6,23.01383774998979,60.990943363132146,55.04122077885984,NaN,NaN,50
1665664200,0.97382,0.97386,0.96315,0.96682,12695,3251.8,-834215,-825088.6,24.419808983070716,36.13671615579144,54.4401944508961,NaN,NaN,50
1665666000,0.96682,0.96822,0.96454,0.9664,9639,3654.25,-843854,-828275,25.725353699503,35.20960459813951,53.785124688002675,NaN,NaN,50
1665667800,0.9664,0.97019,0.9654,0.96942,10173,4099.8,-833681,-830030.4,25.753785487702036,45.947959228832936,54.31160921715857,NaN,NaN,50
1665669600,0.96942,0.97016,0.96754,0.96822,9896,4533.65,-843577,-835369.4,25.780186433886854,42.90501392784051,54.44992543788522,NaN,NaN,50
1665671400,0.96822,0.97262,0.96809,0.97181,10305,5006.6,-833272,-837719.8,24.507530438419206,52.94497088701244,54.38424312846497,NaN,NaN,50
1665673200,0.97181,0.97837,0.9711,0.97677,11104,5486.65,-822168,-835310.4,24.239716921578562,62.70331312610312,55.3465105972968,NaN,NaN,50
1665675000,0.97677,0.97993,0.97602,0.97792,10713,5932.75,-811455,-828830.6,24.399245474972012,64.53949526714148,55.77399062204545,NaN,NaN,50
1665676800,0.97792,0.97992,0.97642,0.97764,8221,6198.15,-819676,-826029.6,24.547379131694505,63.71697701872934,55.312540922354984,NaN,NaN,50
1665678600,0.97764,0.97821,0.97692,0.97748,5435,6354.7,-825111,-822336.4,24.68493181293682,63.22115134271038,55.5238620931391,NaN,NaN,50
1665680400,0.97748,0.97993,0.97686,0.97932,5167,6435.4,-819944,-819670.8,25.28713430049662,66.45407972455486,55.73514439148342,NaN,NaN,50
1665682200,0.97932,0.98061,0.97932,0.97965,4621,6515.15,-815323,-818301.8,26.023277966223716,67.01410423703561,56.391004641923175,NaN,NaN,50
1665684000,0.97965,0.98006,0.97823,0.97846,4075,6577.55,-819398,-819890.4,26.12478547336315,62.934007866437746,56.410249754975155,NaN,NaN,50
1665685800,0.97846,0.97925,0.97815,0.97866,3783,6654.4,-815615,-819078.2,26.176005967700515,63.338013954534155,56.28973933557115,NaN,NaN,50
1665687600,0.97866,0.97894,0.97712,0.97728,3643,6648.25,-819258,-817907.6,25.66620690282615,58.59245119260994,56.11841846624814,NaN,NaN,50
1665689400,0.97728,0.97798,0.97712,0.97748,3239,6658.75,-816019,-817122.6,25.19282205687138,59.07106945920621,57.75658655934918,NaN,NaN,50
1665691200,0.97748,0.97786,0.97734,0.97777,1117,6607.8,-814902,-817038.4,24.75325041419909,59.79671408510077,59.512808665560705,NaN,NaN,50
1665693000,0.97777,0.97811,0.97758,0.97789,722,6511.3,-814180,-815994.8,24.450949190777845,60.11185540772741,60.52451553548174,NaN,NaN,50
1665694800,0.97789,0.97789,0.97722,0.97766,1245,6422.65,-815425,-815956.8,23.93257995317515,59.154739309272344,61.68521020558402,NaN,NaN,50
1665696600,0.97766,0.97791,0.97752,0.97764,762,6059.65,-816187,-815342.6,23.46099043045755,59.06666813142364,62.122474294470535,NaN,NaN,50
1665698400,0.97764,0.9779,0.97689,0.97694,1059,5880.7,-817246,-815588,22.579112243162594,55.9281308441006,61.63853270289893,NaN,NaN,50
1665700200,0.97694,0.97781,0.97694,0.97776,878,5289.85,-816368,-815881.2,21.760225354960134,58.69678776735758,61.22119645291436,NaN,NaN,50
1665702000,0.97776,0.97777,0.97727,0.97732,1201,4867.95,-817569,-816559,20.99983038734356,56.64061710839822,60.715742173605,NaN,NaN,50
1665703800,0.97732,0.97744,0.9767,0.97676,936,4406.1,-818505,-817175,19.84546171957284,54.045685669553784,60.060351768379526,NaN,NaN,50
1665705600,0.97676,0.9779,0.97618,0.97686,3480,4085.3,-815025,-816942.6,18.47600930999977,54.44702462561148,59.20270497559786,NaN,NaN,50
1665707400,0.97686,0.97728,0.9764,0.97681,3006,3720.35,-818031,-817099.6,17.20437492968192,54.19217949979003,58.28685320865175,NaN,NaN,50
1665709200,0.97681,0.97777,0.97681,0.97718,2452,3287.75,-815579,-816941.8,16.318122774680713,55.83940661758662,57.78009597659095,NaN,NaN,50
1665711000,0.97718,0.98088,0.97716,0.97998,4047,2954.45,-811532,-815734.4,17.33673286304024,65.84796330866395,57.95937807331451,NaN,NaN,50
1665712800,0.97998,0.98022,0.97898,0.97909,2517,2669.25,-814049,-814843.2,18.28258508794552,61.107227116026706,58.13900492498714,NaN,NaN,50
1665714600,0.97909,0.97989,0.979,0.97904,2581,2526.55,-816630,-815164.2,19.16087643964328,60.84221049797957,58.265514999185235,NaN,NaN,50
1665716400,0.97904,0.97928,0.97856,0.97881,2118,2374.1,-818748,-815307.6,19.550488790853297,59.56254548787228,58.24878867081178,NaN,NaN,50
1665718200,0.97881,0.97976,0.97846,0.97873,2028,2244.45,-820776,-816347,20.186453607292297,59.09695590363537,58.17629584909091,NaN,NaN,50
1665720000,0.97873,0.97899,0.97798,0.97799,1603,2120.85,-822379,-818516.4,20.300008549467936,54.82766112337827,57.867218835812764,NaN,NaN,50
1665721800,0.97799,0.97852,0.97788,0.97819,1795,2021.45,-820584,-819823.4,20.305169750793933,55.757931968048375,57.63088053842881,NaN,NaN,50
1665723600,0.97819,0.97864,0.97764,0.97793,2302,1954.4,-822886,-821074.6,20.061171841038615,54.19540565505076,57.507114453496676,NaN,NaN,50
1665725400,0.97793,0.9784,0.97752,0.9776,2592,1922.05,-825478,-822420.6,19.706510395721402,52.19607864096539,57.04277808732581,NaN,NaN,50
1665727200,0.9776,0.97959,0.97756,0.9794,4046,2068.5,-821432,-822551.8,20.230935145314714,60.71027400845816,57.33346786590152,NaN,NaN,50
1665729000,0.9794,0.97972,0.97766,0.97884,4498,2257.3,-825930,-823262,20.802796635221597,57.29149931043447,57.565311697392985,NaN,NaN,50
1665730800,0.97884,0.97884,0.97526,0.97626,5220,2456.05,-831150,-825375.2,19.541030598054494,44.78001388476117,56.874810930189405,NaN,NaN,50
1665732600,0.97626,0.97714,0.97552,0.9768,4466,2641.25,-826684,-826134.8,18.369390706399333,47.370644396862765,56.38755842283745,NaN,NaN,50
1665734400,0.9768,0.9768,0.97449,0.9751,4137,2795.15,-830821,-827203.4,18.03251744339892,40.87003543347422,55.31831762397228,NaN,NaN,50
1665736200,0.9751,0.97601,0.97473,0.97504,3048,2903.65,-833869,-829690.8,17.719706556327104,40.657966323395364,53.519032125024516,NaN,NaN,50
1665738000,0.97504,0.9754,0.9727,0.97285,2777,2982.45,-836646,-831834,18.655393192668974,33.770131822802284,51.56638246122277,NaN,NaN,50
1665739800,0.97285,0.97359,0.9719,0.97302,4908,3181.05,-831738,-831951.6,19.908733422242793,34.69498559262932,49.698723539412036,NaN,NaN,50
1665741600,0.97302,0.9758,0.97248,0.97513,5076,3260.85,-826662,-831947.2,19.243851434314976,44.967098981612466,48.656191646107764,NaN,NaN,50
1665743400,0.97513,0.97565,0.97324,0.97341,4743,3347.7,-831405,-832064,18.62646101695343,39.511223738876595,47.25721077719642,NaN,NaN,50
1665745200,0.97341,0.97418,0.97296,0.97352,2957,3372.95,-828448,-830979.8,18.224801129806092,40.01250241173468,46.19898515493617,NaN,NaN,50
1665747000,0.97352,0.97376,0.97092,0.97188,4634,3402.3,-833082,-830267,18.934056706841865,35.31373517974339,44.73868538434295,NaN,NaN,50
1665748800,0.97188,0.97277,0.97146,0.97226,3722,3462.55,-829360,-829791.4,19.592651171232227,37.15527650780899,43.52153330239712,NaN,NaN,50
1665750600,0.97226,0.97768,0.97166,0.97732,7025,3684.75,-822335,-828926,19.176539011633977,55.37373236482459,43.748508568387045,NaN,NaN,50
1665752400,0.97732,0.97998,0.97484,0.97498,6302,3893.95,-828637,-828372.4,19.662610137945006,48.38773999122803,42.86832756715632,NaN,NaN,50
1665754200,0.97498,0.97594,0.97302,0.97373,9804,4282.75,-838441,-830371,19.144755381013184,45.11350588965684,41.99847089424363,NaN,NaN,50
1665756000,0.97373,0.97446,0.97074,0.97402,11008,4753,-827433,-829241.2,17.909366319929322,46.02600328949508,42.08747013743892,NaN,NaN,50
1665757800,0.97402,0.97542,0.97306,0.97538,7400,5033.25,-820033,-827375.8,16.89378406694149,50.20682420283425,42.29005440929403,NaN,NaN,50
1665759600,0.97538,0.97688,0.97416,0.97476,5452,5190.75,-825485,-828005.8,16.513513027515568,48.36745999135297,42.8255847348568,NaN,NaN,50
1665761400,0.97476,0.97476,0.97339,0.97387,3941,5258.2,-829426,-828163.6,15.806561332988805,45.77497586776502,43.19108541659749,NaN,NaN,50
1665763200,0.97387,0.97482,0.97228,0.97354,4989,5305.35,-834415,-827358.4,14.696018158859994,44.815790592528614,43.98006104300651,NaN,NaN,50
1665765000,0.97354,0.97364,0.97134,0.97178,3823,5271.6,-838238,-829519.4,14.060508866808332,40.001482520549615,44.35909653785795,NaN,NaN,50
1665766800,0.97178,0.97246,0.97138,0.9719,3099,5165.55,-835139,-832540.6,13.470393095617503,40.47103529043342,44.03794913134516,NaN,NaN,50
1665768600,0.9719,0.973,0.97182,0.97284,3167,5100.6,-831972,-833838,12.652755266437559,44.15773849440945,44.36984304245465,NaN,NaN,50
1665770400,0.97284,0.97322,0.97201,0.97242,2524,5019.95,-834496,-834852,11.781182984716597,42.87991781780818,44.57465842860275,NaN,NaN,50
1665772200,0.97242,0.97262,0.97188,0.97236,2268,4980.95,-836764,-835321.8,11.04094186663996,42.689864912972105,45.10152483811909,NaN,NaN,50
1665774000,0.97236,0.97266,0.97164,0.97256,2363,4960.25,-834401,-834554.4,10.48699859512665,43.58741765226902,45.56096349129481,NaN,NaN,50
1665775800,0.97256,0.97292,0.97234,0.97282,1959,4812.8,-832442,-834015,9.813062332680826,44.79777377861714,44.805537877994276,NaN,NaN,50
1665777600,0.97282,0.97304,0.97211,0.97238,1009,4609.45,-833451,-834310.8,9.329947980652427,43.111999699552086,44.42869928573172,NaN,NaN,50
1665779400,0.97238,0.97287,0.97157,0.97237,1097,4427.15,-834548,-834321.2,9.21765699041168,43.07232868579437,44.28290091402726,NaN,NaN,50
1665954000,0.97237,0.97272,0.9721,0.97226,93,4283.95,-834641,-833896.6,9.113386785188128,42.60787504136363,44.038748896303574,NaN,NaN,50
1665955800,0.97226,0.97262,0.97202,0.97248,329,4068.7,-834312,-833878.8,9.071087774156197,43.910561193407865,43.589015824201695,NaN,NaN,50
1665957600,0.97248,0.97383,0.97231,0.97315,1011,3933.15,-833301,-834050.6,8.735224606110222,47.79673285916829,43.548249600474215,NaN,NaN,50
1665959400,0.97315,0.97338,0.97264,0.97324,913,3627.55,-832388,-833838,8.423351664353241,48.314768620397665,43.72966336851941,NaN,NaN,50
1665961200,0.97324,0.9739,0.97312,0.97382,1606,3392.75,-830782,-833084.8,8.51554541547472,51.64499428518297,44.217463632280435,NaN,NaN,50
1665963000,0.97382,0.97433,0.97379,0.97399,2231,3014.1,-828551,-831866.8,8.906927478827255,52.60884571627299,45.1179895748321,NaN,NaN,50
1665964800,0.97399,0.97499,0.97372,0.97415,2970,2612.2,-825581,-830120.6,9.716826609095033,53.54734711362907,46.052011847917505,NaN,NaN,50
1665966600,0.97415,0.97509,0.97404,0.97458,3741,2429.25,-821840,-827828.4,10.53564049469765,56.06546921989972,46.90256404259538,NaN,NaN,50
1665968400,0.97458,0.97472,0.97387,0.97424,3517,2332.5,-825357,-826422.2,11.114149484873192,53.59170129956196,47.667691434149226,NaN,NaN,50
1665970200,0.97424,0.97506,0.97413,0.97457,3040,2287.45,-822317,-824729.2,11.90289664939551,55.63766351944514,48.592534191754446,NaN,NaN,50
1665972000,0.97457,0.97524,0.9745,0.97456,2270,2151.5,-824587,-823936.4,12.769215574722256,55.557732157055106,49.44755665638202,NaN,NaN,50
1665973800,0.97456,0.97477,0.97419,0.9745,1971,2058.9,-826558,-824131.8,13.194844849579932,55.0467380938211,50.17962553603945,NaN,NaN,50
1665975600,0.9745,0.97478,0.97426,0.97454,1691,1988.5,-824867,-824737.2,13.598682145238941,55.34163322706076,51.05317078800436,NaN,NaN,50
1665977400,0.97454,0.97456,0.97388,0.97398,1417,1901,-826284,-824922.6,13.487894581430087,50.36069841269355,51.57376862564001,NaN,NaN,50
1665979200,0.97398,0.97402,0.97326,0.97353,1818,1865.7,-828102,-826079.6,12.653826881742644,46.721662477649254,51.86761058537469,NaN,NaN,50
1665981000,0.97353,0.97402,0.97346,0.97367,1585,1831.55,-826517,-826465.6,11.87933544631859,47.98104150821024,52.15835917928915,NaN,NaN,50
1665982800,0.97367,0.97482,0.97359,0.97467,2478,1837.3,-824039,-825961.8,12.003708586590214,55.9843500465162,52.743188978385426,NaN,NaN,50
1665984600,0.97467,0.9756,0.9744,0.97522,2431,1860.9,-821608,-825310,12.811020613079208,59.66044238145829,53.55359424703261,NaN,NaN,50
1665986400,0.97522,0.9754,0.97379,0.97418,2938,1957.35,-824546,-824962.4,12.800693229270998,50.9886625036479,53.506713405494395,NaN,NaN,50
1665988200,0.97418,0.97418,0.97308,0.9732,2737,2039.35,-827283,-824798.6,12.005649487036587,44.43446990479173,52.92282941896001,NaN,NaN,50
1665990000,0.9732,0.97538,0.97318,0.97409,5985,2333.95,-821298,-823754.8,12.326901381237091,50.639878889301215,52.715153117222314,NaN,NaN,50
1665991800,0.97409,0.97572,0.97394,0.97472,4312,2533.1,-816986,-822344.2,12.887644752248278,54.51239510128032,52.604219251606644,NaN,NaN,50
1665993600,0.97472,0.97544,0.97328,0.97338,3794,2672.25,-820780,-822178.6,12.685214224655669,46.208403129000274,52.07684081085223,NaN,NaN,50
1665995400,0.97338,0.97401,0.972,0.97388,4049,2829.05,-816731,-820615.6,12.237148868789486,49.311201421472134,51.62495066099702,NaN,NaN,50
1665997200,0.97388,0.97577,0.97362,0.97534,3147,2906.1,-813584,-817875.8,12.283593834604902,57.09383130776057,51.73467202890456,NaN,NaN,50
1665999000,0.97534,0.97571,0.97476,0.9753,2592,2924.15,-816176,-816851.4,12.326721302862076,56.83635786583205,51.862502012619636,NaN,NaN,50
1666000800,0.9753,0.97706,0.97488,0.97564,3801,2965.7,-812375,-815929.2,13.231221337353489,58.54754352637754,52.09149560542797,NaN,NaN,50
1666002600,0.97564,0.97612,0.97466,0.9749,2896,2923.45,-815271,-814827.4,13.858620317760858,53.56975759096583,52.32071411816171,NaN,NaN,50
1666004400,0.9749,0.97518,0.97412,0.97498,2483,2871.75,-812788,-814038.8,13.925333220456054,54.02484382841608,52.84236992893076,NaN,NaN,50
1666006200,0.97498,0.97518,0.97323,0.97408,2773,2858.4,-815561,-814434.2,13.207741302645637,48.29040641520832,52.86446742228777,NaN,NaN,50
1666008000,0.97408,0.9754,0.97298,0.97533,3767,2933.25,-811794,-813557.8,12.333975306736459,55.37517979808136,52.82095526168528,NaN,NaN,50
1666009800,0.97533,0.97848,0.9751,0.97754,3751,3022.25,-808043,-812691.4,13.436331600541413,64.6078737111373,53.17434321380519,NaN,NaN,50
1666011600,0.97754,0.97874,0.97726,0.97828,2473,3061.35,-805570,-810751.2,14.58380554938638,67.0650330496639,54.32265539566348,NaN,NaN,50
1666013400,0.97828,0.97984,0.97794,0.97822,4694,3225.2,-810264,-810246.4,16.14578918176121,66.66092064079365,55.91025901966361,NaN,NaN,50
1666015200,0.97822,0.98022,0.97822,0.9796,5102,3389.4,-805162,-808166.6,17.75680340719277,70.99061365341865,57.363882931386286,NaN,NaN,50
1666017000,0.9796,0.98192,0.97944,0.98168,6456,3632.95,-798706,-805549,19.890417050014126,76.04115865834436,58.90165175689085,NaN,NaN,50
1666018800,0.98168,0.98184,0.98046,0.9813,4250,3721.55,-802956,-804531.6,21.87162971834824,73.52274894920825,60.85267645833428,NaN,NaN,50
1666020600,0.9813,0.98486,0.98078,0.98418,3699,3784.95,-799257,-803269,24.57472026703071,79.15695167363809,62.984515762060425,NaN,NaN,50
1666022400,0.98418,0.98476,0.98352,0.98448,3308,3803.45,-795949,-800406,27.084732919378716,79.64289873841577,64.59516343567866,NaN,NaN,50
1666024200,0.98448,0.98522,0.98367,0.98394,3527,3842.95,-799476,-799268.8,29.528182300260703,76.1991227944536,65.97821807343735,NaN,NaN,50
1666026000,0.98394,0.98511,0.9837,0.9843,3317,3709.55,-796159,-798759.4,31.79709958250826,76.91575597182008,67.29023324811182,NaN,NaN,50
1666027800,0.9843,0.98477,0.98384,0.98414,2597,3623.8,-798756,-797919.4,33.90395134459527,75.82303996595428,68.87975341775385,NaN,NaN,50
1666029600,0.98414,0.9849,0.98374,0.98413,2633,3565.75,-801389,-798345.8,35.8980217590053,75.75060591014274,70.4315935664486,NaN,NaN,50
1666031400,0.98413,0.98484,0.98406,0.9847,1957,3461.15,-799432,-799042.4,37.74965857238604,77.0938450678554,72.48898204163768,NaN,NaN,50
1666033200,0.9847,0.9847,0.98324,0.98349,2749,3441.25,-802181,-799583.4,38.42041948863265,68.42852109968256,73.42136356318062,NaN,NaN,50
1666035000,0.98349,0.98428,0.98344,0.98351,2015,3412.4,-800166,-800384.8,39.043268910861656,68.49156183677786,73.69876985786924,NaN,NaN,50
1666036800,0.98351,0.98421,0.98351,0.98404,1302,3287.45,-798864,-800406.4,39.62162908864572,70.19025587284005,73.92200005952466,NaN,NaN,50
1666038600,0.98404,0.98448,0.98388,0.98446,643,3174.8,-798221,-799772.8,40.29447859391483,71.50145622977782,74.26775260159498,NaN,NaN,50
1666040400,0.98446,0.98446,0.98393,0.98437,277,3064.5,-798498,-799586,40.91926742023615,70.78297156364238,74.25292102375381,NaN,NaN,50
1666042200,0.98437,0.98438,0.98404,0.98407,323,2942,-798821,-798914,41.4994284732488,68.31860649068275,73.70131015463512,NaN,NaN,50
1666044000,0.98407,0.98458,0.9837,0.98426,1026,2804.95,-797795,-798439.8,41.468173622132596,69.05346762050853,73.38207577401371,NaN,NaN,50
1666045800,0.98426,0.98438,0.98396,0.98426,557,2645.25,-797795,-798226,41.439151260381834,69.05346762050853,72.66039834164731,NaN,NaN,50
1666047600,0.98426,0.98447,0.98396,0.98437,1377,2590.45,-796418,-797865.4,41.48027859030927,69.52804794356442,71.93790899915793,NaN,NaN,50
1666049400,0.98437,0.98469,0.98403,0.98438,1552,2433.35,-794866,-797139,41.687581648162585,69.57372924402475,71.46466660269873,NaN,NaN,50
1666051200,0.98438,0.98528,0.98404,0.98456,2212,2288.85,-792654,-795905.6,42.299135890427216,70.43294732223112,71.0016088420138,NaN,NaN,50
1666053000,0.98456,0.9851,0.98396,0.98414,2485,2090.3,-795139,-795374.4,42.704205563672076,65.76615373403268,70.28325982544797,NaN,NaN,50
1666054800,0.98414,0.98418,0.98326,0.98358,2625,2009.05,-797764,-795368.2,41.758470972060906,60.05270031634024,69.16198085446209,NaN,NaN,50
1666056600,0.98358,0.98392,0.98292,0.98322,2320,1940.1,-800084,-796101.4,40.312471611555225,56.64577267487196,67.70140425496326,NaN,NaN,50
1666058400,0.98322,0.98358,0.98272,0.98307,1692,1859.3,-801776,-797483.4,38.6447822567571,55.239550484895176,66.7593349253356,NaN,NaN,50
1666060200,0.98307,0.9834,0.98268,0.98317,1295,1747.7,-800481,-799048.8,37.02937848302386,56.023344713471445,65.86874798795657,NaN,NaN,50
1666062000,0.98317,0.98358,0.98232,0.98274,1349,1649.3,-801830,-800387,34.932996419325654,51.82122486488988,64.55667434453156,NaN,NaN,50
1666063800,0.98274,0.98454,0.98274,0.98412,2270,1632.95,-799560,-800746.2,34.11566793701989,61.73966694584221,63.859403681393296,NaN,NaN,50
1666065600,0.98412,0.98644,0.9841,0.98592,3224,1662.5,-796336,-799996.6,34.81810002317166,70.32192451225607,63.82647174915142,NaN,NaN,50
1666067400,0.98592,0.98664,0.98554,0.98575,2562,1692.75,-798898,-799421,35.58815063225692,68.75334079150653,63.85752419921026,NaN,NaN,50
1666069200,0.98575,0.98632,0.9855,0.98593,2446,1677.6,-796452,-798615.2,36.23770868698254,69.52837494100172,63.891446150674064,NaN,NaN,50
1666071000,0.98593,0.98622,0.98504,0.9854,2540,1703.85,-798992,-798047.6,36.093227825079175,64.45862722806453,63.56324326549949,NaN,NaN,50
1666072800,0.9854,0.9858,0.98469,0.98538,2942,1785.85,-801934,-798522.4,35.42257325059047,64.26818681013354,63.187538898825856,NaN,NaN,50
1666074600,0.98538,0.98728,0.98474,0.98627,3466,1927,-798468,-798948.8,35.863066953520274,68.6998718167425,63.12512051116284,NaN,NaN,50
1666076400,0.98627,0.98737,0.98313,0.98445,5326,2179.45,-803794,-799928,34.328345803578095,53.96111617696761,61.94856114364402,NaN,NaN,50
1666078200,0.98445,0.98584,0.98426,0.98577,3448,2335.7,-800346,-800706.8,32.903247592917495,60.56857663234594,61.57730563638068,NaN,NaN,50
1666080000,0.98577,0.98594,0.9846,0.98518,3433,2456.05,-803779,-801664.2,31.663458615787427,56.65468851576502,61.33459050776816,NaN,NaN,50
1666081800,0.98518,0.98534,0.98245,0.9829,3872,2621.8,-807651,-802807.6,30.273987975824717,44.647840450327784,60.47759534887216,NaN,NaN,50
1666083600,0.9829,0.98528,0.98274,0.98502,5350,2820.45,-802301,-803574.2,28.98376523871649,54.33805260785657,60.413202643369395,NaN,NaN,50
1666085400,0.98502,0.98536,0.98328,0.9838,3425,2914.1,-805726,-803960.6,27.703464364901293,49.01969016148891,59.912941603942066,NaN,NaN,50
1666087200,0.9838,0.98462,0.98334,0.98356,2535,2930.25,-808261,-805543.6,26.514613553501466,48.023901009500364,59.641704185699965,NaN,NaN,50
1666089000,0.98356,0.98377,0.98128,0.98193,3076,2959.8,-811337,-807055.2,26.900718873845214,41.81157296010574,58.2182689010045,NaN,NaN,50
1666090800,0.98193,0.98363,0.98188,0.9836,2853,2971.2,-808484,-807221.8,27.259245242735837,49.07939157929771,56.700945120078906,NaN,NaN,50
1666092600,0.9836,0.98401,0.9826,0.98312,3428,3026.6,-811912,-809144,27.14193517767446,47.25254483625623,55.16517398041817,NaN,NaN,50
1666094400,0.98312,0.98465,0.98253,0.98457,3885,3136.25,-808027,-809604.2,26.317428753831212,52.9499193137224,53.980998578469645,NaN,NaN,50
1666096200,0.98457,0.98581,0.9844,0.98544,3660,3254.5,-804367,-808825.4,24.43959557699034,56.019435891833105,53.37819919731026,NaN,NaN,50
1666098000,0.98544,0.9869,0.985,0.98668,3656,3369.85,-800711,-806700.2,23.548994990614915,60.022666007917664,53.07494771143769,NaN,NaN,50
1666099800,0.98668,0.98757,0.98457,0.98528,5017,3507.2,-805728,-806149,23.184568154758985,54.04171907370862,52.027936801220974,NaN,NaN,50
1666101600,0.98528,0.98592,0.98354,0.98369,4539,3572.95,-810267,-805820,21.927624152015625,48.170966227267314,51.61435466195667,NaN,NaN,50
1666103400,0.98369,0.98544,0.98245,0.985,5539,3721.8,-804728,-805160.2,20.79269470293572,52.72747582247494,51.05427603268017,NaN,NaN,50
1666105200,0.985,0.985,0.98213,0.98236,5315,3865.25,-810043,-806295.4,19.964611553228544,44.27906649170761,50.17030303096179,NaN,NaN,50
1666107000,0.98236,0.9843,0.98236,0.98418,4392,3957.85,-805651,-807283.4,19.19567719992902,50.20279417432828,50.56708543981897,NaN,NaN,50
1666108800,0.98418,0.9851,0.98374,0.98486,3514,3986.45,-802137,-806565.2,17.860628835853156,52.24553330957941,50.41761977565631,NaN,NaN,50
1666110600,0.98486,0.98606,0.98432,0.9856,3199,3973.1,-798938,-804299.4,17.35305326742817,54.43600295835986,50.8044992611471,NaN,NaN,50
1666112400,0.9856,0.98588,0.98418,0.98533,4326,3923.1,-803264,-804006.6,16.755779838112435,53.47224410806241,51.1936666253301,NaN,NaN,50
1666114200,0.98533,0.98602,0.98498,0.98534,3336,3917.5,-799928,-801983.6,16.3107490862772,53.505076959580634,52.02891691100688,NaN,NaN,50
1666116000,0.98534,0.98599,0.9849,0.98538,2308,3861.25,-797620,-800377.4,15.816451998290823,53.64598265573811,52.35510198789548,NaN,NaN,50
1666117800,0.98538,0.98554,0.9842,0.985,3295,3832.4,-800915,-800133,14.705204725188855,52.032710078053356,52.696542362309565,NaN,NaN,50
1666119600,0.985,0.98504,0.98454,0.98474,2505,3690.15,-803420,-801029.4,13.673332257308457,50.904725704405216,52.550457104501184,NaN,NaN,50
1666121400,0.98474,0.98578,0.9847,0.98574,1960,3616.9,-801460,-800668.6,13.377086821208401,54.949870023928106,52.47405954250797,NaN,NaN,50
1666123200,0.98574,0.98596,0.98527,0.98594,1158,3548.05,-800302,-800743.4,13.263099973589714,55.735404959217995,52.167826610458,NaN,NaN,50
1666125000,0.98594,0.98638,0.9857,0.98588,730,3430.75,-801032,-801425.8,13.52870666575153,55.42318055971821,52.26650243088726,NaN,NaN,50
1666126800,0.98588,0.98638,0.98556,0.98612,69,3291.55,-800963,-801435.4,13.602189148280091,56.47352998034663,52.85954269896435,NaN,NaN,50
1666128600,0.98612,0.98644,0.98588,0.98633,163,3128.3,-800800,-800911.4,13.728240321881621,57.41896923140454,53.19464937103074,NaN,NaN,50
1666130400,0.98633,0.98638,0.98599,0.98608,578,2962.95,-801378,-800895,13.845287840225899,55.86331776165183,54.02209589031248,NaN,NaN,50
1666132200,0.98608,0.9869,0.98607,0.98671,620,2810.95,-800758,-800986.2,14.47956168712213,58.88625528060877,54.642343112189664,NaN,NaN,50
1666134000,0.98671,0.98727,0.98638,0.98657,1676,2711.95,-802434,-801266.6,15.413288997435362,57.93662436644853,55.048849616251744,NaN,NaN,50
1666135800,0.98657,0.9868,0.98614,0.98628,1294,2525.8,-803728,-801819.6,15.89942198821814,55.92475560540337,55.155189091040555,NaN,NaN,50
1666137600,0.98628,0.98671,0.98534,0.98564,2871,2442.4,-806599,-802979.4,15.21163214838053,51.661148513011874,55.025825119965525,NaN,NaN,50
1666139400,0.98564,0.98631,0.9854,0.9861,2643,2297.6,-803956,-803495,14.572970154245606,54.35473752008673,55.08651516000167,NaN,NaN,50
1666141200,0.9861,0.98644,0.98541,0.98559,2493,2156.5,-806449,-804633.2,14.14062419500233,50.963989998081125,54.89494425588332,NaN,NaN,50
1666143000,0.98559,0.98631,0.98546,0.98586,3037,2088.75,-803412,-804828.8,13.739160089990715,52.64811226843837,54.93890155519653,NaN,NaN,50
1666144800,0.98586,0.98614,0.98566,0.98584,2710,2048.55,-806122,-805307.6,13.36637199247993,52.504264216263984,55.05315430604359,NaN,NaN,50
1666146600,0.98584,0.98584,0.98492,0.98526,2282,2002.7,-808404,-805668.6,12.932997334381819,48.37629485175496,54.583613222316934,NaN,NaN,50
1666148400,0.98526,0.98556,0.98498,0.98502,1837,1878.25,-810241,-806925.6,12.530578009004998,46.738772915527825,53.94099664776763,NaN,NaN,50
1666150200,0.98502,0.98512,0.98432,0.98442,1134,1768.15,-811375,-807910.8,13.02450180830807,42.83505403618559,53.04184475322959,NaN,NaN,50
1666152000,0.98442,0.98464,0.98399,0.98412,1161,1710.8,-812536,-809735.6,13.862347899091024,40.991524959936505,51.935987251771714,NaN,NaN,50
1666153800,0.98412,0.98413,0.98372,0.98402,1341,1613.1,-813877,-811286.6,14.935321656090665,40.36786214394122,50.71805103123862,NaN,NaN,50
1666155600,0.98402,0.9844,0.98316,0.98377,1689,1572.3,-815566,-812719,16.48635551734281,38.779383540908654,49.497770015471254,NaN,NaN,50
1666157400,0.98377,0.98416,0.98342,0.98358,1839,1566.25,-817405,-814151.8,17.926601245648367,37.569403532430286,47.97513774774422,NaN,NaN,50
1666159200,0.98358,0.98411,0.98307,0.98348,3705,1693.6,-821110,-816098.8,19.595871199152683,36.91652972512746,46.473702416221286,NaN,NaN,50
1666161000,0.98348,0.98386,0.98203,0.98218,3838,1849,-824948,-818581.2,21.942996748452156,29.692630819831336,44.59997921725186,NaN,NaN,50
1666162800,0.98218,0.98297,0.98152,0.98244,4736,2082.35,-820212,-819848.2,24.432295085737913,32.53602704617204,43.23389911247758,NaN,NaN,50
1666164600,0.98244,0.98396,0.98236,0.98394,3844,2266.4,-816368,-820008.6,24.949944005364227,46.083563052913775,42.643100936250946,NaN,NaN,50
1666166400,0.98394,0.98394,0.98125,0.98212,3997,2437.35,-820365,-820600.6,26.221469929307368,36.504909090044755,41.610309442819776,NaN,NaN,50
1666168200,0.98212,0.98335,0.98168,0.98169,3321,2572.4,-823686,-821115.8,27.40217257296885,34.671285733955344,40.326250404642416,NaN,NaN,50
1666170000,0.98169,0.98241,0.98076,0.98112,3414,2659.3,-827100,-821546.2,29.049688046209894,32.351517479333836,38.8867684948617,NaN,NaN,50
1666171800,0.98112,0.98185,0.98054,0.98184,3090,2749.1,-824010,-822305.8,30.69820874448686,37.99495837891673,38.145244461087536,NaN,NaN,50
1666173600,0.98184,0.98212,0.97906,0.97911,2879,2749.5,-826889,-824410,32.89750630310095,28.340825828731724,36.83110538345924,NaN,NaN,50
1666175400,0.97911,0.97981,0.97808,0.97809,3134,2774.05,-830023,-826341.6,35.276303561009854,25.71209039840369,35.6080365521891,NaN,NaN,50
1666177200,0.97809,0.97834,0.97596,0.97732,4388,2868.8,-834411,-828486.6,38.02072672720101,23.909179411733447,34.38786901303174,NaN,NaN,50
1666179000,0.97732,0.97844,0.9768,0.97834,3837,2908.8,-830574,-829181.4,40.43087079862273,30.82842424465811,33.706480591654376,NaN,NaN,50
1666180800,0.97834,0.9784,0.97681,0.97727,3838,2965.2,-834412,-831261.8,42.668861722085744,27.956472780679718,32.9334155373523,NaN,NaN,50
1666182600,0.97727,0.97818,0.97646,0.97799,4410,3071.6,-830002,-831884.4,44.8342760067073,32.512462673570994,32.57220547600521,NaN,NaN,50
1666184400,0.97799,0.97909,0.97724,0.97828,4173,3188.4,-825829,-831045.6,45.5096910077379,34.31427263113919,32.386329969291765,NaN,NaN,50
1666186200,0.97828,0.9796,0.97716,0.9774,5777,3420.55,-831606,-830484.6,45.46203940813419,31.560671714985418,32.519761461802766,NaN,NaN,50
1666188000,0.9774,0.98021,0.97706,0.98007,4008,3562.9,-827598,-829889.4,44.66144256434319,45.77792254624048,33.46561114037909,NaN,NaN,50
1666189800,0.98007,0.98027,0.97824,0.97904,4474,3719.55,-832072,-829421.4,43.844341285630236,42.14106692217937,33.18400427389806,NaN,NaN,50
1666191600,0.97904,0.97944,0.978,0.97832,3357,3802.95,-835429,-830506.8,43.23843719621855,39.762974130585455,33.41672320536526,NaN,NaN,50
1666193400,0.97832,0.97892,0.97786,0.97788,2984,3860.2,-838413,-833023.6,42.76691230197685,38.33910490892311,33.67871028929153,NaN,NaN,50
1666195200,0.97788,0.9781,0.9765,0.97733,3105,3830.2,-841518,-835006,43.10346139793545,36.575984537910884,33.98045793633275,NaN,NaN,50
1666197000,0.97733,0.97816,0.97651,0.9766,2832,3779.9,-844350,-838356.4,43.33102653901545,34.32001945584767,33.717962298970676,NaN,NaN,50
1666198800,0.9766,0.97729,0.97572,0.97701,3789,3732.55,-840561,-840054.2,43.9359874303576,36.68217250712748,34.31377277599894,NaN,NaN,50
1666200600,0.97701,0.97737,0.97626,0.97664,2485,3664.6,-843046,-841577.6,44.37774864541657,35.443341056146394,35.00886210869485,NaN,NaN,50
1666202400,0.97664,0.97786,0.97632,0.97783,2302,3579.85,-840744,-842043.8,44.058498907341914,42.20394215086193,36.315630875775454,NaN,NaN,50
1666204200,0.97783,0.97783,0.97646,0.9767,1900,3508.8,-842644,-842269,43.76205272198689,38.12141192792115,36.8365585674371,NaN,NaN,50
1666206000,0.9767,0.97767,0.97656,0.9766,2288,3452.5,-844932,-842385.4,43.48678126415722,37.77318191455242,37.53775207699943,NaN,NaN,50
1666207800,0.9766,0.97734,0.97648,0.97732,2070,3401.5,-842862,-842845.6,43.28989917891245,41.889146735540834,38.20751522428299,NaN,NaN,50
1666209600,0.97732,0.97762,0.97708,0.97726,1372,3326.15,-844234,-843083.2,42.61410373167192,41.64195802088038,38.73092132355022,NaN,NaN,50
1666211400,0.97726,0.97752,0.97722,0.97726,768,3207.85,-844234,-843781.2,41.98657938780571,41.64195802088039,39.45101320254272,NaN,NaN,50
1666213200,0.97726,0.97745,0.97718,0.97742,112,2994.05,-844122,-844076.8,41.44197287667238,42.68790934806483,39.230297974101596,NaN,NaN,50
1666215000,0.97742,0.9775,0.97734,0.97736,98,2807.1,-844220,-843934.4,40.833256741194276,42.381148846268815,39.247446682965126,NaN,NaN,50
1666216800,0.97736,0.9776,0.97726,0.97726,691,2649.75,-844911,-844344.2,40.05349319384298,41.84147058215005,39.39591071521975,NaN,NaN,50
1666218600,0.97726,0.97728,0.97644,0.97652,494,2453.95,-845405,-844578.4,40.16213578936905,37.986606234985345,39.3707322385099,NaN,NaN,50
1666220400,0.97652,0.97666,0.97624,0.97646,1266,2308.6,-846671,-845065.8,40.43772449322978,37.68345656072963,39.44983738299696,NaN,NaN,50
1666222200,0.97646,0.97674,0.97608,0.97656,992,2069.35,-845679,-845377.2,40.832823045378895,38.56346484129146,39.75294062481437,NaN,NaN,50
1666224000,0.97656,0.97701,0.97584,0.9769,2246,1981.25,-843433,-845219.8,40.57934334333203,41.58396642899338,40.10306876209051,NaN,NaN,50
1666225800,0.9769,0.9772,0.976,0.97652,3256,1920.35,-846689,-845575.4,39.920890152087665,39.26069627174058,40.3757369917758,NaN,NaN,50
1666227600,0.97652,0.97654,0.9755,0.97595,2471,1876.05,-849160,-846326.4,39.84363371421085,36.010710669634,39.93336331454525,NaN,NaN,50
1666229400,0.97595,0.97627,0.97546,0.97585,2527,1853.2,-851687,-847329.6,39.81252061148341,35.45618045259356,39.74298963773613,NaN,NaN,50
1666231200,0.97585,0.97608,0.97562,0.97586,2116,1803.75,-849571,-848108,39.7836298732365,35.56303998039829,39.585122356725115,NaN,NaN,50
1666233000,0.97586,0.97667,0.97579,0.97654,2176,1770.95,-847395,-848900.4,38.390151705021296,42.53071631601726,39.63094875533058,NaN,NaN,50
1666234800,0.97654,0.97666,0.97568,0.9758,1678,1665.4,-849073,-849377.2,37.248923619874056,37.74722054632951,39.35275322143409,NaN,NaN,50
1666236600,0.9758,0.97635,0.97568,0.97614,1448,1613.55,-847625,-849070.2,36.18921182652305,41.02902633020441,39.308972386385804,NaN,NaN,50
1666238400,0.97614,0.97856,0.97593,0.97676,3312,1664.05,-844313,-847595.4,35.36589000884037,46.561344030880036,39.58564629230118,NaN,NaN,50
1666240200,0.97676,0.97794,0.97628,0.97786,2958,1716.95,-841355,-845952.2,34.60137689242074,54.68412690598586,40.46443043942382,NaN,NaN,50
1666242000,0.97786,0.97893,0.9775,0.97814,3575,1781.3,-837780,-844029.2,34.78757258390678,56.496804258615654,41.51123998774279,NaN,NaN,50
1666243800,0.97814,0.9786,0.97792,0.97833,2666,1811.1,-835114,-841237.4,34.960468583143815,57.73234912728138,42.92165019433537,NaN,NaN,50
1666245600,0.97833,0.97942,0.97792,0.97908,3059,1895.45,-832055,-838123.4,35.739534876878,62.28574340432647,44.678956397449426,NaN,NaN,50
1666247400,0.97908,0.97936,0.97806,0.97922,2749,1994.5,-829306,-835122,36.46295357820259,63.08517158873539,46.43050687940971,NaN,NaN,50
1666249200,0.97922,0.97944,0.97716,0.9785,4745,2226.15,-834051,-833661.2,35.57884474093923,56.457176160012075,47.49287900305391,NaN,NaN,50
1666251000,0.9785,0.97946,0.97754,0.97869,4203,2431.4,-829848,-832074.8,34.777195495011156,57.719584756920185,48.81137103770959,NaN,NaN,50
1666252800,0.97869,0.97924,0.97801,0.97804,3283,2561,-833131,-831678.2,34.03280690950652,52.14931300154095,49.96412834713152,NaN,NaN,50
1666254600,0.97804,0.97885,0.97734,0.97817,3356,2704.1,-829775,-831222.2,32.26204980651779,53.12367738161321,51.226092413490065,NaN,NaN,50
1666256400,0.97817,0.97892,0.97762,0.97776,2465,2764.05,-832240,-831809,30.70522657187732,49.68727812706397,52.23496656682333,NaN,NaN,50
1666258200,0.97776,0.9788,0.97731,0.97831,2563,2842.6,-829677,-830934.2,28.782644998024416,53.98717373200033,53.05328495367927,NaN,NaN,50
1666260000,0.97831,0.97881,0.97769,0.97796,1975,2829.05,-831652,-831295,27.011791511222494,51.00013104500261,53.999921417870205,NaN,NaN,50
1666261800,0.97796,0.98074,0.97792,0.9807,3811,2856.8,-827841,-830237,27.44809017320825,66.58637899296855,55.82544660806764,NaN,NaN,50
1666263600,0.9807,0.9829,0.98018,0.98147,4585,2962.5,-823256,-828933.2,29.13236426903208,69.52050816903022,57.465386903649794,NaN,NaN,50
1666265400,0.98147,0.98184,0.9805,0.98128,3418,3007.05,-826674,-827820,30.696333072297072,67.93525561861492,58.41189609740901,NaN,NaN,50
1666267200,0.98128,0.98332,0.98076,0.98268,4682,3135.35,-821992,-826283,32.76230375856241,72.84821359354164,59.579853907046584,NaN,NaN,50
1666269000,0.98268,0.98374,0.97957,0.98028,7907,3421.9,-829899,-825932.4,33.17703646734248,56.785451134013144,59.512218336098854,NaN,NaN,50
1666270800,0.98028,0.98086,0.97924,0.97925,4906,3583.3,-834805,-827325.2,33.18708221827101,51.5337089549407,58.744215875428445,NaN,NaN,50
1666272600,0.97925,0.97977,0.97797,0.97862,6493,3835.55,-841298,-830933.6,31.90385482755386,48.57458329030183,57.707745282683184,NaN,NaN,50
1666274400,0.97862,0.98373,0.97836,0.98349,5987,3969.3,-835311,-832661,32.60821661839059,65.20652384064807,58.33269868844291,NaN,NaN,50
1666276200,0.98349,0.98455,0.98181,0.9845,6835,4163.15,-828476,-833957.8,33.53373356771555,67.55048499764496,59.03490584849468,NaN,NaN,50
1666278000,0.9845,0.9845,0.98211,0.98242,4066,4187.7,-832542,-834486.4,34.393142163517304,58.769711171353066,59.50779143205268,NaN,NaN,50
1666279800,0.98242,0.98326,0.98222,0.98226,3299,4219.35,-835841,-834693.6,35.1911644310475,58.143605540438585,59.86635772911164,NaN,NaN,50
1666281600,0.98226,0.98227,0.97993,0.98013,3633,4248.05,-839474,-834328.8,34.004228388287736,50.439701490092574,59.92010225504225,NaN,NaN,50
1666283400,0.98013,0.98048,0.97979,0.98026,2575,4239.35,-836899,-834646.4,32.79992401949458,50.86758490227849,59.697274481490695,NaN,NaN,50
1666285200,0.98026,0.98028,0.97854,0.97874,3718,4188,-840617,-837074.6,30.812118589865527,45.87990093732522,59.331543759513735,NaN,NaN,50
1666287000,0.97874,0.97896,0.97804,0.97852,2886,4122.15,-843503,-839266.8,28.645040344691346,45.18925295574016,57.80317761399741,NaN,NaN,50
1666288800,0.97852,0.97878,0.97751,0.97759,2453,4080.65,-845956,-841289.8,26.899827042512047,42.29105687359992,55.85821680718096,NaN,NaN,50
1666290600,0.97759,0.97872,0.97753,0.97844,2928,4059.25,-843028,-842000.6,25.279271833345557,45.7177195052155,54.271249941938144,NaN,NaN,50
1666292400,0.97844,0.97896,0.97746,0.97766,2569,4064.45,-845597,-843740.2,23.596538336533214,43.18370835089294,52.15235671032038,NaN,NaN,50
1666294200,0.97766,0.97858,0.97732,0.97843,1854,4029,-843743,-844365.4,22.13785470378032,46.34534650453232,51.40663495107175,NaN,NaN,50
1666296000,0.97843,0.97858,0.97816,0.97856,873,3973.9,-842870,-844238.8,20.783362759081196,46.882764315456946,51.07442461968005,NaN,NaN,50
1666297800,0.97856,0.9789,0.97844,0.97886,765,3821.6,-842105,-843468.6,19.350168261756505,48.1728674431083,51.045730630594804,NaN,NaN,50
1666299600,0.97886,0.97887,0.97849,0.97868,116,3598.15,-842221,-843307.2,18.019344799955,47.42853895263303,49.77587456716516,NaN,NaN,50
1666301400,0.97868,0.97892,0.97804,0.9786,393,3446.9,-842614,-842710.6,17.098028798126457,47.08035875023955,48.31372269235048,NaN,NaN,50
1666303200,0.9786,0.97894,0.97833,0.97844,663,3245.95,-843277,-842617.4,16.221741822151703,46.347524848510304,47.42642366929029,NaN,NaN,50
1666305000,0.97844,0.97852,0.97818,0.97832,673,2884.25,-843950,-842833.4,15.556669925019115,45.77206864532462,46.542742462496435,NaN,NaN,50
1666306800,0.97832,0.97832,0.97748,0.9775,977,2687.8,-844927,-843397.8,15.59737116629483,41.94001483050397,45.93562198681153,NaN,NaN,50
1666308600,0.9775,0.97795,0.97735,0.97787,956,2410.95,-843971,-843747.8,15.751482136099568,44.20968338121564,45.4600575924499,NaN,NaN,50
1666310400,0.97787,0.97825,0.97688,0.97738,2294,2226.3,-846265,-844478,16.307460633791628,41.87504385697428,45.17399637242483,NaN,NaN,50
1666312200,0.97738,0.97748,0.97681,0.9771,2367,2002.9,-848632,-845549,16.884608180268458,40.557044016148595,44.84312430531115,NaN,NaN,50
1666314000,0.9771,0.97728,0.97663,0.97696,2399,1919.55,-851031,-846965.2,17.5822551765161,39.88114412019772,44.67098768006813,NaN,NaN,50
1666315800,0.97696,0.97726,0.9765,0.97704,2603,1884.75,-848428,-847665.4,18.349312151576555,40.4914423972971,44.29768217235967,NaN,NaN,50
1666317600,0.97704,0.9778,0.97678,0.97768,1612,1783.7,-846816,-848234.4,18.214617379267775,45.27744037198796,44.44723445958075,NaN,NaN,50
1666319400,0.97768,0.97802,0.97744,0.97768,1492,1729.55,-846816,-848344.6,17.765420518625373,45.27744037198796,44.37095545011329,NaN,NaN,50
1666321200,0.97768,0.97836,0.97754,0.97803,1221,1604.7,-845595,-847737.2,16.86144913835963,47.933331766391184,44.44599598232288,NaN,NaN,50
1666323000,0.97803,0.97808,0.97674,0.97686,1689,1544.85,-847284,-846987.8,16.928129693686213,40.8039954863902,43.91964798541444,NaN,NaN,50
1666324800,0.97686,0.97716,0.97647,0.97699,1518,1498.1,-845766,-846455.4,17.262128374531336,41.839101341765215,43.52040244178102,NaN,NaN,50
1666326600,0.97699,0.97714,0.97672,0.97712,1248,1414.1,-844518,-845995.8,17.572270006744667,42.91409510275382,43.22281218124633,NaN,NaN,50
1666328400,0.97712,0.97713,0.97634,0.97652,1638,1367.55,-846156,-845863.8,18.25400620807324,39.30334882131475,42.71965675073236,NaN,NaN,50
1666330200,0.97652,0.97766,0.9764,0.97757,1915,1370.6,-844241,-845593,18.019686918882556,47.61069622188937,42.85098729191556,NaN,NaN,50
1666332000,0.97757,0.97776,0.97654,0.97656,3002,1477.05,-847243,-845584.8,17.64573420364187,41.698667000210634,42.833748161180324,NaN,NaN,50
1666333800,0.97656,0.97715,0.97618,0.9766,3070,1592.3,-844173,-845266.2,17.726752123255963,42.00580944147149,42.67632859405574,NaN,NaN,50
1666335600,0.9766,0.98025,0.97612,0.9796,4946,1833.8,-839227,-844208,18.422191197887297,59.31681342832512,43.922169277723654,NaN,NaN,50
1666337400,0.9796,0.9801,0.9786,0.9789,3940,2011.15,-843167,-843610.2,19.0679560529021,55.17809450728445,44.966530027090506,NaN,NaN,50
1666339200,0.9789,0.97908,0.97716,0.97744,3764,2166.2,-846931,-844148.2,18.089121812721803,47.702157378340694,45.52517383124357,NaN,NaN,50
1666341000,0.97744,0.97794,0.97529,0.97563,3364,2300.75,-850295,-844758.6,17.882558958415466,40.395163914017104,45.51829679672357,NaN,NaN,50
1666342800,0.97563,0.97636,0.97441,0.97512,3231,2413.45,-853526,-846629.2,18.235895678034723,38.600947017575166,45.041404414265514,NaN,NaN,50
1666344600,0.97512,0.97518,0.97352,0.97406,3608,2546.05,-857134,-850210.6,19.05607417356216,35.11033987125472,44.315182949927426,NaN,NaN,50
1666346400,0.97406,0.97482,0.97322,0.97473,3028,2582.75,-854106,-852398.4,19.975244556109143,38.87295695050154,43.66801332022102,NaN,NaN,50
1666348200,0.97473,0.97538,0.97357,0.97498,2844,2606.6,-851262,-853264.6,20.269451544250394,40.26481399777779,43.629500356748714,NaN,NaN,50
1666350000,0.97498,0.97592,0.97452,0.97548,3968,2685.05,-847294,-852664.4,20.028018044391306,43.05744082502504,43.71652460555298,NaN,NaN,50
1666351800,0.97548,0.97558,0.97413,0.9745,3056,2707.7,-850350,-852029.2,20.060319981635416,39.19020241373583,43.45053227062313,NaN,NaN,50
1666353600,0.9745,0.97492,0.97064,0.97142,5253,2889.75,-855603,-851723,21.76008060824504,30.05402215488502,42.78986608016386,NaN,NaN,50
1666355400,0.97142,0.9778,0.97049,0.97578,7355,3182.9,-848248,-850551.4,21.209990783041356,48.394280431478464,42.8458363808488,NaN,NaN,50
1666357200,0.97578,0.97919,0.9752,0.97698,13081,3775.9,-835167,-847332.4,19.90731442181505,52.115752854774726,43.589913941889094,NaN,NaN,50
1666359000,0.97698,0.98072,0.97577,0.97976,11876,4285.25,-823291,-842531.8,19.03293399174995,59.41717524137418,44.833582927596424,NaN,NaN,50
1666360800,0.97976,0.98171,0.97756,0.97768,8910,4654.85,-832201,-838902,18.663933892830922,52.91582446265901,44.37636943004885,NaN,NaN,50
1666362600,0.97768,0.98171,0.97654,0.97972,13939,5289.4,-818262,-831433.8,17.757260248862707,57.793596102167264,44.563190972540475,NaN,NaN,50
1666364400,0.97972,0.98186,0.97798,0.98024,13458,5880.4,-804804,-822745,16.988311772408352,58.960686356574016,45.367371613842856,NaN,NaN,50
1666366200,0.98024,0.98566,0.97872,0.98548,12304,6399.85,-792500,-814211.6,17.793099354671444,68.43326774291349,47.370093315906885,NaN,NaN,50
1666368000,0.98548,0.9868,0.9825,0.98323,11591,6829.3,-804091,-810371.6,18.89287904388484,61.83350894504309,49.029562025011735,NaN,NaN,50
1666369800,0.98323,0.9855,0.98318,0.9839,8214,7086.5,-795877,-803106.8,19.914103041011565,62.97847358400035,51.02014300449356,NaN,NaN,50
1666371600,0.9839,0.98482,0.98302,0.98342,5382,7108.3,-801259,-799706.2,20.757050053894638,61.55379853851022,52.64020311792276,NaN,NaN,50
1666373400,0.98342,0.98416,0.98287,0.98296,4390,7130.8,-805649,-799875.2,21.43578137219939,60.1495077657308,54.06053838706226,NaN,NaN,50
1666375200,0.98296,0.98386,0.98242,0.98296,4168,7151,-805649,-802505,21.74518863176737,60.1495077657308,55.281400311398386,NaN,NaN,50
1666377000,0.98296,0.98528,0.98292,0.98442,4745,7220.05,-800904,-801867.6,22.588673279658952,63.23681403865902,56.99901542746433,NaN,NaN,50
1666378800,0.98442,0.98692,0.98432,0.98627,4529,7284.95,-796375,-801967.2,23.919646363746352,66.7517569944228,59.62028220171702,NaN,NaN,50
1666380600,0.98627,0.98652,0.98596,0.9862,3309,7270,-799684,-801652.2,25.15554994182751,66.49270310111908,60.91302667811992,NaN,NaN,50
1666382400,0.9862,0.98662,0.98583,0.98628,1721,7204.65,-797963,-800115,26.197275648195568,66.6519877800962,61.951329172785734,NaN,NaN,50
1666384200,0.98628,0.9865,0.98582,0.98605,1369,7130.9,-799332,-798851.6,27.155919314369875,65.68521422174152,62.39904624281197,NaN,NaN,50
1666558800,0.98605,0.98768,0.98605,0.98705,317,6948.35,-799015,-798473.8,28.474970079427237,67.86750658227687,63.467023537070396,NaN,NaN,50
1666560600,0.98705,0.98863,0.98678,0.9886,309,6811,-798706,-798940,30.00809364182169,70.95123225334672,64.40685469072606,NaN,NaN,50
1666562400,0.9886,0.98996,0.98513,0.98578,4976,6797.15,-803682,-799739.6,30.04723575366426,59.72161517988255,64.46120674953382,NaN,NaN,50
1666564200,0.98578,0.98633,0.98472,0.98492,3755,6617.15,-807437,-801634.4,29.771777075538758,56.77065766898975,63.62816317282498,NaN,NaN,50
1666566000,0.98492,0.98496,0.98312,0.98334,3178,6122,-810615,-803891,28.405459841348268,51.71485577196142,62.90540223189057,NaN,NaN,50
1666567800,0.98334,0.98891,0.98332,0.986,9968,6026.6,-800647,-804217.4,28.711582335886877,58.427338553964546,62.580321158316586,NaN,NaN,50
1666569600,0.986,0.9868,0.98462,0.98534,6719,5917.05,-807366,-805949.4,28.995838937958446,56.334707444646234,62.2075289373263,NaN,NaN,50
1666571400,0.98534,0.98602,0.98406,0.98492,5437,5491.95,-812803,-807773.6,28.890267794545206,54.98508736542033,61.83864176587556,NaN,NaN,50
1666573200,0.98492,0.98493,0.98335,0.98394,4436,5040.85,-817239,-809734,28.331873137366863,51.86293531621601,61.24674373376736,NaN,NaN,50
1666575000,0.98394,0.98444,0.98322,0.98354,4168,4634.05,-821407,-811892.4,27.728026310318505,50.60000812007091,60.344114739582494,NaN,NaN,50
1666576800,0.98354,0.98365,0.98288,0.98365,3536,4231.3,-817871,-815337.2,26.935759941402615,50.95371597816916,59.21568323842151,NaN,NaN,50
1666578600,0.98365,0.98451,0.98348,0.98433,2260,3933.6,-815611,-816986.2,26.608612024866357,53.18523988592821,58.265150151622166,NaN,NaN,50
1666580400,0.98433,0.98452,0.98254,0.98308,2278,3778.4,-817889,-818003.4,25.651769660051293,48.79065491011513,56.989340660909235,NaN,NaN,50
1666582200,0.98308,0.9835,0.98302,0.98346,1321,3624.95,-816568,-817869.2,24.763273178437302,50.13943820582811,55.87892808834399,NaN,NaN,50
1666584000,0.98346,0.98406,0.98316,0.98398,1161,3474.6,-815407,-816669.2,24.242576643901764,52.002453521459856,54.74571001257135,NaN,NaN,50
1666585800,0.98398,0.98495,0.98382,0.98482,1691,3321.9,-813716,-815838.2,24.215990442469284,54.93192257922417,53.60147360727689,NaN,NaN,50
1666587600,0.98482,0.98504,0.98407,0.98418,2074,3199.15,-815790,-815874,24.236821443874533,52.31218316800628,53.072228463571435,NaN,NaN,50
1666589400,0.98418,0.98493,0.98398,0.98434,2237,3145.55,-813553,-815006.8,24.176710757039924,52.9167226530668,52.79694739100551,NaN,NaN,50
1666591200,0.98434,0.98618,0.98416,0.98462,3757,3247.35,-809796,-813652.4,24.765887512834478,54.0153560362764,52.961268838456576,NaN,NaN,50
1666593000,0.98462,0.98496,0.98321,0.9846,4167,3387.25,-813963,-813363.6,24.480700905591238,53.91857702611856,52.639214443610435,NaN,NaN,50
1666594800,0.9846,0.98619,0.98434,0.9851,6290,3685.9,-807673,-812155,24.834297389702645,56.039156911869924,52.61810369126927,NaN,NaN,50
1666596600,0.9851,0.9851,0.98266,0.98348,4624,3901.65,-812297,-811456.4,23.882374311723744,48.285982981353456,52.13959623526449,NaN,NaN,50
1666598400,0.98348,0.98384,0.98166,0.98301,6301,3967.9,-818598,-812465.4,22.349058686467394,46.285210506948744,51.74118732031683,NaN,NaN,50
1666600200,0.98301,0.98429,0.98181,0.9835,4744,4017.35,-813854,-813277,21.190205087528895,48.67304926230488,51.60354740190497,NaN,NaN,50
1666602000,0.9835,0.98357,0.98134,0.98134,3435,4030.2,-817289,-813942.2,19.803331317472324,40.19129843274619,50.834803291517616,NaN,NaN,50
1666603800,0.98134,0.98342,0.9807,0.98334,3744,3719,-813545,-815116.6,18.67438566443104,49.04534407531173,50.539096447902146,NaN,NaN,50
1666605600,0.98334,0.98358,0.98248,0.98252,3666,3566.35,-817211,-816099.4,17.51435788151729,46.036184334547876,50.34234854964735,NaN,NaN,50
1666607400,0.98252,0.98278,0.9817,0.98226,3705,3479.75,-820916,-816563,16.947180860632685,45.09150084128149,49.98178159503688,NaN,NaN,50
1666609200,0.98226,0.98261,0.98148,0.98189,4076,3461.75,-824992,-818790.6,16.560966993104685,43.71667652718404,49.38994038116003,NaN,NaN,50
1666611000,0.98189,0.98467,0.98132,0.98356,5836,3545.15,-819156,-819164,15.986552306128946,50.98130908435128,49.107753702954824,NaN,NaN,50
1666612800,0.98356,0.98578,0.98288,0.9837,6074,3672.05,-813082,-819071.4,16.070640415719193,51.54593445530644,49.05302165204769,NaN,NaN,50
1666614600,0.9837,0.9852,0.9832,0.98436,5699,3844,-807383,-817105.8,16.14872223176728,54.22292770964444,49.1463220132318,NaN,NaN,50
1666616400,0.98436,0.9844,0.9827,0.98342,5675,4013.85,-813058,-815534.2,15.827522120563534,49.987052249475596,48.85858602846032,NaN,NaN,50
1666618200,0.98342,0.98912,0.9833,0.98756,9868,4441.2,-803190,-811173.8,17.570912684244675,63.50817996501585,49.543557666952985,NaN,NaN,50
1666620000,0.98756,0.98782,0.98541,0.98702,8930,4829.65,-812120,-809766.6,19.18977535052002,61.18463573804739,49.9110918688228,NaN,NaN,50
1666621800,0.98702,0.98936,0.9868,0.98854,7689,5129.55,-804431,-808036.4,21.158615280288533,65.0597281809427,51.109216525936326,NaN,NaN,50
1666623600,0.98854,0.98914,0.98744,0.98788,5707,5311.2,-810138,-808587.4,22.986823786502146,62.15797614626754,52.24298550017338,NaN,NaN,50
1666625400,0.98788,0.98802,0.98635,0.98738,4708,5434.75,-814846,-808945,23.82305706091716,59.97558157199535,53.05030923657984,NaN,NaN,50
1666627200,0.98738,0.98784,0.98684,0.98711,3471,5420.45,-818317,-811970.4,24.599559387159672,58.775498872412136,54.377752125127415,NaN,NaN,50
1666629000,0.98711,0.98758,0.98634,0.98708,2871,5355.65,-821188,-813784,24.917611864557095,58.63510872960323,55.06273531471966,NaN,NaN,50
1666630800,0.98708,0.98748,0.98706,0.98728,1694,5125.85,-819494,-816796.6,25.2129463078547,59.33250739588384,56.01247267624366,NaN,NaN,50
1666632600,0.98728,0.98754,0.98685,0.9871,1262,4957.75,-820756,-818920.2,25.3028734556067,58.378548394942975,56.9615475015052,NaN,NaN,50
1666634400,0.9871,0.98744,0.98684,0.987,1424,4713.9,-822180,-820387,25.377123815794555,57.82233072718217,57.96909423007649,NaN,NaN,50
1666636200,0.987,0.9877,0.98684,0.98752,2013,4577.35,-820167,-820757,25.59276146798369,59.958753056420605,58.610340228081434,NaN,NaN,50
1666638000,0.98752,0.9881,0.98737,0.98804,1341,4472.65,-818826,-820284.6,26.018826392122087,62.02999064435863,59.35920138444231,NaN,NaN,50
1666639800,0.98804,0.98808,0.9872,0.9874,1178,4344.35,-820004,-820386.6,26.228315756342507,58.049967307981326,59.63256135575209,NaN,NaN,50
1666641600,0.9874,0.98759,0.98722,0.98759,623,4192.2,-819381,-820111.6,26.422841594547187,58.893216072184856,60.26871591451704,NaN,NaN,50
1666643400,0.98759,0.98768,0.98734,0.98736,635,4038.7,-820016,-819678.8,26.664453877882227,57.38933490804168,59.8316555533046,NaN,NaN,50
1666645200,0.98736,0.98756,0.9873,0.98736,202,3845,-820016,-819648.6,26.835787362460227,57.38933490804168,59.560562636875616,NaN,NaN,50
1666647000,0.98736,0.98738,0.98692,0.98723,196,3563,-820212,-819925.8,26.48535125672135,56.44450249995326,58.945189373947805,NaN,NaN,50
1666648800,0.98723,0.98836,0.98716,0.98822,1029,3310.75,-819183,-819761.6,26.902046046928525,61.62580967699496,58.90717748328547,NaN,NaN,50
1666650600,0.98822,0.98876,0.9879,0.98872,1211,3086.35,-817972,-819479.8,27.556137365177868,63.9578020335738,59.191621801969646,NaN,NaN,50
1666652400,0.98872,0.98902,0.98838,0.98867,1217,2863.45,-819189,-819314.4,28.333605278673556,63.54195543219184,59.532082984811055,NaN,NaN,50
1666654200,0.98867,0.98896,0.98842,0.98844,871,2413.6,-820060,-819323.2,29.0555397697767,61.55917363892786,59.740944764048535,NaN,NaN,50
1666656000,0.98844,0.98929,0.98788,0.98908,2577,2095.95,-817483,-818777.4,28.91183466588258,64.84634022234886,60.134789965938886,NaN,NaN,50
1666657800,0.98908,0.98973,0.9889,0.98944,2895,1856.25,-814588,-817858.4,29.12948104933801,66.57764397175146,60.72043964999664,NaN,NaN,50
1666659600,0.98944,0.98988,0.98774,0.98883,3602,1751,-818190,-817902,27.81813734118414,61.087692998909866,60.953679812262905,NaN,NaN,50
1666661400,0.98883,0.98954,0.98833,0.98878,3765,1703.85,-821955,-818455.2,26.60046104075554,60.646255837970514,61.002787153802196,NaN,NaN,50
1666663200,0.98878,0.98899,0.98823,0.98836,2247,1642.65,-824202,-819283.6,25.344750880312866,56.925059148958795,60.638149189845066,NaN,NaN,50
1666665000,0.98836,0.98857,0.98783,0.98847,1930,1595.6,-822272,-820241.4,23.68250820663542,57.65784930035178,60.61014076072866,NaN,NaN,50
1666666800,0.98847,0.9889,0.98818,0.98869,2071,1614.45,-820201,-821364,22.513792118593187,59.15447798230855,60.6288023257375,NaN,NaN,50
1666668600,0.98869,0.98892,0.98837,0.98848,1400,1621.35,-821601,-822046.2,21.45162647379328,57.08047200633502,60.60674068990131,NaN,NaN,50
1666670400,0.98848,0.98866,0.98819,0.98829,999,1600.1,-822600,-822175.2,20.21410351245521,55.19491177311568,60.44999618026373,NaN,NaN,50
1666672200,0.98829,0.98842,0.98777,0.98789,831,1541,-823431,-822021,19.039828973282937,51.349192763829464,60.08604548482632,NaN,NaN,50
1666674000,0.98789,0.98803,0.98734,0.98752,1460,1546.95,-824891,-822544.8,18.480038194623578,48.01649897004901,59.11395186290161,NaN,NaN,50
1666675800,0.98752,0.98785,0.98666,0.98708,1609,1568.5,-826500,-823804.6,18.697223733059882,44.331715555043665,57.712088543006594,NaN,NaN,50
1666677600,0.98708,0.98789,0.98693,0.98762,2119,1643.3,-824381,-824360.6,18.835470562828657,49.45796746858575,56.706089402749015,NaN,NaN,50
1666679400,0.98762,0.98768,0.98556,0.98614,2236,1723.35,-826617,-825164,20.16738634918285,38.88825445776262,55.086738032665785,NaN,NaN,50
1666681200,0.98614,0.98626,0.98556,0.98582,2891,1857.8,-829508,-826379.4,21.404165293654597,37.04482135461132,53.10091525639883,NaN,NaN,50
1666683000,0.98582,0.98672,0.98528,0.98564,2340,1965,-831848,-827770.8,21.802748525838105,36.01075508913116,50.91756605049738,NaN,NaN,50
1666684800,0.98564,0.98754,0.98544,0.98682,2650,2046.05,-829198,-828310.4,21.013247279939954,46.544999471464294,49.87880222710841,NaN,NaN,50
1666686600,0.98682,0.98762,0.98535,0.98572,2468,2108.9,-831666,-829767.4,20.375040370785484,39.94356145359183,48.40003834250994,NaN,NaN,50
1666688400,0.98572,0.98738,0.98553,0.98715,2554,2175.75,-829112,-830266.4,19.78241966942776,49.8928735329701,47.89773936993931,NaN,NaN,50
1666690200,0.98715,0.98754,0.98637,0.98642,2408,2252.6,-831520,-830668.8,18.99373117083605,45.728128552663996,47.04561645939019,NaN,NaN,50
1666692000,0.98642,0.98725,0.98627,0.9863,1772,2212.35,-833292,-830957.6,18.38946406550181,45.06223366523595,46.03902757959929,NaN,NaN,50
1666693800,0.9863,0.98656,0.98542,0.98586,1964,2165.8,-835256,-832169.2,18.80257251278426,42.61198515749606,45.00556423325365,NaN,NaN,50
1666695600,0.98586,0.9863,0.98488,0.98621,2079,2089.65,-833177,-832471.4,19.69772854339627,45.166134751307375,44.28922301741021,NaN,NaN,50
1666697400,0.98621,0.98673,0.98586,0.98668,2309,2016.85,-830868,-832822.6,19.826060030175423,48.48201252741867,44.084424429095144,NaN,NaN,50
1666699200,0.98668,0.98668,0.98566,0.98645,2842,2046.6,-833710,-833260.6,20.148063698838566,46.984672217484594,44.01072251819769,NaN,NaN,50
1666701000,0.98645,0.98756,0.98615,0.98746,2487,2074.45,-831223,-832846.8,19.147580505024138,53.74104923642665,44.682817781153624,NaN,NaN,50
1666702800,0.98746,0.993,0.98733,0.99278,5374,2239.6,-825849,-830965.4,21.082288406418655,73.15076778915159,46.37516066119404,NaN,NaN,50
1666704600,0.99278,0.99696,0.99254,0.99676,7989,2569.05,-817860,-827902,23.950025664385297,79.93404326671931,49.30700271897666,NaN,NaN,50
1666706400,0.99676,0.99766,0.99354,0.99474,7789,2908.55,-825649,-826858.2,26.752553475829576,70.23528934783522,51.677750432778375,NaN,NaN,50
1666708200,0.99474,0.99594,0.99396,0.99572,4966,3115.3,-820683,-824252.8,29.35490072931355,72.00968834297743,54.2491028080531,NaN,NaN,50
1666710000,0.99572,0.99768,0.99526,0.9975,3580,3221.3,-817103,-821428.8,32.105089054680256,74.93273157919695,56.27679795860543,NaN,NaN,50
1666711800,0.9975,0.99768,0.99551,0.99579,3132,3297.45,-820235,-820306,34.658835356806485,67.62632123142605,58.25413794273645,NaN,NaN,50
1666713600,0.99579,0.99656,0.9953,0.99558,2512,3317.1,-822747,-821283.4,36.8209047849272,66.76534441650688,59.45931443441764,NaN,NaN,50
1666715400,0.99558,0.99645,0.99466,0.99538,1981,3304.35,-824728,-821099.2,38.19026784885265,65.90477098692531,60.90050317972202,NaN,NaN,50
1666717200,0.99538,0.99606,0.99508,0.99576,2934,3306.5,-821794,-821321.4,39.461819265354855,66.7808900218109,62.45183577662023,NaN,NaN,50
1666719000,0.99576,0.99646,0.9955,0.99646,2256,3302.3,-819538,-821808.4,40.76133127104008,68.39214282246354,64.2932756098322,NaN,NaN,50
1666720800,0.99646,0.99698,0.99616,0.99692,1724,3256,-817814,-821324.2,42.11999660330415,69.44110029456026,66.02720172006454,NaN,NaN,50
1666722600,0.99692,0.99696,0.99556,0.99592,1499,3207.55,-819313,-820637.4,42.710909909462735,64.43487202133059,67.1666916839154,NaN,NaN,50
1666724400,0.99592,0.99682,0.99584,0.99662,1423,3151,-817890,-819269.8,43.25961512232428,66.26810442691274,68.54407969887454,NaN,NaN,50
1666726200,0.99662,0.9968,0.99636,0.99668,1121,3086.65,-816769,-818264.8,43.7691271056957,66.42784317873472,69.45027926618226,NaN,NaN,50
1666728000,0.99668,0.99696,0.99628,0.9969,786,3037.35,-815983,-817553.8,44.31026763161079,67.04409594677459,69.0140884202982,NaN,NaN,50
1666729800,0.9969,0.99695,0.9967,0.99679,400,2959.15,-816383,-817267.6,44.81275526281766,66.38791538739488,68.04650785748932,NaN,NaN,50
1666731600,0.99679,0.9968,0.99652,0.9967,719,2891.15,-817102,-816825.4,45.01519970413826,65.82029607964404,67.73115119547565,NaN,NaN,50
1666733400,0.9967,0.99678,0.99662,0.99666,173,2784.35,-817275,-816702.4,45.20318382822167,65.55203573603876,67.26989029498004,NaN,NaN,50
1666735200,0.99666,0.99666,0.99554,0.99595,1145,2699.5,-818420,-817032.6,43.845131498394515,60.814152589744005,66.26142036716197,NaN,NaN,50
1666737000,0.99595,0.9964,0.99582,0.99602,1080,2629.15,-817340,-817304,42.58408290641215,61.11257519729907,65.79615279329576,NaN,NaN,50
1666738800,0.99602,0.99652,0.99574,0.99627,1001,2410.5,-816339,-817295.2,41.510023661760115,62.21919970249693,65.47142817086647,NaN,NaN,50
1666740600,0.99627,0.99648,0.99598,0.99618,961,2059.1,-817300,-817334.8,40.512682934583225,61.540250097884694,65.15967667879214,NaN,NaN,50
1666742400,0.99618,0.99675,0.99534,0.99578,2010,1770.15,-819310,-817741.8,38.65644628771405,58.48558152505289,64.56715464330942,NaN,NaN,50
1666744200,0.99578,0.99595,0.99434,0.99473,2555,1649.6,-821865,-818430.8,36.057050812534804,51.288755674148376,63.34548413271549,NaN,NaN,50
1666746000,0.99473,0.9955,0.99453,0.9951,2618,1601.5,-819247,-818812.2,33.6433264427255,53.46194478457972,62.2041158820026,NaN,NaN,50
1666747800,0.9951,0.99578,0.99466,0.99475,2874,1588.6,-822121,-819968.6,31.410410522240902,51.137809413189736,61.25432569570682,NaN,NaN,50
1666749600,0.99475,0.99523,0.99468,0.99488,1526,1539.3,-820595,-820627.6,29.33698859607663,51.97295563204598,60.23324363893062,NaN,NaN,50
1666751400,0.99488,0.99544,0.99481,0.99524,1206,1500.55,-819389,-820643.4,27.676810108306388,54.30226969107668,59.367131246955054,NaN,NaN,50
1666753200,0.99524,0.9961,0.99518,0.996,1242,1415.95,-818147,-819899.8,26.900057307510732,58.840702555055124,58.78117457611795,NaN,NaN,50
1666755000,0.996,0.99608,0.99528,0.99574,1138,1360.05,-819285,-819907.4,26.17878684962905,56.76374895269963,58.093734116496854,NaN,NaN,50
1666756800,0.99574,0.99602,0.9951,0.99542,1087,1328.2,-820372,-819557.6,25.218605437418574,54.22673020299303,57.26562226816464,NaN,NaN,50
1666758600,0.99542,0.9957,0.9953,0.99547,1287,1317.6,-819085,-819255.6,24.32700841179456,54.56840683871185,56.48107734692701,NaN,NaN,50
1666760400,0.99547,0.99622,0.99517,0.99622,1410,1316.95,-817675,-818912.8,24.150147126225598,59.45711323964567,56.384145964777126,NaN,NaN,50
1666762200,0.99622,0.99712,0.99595,0.99622,1803,1351.05,-817675,-818818.4,24.89556968864343,59.45711323964567,56.265898682087595,NaN,NaN,50
1666764000,0.99622,0.99818,0.99606,0.99749,2312,1427.35,-815363,-818034,26.388083784968945,66.53009170659024,56.57381953952284,NaN,NaN,50
1666765800,0.99749,0.99854,0.99685,0.99828,2503,1532.5,-812860,-816531.6,28.002269261322848,70.03235170903562,57.18039822603362,NaN,NaN,50
1666767600,0.99828,1.00036,0.99738,1.00019,4694,1731.25,-808166,-814347.8,30.386547108107038,76.44883672659944,58.46348788328694,NaN,NaN,50
1666769400,1.00019,1.00348,0.9997,1.00333,4862,1965.7,-803304,-811473.6,33.45472553771008,82.92249647400868,60.72304079756268,NaN,NaN,50
1666771200,1.00333,1.00416,1.00156,1.00244,5355,2176.2,-808659,-809670.4,36.43277661985286,76.50354479124371,62.36886936946725,NaN,NaN,50
1666773000,1.00244,1.00455,1.00227,1.00384,4867,2365.55,-803792,-807356.2,39.269419271448385,79.22751805544388,64.37527712962826,NaN,NaN,50
1666774800,1.00384,1.00478,1.00206,1.0022,3810,2506,-807602,-806304.6,41.94583314496375,69.11877776733186,65.59997871072011,NaN,NaN,50
1666776600,1.0022,1.00272,1.00188,1.00259,3021,2609,-804581,-805587.6,44.171815656405336,70.09591802137088,66.72809644859827,NaN,NaN,50
1666778400,1.00259,1.00314,1.00086,1.0017,3347,2675.85,-807928,-806512.4,44.86172964921487,65.03834687360911,67.17078532849497,NaN,NaN,50
1666780200,1.0017,1.00242,1.00132,1.00232,2799,2688.05,-805129,-805806.4,45.50236407110944,66.83363247681274,67.8900627230745,NaN,NaN,50
1666782000,1.00232,1.00326,1.00217,1.00255,3242,2719.25,-801887,-805425.4,46.41429621145956,67.50034884567907,68.8381783404092,NaN,NaN,50
1666783800,1.00255,1.00292,1.00131,1.00216,3540,2752.55,-805427,-804990.4,46.177591502117586,65.11025974635587,69.59116783381235,NaN,NaN,50
1666785600,1.00216,1.00288,1.00065,1.00065,4218,2887.15,-809645,-806003.2,45.207561736259294,56.73402746781507,69.39666170725302,NaN,NaN,50
1666787400,1.00065,1.00132,0.99956,1.00046,5351,3094.4,-814996,-807416.8,43.213191427177996,55.761955065645715,69.13272183768159,NaN,NaN,50
1666789200,1.00046,1.00148,1.0002,1.00082,4806,3272.6,-810190,-808429,41.46718563112685,57.2563327123345,68.47031048094904,NaN,NaN,50
1666791000,1.00082,1.00318,1.00058,1.0014,6180,3524.7,-804010,-808853.6,40.83345529547891,59.62285305368024,67.72677486270936,NaN,NaN,50
1666792800,1.0014,1.00416,1.0014,1.00282,9049,3922.8,-794961,-806760.4,40.705113549737185,64.76617064298583,66.89229871387981,NaN,NaN,50
1666794600,1.00282,1.005,1.00176,1.0048,6262,4171.55,-788699,-802571.2,40.93893710017365,70.42354985428906,65.99951681247127,NaN,NaN,50
1666796400,1.0048,1.00728,1.00428,1.0069,4532,4327.65,-784167,-796405.4,41.92261237894903,75.00717933818156,65.89263356582397,NaN,NaN,50
1666798200,1.0069,1.0081,1.00626,1.0068,3512,4413.1,-787679,-791903.2,43.05946853457354,74.41576236964251,65.54893673112387,NaN,NaN,50
1666800000,1.0068,1.00812,1.00612,1.00746,2882,4441.6,-784797,-788060.6,43.973736659345356,75.77348338362805,66.0242728465736,NaN,NaN,50
1666801800,1.00746,1.00838,1.00678,1.00766,2724,4452.65,-782073,-785483,44.899843339080206,76.18590636741177,66.45927201414796,NaN,NaN,50
1666803600,1.00766,1.00784,1.007,1.00705,3308,4383.35,-785381,-784819.4,45.75979954169114,72.15148124045683,66.96735304035136,NaN,NaN,50
1666805400,1.00705,1.00832,1.0067,1.008,2784,4279.45,-782597,-784505.4,46.71143991153254,74.4230900750471,67.50945715451095,NaN,NaN,50
1666807200,1.008,1.00858,1.00796,1.00805,2430,4133.2,-780167,-783003,47.677579076670796,74.54079843551901,68.01234641092809,NaN,NaN,50
1666809000,1.00805,1.00888,1.00747,1.00814,2407,4010.2,-777760,-781595.6,47.95470976605215,74.76591321945767,68.70203594472108,NaN,NaN,50
1666810800,1.00814,1.00814,1.0076,1.00764,2129,3926.15,-779889,-781158.8,48.212045406191976,71.00938079567582,69.72170403956828,NaN,NaN,50
1666812600,1.00764,1.00821,1.00756,1.00816,1499,3850.05,-778390,-779760.6,48.481778267349064,72.55386246204945,70.92112599645426,NaN,NaN,50
1666814400,1.00816,1.0085,1.00796,1.00802,1103,3737.85,-779493,-779139.8,48.86314687533047,71.4501954485902,71.93497333475825,NaN,NaN,50
1666816200,1.00802,1.00853,1.00792,1.00852,890,3642.4,-778603,-778827,49.15532973524478,73.02822010273886,72.89249955254814,NaN,NaN,50
1666818000,1.00852,1.0087,1.0073,1.00862,526,3506.6,-778077,-778890.4,48.48690371270074,73.34553848882024,73.50531154153633,NaN,NaN,50
1666819800,1.00862,1.00882,1.00749,1.00816,1322,3395.7,-779399,-778792.4,47.94196138798563,69.30628802140812,73.42550712490197,NaN,NaN,50
1666821600,1.00816,1.00828,1.00747,1.00816,1287,3249.15,-779399,-778994.2,47.40423709144947,69.30628802140812,73.01830060227529,NaN,NaN,50
1666823400,1.00816,1.00837,1.00792,1.00801,1393,3051.25,-780792,-779254,46.96894334559328,67.89228511230993,72.55233794103724,NaN,NaN,50
1666825200,1.00801,1.0088,1.00792,1.00856,1128,2867.35,-779664,-779466.2,46.86588989702373,70.28611464760786,72.16038303132152,NaN,NaN,50
1666827000,1.00856,1.00938,1.00853,1.00934,1617,2639.2,-778047,-779460.2,47.1378538399307,73.32368444419555,71.95593860823465,NaN,NaN,50
1666828800,1.00934,1.00938,1.00815,1.00874,3006,2337.05,-781053,-779791,46.71772236433577,67.59903800702394,71.63076409156086,NaN,NaN,50
1666830600,1.00874,1.00874,1.00743,1.00784,2533,2150.6,-783586,-780628.4,45.18636304169826,60.028328499475776,70.60256683616292,NaN,NaN,50
1666832400,1.00784,1.00844,1.00756,1.00788,3236,2085.8,-780350,-780540,43.76438652782057,60.24145073414091,69.58118485749306,NaN,NaN,50
1666834200,1.00788,1.00808,1.00744,1.00758,3451,2082.75,-783801,-781367.4,42.252522642974604,57.75427465429698,68.36606781712443,NaN,NaN,50
1666836000,1.00758,1.00758,1.00631,1.00647,2005,2038.9,-785806,-782919.2,39.287372132842776,49.59526038846226,66.83648778803774,NaN,NaN,50
1666837800,1.00647,1.00702,1.0062,1.00668,2214,2013.4,-783592,-783427,36.56026935856244,51.00546521341049,65.2973165559921,NaN,NaN,50
1666839600,1.00668,1.00719,1.00664,1.00684,1918,1943.9,-781674,-783044.6,34.08368399751423,52.10494405673184,63.91551288514508,NaN,NaN,50
1666841400,1.00684,1.00732,1.00663,1.00694,1608,1885.1,-780066,-782987.8,31.950937382442202,52.817606556818156,62.471897631865026,NaN,NaN,50
1666843200,1.00694,1.00708,1.00658,1.00704,1144,1820.8,-778922,-782012,29.89779234569306,53.56174509477633,61.05876953229046,NaN,NaN,50
1666845000,1.00704,1.00744,1.00638,1.00708,1756,1788.25,-777166,-780284,28.47819194314201,53.8751125014179,59.95654270943402,NaN,NaN,50
1666846800,1.00708,1.00794,1.007,1.0075,2295,1796.55,-774871,-778539.8,27.772449282315385,57.14514413253394,59.08788957451444,NaN,NaN,50
1666848600,1.0075,1.0084,1.00727,1.00768,2913,1867.25,-771958,-776596.6,27.618734210236834,58.5029623362153,58.41722366193625,NaN,NaN,50
1666850400,1.00768,1.00808,1.00626,1.00674,2950,1959.6,-774908,-775565,25.955726332909606,49.654976814759614,56.94357095958994,NaN,NaN,50
1666852200,1.00674,1.00674,1.00544,1.0057,3089,2069.55,-777997,-775380,24.753557223140113,42.07332922539828,54.71140272967585,NaN,NaN,50
1666854000,1.0057,1.00696,1.0055,1.00588,4156,2251.05,-773841,-774715,23.357122079330537,43.67626494332656,53.00263322512603,NaN,NaN,50
1666855800,1.00588,1.00702,1.00574,1.00666,3776,2373.75,-770065,-773753.8,21.981940344456007,50.11780713190549,52.294738841728154,NaN,NaN,50
1666857600,1.00666,1.00778,1.00583,1.0067,4099,2514.35,-765966,-772555.4,21.046005332410687,50.43089021368384,51.59398451883836,NaN,NaN,50
1666859400,1.0067,1.00718,1.00578,1.00602,3631,2626.25,-769597,-771493.2,20.10880582061459,45.23325808768272,50.699626192651635,NaN,NaN,50
1666861200,1.00602,1.00628,1.00464,1.00471,3251,2732.4,-772848,-770463.4,19.470823128630695,37.26509517715506,49.818900106129696,NaN,NaN,50
1666863000,1.00471,1.0049,1.00308,1.00382,3367,2819.9,-776215,-770938.2,20.190928130745366,33.01052093450315,48.5335469433506,NaN,NaN,50
1666864800,1.00382,1.00464,1.0032,1.00336,3539,2846.55,-779754,-772876,20.859597061280418,31.038091865627493,47.02877178684315,NaN,NaN,50
1666866600,1.00336,1.00394,1.00296,1.0036,3145,2877.15,-776609,-775004.6,21.659630904068276,33.27812953940945,45.63309485702825,NaN,NaN,50
1666868400,1.0036,1.00501,1.00284,1.00492,2867,2858.7,-773742,-775833.6,21.025634594315555,44.04381159347485,44.95324246407814,NaN,NaN,50
1666870200,1.00492,1.00504,1.00412,1.00498,3428,2857.55,-770314,-775326.8,20.401574122642927,44.48230870514866,44.28232790720176,NaN,NaN,50
1666872000,1.00498,1.00518,0.99859,0.99995,7877,3151.15,-778191,-775722,22.73878514057965,26.05129186708581,42.061338459669756,NaN,NaN,50
1666873800,0.99995,1.0026,0.99916,1.00066,10861,3583.5,-767330,-773237.2,24.90905251437804,30.432970128318317,40.05633901624854,NaN,NaN,50
1666875600,1.00066,1.00142,0.99724,0.99934,9767,3975.95,-777097,-773334.8,27.452900021633848,27.20546917380662,38.45280275618047,NaN,NaN,50
1666877400,0.99934,1.00302,0.99924,1.00058,9768,4383.95,-767329,-772052.2,28.39219038038691,34.25876846372746,37.894619844632565,NaN,NaN,50
1666879200,1.00058,1.00434,1.00056,1.00428,8192,4736.35,-759137,-769816.8,28.26706880138498,49.867775032422,38.33687056528223,NaN,NaN,50
1666881000,1.00428,1.0044,0.99886,0.99982,7799,5038.5,-766936,-767565.8,28.78521696208517,38.11891403810856,37.47980677286817,NaN,NaN,50
1666882800,0.99982,1.00118,0.9992,1.00068,6173,5232.4,-760763,-766252.4,29.266354539878197,41.00519002662686,36.80654247379267,NaN,NaN,50
1666884600,1.00068,1.0007,0.99778,0.99839,5926,5383.05,-766689,-764170.8,30.196548258249916,36.1676758968991,36.15900088873669,NaN,NaN,50
1666886400,0.99839,0.99904,0.99742,0.99742,3953,5433.2,-770642,-764833.4,31.17514038090879,34.32070297769852,35.94868716020408,NaN,NaN,50
1666888200,0.99742,0.99824,0.99704,0.9978,2946,5426.05,-767696,-766545.2,32.2068460546911,35.705887646086225,36.14121335388859,NaN,NaN,50
1666890000,0.9978,0.99956,0.9977,0.99892,3169,5376.7,-764527,-766063.4,32.09347006937225,39.739820897498355,36.76276542759365,NaN,NaN,50
1666891800,0.99892,0.999,0.99714,0.99717,1793,5277.55,-766320,-767174.8,32.2109295853463,35.944925573871416,36.95325085862665,NaN,NaN,50
1666893600,0.99717,0.99738,0.99602,0.99612,1609,5153.05,-767929,-767422.8,32.73773930521112,33.8558980249493,36.22554274658911,NaN,NaN,50
1666895400,0.99612,0.99696,0.99577,0.9963,1549,5048.95,-766380,-766570.4,33.31657290869348,34.558049324728216,35.51666707655908,NaN,NaN,50
1666897200,0.9963,0.99714,0.99592,0.99698,1954,4984.1,-764426,-765916.4,33.69456995011769,37.26733265213955,36.31781284692006,NaN,NaN,50
1666899000,0.99698,0.99726,0.99651,0.99708,1795,4905.5,-762631,-765537.2,33.93414423899969,37.675961988814066,36.83516940838405,NaN,NaN,50
1666900800,0.99708,0.99724,0.99603,0.99634,1922,4824.65,-764553,-765183.8,34.364515816513794,35.81671151488602,37.45025814703257,NaN,NaN,50
1666902600,0.99634,0.99683,0.99615,0.99648,2138,4774.3,-762415,-764081,34.76414656706261,36.455609864167705,37.60717538992116,NaN,NaN,50
1666904400,0.99648,0.99666,0.99646,0.99652,76,4634.75,-762339,-763272.8,35.13523226400079,36.64964282379605,36.66302308930502,NaN,NaN,50
1666906200,0.99652,0.99678,0.99622,0.99673,371,4481.9,-761968,-762781.2,35.60017022967544,37.72476459605545,36.63486955772981,NaN,NaN,50
1666908000,0.99673,0.99712,0.99648,0.99684,1241,4150.1,-760727,-762400.4,35.61649047797684,38.315297548762324,36.44273438073947,NaN,NaN,50
1666909800,0.99684,0.99722,0.99678,0.99716,794,3646.75,-759933,-761476.4,35.50709004116495,40.09494591500203,36.723253667746825,NaN,NaN,50
1666911600,0.99716,0.99722,0.99685,0.99704,869,3201.85,-760802,-761153.8,35.40550392126819,39.63316977953849,37.10271558216397,NaN,NaN,50
1666913400,0.99704,0.99722,0.99666,0.99671,819,2754.4,-761621,-761010.2,35.44070155304739,38.32593967210686,37.289862155451154,NaN,NaN,50
1666915200,0.99671,0.9968,0.99582,0.99644,1825,2436.05,-763446,-761305.8,36.00366018540565,37.243561691451504,37.11155792644781,NaN,NaN,50
1666917000,0.99644,0.99692,0.9963,0.99668,2215,2156.85,-761231,-761406.6,36.347197802924974,38.89549136331243,37.3223126256936,NaN,NaN,50
1666918800,0.99668,0.99842,0.99642,0.99838,2568,1976.6,-758663,-761152.6,34.748013656028455,49.113342174558134,38.41213006495138,NaN,NaN,50
1666920600,0.99838,0.99962,0.99786,0.99953,2522,1806.4,-756141,-760220.4,32.417656353577826,54.639210231853816,39.84649870117463,NaN,NaN,50
1666922400,0.99953,0.99982,0.99898,0.99905,1956,1706.55,-758097,-759515.6,30.42645846340645,52.09629713055739,40.90571044963305,NaN,NaN,50
1666924200,0.99905,0.99926,0.99813,0.99886,2861,1702.3,-760958,-759018,28.68730661867452,51.08285417613704,41.8633456058704,NaN,NaN,50
1666926000,0.99886,0.99908,0.99801,0.99814,2064,1647.05,-763022,-759376.2,27.174411638800184,47.32574760591447,42.685419612372435,NaN,NaN,50
1666927800,0.99814,0.99928,0.998,0.99924,1708,1642.8,-761314,-759906.4,25.56552790804243,53.0118138132909,43.86800560873838,NaN,NaN,50
1666929600,0.99924,0.99928,0.9983,0.99862,1492,1636.95,-762806,-761239.4,24.07156444376737,49.75189455983328,44.80388073274104,NaN,NaN,50
1666931400,0.99862,0.99874,0.99818,0.9985,1621,1640.55,-764427,-762505.4,22.80796162252603,49.122262575902006,45.61798773130151,NaN,NaN,50
1666933200,0.9985,0.99876,0.998,0.9982,1527,1619.2,-765954,-763504.6,21.82514282165185,47.503700746642345,46.2743022454358,NaN,NaN,50
1666935000,0.9982,0.99914,0.99731,0.9974,2670,1662.95,-768624,-764625,21.596231215775678,43.39725052398023,46.510181146077095,NaN,NaN,50
1666936800,0.9974,0.99811,0.99636,0.9971,3234,1728.55,-771858,-766733.8,22.168291514779607,41.933340026002725,46.67447902082454,NaN,NaN,50
1666938600,0.9971,0.99768,0.99632,0.99682,4153,1829.3,-776011,-769374.8,22.730078759134088,40.55818309698812,46.83392497974463,NaN,NaN,50
1666940400,0.99682,0.9977,0.99377,0.99476,5442,2097.6,-781453,-772780,24.72406356926264,32.19341773646944,46.47320041153163,NaN,NaN,50
1666942200,0.99476,0.99528,0.99428,0.99458,3754,2266.75,-785207,-776630.6,26.575620892953438,31.580524846627867,45.95070280319702,NaN,NaN,50
1666944000,0.99458,0.9953,0.99265,0.99388,4604,2434.9,-789811,-780868,28.926844044101024,29.248509242695718,44.53178616520684,NaN,NaN,50
1666945800,0.99388,0.99506,0.99378,0.99412,3035,2546.95,-786776,-783851.6,31.110122684452357,31.126368234379086,42.85229745110151,NaN,NaN,50
1666947600,0.99412,0.99648,0.99412,0.99597,3893,2698.15,-782883,-785226,31.39058484447875,43.56144425750356,42.24266510302623,NaN,NaN,50
1666949400,0.99597,0.99609,0.99454,0.99536,2778,2796.1,-785661,-786067.6,31.651013993074677,40.93690396515658,41.51795437367048,NaN,NaN,50
1666951200,0.99536,0.9957,0.99466,0.9949,2344,2822.05,-788005,-786627.2,31.892841059628047,39.02734672485657,40.92521145359492,NaN,NaN,50
1666953000,0.9949,0.99492,0.99355,0.99475,1910,2806.8,-789915,-786648,32.72160805210385,38.398350033385654,39.881392612173116,NaN,NaN,50
1666954800,0.99475,0.9967,0.9939,0.99663,2533,2805.05,-787382,-786769.2,31.609471431595498,49.40464724168382,39.856589232305296,NaN,NaN,50
1666956600,0.99663,0.99758,0.99535,0.9954,3659,2861.9,-791041,-788400.8,29.831684002404373,43.88064507385878,39.48218798215935,NaN,NaN,50
1666958400,0.9954,0.99594,0.99448,0.99474,3949,2961.55,-794990,-790266.6,28.757823887806538,41.21752092809963,39.03317513797773,NaN,NaN,50
1666960200,0.99474,0.99732,0.99368,0.99691,9107,3273.85,-785883,-789842.2,26.704062229994314,51.6150311568809,39.6201594688992,NaN,NaN,50
1666962000,0.99691,0.999,0.99685,0.9971,5668,3454.05,-780215,-787902.2,25.828609461354503,52.40878672627658,40.3684056617759,NaN,NaN,50
1666963800,0.9971,0.99842,0.9966,0.99694,6523,3694.8,-786738,-787773.4,24.83064167642785,51.6405095982912,41.16000041186898,NaN,NaN,50
1666965600,0.99694,0.99826,0.99392,0.99594,6880,3964.2,-793618,-788288.8,23.865446443666723,47.002812845459644,42.217814348225424,NaN,NaN,50
1666967400,0.99594,0.99685,0.99422,0.9951,4952,4130.75,-798570,-789004.8,22.969193727531394,43.47116736714687,43.067145956833926,NaN,NaN,50
1666969200,0.9951,0.99531,0.99306,0.9945,3780,4243.4,-802350,-792298.2,22.733699855130958,41.0959212323374,43.91338967037975,NaN,NaN,50
1666971000,0.9945,0.99472,0.99332,0.99337,3186,4269.2,-805536,-797362.4,22.515026973616266,36.99601316143347,44.332650022312215,NaN,NaN,50
1666972800,0.99337,0.99386,0.99298,0.99304,2254,4220.2,-807790,-801572.8,22.490012921639643,35.87054414584799,43.78330001433681,NaN,NaN,50
1666974600,0.99304,0.99392,0.99288,0.99388,1746,4099.85,-806044,-804058,22.520896465066723,40.80682942219472,43.774008975553826,NaN,NaN,50
1666976400,0.99388,0.99494,0.99388,0.99413,1386,3897.05,-804658,-805275.6,21.701542710235994,42.23202749604109,44.002914744924155,NaN,NaN,50
1666978200,0.99413,0.99448,0.99342,0.99384,1143,3766.5,-805801,-805965.8,21.22539673132882,40.998871002662455,44.18866624272964,NaN,NaN,50
1666980000,0.99384,0.99492,0.99378,0.99455,1265,3599.55,-804536,-805765.8,20.42074300711212,45.21652431972969,43.8895146054472,NaN,NaN,50
1666981800,0.99455,0.99573,0.99448,0.99558,1619,3528.75,-802917,-804791.2,19.041829984561755,50.72008849838541,44.37804627862767,NaN,NaN,50
1666983600,0.99558,0.9962,0.99526,0.99597,1575,3412.85,-801342,-803850.8,17.947624019938687,52.65936870075168,45.19532111953139,NaN,NaN,50
1666985400,0.99597,0.99662,0.99584,0.9966,1568,3352.35,-799774,-802874,17.234339813490923,55.692613123764616,45.48657697430879,NaN,NaN,50
1666987200,0.9966,0.99676,0.99599,0.99668,831,3276.7,-798943,-801502.4,16.67428760120937,56.07746611829465,45.748625502310084,NaN,NaN,50
1666989000,0.99668,0.99672,0.99628,0.9966,839,3223.15,-799782,-800551.6,16.1542391183765,55.55777148348245,46.0284299226809,NaN,NaN,50
1667163600,0.9966,0.9966,0.99543,0.9957,18,3097.4,-799800,-799928.2,15.100898942538468,49.949509588988455,46.238908261504385,NaN,NaN,50
1667165400,0.9957,0.9962,0.9957,0.99601,55,2917.2,-799745,-799608.8,14.122797350688868,51.755979892224325,46.8306805847242,NaN,NaN,50
1667167200,0.99601,0.99606,0.9944,0.9951,2537,2846.6,-802282,-800110.4,14.26409771399467,46.455403392156626,47.213500738997006,NaN,NaN,50
1667169000,0.9951,0.99604,0.9951,0.99575,1785,2480.5,-800497,-800421.2,14.3953051942072,50.36562838284173,48.16847325481188,NaN,NaN,50
1667170800,0.99575,0.99622,0.99564,0.99591,1552,2274.7,-798945,-800253.8,14.323312343855903,51.30824019203076,49.27116582953922,NaN,NaN,50
1667172600,0.99591,0.99604,0.99538,0.99545,1085,2002.8,-800030,-800299.8,14.473501108672318,48.458886812615916,49.81774135742645,NaN,NaN,50
1667174400,0.99545,0.99648,0.99545,0.99592,1743,1745.95,-798287,-800008.2,14.113209169420951,51.42698952504936,50.47452435949847,NaN,NaN,50
1667176200,0.99592,0.99618,0.99533,0.99592,1645,1580.6,-798287,-799209.2,13.890856152146439,51.42698952504936,51.219389968240385,NaN,NaN,50
1667178000,0.99592,0.99636,0.99509,0.9954,1458,1464.5,-799745,-799058.8,13.91331184498056,47.88839906287711,51.41023816417949,NaN,NaN,50
1667179800,0.9954,0.99544,0.99433,0.99485,2263,1418.35,-802008,-799671.4,14.604433736663161,44.40788554510138,50.95936652465921,NaN,NaN,50
1667181600,0.99485,0.99522,0.99459,0.99488,1081,1359.7,-800927,-799850.8,15.246189778939861,44.6442157669864,50.386855600818826,NaN,NaN,50
1667183400,0.99488,0.99566,0.9948,0.99556,1214,1333.1,-799713,-800136,15.238157259928245,49.84851444675167,49.96941998103218,NaN,NaN,50
1667185200,0.99556,0.99594,0.99526,0.99538,1180,1322.8,-800893,-800657.2,14.862388309278757,48.54740595826542,49.4315585410301,NaN,NaN,50
1667187000,0.99538,0.99658,0.99534,0.99649,1355,1333.4,-799538,-800615.8,13.868134544158615,56.1485715235115,49.47375854388931,NaN,NaN,50
1667188800,0.99649,0.99656,0.996,0.99633,906,1315.45,-800444,-800303,12.944898905118482,54.889801861029646,49.82663656332083,NaN,NaN,50
1667190600,0.99633,0.99653,0.99588,0.99608,739,1271.45,-801183,-800354.2,12.105312183494137,52.89443724774415,49.907954945857966,NaN,NaN,50
1667192400,0.99608,0.99618,0.99548,0.99558,1264,1255.9,-802447,-800901,11.82342586565017,49.053679862198095,50.0935461222895,NaN,NaN,50
1667194200,0.99558,0.99586,0.99444,0.99482,1442,1249.6,-803889,-801500.2,12.643430691968408,43.8425601382699,49.62761267624865,NaN,NaN,50
1667196000,0.99482,0.99524,0.99382,0.99426,1727,1294.4,-805616,-802715.8,13.92931829700884,40.43404109385443,48.85088416923605,NaN,NaN,50
1667197800,0.99426,0.99535,0.99418,0.99524,1708,1337.85,-803908,-803408.6,14.955730726576563,48.04623092721086,48.82140874884998,NaN,NaN,50
1667199600,0.99524,0.99549,0.99383,0.99422,2384,1456.15,-806292,-804430.4,16.205782403423388,42.026301209016225,48.14993101199047,NaN,NaN,50
1667201400,0.99422,0.99487,0.99283,0.99296,2292,1568,-808584,-805657.8,18.096961278097286,36.02208882230828,47.04958096179468,NaN,NaN,50
1667203200,0.99296,0.99333,0.99159,0.99192,3003,1591.3,-811587,-807197.4,20.541574056313834,31.962988930016706,45.912051666590365,NaN,NaN,50
1667205000,0.99192,0.99247,0.99144,0.99232,2596,1631.85,-808991,-807872.4,22.88458310009164,34.99692271884352,45.23984003614338,NaN,NaN,50
1667206800,0.99232,0.99336,0.99213,0.99274,2457,1677.1,-806534,-808397.6,23.740572704328148,38.11727949121444,44.77363030215967,NaN,NaN,50
1667208600,0.99274,0.99492,0.99274,0.99466,2418,1743.75,-804116,-807962.4,22.750453055568006,49.94617572820702,44.7806061079779,NaN,NaN,50
1667210400,0.99466,0.99466,0.99304,0.99356,1916,1752.4,-806032,-807452,21.83105623886216,44.67708373425969,44.50415452054892,NaN,NaN,50
1667212200,0.99356,0.99398,0.99274,0.99328,2017,1771,-808049,-806744.4,21.23279248863391,43.42137998341005,43.595069410541676,NaN,NaN,50
1667214000,0.99328,0.99393,0.99308,0.9933,2159,1806.05,-805890,-806124.2,20.67726186342196,43.543440002728985,42.78461499209163,NaN,NaN,50
1667215800,0.9933,0.9938,0.99244,0.99364,2445,1815.15,-803445,-805506.4,20.71411442818137,45.688533461146896,42.26990757876326,NaN,NaN,50
1667217600,0.99364,0.99368,0.99233,0.99254,3146,1918.4,-806591,-806001.4,20.839974422134603,40.34726552595459,41.648020840460156,NaN,NaN,50
1667219400,0.99254,0.9929,0.99074,0.9909,3026,2009,-809617,-806718.4,22.076407929363363,33.97081544267368,40.94289621934614,NaN,NaN,50
1667221200,0.9909,0.99158,0.99012,0.99024,2688,2084.4,-812305,-807569.6,23.570258165014412,31.793187409086087,40.32569238471983,NaN,NaN,50
1667223000,0.99024,0.99083,0.98882,0.989,4063,2219.8,-816368,-809665.2,25.568933364424595,28.143034313940973,38.90403548377197,NaN,NaN,50
1667224800,0.989,0.99083,0.98896,0.99048,3272,2338.1,-813096,-811595.4,27.424846049591196,37.38343795671083,38.57240239432159,NaN,NaN,50
1667226600,0.99048,0.99051,0.98806,0.98898,3136,2457.95,-816232,-813523.6,29.52056236962119,32.78220281284207,38.340981965074,NaN,NaN,50
1667228400,0.98898,0.98955,0.98782,0.98858,2044,2496.95,-818276,-815255.4,31.55915417077001,31.663020228081237,38.319555629221476,NaN,NaN,50
1667230200,0.98858,0.989,0.9873,0.98828,4072,2628.45,-822348,-817264,33.647957004882784,30.813355191135727,38.02072937724234,NaN,NaN,50
1667232000,0.98828,0.98898,0.98806,0.98865,3855,2734.85,-818493,-817689,35.587559636558936,33.194431035465996,37.669097344688886,NaN,NaN,50
1667233800,0.98865,0.989,0.98754,0.98754,3274,2813.15,-821767,-819423.2,37.5859250467451,29.872927754633665,36.23529391800507,NaN,NaN,50
1667235600,0.98754,0.98838,0.98744,0.98814,2154,2801.65,-819613,-820099.4,39.47898627670597,33.73286804291671,35.453564225766286,NaN,NaN,50
1667237400,0.98814,0.98872,0.98732,0.9887,1803,2777.2,-817810,-820006.2,40.65039428416956,37.206857958124885,35.009669795388774,NaN,NaN,50
1667239200,0.9887,0.98957,0.98868,0.98898,1794,2716.75,-816016,-818739.8,40.41632339914722,38.93074068850162,34.68019127294396,NaN,NaN,50
1667241000,0.98898,0.98919,0.98816,0.98882,1618,2667.85,-817634,-818568,40.52346434645262,38.28395714662017,34.15129296476348,NaN,NaN,50
1667242800,0.98882,0.98883,0.98768,0.98787,1674,2628.7,-819308,-818076.2,40.902003177775086,34.60753581988756,33.74131227147297,NaN,NaN,50
1667244600,0.98787,0.98831,0.98774,0.9883,1584,2587,-817724,-817698.4,41.25350352114595,37.53167377940286,33.99565929552506,NaN,NaN,50
1667246400,0.9883,0.9884,0.98807,0.98832,762,2529.3,-816962,-817528.8,41.42974865929171,37.6712799413014,34.41552304782615,NaN,NaN,50
1667248200,0.98832,0.98838,0.98801,0.98828,519,2454.4,-817481,-817821.8,41.6345825809037,37.49081854246236,35.08322192129196,NaN,NaN,50
1667250000,0.98828,0.98872,0.98812,0.98834,98,2351.35,-817383,-817771.6,41.21839419070291,37.970823695512784,35.1251780454921,NaN,NaN,50
1667251800,0.98834,0.98846,0.98817,0.9883,85,2233.35,-817468,-817403.6,40.831933542659314,37.762634685825724,35.480923179276644,NaN,NaN,50
1667253600,0.9883,0.9885,0.98808,0.98844,819,2117,-816649,-817188.6,40.55442292514502,39.0228013230075,36.00662182891424,NaN,NaN,50
1667255400,0.98844,0.98858,0.98834,0.98848,532,1992.3,-816117,-817019.6,40.13338280233192,39.40034186180388,36.619978019676246,NaN,NaN,50
1667257200,0.98848,0.98876,0.98831,0.98872,853,1900.55,-815264,-816576.2,39.36834930611363,41.73146985275943,37.22976650662578,NaN,NaN,50
1667259000,0.98872,0.98878,0.98854,0.98859,712,1733,-815976,-816294.8,38.61514082488688,40.815589356380066,38.01138519246481,NaN,NaN,50
1667260800,0.98859,0.98902,0.98827,0.98879,1399,1639.35,-814577,-815716.6,38.23650009485436,42.89213914593035,38.66561884268007,NaN,NaN,50
1667262600,0.98879,0.98898,0.98824,0.98853,1544,1559.75,-816121,-815611,37.92059641179535,40.88390023780942,38.92826471980039,NaN,NaN,50
1667264400,0.98853,0.98938,0.98842,0.98922,2494,1582.25,-813627,-815113,36.69877581056505,47.86079966954016,39.566126075588855,NaN,NaN,50
1667266200,0.98922,0.99,0.98922,0.9895,2747,1516,-810880,-814236.2,34.36016938354312,50.41805376942993,40.432847262932405,NaN,NaN,50
1667268000,0.9895,0.99024,0.98928,0.99012,2174,1431.95,-808706,-812782.2,32.031302602438814,55.60981610275236,41.9330101402799,NaN,NaN,50
1667269800,0.99012,0.99084,0.99009,0.99064,1669,1351.7,-807037,-811274.2,30.773411788210787,59.44536938973951,43.4982741124468,NaN,NaN,50
1667271600,0.99064,0.99078,0.98994,0.99005,1679,1327.95,-808716,-809793.2,29.331227602919302,53.76857748216334,44.64808107965123,NaN,NaN,50
1667273400,0.99005,0.9906,0.98944,0.99035,2649,1370.25,-806067,-808281.2,27.32910212399972,56.06599368271244,45.97487930395481,NaN,NaN,50
1667275200,0.99035,0.9908,0.98996,0.99058,1735,1367.3,-804332,-806971.6,25.60421924881058,57.79752981681691,47.39107259833367,NaN,NaN,50
1667277000,0.99058,0.99079,0.99028,0.99053,1109,1341.85,-805441,-806318.6,24.002542293277806,57.269111277632874,48.784392354891324,NaN,NaN,50
1667278800,0.99053,0.99108,0.99044,0.99094,1534,1334.85,-803907,-805692.6,22.994208454491368,60.461307693466885,50.315714238495566,NaN,NaN,50
1667280600,0.99094,0.99281,0.99086,0.99251,2373,1374.3,-801534,-804256.2,24.039883127925584,69.77323912829706,52.48520690038794,NaN,NaN,50
1667282400,0.99251,0.99386,0.99218,0.99318,2889,1480.65,-798645,-802771.8,25.757225411503104,72.72537345400056,54.69905715761945,NaN,NaN,50
1667284200,0.99318,0.99348,0.99257,0.99331,2547,1582.05,-796098,-801125,27.3519003891108,73.2708583745141,57.01729065891474,NaN,NaN,50
1667286000,0.99331,0.99334,0.99088,0.99175,4023,1778.3,-800121,-800061,26.312745571111478,58.222731550514744,58.112332973527906,NaN,NaN,50
1667287800,0.99175,0.99335,0.99114,0.99304,3734,1960.75,-796387,-798557,25.35725714780479,64.68217259243113,59.812209570286605,NaN,NaN,50
1667289600,0.99304,0.9948,0.99278,0.9937,3949,2117.25,-792438,-796737.8,25.660297236724144,67.4547366947235,61.211776500656846,NaN,NaN,50
1667291400,0.9937,0.9939,0.99212,0.99227,2196,2200.45,-794634,-795935.6,25.147676604738322,57.01166771711054,61.68274892549117,NaN,NaN,50
1667293200,0.99227,0.99242,0.99152,0.99218,1789,2247.25,-796423,-796000.6,24.016046352405883,56.419646581161544,61.74059395966325,NaN,NaN,50
1667295000,0.99218,0.99354,0.99192,0.9934,2431,2333.2,-793992,-794774.8,23.838169900446623,62.15641986157653,61.934240421937325,NaN,NaN,50
1667296800,0.9934,0.99418,0.99234,0.9937,2936,2410.05,-791056,-793708.6,24.102207743897967,63.431195652225604,62.62442743408463,NaN,NaN,50
1667298600,0.9937,0.99405,0.99299,0.99366,2603,2463,-793659,-793952.8,24.3473857413885,63.125863636740426,63.128703859372344,NaN,NaN,50
1667300400,0.99366,0.99381,0.9926,0.99366,2291,2452.85,-793659,-793757.8,24.107385145097766,63.125863636740426,63.50929913222402,NaN,NaN,50
1667302200,0.99366,0.99424,0.99278,0.99345,2056,2418.3,-795715,-793616.2,24.208788308925,61.328401454942565,63.79924843060328,NaN,NaN,50
1667304000,0.99345,0.99472,0.99345,0.99426,3496,2484.4,-792219,-793261.6,24.646623779886504,65.41860857211653,64.15334135050684,NaN,NaN,50
1667305800,0.99426,0.9948,0.99344,0.9941,2827,2542.3,-795046,-794059.6,25.110223903190025,63.97911071771627,63.73947503546534,NaN,NaN,50
1667307600,0.9941,0.9954,0.99364,0.99388,3111,2613.9,-798157,-794959.2,25.957532800249105,61.96023242245458,62.97053639035492,NaN,NaN,50
1667309400,0.99388,0.99418,0.99297,0.99366,4441,2703.5,-802598,-796747,25.839498027085828,59.923863642253146,62.01717962376485,NaN,NaN,50
1667311200,0.99366,0.99378,0.98904,0.98994,8104,3021.95,-810702,-799744.4,25.53199023063122,37.48807065335751,60.536132416825055,NaN,NaN,50
1667313000,0.98994,0.99088,0.98588,0.98692,6073,3270.15,-816775,-804655.6,26.60297921212954,28.243146021950622,57.93334480464787,NaN,NaN,50
1667314800,0.98692,0.98818,0.9861,0.98802,4303,3408.6,-812472,-808140.8,27.5974689806637,34.5722561890654,55.58459619710086,NaN,NaN,50
1667316600,0.98802,0.98856,0.98638,0.98704,4160,3497.95,-816632,-811835.8,28.193164570327482,31.874854927838527,53.78910956929571,NaN,NaN,50
1667318400,0.98704,0.99099,0.98654,0.98657,6211,3664.05,-822843,-815884.8,26.963710324732887,30.640144520871857,51.94771656498931,NaN,NaN,50
1667320200,0.98657,0.9867,0.9853,0.98614,3419,3707.65,-826262,-818996.8,26.40478874419932,29.51373491580827,49.61609621172015,NaN,NaN,50
1667322000,0.98614,0.98748,0.9858,0.98696,2170,3615,-824092,-820460.2,25.388367627021076,34.46174408504122,47.54684967120698,NaN,NaN,50
1667323800,0.98696,0.98828,0.98681,0.98821,1977,3527.15,-822115,-822388.8,23.958614616815446,41.23399455396522,45.98314473672303,NaN,NaN,50
1667325600,0.98821,0.98862,0.98767,0.98846,1770,3418.2,-820345,-823131.4,22.427709707833614,42.513432390276435,44.510828219118466,NaN,NaN,50
1667327400,0.98846,0.98855,0.98769,0.98828,1720,3394.4,-822065,-822975.8,21.006155149493335,41.80765777180754,43.11648938460882,NaN,NaN,50
1667329200,0.98828,0.9884,0.98774,0.98786,1538,3381.85,-823603,-822444,19.686140202463083,40.13345564049743,41.31040703235031,NaN,NaN,50
1667331000,0.98786,0.98802,0.98738,0.98777,1301,3325.35,-824904,-822606.4,18.700510690604684,39.76596902545228,39.58089691147431,NaN,NaN,50
1667332800,0.98777,0.98798,0.98735,0.98741,655,3211.3,-825559,-823295.2,17.806023358865275,38.25696580324639,37.88780643867373,NaN,NaN,50
1667334600,0.98741,0.98755,0.9873,0.98742,390,3100.65,-825169,-824260,17.012334524473424,38.326975150660985,36.34517154641714,NaN,NaN,50
1667336400,0.98742,0.98839,0.98742,0.98799,3543,3163.25,-821626,-824172.2,16.009529383460194,42.34026254628027,36.69175668162591,NaN,NaN,50
1667338200,0.98799,0.98799,0.98742,0.98756,1904,3155.65,-823530,-824157.6,15.078353181090767,40.21426187868413,37.546836385678304,NaN,NaN,50
1667340000,0.98756,0.988,0.98702,0.98776,1102,3035.95,-822428,-823662.4,14.13948386370951,41.681044680237605,38.0546069921906,NaN,NaN,50
1667341800,0.98776,0.98777,0.98706,0.98742,774,2933.3,-823202,-823191,13.267676640426911,39.88937063443921,38.62707239980494,NaN,NaN,50
1667343600,0.98742,0.98771,0.98723,0.98758,946,2825.05,-822256,-822608.4,12.4581413616645,41.17092829668258,39.37927124093427,NaN,NaN,50
1667345400,0.98758,0.98791,0.9874,0.98776,875,2646.75,-821381,-822559.4,11.640541513586788,42.65222034048776,40.31773448555424,NaN,NaN,50
1667347200,0.98776,0.98808,0.98745,0.98795,1522,2317.65,-819859,-821825.2,11.063572298847149,44.24800714575944,41.01675327560554,NaN,NaN,50
1667349000,0.98795,0.98878,0.9879,0.98875,2620,2145,-817239,-820787.4,11.23432467434681,50.494455746250416,41.678214789340196,NaN,NaN,50
1667350800,0.98875,0.98888,0.9882,0.9884,2278,2043.75,-819517,-820050.4,11.48891067308501,47.96260401267941,42.06744133379755,NaN,NaN,50
1667352600,0.9884,0.98893,0.98816,0.98882,2049,1938.2,-817468,-819092.8,11.775795016252186,51.12931843065892,42.73327423800122,NaN,NaN,50
1667354400,0.98882,0.98884,0.98789,0.98868,1772,1716.25,-819240,-818664.6,11.662507145448577,50.03626434848378,43.4406177171431,NaN,NaN,50
1667356200,0.98868,0.98966,0.98864,0.98938,1442,1617.4,-817798,-818252.4,12.396548572235591,55.194036527256614,44.54262253870054,NaN,NaN,50
1667358000,0.98938,0.98991,0.98916,0.98974,1698,1593.8,-816100,-818024.6,13.307793688245761,57.617217567130695,45.92549766469228,NaN,NaN,50
1667359800,0.98974,0.98998,0.9893,0.9893,1450,1567.45,-817550,-817631.2,14.219527561981607,53.78832713797683,47.02987994950056,NaN,NaN,50
1667361600,0.9893,0.98938,0.98858,0.9889,1734,1565.65,-819284,-817994.4,13.988939678944309,50.50263624584385,47.61290664232653,NaN,NaN,50
1667363400,0.9889,0.98896,0.98796,0.98844,1371,1548.2,-820655,-818277.4,12.996268024256436,46.950714448349444,48.09408182587405,NaN,NaN,50
1667365200,0.98844,0.98896,0.98834,0.98876,1686,1555.6,-818969,-818511.6,12.074501487760552,49.60596384979515,48.66014748084245,NaN,NaN,50
1667367000,0.98876,0.98932,0.98864,0.98878,1721,1576.6,-817248,-818741.2,11.655950638358965,49.775167208872176,49.366275807587655,NaN,NaN,50
1667368800,0.98878,0.98896,0.98787,0.98798,1828,1635.25,-819076,-819046.4,11.340981401743074,43.485609913080935,49.53161020875897,NaN,NaN,50
1667370600,0.98798,0.98876,0.98786,0.98828,1799,1705.7,-817277,-818645,11.060232610083265,46.229504000282226,49.78713047017286,NaN,NaN,50
1667372400,0.98828,0.98858,0.98712,0.98753,2049,1631,-819326,-818379.2,11.616843307272655,40.88511333397098,49.54692376933082,NaN,NaN,50
1667374200,0.98753,0.98854,0.9873,0.98842,2183,1644.95,-817143,-818014,12.133696097519946,48.494444189103916,49.40406580096322,NaN,NaN,50
1667376000,0.98842,0.99056,0.98792,0.9901,3371,1758.4,-813772,-817318.8,12.307748623842267,59.17667464528874,50.2050708461496,NaN,NaN,50
1667377800,0.9901,0.99068,0.98992,0.99002,2286,1834,-816058,-816715.2,12.577211262162397,58.55390261465135,50.73539828786335,NaN,NaN,50
1667379600,0.99002,0.99036,0.98866,0.98916,1961,1884.75,-818019,-816863.6,11.911240379435686,52.19475960195704,50.889576520254295,NaN,NaN,50
1667381400,0.98916,0.99056,0.98907,0.99052,2283,1955.15,-815736,-816145.6,11.088670096044817,59.656519194817626,51.20832528222294,NaN,NaN,50
1667383200,0.99052,0.9912,0.9896,0.98986,2378,1997.95,-818114,-816339.8,10.892928183492819,55.15709593751852,51.032602308679216,NaN,NaN,50
1667385000,0.98986,0.99018,0.98944,0.99016,1990,1966.45,-816124,-816810.2,10.533860312245903,56.75374491513255,51.24441786419034,NaN,NaN,50
1667386800,0.99016,0.99058,0.98878,0.9888,2244,1964.75,-818368,-817272.2,10.060960648973689,48.349313026306184,51.09060906279479,NaN,NaN,50
1667388600,0.9888,0.98992,0.98868,0.98978,1867,1955.65,-816501,-816968.6,9.723752125052028,53.67308086335439,51.570778092438,NaN,NaN,50
1667390400,0.98978,0.99044,0.98846,0.9896,3888,2061.45,-820389,-817899.2,9.225405097418506,52.60065985996468,51.784684950307245,NaN,NaN,50
1667392200,0.9896,0.9908,0.98886,0.99062,4319,2205.3,-816070,-817490.4,9.138731951032856,57.75207468105974,52.3544640554635,NaN,NaN,50
1667394000,0.99062,0.99154,0.99021,0.99046,2949,2267.85,-819019,-818069.4,9.761422009097254,56.710896085779176,53.29912735351338,NaN,NaN,50
1667395800,0.99046,0.99051,0.98882,0.98942,4048,2397.75,-823067,-819009.2,9.286835054706392,50.35602010950131,53.59387850417188,NaN,NaN,50
1667397600,0.98942,0.98944,0.98805,0.98872,2894,2455.75,-825961,-820901.2,9.510317079846198,46.57311667286674,54.000164456950145,NaN,NaN,50
1667399400,0.98872,0.98889,0.98726,0.98736,2705,2522.45,-828666,-822556.6,10.317638852815547,40.247053809060304,53.41106514408989,NaN,NaN,50
1667401200,0.98736,0.98782,0.98644,0.98766,3019,2589.1,-825647,-824472,11.614805788296025,42.11486211891606,52.192364249348984,NaN,NaN,50
1667403000,0.98766,0.98862,0.98705,0.98744,2830,2644.55,-828477,-826363.6,11.972161542523473,41.10024200345373,50.94567420569201,NaN,NaN,50
1667404800,0.98744,0.98764,0.98617,0.98651,2236,2664.95,-830713,-827892.8,12.89109581867918,37.03804407545125,49.86305166808445,NaN,NaN,50
1667406600,0.98651,0.98696,0.9859,0.98676,1432,2646.6,-829281,-828556.8,13.913743802241202,38.78944181411315,48.37254614089128,NaN,NaN,50
1667408400,0.98676,0.98687,0.98588,0.98671,1299,2609.1,-830580,-828939.6,14.876396068856218,38.558426613657254,47.18692690347262,NaN,NaN,50
1667410200,0.98671,0.9892,0.9866,0.98808,2023,2601.1,-828557,-829521.6,14.036519363232788,47.74206036971581,46.54323515022856,NaN,NaN,50
1667412000,0.98808,0.99597,0.98752,0.99448,11125,2988.8,-817432,-827312.6,16.22102346757931,70.17177439956045,48.1019823911753,NaN,NaN,50
1667413800,0.99448,0.9976,0.98735,0.98849,15927,3670.85,-833359,-827841.8,18.64494052800595,48.98155157589604,47.766873156356844,NaN,NaN,50
1667415600,0.98849,0.99054,0.98224,0.98358,10996,4122.6,-844355,-830856.6,18.189276719457382,38.672575829822215,46.772010011346666,NaN,NaN,50
1667417400,0.98358,0.98436,0.9823,0.98286,6735,4345.2,-851090,-834958.6,17.76616032580514,37.42857142322769,45.32033120721581,NaN,NaN,50
1667419200,0.98286,0.98315,0.98214,0.98248,2540,4353.3,-853630,-839973.2,17.30045324816092,36.756540538985035,43.895020096730505,NaN,NaN,50
1667421000,0.98248,0.98266,0.9813,0.98156,1435,4325.55,-855065,-847499.8,16.47999379832846,35.11277435904171,42.80621682884053,NaN,NaN,50
1667422800,0.98156,0.98193,0.98156,0.98169,121,4219.4,-854944,-851816.8,15.718138594912604,35.551364982889595,42.01894885098502,NaN,NaN,50
1667424600,0.98169,0.98205,0.98159,0.98174,3288,4290.45,-851656,-853277,15.06469290454968,35.73129805762774,41.69639486873984,NaN,NaN,50
1667426400,0.98174,0.98318,0.98125,0.98172,1581,4175.1,-853237,-853706.4,14.96017837346927,35.688377164316464,41.23736022912558,NaN,NaN,50
1667428200,0.98172,0.9823,0.9814,0.9815,940,4006.15,-854177,-853815.8,14.863129166037462,35.1876654165262,40.81503333005933,NaN,NaN,50
1667430000,0.9815,0.98162,0.981,0.98132,1125,3914.95,-855302,-853863.2,14.529814972467268,34.75798058283853,40.65217165201556,NaN,NaN,50
1667431800,0.98132,0.98182,0.98106,0.98139,1266,3775.85,-854036,-853681.6,14.32218410505183,35.08993757149233,40.387921348971226,NaN,NaN,50
1667433600,0.98139,0.98182,0.981,0.9811,1399,3701.1,-855435,-854437.4,14.08868226709729,34.311052986348955,40.0845375184492,NaN,NaN,50
1667435400,0.9811,0.98228,0.98104,0.9821,1617,3646.7,-853818,-854553.6,14.128810982684268,39.31335945515211,39.48248745312322,NaN,NaN,50
1667437200,0.9821,0.98371,0.98202,0.98338,2471,3619.3,-851347,-853987.6,14.893077790763614,45.07856174029715,37.6901151203187,NaN,NaN,50
1667439000,0.98338,0.98398,0.98296,0.98313,2712,3613.4,-854059,-853739,15.729868941609482,44.19545383249046,37.348250995789726,NaN,NaN,50
1667440800,0.98313,0.98394,0.983,0.98343,2116,3607.4,-851943,-853320.4,16.506889295966356,45.57336474095025,37.84116448944173,NaN,NaN,50
1667442600,0.98343,0.98354,0.98261,0.98273,1516,3611.6,-853459,-852925.2,16.883435878654048,42.91091856003381,38.23276071349932,NaN,NaN,50
1667444400,0.98273,0.98334,0.98266,0.9827,1473,3620.3,-854932,-853148,17.233086276864046,42.79552647654683,38.66411685189659,NaN,NaN,50
1667446200,0.9827,0.98314,0.98244,0.98294,884,3563.35,-854048,-853688.2,17.345966754399043,44.090813594868074,39.305405368741326,NaN,NaN,50
1667448000,0.98294,0.98322,0.98284,0.98314,1108,3062.5,-852940,-853464.4,17.505556463054766,45.20430264136563,39.994900915775325,NaN,NaN,50
1667449800,0.98314,0.98364,0.98278,0.98348,1039,2318.1,-851901,-853456,17.94494499366169,47.131958933318245,40.809233835467516,NaN,NaN,50
1667451600,0.98348,0.9836,0.98278,0.98283,1338,1835.2,-853239,-853412,18.35294862922526,43.94886176297779,41.399268449657605,NaN,NaN,50
1667453400,0.98283,0.98322,0.98246,0.98261,1251,1561,-854490,-853323.6,18.353119389029562,42.89298155518372,41.94964817384743,NaN,NaN,50
1667455200,0.98261,0.98261,0.98122,0.98155,1941,1531.05,-856431,-853800.2,17.070279198075163,38.1385454920814,42.1911170959362,NaN,NaN,50
1667457000,0.98155,0.98204,0.98099,0.98116,1835,1551.05,-858266,-854865.4,16.033867752228094,36.533995078604796,42.29426406072996,NaN,NaN,50
1667458800,0.98116,0.98134,0.97804,0.97804,3877,1738.85,-862143,-856913.8,17.082710355660073,26.814665736577552,41.75880782860343,NaN,NaN,50
1667460600,0.97804,0.9789,0.97728,0.9784,3437,1746.3,-858706,-858007.2,18.42394410956111,29.15658130427687,41.03332367496948,NaN,NaN,50
1667462400,0.9784,0.97903,0.97631,0.97683,4040,1869.25,-862746,-859658.4,20.093498048492783,25.347165278374717,39.6239382134036,NaN,NaN,50
1667464200,0.97683,0.97734,0.97612,0.97676,3724,2008.45,-866470,-861666.2,21.723426885138988,25.189143018838564,38.26634458385703,NaN,NaN,50
1667466000,0.97676,0.97705,0.975,0.9756,3620,2133.2,-870090,-864031,23.678995834447786,22.667220327313586,36.630191411454405,NaN,NaN,50
1667467800,0.9756,0.97608,0.97474,0.97534,2890,2214.4,-872980,-866198.4,25.590816006334975,22.132353074555056,35.14600816249164,NaN,NaN,50
1667469600,0.97534,0.97564,0.97397,0.97397,3148,2301.85,-876128,-869682.8,27.64084871335043,19.518792380227595,33.483384298468835,NaN,NaN,50
1667471400,0.97397,0.97458,0.97302,0.97454,2777,2359.85,-873351,-871803.8,29.849707287530507,23.563125258311203,32.01712084585763,NaN,NaN,50
1667473200,0.97454,0.97516,0.97366,0.97403,2655,2369.05,-876006,-873711,31.244866508665975,22.474872802346212,30.393590143070536,NaN,NaN,50
1667475000,0.97403,0.97458,0.97354,0.97397,2907,2378.8,-878913,-875475.6,32.586431263635696,22.34412755122098,28.623030758635018,NaN,NaN,50
1667476800,0.97397,0.97636,0.9733,0.97552,5769,2561.45,-873144,-875508.4,32.0201551449574,33.16147264596127,27.852502964562408,NaN,NaN,50
1667478600,0.97552,0.97568,0.97401,0.9741,5748,2773.05,-878892,-876061.2,31.494327320470404,29.15468712101891,26.871196219264924,NaN,NaN,50
1667480400,0.9741,0.97594,0.97353,0.97537,4711,2934.95,-874181,-876227.2,31.276353353785392,36.53990123749709,26.757007343937477,NaN,NaN,50
1667482200,0.97537,0.97616,0.97428,0.97446,6248,3203.15,-880429,-877111.8,30.852004745797228,33.8194504761493,26.563111300904943,NaN,NaN,50
1667484000,0.97446,0.97846,0.97427,0.97801,7924,3543.95,-872505,-875830.2,28.755014259025824,49.587649470785,28.189752996205478,NaN,NaN,50
1667485800,0.97801,0.97948,0.97682,0.97855,5417,3762.85,-867088,-874619,27.460424384593107,51.48134673141721,29.78437909814407,NaN,NaN,50
1667487600,0.97855,0.97875,0.9769,0.97694,4395,3915.7,-871483,-873137.2,26.258305215477012,45.94038633330309,31.25532345921038,NaN,NaN,50
1667489400,0.97694,0.97708,0.97532,0.9758,5123,4109.3,-876606,-873622.2,24.752036819279763,42.45591414924197,32.4886642542392,NaN,NaN,50
1667491200,0.9758,0.97696,0.9753,0.97535,4072,4215.85,-880678,-873672,23.366521725514005,41.129769254351984,33.80741774902765,NaN,NaN,50
1667493000,0.97535,0.97592,0.97456,0.97481,2885,4268.35,-883563,-875883.6,22.565816333379704,39.53393156782907,35.05038764140436,NaN,NaN,50
1667494800,0.97481,0.97536,0.97445,0.97474,2551,4202.05,-886114,-879688.8,21.893669197476537,39.320948346627155,36.46482735329005,NaN,NaN,50
1667496600,0.97474,0.97542,0.97469,0.97472,1687,4114.55,-887801,-882952.4,21.215890636474786,39.25587596580043,37.58573811811071,NaN,NaN,50
1667498400,0.97472,0.97518,0.97425,0.97504,1723,3998.7,-886078,-884846.8,20.89813240218826,40.939987738907526,38.90467489929366,NaN,NaN,50
1667500200,0.97504,0.97566,0.97487,0.97536,1729,3898.95,-884349,-885581,20.14204346508059,42.652240123515554,40.35525436874327,NaN,NaN,50
1667502000,0.97536,0.97614,0.97536,0.97605,1851,3810.5,-882498,-885368,18.99726595962785,46.26949386326686,41.29154159855081,NaN,NaN,50
1667503800,0.97605,0.97616,0.97488,0.97516,1600,3746,-884098,-884964.8,18.32500938607776,42.54208616084428,42.24778438710977,NaN,NaN,50
1667505600,0.97516,0.97522,0.97488,0.97512,766,3626.9,-884864,-884377.4,17.70077113920982,42.376853641009866,42.66470955878925,NaN,NaN,50
1667507400,0.97512,0.97512,0.97478,0.975,820,3529.05,-885684,-884298.6,17.208936557333747,41.851688769471274,43.238440865455104,NaN,NaN,50
1667509200,0.975,0.97553,0.97476,0.97481,685,3430.55,-886369,-884702.6,16.303923073260577,40.98561388912002,42.62400975247903,NaN,NaN,50
1667511000,0.97481,0.97502,0.9748,0.97495,853,3327.85,-885516,-885306.2,15.463553409478346,41.939037288061144,41.94241622081074,NaN,NaN,50
1667512800,0.97495,0.97576,0.97426,0.97499,1119,3095.35,-884397,-885366,14.82625423464575,42.22623121397381,41.677119426572936,NaN,NaN,50
1667514600,0.97499,0.9752,0.9748,0.97514,717,2843.8,-883680,-885129.2,14.23447642944406,43.357713464376324,41.74153366336825,NaN,NaN,50
1667516400,0.97514,0.9752,0.97478,0.97484,443,2630.4,-884123,-884817,13.659769409909936,41.60280550376202,41.775321966897536,NaN,NaN,50
1667518200,0.97484,0.975,0.97472,0.97492,656,2350.8,-883467,-884236.6,13.045829001832956,42.273792975354496,41.97102635314935,NaN,NaN,50
1667520000,0.97492,0.97602,0.97476,0.97551,1918,2050.5,-881549,-883443.2,13.576488557037724,47.101210574453496,42.52675936942266,NaN,NaN,50
1667521800,0.97551,0.97599,0.97521,0.97528,1823,1870.8,-883372,-883238.2,14.069243858299293,45.50368107858594,42.973031163193056,NaN,NaN,50
1667523600,0.97528,0.97568,0.97483,0.97528,1670,1734.55,-883372,-883176.6,13.962813650755775,45.50368107858594,43.299009258884375,NaN,NaN,50
1667525400,0.97528,0.97666,0.97523,0.9764,2019,1579.35,-881353,-882622.6,14.8255731151025,54.26424770033487,44.12843837151432,NaN,NaN,50
1667527200,0.9764,0.97668,0.97605,0.97638,1504,1450.95,-882857,-882500.6,15.644525922052086,54.09700970822875,44.68754664615445,NaN,NaN,50
1667529000,0.97638,0.97714,0.9762,0.97668,1323,1372.85,-881534,-882497.6,16.810939798014836,56.27390621543442,45.66839093576804,NaN,NaN,50
1667530800,0.97668,0.9774,0.97666,0.97706,1517,1321.15,-880017,-881826.6,18.111866301645428,58.930718868446974,46.85080988058497,NaN,NaN,50
1667532600,0.97706,0.97734,0.97682,0.97732,1127,1293.15,-878890,-880930.2,19.319869483588118,60.69063011261146,48.19644854795212,NaN,NaN,50
1667534400,0.97732,0.97824,0.97723,0.97774,1179,1265.95,-877711,-880201.8,21.149468407561315,63.417752767632265,49.798744182131564,NaN,NaN,50
1667536200,0.97774,0.97889,0.97766,0.97866,1770,1268,-875941,-878818.6,23.265498903495804,68.56266053803417,51.70043155712964,NaN,NaN,50
1667538000,0.97866,0.97907,0.9781,0.9783,1829,1266.9,-877770,-878065.8,25.33817808888067,64.72656737423412,53.30759842571966,NaN,NaN,50
1667539800,0.9783,0.97847,0.97754,0.97755,1649,1269.35,-879419,-877946.2,26.249627644203006,57.50767244770653,54.31830978167182,NaN,NaN,50
1667541600,0.97755,0.9785,0.9773,0.97801,1873,1324.7,-877546,-877677.4,26.689387961800037,60.42315574839634,55.66262051343141,NaN,NaN,50
1667543400,0.97801,0.97966,0.97732,0.97805,3417,1454.55,-874129,-876961,27.950614384813743,60.67582159328329,56.97705112899775,NaN,NaN,50
1667545200,0.97805,0.97858,0.97704,0.97734,3222,1581.4,-877351,-877243,28.66909190795076,54.076531152308604,57.47528831313026,NaN,NaN,50
1667547000,0.97734,0.97828,0.9757,0.97639,3586,1718.05,-880937,-877876.4,27.517299719655597,46.74978514982193,57.56429574678997,NaN,NaN,50
1667548800,0.97639,0.97828,0.97639,0.97714,3634,1843.8,-877303,-877453.2,26.44777840195294,52.250208669219106,58.04619057469234,NaN,NaN,50
1667550600,0.97714,0.97837,0.97692,0.9774,2547,1935.3,-874756,-876895.2,25.543165344807512,54.023214398311,58.02897391026206,NaN,NaN,50
1667552400,0.9774,0.9787,0.97718,0.97845,3073,2066.8,-871683,-876406,25.02947432543945,60.41560503432847,58.48030214784062,NaN,NaN,50
1667554200,0.97845,0.97909,0.97733,0.97754,2285,2148.25,-873968,-875729.4,24.920923030174144,53.476203106200565,58.28046621146677,NaN,NaN,50
1667556000,0.97754,0.97858,0.97734,0.9781,2084,2156.55,-871884,-873918.8,24.820125398856362,56.76713044779728,58.125924181420366,NaN,NaN,50
1667557800,0.9781,0.97964,0.978,0.97918,2575,2194.15,-869309,-872320,25.63387353071573,62.30505092995553,58.241239954087796,NaN,NaN,50
1667559600,0.97918,0.98119,0.97853,0.97996,4537,2337.5,-864772,-870323.2,27.334031741472963,65.72032012676672,58.405709051168834,NaN,NaN,50
1667561400,0.97996,0.98036,0.9793,0.97972,2970,2385.05,-867742,-869535,28.912750080033256,63.80475831435481,58.06585889233459,NaN,NaN,50
1667563200,0.97972,0.98024,0.97808,0.97896,4316,2525.65,-872058,-869153,28.68019603025786,58.03601616547411,57.58796237742316,NaN,NaN,50
1667565000,0.97896,0.9851,0.97514,0.9847,11829,3050.95,-860229,-866822,30.61861205528335,75.81854382281358,58.89588176135938,NaN,NaN,50
1667566800,0.9847,0.98818,0.98446,0.98704,9326,3441.4,-850903,-863140.8,33.10290557335325,79.61159485044932,60.26648455436317,NaN,NaN,50
1667568600,0.98704,0.9879,0.98395,0.98668,8018,3785.95,-858921,-861970.6,34.969920974352156,77.59503328383661,61.47499967511698,NaN,NaN,50
1667570400,0.98668,0.99364,0.98604,0.99225,8990,4176.5,-849931,-858408.4,37.60881298083509,84.24469286794532,63.62986836909103,NaN,NaN,50
1667572200,0.99225,0.99406,0.9919,0.99292,7327,4454.35,-842604,-852517.6,40.10718959955323,84.82800640016131,66.34974131554385,NaN,NaN,50
1667574000,0.99292,0.99338,0.98972,0.98978,5767,4651.25,-848371,-850146,40.973475191971175,71.47267307363535,67.72277448728786,NaN,NaN,50
1667575800,0.98978,0.99106,0.98872,0.98954,6134,4875.5,-854505,-850866.4,41.17932810208996,70.5582866387283,68.9038510758891,NaN,NaN,50
1667577600,0.98954,0.99171,0.98878,0.99124,5031,5033.4,-849474,-848977,41.51926779310715,73.17607448529778,69.81531317952977,NaN,NaN,50
1667579400,0.99124,0.99168,0.99044,0.99152,4721,5098.6,-844753,-847941.4,41.83492607762311,73.59255203245988,71.25219524569114,NaN,NaN,50
1667581200,0.99152,0.99278,0.99132,0.99207,3677,5121.35,-841076,-847635.8,42.39014396944324,74.43230243472168,72.51399324475717,NaN,NaN,50
1667583000,0.99207,0.99236,0.99154,0.99232,2651,5074.6,-838425,-845646.6,42.90570344041907,74.82419689438012,73.40821795650177,NaN,NaN,50
1667584800,0.99232,0.99342,0.99146,0.99333,2898,5037.8,-835527,-841851,43.6382300036127,76.39814255528458,74.17091955853877,NaN,NaN,50
1667586600,0.99333,0.99492,0.99333,0.99484,2986,5059.75,-832541,-838464.4,44.64304886959864,78.55658561506168,75.22462150858927,NaN,NaN,50
1667588400,0.99484,0.99612,0.99444,0.99552,3327,5072.45,-829214,-835356.6,45.80914718404344,79.46724965759208,76.7554239008834,NaN,NaN,50
1667590200,0.99552,0.99666,0.99524,0.99607,3012,5108.8,-826202,-832381.8,46.992424678189174,80.19969397408128,77.06836319740252,NaN,NaN,50
1667592000,0.99607,0.99638,0.99588,0.99628,1222,5065.7,-824980,-829692.8,48.091182351324505,80.48592502469728,77.13081535270594,NaN,NaN,50
1667593800,0.99628,0.9963,0.99565,0.99589,1066,4990.25,-826046,-827796.6,48.908601193113746,78.22432063830922,77.17576444945398,NaN,NaN,50
1667772000,0.99589,0.99589,0.99048,0.99137,1200,4823.4,-827246,-826737.6,46.27804134384711,57.91323856826092,75.2949462851908,NaN,NaN,50
1667773800,0.99137,0.99331,0.99126,0.99235,2849,4817.35,-824397,-825774.2,43.835378626670945,60.3189667584011,73.54430059649364,NaN,NaN,50
1667775600,0.99235,0.99451,0.99186,0.99317,2482,4725.65,-821915,-824916.8,42.03275930475206,62.2627326531607,72.8864477093169,NaN,NaN,50
1667777400,0.99317,0.99344,0.99282,0.99285,1319,4200.15,-823234,-824567.6,40.35889850582738,61.00681788368039,72.20419994109919,NaN,NaN,50
1667779200,0.99285,0.99471,0.99285,0.99308,2043,3836,-821191,-823596.6,39.28955149224492,61.60627046197904,71.37778536800498,NaN,NaN,50
1667781000,0.99308,0.99392,0.99283,0.9933,2278,3549,-818913,-821930,38.28393552291357,62.20479558029027,70.56437419285001,NaN,NaN,50
1667782800,0.9933,0.99344,0.99178,0.99218,2467,3222.85,-821380,-821326.6,36.68872059933196,57.306905203141156,69.3411315334514,NaN,NaN,50
1667784600,0.99218,0.99406,0.99202,0.99306,3349,3023.95,-818031,-820549.8,35.47710089677161,59.973644580045786,68.28037779671324,NaN,NaN,50
1667786400,0.99306,0.99363,0.99277,0.99331,2039,2837.55,-815992,-819101.4,34.35202545867986,60.72421226136575,67.1608113471476,NaN,NaN,50
1667788200,0.99331,0.99394,0.99286,0.99378,2081,2634.9,-813911,-817645.4,33.45286412012847,62.16078768580914,65.98968292362957,NaN,NaN,50
1667790000,0.99378,0.99406,0.99254,0.99398,1830,2474.85,-812081,-816279,32.37923123986764,62.78458459776015,64.79806399078443,NaN,NaN,50
1667791800,0.99398,0.99451,0.99374,0.99376,1470,2312.3,-813551,-814713.2,31.61480856644272,61.581954766999914,63.4682254759929,NaN,NaN,50
1667793600,0.99376,0.99432,0.99361,0.99382,1348,2195.85,-812203,-813547.6,30.79841186129078,61.796881784572214,62.133293815983976,NaN,NaN,50
1667795400,0.99382,0.99424,0.99374,0.99391,977,2112.15,-811226,-812594.4,30.04032920650684,62.13903714287316,60.9843449948814,NaN,NaN,50
1667797200,0.99391,0.99458,0.99382,0.99456,1245,2029.5,-809981,-811808.4,29.54084014910491,64.60465737185422,61.462303480852356,NaN,NaN,50
1667799000,0.99456,0.99558,0.9942,0.99444,1721,1966.25,-811702,-811732.6,29.637686393904616,63.778878098054925,61.709440005113336,NaN,NaN,50
1667800800,0.99444,0.99476,0.99408,0.99463,1945,1897.15,-809757,-810973.8,29.605973457538763,64.55147917113877,61.87292189925463,NaN,NaN,50
1667802600,0.99463,0.99486,0.9939,0.994,1624,1827.75,-811381,-810809.4,29.38657628245827,59.982789106968454,61.79977698663235,NaN,NaN,50
1667804400,0.994,0.99472,0.9929,0.99308,3510,1942.15,-814891,-811542.4,28.191837035564436,53.975056865917246,61.25469030119937,NaN,NaN,50
1667806200,0.99308,0.99361,0.99242,0.99278,3292,2053.45,-818183,-813182.8,26.650793851783224,52.141128166768205,60.53585691451922,NaN,NaN,50
1667808000,0.99278,0.99676,0.99247,0.99591,4325,2209.7,-813858,-813614,27.053336189375475,65.363979001438,61.11136218582613,NaN,NaN,50
1667809800,0.99591,0.99902,0.99591,0.99866,4540,2294.25,-809318,-813526.2,28.27441956740261,72.54199813590473,62.00910172553035,NaN,NaN,50
1667811600,0.99866,1.00072,0.99858,0.99911,4617,2401,-804701,-812190.2,29.90405982372065,73.50945586775435,62.92233341170096,NaN,NaN,50
1667813400,0.99911,0.99925,0.99806,0.99857,3510,2510.55,-808211,-810854.2,30.992872980177506,70.30809712954645,63.50428408625363,NaN,NaN,50
1667815200,0.99857,0.99954,0.9983,0.99926,3000,2558.4,-805211,-808259.8,32.0943211320135,71.98687307731765,64.16159040622202,NaN,NaN,50
1667817000,0.99926,0.99936,0.99796,0.99818,2196,2554.3,-807407,-806969.6,32.8210337750729,65.72315162679413,64.45739018192161,NaN,NaN,50
1667818800,0.99818,0.99895,0.9975,0.9985,2228,2542.35,-805179,-806141.8,33.0932895358622,66.64912244261815,64.80397880035346,NaN,NaN,50
1667820600,0.9985,0.99894,0.99752,0.99813,2040,2476.9,-807219,-806645.4,33.346098456595115,64.48012656742137,64.97119947353548,NaN,NaN,50
1667822400,0.99813,0.9983,0.9966,0.99684,3136,2531.75,-810355,-807074.2,32.759576019061484,57.4591696820689,64.46080749569367,NaN,NaN,50
1667824200,0.99684,0.9988,0.99673,0.99874,2955,2575.45,-807400,-807512,32.465963458385325,63.72435771254078,64.45691318244266,NaN,NaN,50
1667826000,0.99874,0.99984,0.9978,0.99838,5510,2759.45,-812910,-808612.6,32.67821899575016,61.865233583516044,64.26503849761247,NaN,NaN,50
1667827800,0.99838,0.9994,0.99758,0.99938,4069,2889.4,-808841,-809345,32.67007964631569,64.92626067383583,64.61814360953156,NaN,NaN,50
1667829600,0.99938,1.0006,0.99882,0.99926,4202,3032.1,-813043,-810509.8,33.19627186538966,64.25968326226794,65.35275978069946,NaN,NaN,50
1667831400,0.99926,1.0003,0.9981,0.99887,5931,3279.8,-818974,-812233.6,33.01654523728219,62.030709311287886,66.05915843387945,NaN,NaN,50
1667833200,0.99887,1.00022,0.99812,0.99912,5128,3473.95,-813846,-813522.8,32.8496562254681,62.9186461602876,65.88449180236869,NaN,NaN,50
1667835000,0.99912,1.00026,0.9983,1.00012,4763,3626.05,-809083,-812757.4,32.71591250177262,66.31228643860345,65.4395123954186,NaN,NaN,50
1667836800,1.00012,1.00022,0.99886,0.99985,3527,3705.15,-812610,-813511.2,32.59172190119824,64.59340142129491,64.80265136352864,NaN,NaN,50
1667838600,0.99985,1.00028,0.99884,0.99968,2998,3773.85,-815608,-814024.2,32.51289499675326,63.4777104513041,64.31476660079704,NaN,NaN,50
1667840400,0.99968,1.00248,0.99939,1.0024,3178,3757.25,-812430,-812715.4,33.54652980325876,71.85437800861348,64.30530266731816,NaN,NaN,50
1667842200,1.0024,1.00266,1.00177,1.0022,2536,3719.45,-814966,-812939.4,34.580326294827245,70.5726511288153,64.65169548889111,NaN,NaN,50
1667844000,1.0022,1.00279,1.00196,1.00277,1896,3598,-813070,-813736.8,35.59586093477776,72.1001258962703,65.0410528784377,NaN,NaN,50
1667845800,1.00277,1.00316,1.00224,1.00309,2060,3474,-811010,-813416.8,36.699305185862826,72.94904311972871,65.64597548931678,NaN,NaN,50
1667847600,1.00309,1.00345,1.00274,1.00292,2072,3346.75,-813082,-812911.6,37.84879680325626,71.7008803738286,66.6632405387282,NaN,NaN,50
1667849400,1.00292,1.00318,1.00253,1.00264,1546,3248.55,-814628,-813351.2,38.62050744285864,69.58892122344339,67.08213793236409,NaN,NaN,50
1667851200,1.00264,1.00314,1.0025,1.0027,1748,3185.95,-812880,-812934,39.29302358260946,69.79424001300637,67.64849553447054,NaN,NaN,50
1667853000,1.0027,1.00295,1.00188,1.00206,1650,3158.65,-814530,-813226,39.02328983136608,64.77092541197581,67.63740015862341,NaN,NaN,50
1667854800,1.00206,1.0025,1.00194,1.00222,539,3074.2,-813991,-813822.2,38.77282277664008,65.44059676629811,67.72175112319698,NaN,NaN,50
1667856600,1.00222,1.00224,1.00202,1.0021,373,2990.85,-814364,-814078.6,38.54024622582308,64.45104976025623,67.89463258383759,NaN,NaN,50
1667858400,1.0021,1.0021,1.00136,1.00184,300,2849.05,-814664,-814085.8,37.34592308734888,62.254521170137494,67.84719508454114,NaN,NaN,50
1667860200,1.00184,1.00196,1.00164,1.00183,502,2726.4,-815166,-814543,36.23690874447997,62.1667652406553,67.55108642754485,NaN,NaN,50
1667862000,1.00183,1.00222,1.0016,1.0018,1050,2503.4,-816216,-814880.2,35.4535977718137,61.884929276991635,67.3576241315232,NaN,NaN,50
1667863800,1.0018,1.00205,1.00154,1.00176,832,2341.55,-817048,-815491.6,34.62914810061245,61.48468190331295,67.21526494952383,NaN,NaN,50
1667865600,1.00176,1.00226,1.00154,1.00216,962,2179.55,-816086,-815836,34.07713190818086,63.992636113447794,66.65371195701199,NaN,NaN,50
1667867400,1.00216,1.00312,1.00214,1.00275,1614,1963.7,-814472,-815797.6,34.335697638575816,67.36790076115261,66.42480121646466,NaN,NaN,50
1667869200,1.00275,1.00278,1.00152,1.00167,2271,1820.85,-816743,-816113,33.5640144618912,56.86073876375519,65.33627356414215,NaN,NaN,50
1667871000,1.00167,1.00186,1.0011,1.0014,1676,1666.5,-818419,-816553.6,32.23148613539631,54.569314012191036,64.0234357707466,NaN,NaN,50
1667872800,1.0014,1.00152,1.00096,1.0014,1451,1562.7,-818419,-816827.8,30.793486434122556,54.569314012191036,62.79975245920105,NaN,NaN,50
1667874600,1.0014,1.00158,1.0007,1.00079,1070,1466.3,-819489,-817508.4,29.084956708239098,49.35757831884946,61.35465653744434,NaN,NaN,50
1667876400,1.00079,1.00129,1.00064,1.00116,1189,1366.85,-818300,-818274,27.411042511546018,52.33145114257598,60.10731447527074,NaN,NaN,50
1667878200,1.00116,1.00149,1.0011,1.00134,921,1286.1,-817379,-818401.2,26.122801748099615,53.75422365443805,59.32040720687519,NaN,NaN,50
1667880000,1.00134,1.00145,1.00092,1.00104,896,1236.1,-818275,-818372.4,24.63860364694996,51.0209357032978,58.29043141666087,NaN,NaN,50
1667881800,1.00104,1.00106,1.00035,1.0006,980,1182.1,-819255,-818539.6,23.33723253584666,47.227895129668404,57.0602060859046,NaN,NaN,50
1667883600,1.0006,1.00075,1.00019,1.00044,1175,1137.25,-820430,-818727.8,22.34708633167753,45.89183357084814,55.89144268595537,NaN,NaN,50
1667885400,1.00044,1.00067,0.99956,0.99956,1425,1131.2,-821855,-819438.8,22.214096503280032,39.305696724728456,54.25850922053202,NaN,NaN,50
1667887200,0.99956,1.00077,0.99956,1.00002,1433,1115.45,-820422,-820047.4,21.91532502672737,43.84262566454278,52.96977324821425,NaN,NaN,50
1667889000,1.00002,1.00058,0.99958,0.99989,1473,1106.6,-821895,-820771.4,21.63789436992847,42.86738622860884,51.63996641430681,NaN,NaN,50
1667890800,0.99989,1.00046,0.99872,0.99963,2148,1187.05,-824043,-821729,22.368834086084284,40.90749372995017,49.99102767262841,NaN,NaN,50
1667892600,0.99963,0.99996,0.99875,0.99996,1867,1261.75,-822176,-822078.2,23.047563822514686,44.383150679408814,48.34925980964671,NaN,NaN,50
1667894400,0.99996,1.00057,0.99838,0.99892,3781,1435.8,-825957,-822898.6,22.529078827794976,36.99761066650867,46.930464945557674,NaN,NaN,50
1667896200,0.99892,1.00014,0.99786,0.99827,2815,1551.45,-828772,-824568.6,22.65326172444028,33.27114924316457,45.409167462055784,NaN,NaN,50
1667898000,0.99827,0.99941,0.99716,0.99906,2515,1624.7,-826257,-825441,23.457590629567147,41.04351062032848,44.44303864835131,NaN,NaN,50
1667899800,0.99906,1.00036,0.99884,1.00035,2178,1692,-824079,-825448.2,22.703260771961787,51.066416713416174,44.5650985336775,NaN,NaN,50
1667901600,1.00035,1.0005,0.99932,0.99951,1975,1742.65,-826054,-826223.8,21.806836184169867,45.62693410237679,44.08620445937756,NaN,NaN,50
1667903400,0.99951,1.00012,0.99942,0.99948,1764,1750.15,-827818,-826596,20.974441924077368,45.44077059715605,43.49238638385742,NaN,NaN,50
1667905200,0.99948,1.00098,0.99898,1.00008,1551,1714.15,-826267,-826095,19.912234194973514,49.84809831435414,43.40861228464716,NaN,NaN,50
1667907000,1.00008,1.00037,0.99948,0.99982,1781,1719.4,-828048,-826453.2,18.925898446519934,48.03720997039411,43.46642048755614,NaN,NaN,50
1667908800,0.99982,1.00018,0.99879,0.99916,2188,1756.25,-830236,-827684.6,18.053195330974983,43.69755240595845,43.30968611863545,NaN,NaN,50
1667910600,0.99916,1.00006,0.99852,0.99938,2569,1831.2,-827667,-828007.2,17.56548006785958,45.46606418715063,43.74971236595132,NaN,NaN,50
1667912400,0.99938,1.00018,0.99918,0.99958,2851,1914.3,-824816,-827406.8,16.93265425913197,47.09305596204776,43.981885958630244,NaN,NaN,50
1667914200,0.99958,1.00048,0.99932,0.99996,2003,1968.4,-822813,-826716,15.898744997495537,50.136990352545844,44.50114339605432,NaN,NaN,50
1667916000,0.99996,1.00124,0.99986,1.00107,3021,2074.65,-819792,-825064.8,15.579576054877672,57.77851741049298,45.70621651609309,NaN,NaN,50
1667917800,1.00107,1.00127,0.99988,1.00114,3704,2210.85,-816088,-822235.2,15.319450670630925,58.21342619040669,46.69409333830722,NaN,NaN,50
1667919600,1.00114,1.00684,1.00106,1.00487,6490,2476.6,-809598,-818621.4,18.436358438122074,73.73728742085568,49.31835596361772,NaN,NaN,50
1667921400,1.00487,1.00734,1.00443,1.00662,5694,2690.05,-803904,-814439,21.47452319884971,77.88785719391342,52.505263674385496,NaN,NaN,50
1667923200,1.00662,1.00792,1.00604,1.0076,4320,2834.4,-799584,-809793.2,24.456734150734455,79.81198723113043,55.274440575157065,NaN,NaN,50
1667925000,1.0076,1.00942,1.0074,1.00877,3600,2940.75,-795984,-805031.6,27.59000407368663,81.84333440059544,57.47279183852701,NaN,NaN,50
1667926800,1.00877,1.0094,1.00795,1.00822,2389,2952.8,-798373,-801488.6,30.499469002142227,77.87637442965959,59.77632329047577,NaN,NaN,50
1667928600,1.00822,1.00896,1.00812,1.00884,1922,2955.55,-796451,-798859.2,33.20111500713671,79.10583126126112,62.180970480768984,NaN,NaN,50
1667930400,1.00884,1.00965,1.00684,1.00704,3046,2918.8,-799497,-797977.8,34.16232020798836,67.3958628934723,63.434382236420284,NaN,NaN,50
1667932200,1.00704,1.00786,1.0061,1.00675,3894,2972.75,-803391,-798739.2,34.2777020482966,65.70823308171664,64.69659817294333,NaN,NaN,50
1667934000,1.00675,1.00716,1.00567,1.00572,3398,3016.9,-806789,-800900.2,33.954564081594704,59.96488828542455,65.85855073576234,NaN,NaN,50
1667935800,1.00572,1.0077,1.00543,1.00726,3573,3086.65,-803216,-801868.8,33.93852663061057,64.90421985666691,67.2469904264421,NaN,NaN,50
1667937600,1.00726,1.00794,1.00714,1.00744,3004,3138.1,-800212,-802621,34.048497748908666,65.44091277778212,68.55755162756599,NaN,NaN,50
1667939400,1.00744,1.00828,1.00696,1.00716,2406,3170.2,-802618,-803245.2,34.32890972936954,63.8063372559971,69.53393354924107,NaN,NaN,50
1667941200,1.00716,1.00764,1.00696,1.00762,489,3117.1,-802129,-802992.8,34.58929228265465,65.33810334084396,70.07390397283757,NaN,NaN,50
1667943000,1.00762,1.00763,1.0072,1.00732,312,3043.65,-802441,-802123.2,34.83107608213366,63.45205123473225,70.44809147600368,NaN,NaN,50
1667944800,1.00732,1.00781,1.00708,1.00738,1807,3024.6,-800634,-801606.8,35.166095196494354,63.6778767811873,69.7295621445988,NaN,NaN,50
1667946600,1.00738,1.00768,1.00714,1.00738,2498,3021.05,-800634,-801691.2,35.477184374114984,63.6778767811873,68.71456354368979,NaN,NaN,50
1667948400,1.00738,1.00851,1.00726,1.00792,1257,2941.35,-799377,-801043,36.27445924553241,65.878520765746,67.71931593901947,NaN,NaN,50
1667950200,1.00792,1.00821,1.00758,1.00804,1015,2891.95,-798362,-800289.6,37.014785911848605,66.36619159357271,66.61380573851785,NaN,NaN,50
1667952000,1.00804,1.00804,1.00648,1.00675,1940,2837.9,-800302,-799861.8,36.097760727641045,56.94422126009158,65.11865194069156,NaN,NaN,50
1667953800,1.00675,1.00754,1.0062,1.00638,1539,2729.65,-801841,-800103.2,34.88879379691912,54.55199543633047,63.36480652462509,NaN,NaN,50
1667955600,1.00638,1.00697,1.00592,1.00688,2307,2520.5,-799534,-799883.2,33.41212110088087,57.170472436787065,62.63442149200471,NaN,NaN,50
1667957400,1.00688,1.0073,1.0062,1.00631,3515,2411.55,-803049,-800617.6,32.348187702026244,53.393759471512034,61.75481623413295,NaN,NaN,50
1667959200,1.00631,1.0076,1.00631,1.00754,2396,2315.35,-800653,-801075.8,31.632610629008923,59.5964072751835,61.72849616197288,NaN,NaN,50
1667961000,1.00754,1.00832,1.00714,1.00815,1918,2231.25,-798735,-800762.4,31.56675224528281,62.27767920006783,61.54088611507295,NaN,NaN,50
1667962800,1.00815,1.00884,1.00762,1.00767,2656,2244.6,-801391,-800672.4,31.88878703694908,58.96187955221771,61.07809802753263,NaN,NaN,50
1667964600,1.00767,1.00786,1.00702,1.00718,1892,2243.1,-803283,-801422.2,31.33478737109775,55.70154172402398,60.499184060963124,NaN,NaN,50
1667966400,1.00718,1.00724,1.00646,1.00698,1968,2189.2,-805251,-801862.6,30.10160552555291,54.3797973589513,59.716447919399364,NaN,NaN,50
1667968200,1.00698,1.00733,1.00658,1.00694,1753,2082.15,-807004,-803132.8,29.041431114033898,54.103282454408514,59.04867872080481,NaN,NaN,50
1667970000,1.00694,1.00732,1.00646,1.00708,1986,2011.55,-805018,-804389.4,27.89660826996808,54.96640079767529,58.42643043626824,NaN,NaN,50
1667971800,1.00708,1.0073,1.00634,1.00684,2148,1940.3,-807166,-805544.4,26.667690842461546,53.12209962990211,57.67244635403358,NaN,NaN,50
1667973600,1.00684,1.00706,1.00563,1.00636,2012,1890.7,-809178,-806723.4,24.914479292271725,49.54178748245079,56.50553683379821,NaN,NaN,50
1667975400,1.00636,1.0065,1.00562,1.00585,1927,1866.75,-811105,-807894.2,23.298751885591788,45.99473660210063,55.05043290583592,NaN,NaN,50
1667977200,1.00585,1.00716,1.00585,1.0065,2605,1972.55,-808500,-808193.4,22.2801619895498,50.826997125524485,54.61348832479541,NaN,NaN,50
1667979000,1.0065,1.00706,1.00597,1.00644,3062,2110.05,-811562,-809502.2,21.33432851465367,50.37888634520087,54.31540910400044,NaN,NaN,50
1667980800,1.00644,1.00854,1.00632,1.00812,4469,2243.15,-807093,-809487.6,21.90932358506455,60.80010594759159,54.57466864048648,NaN,NaN,50
1667982600,1.00812,1.00848,1.00656,1.00694,4333,2334.9,-811426,-809937.2,22.44324757901751,52.465529905606246,54.50836652863607,NaN,NaN,50
1667984400,1.00694,1.00709,1.00538,1.00624,4089,2476.5,-815515,-810819.2,21.35518193947887,48.24084073596667,53.69725463297772,NaN,NaN,50
1667986200,1.00624,1.00676,1.00402,1.0047,4436,2647.55,-819951,-813109.4,20.65802284888328,40.512039039331725,52.142566050068,NaN,NaN,50
1667988000,1.0047,1.00533,1.0034,1.00385,4721,2786.6,-824672,-815731.4,20.511333373005904,36.98947903794243,50.57310887047691,NaN,NaN,50
1667989800,1.00385,1.00513,1.00342,1.00458,3036,2861.45,-821636,-818640,20.37512171683406,41.679593652645075,49.571541151092696,NaN,NaN,50
1667991600,1.00458,1.00623,1.00454,1.0059,2957,2893.95,-818679,-820090.6,19.060373314947647,49.06274360632863,49.19175159733394,NaN,NaN,50
1667993400,1.0059,1.00644,1.00514,1.0054,2974,2866.9,-821653,-821318.2,17.762448268577298,46.65347140976342,48.659622237002154,NaN,NaN,50
1667995200,1.0054,1.00568,1.00416,1.00419,3296,2911.9,-824949,-822317.8,17.319948951791673,41.360280444374126,47.687756497480635,NaN,NaN,50
1667997000,1.00419,1.00504,1.00406,1.00498,3177,2974.85,-821772,-821737.8,16.99361446895937,45.69258642463201,47.15707698281849,NaN,NaN,50
1667998800,1.00498,1.00506,1.00228,1.00254,5037,3093.9,-826809,-822772.4,17.963226405376318,36.67909137312224,46.23831297500931,NaN,NaN,50
1668000600,1.00254,1.00357,1.00236,1.00286,4903,3244.45,-821906,-823417.8,18.86358034633491,38.395438735697034,45.695505984551914,NaN,NaN,50
1668002400,1.00286,1.0041,1.0021,1.00227,4498,3370.95,-826404,-824368,19.08527584899099,36.43452761857544,44.667472448341265,NaN,NaN,50
1668004200,1.00227,1.00268,1.0011,1.00184,6233,3594.95,-832637,-825905.6,19.949107357041242,35.03034430641915,43.57114801699971,NaN,NaN,50
1668006000,1.00184,1.00866,1.0018,1.00404,8997,3945.5,-823640,-826279.2,20.34390091877285,46.410090943712795,42.543289802436945,NaN,NaN,50
1668007800,1.00404,1.0045,1.00125,1.0028,7708,4223.5,-831348,-827187,20.3428209544418,41.95005601004477,41.79218452418255,NaN,NaN,50
1668009600,1.0028,1.00528,1.00278,1.0047,5302,4388,-826046,-828015,20.677345397329976,49.89551582536272,41.91037560199654,NaN,NaN,50
1668011400,1.0047,1.00498,1.00352,1.00368,3803,4481.8,-829849,-828704,20.987975237154714,46.2367408620652,42.319282875048934,NaN,NaN,50
1668013200,1.00368,1.0043,1.00253,1.00273,2950,4499.05,-832799,-828736.4,20.56324895865851,43.069017392539436,42.75353561466301,NaN,NaN,50
1668015000,1.00273,1.00342,1.00226,1.0027,2751,4483.5,-835550,-831118.4,19.98054246930811,42.96890296990411,42.84562913732436,NaN,NaN,50
1668016800,1.0027,1.00311,1.00168,1.002,4155,4467.8,-839705,-832789.8,19.035220602617684,40.59756663670234,42.240973639493916,NaN,NaN,50
1668018600,1.002,1.002,1.0003,1.00124,3135,4407.9,-842840,-836148.6,18.064947156080073,38.136731099489715,41.63263504590294,NaN,NaN,50
1668020400,1.00124,1.00146,1.00074,1.00091,1849,4295.9,-844689,-839116.6,17.16397895572371,37.085562243564816,41.32729803155941,NaN,NaN,50
1668022200,1.00091,1.00093,0.9993,1.00027,3268,4237.5,-847957,-842148.2,17.147804241258406,35.066840873030216,40.568316206445,NaN,NaN,50
1668024000,1.00027,1.00127,1.00017,1.00117,2743,4138.6,-845214,-844081,16.882500569213164,40.01202991270588,40.80638324498669,NaN,NaN,50
1668025800,1.00117,1.00156,1.00072,1.00102,2534,4113.5,-847748,-845689.6,16.41911054951529,39.472464575419764,40.883313662109735,NaN,NaN,50
1668027600,1.00102,1.00143,1.00072,1.00142,1237,4027.5,-846511,-846423.8,15.98881981693869,41.729085979826536,41.26149640219911,NaN,NaN,50
1668029400,1.00142,1.0016,1.00114,1.00117,908,3924.2,-847419,-846969.8,15.44823026665925,40.70756902048447,41.667012453203775,NaN,NaN,50
1668031200,1.00117,1.00118,1.00076,1.00105,1126,3815.7,-848545,-847087.4,15.216266874721867,40.19888668658609,41.223355006266154,NaN,NaN,50
1668033000,1.00105,1.0013,1.00076,1.0012,1778,3745.75,-846767,-847398,14.889926701671818,41.18819283522343,41.16893620806463,NaN,NaN,50
1668034800,1.0012,1.00137,1.00094,1.00133,1116,3549.7,-845651,-846978.6,14.518757357778084,42.08246210492151,40.61086094231883,NaN,NaN,50
1668036600,1.00133,1.00206,1.00126,1.00192,889,3349,-844762,-846628.8,13.517138192805941,46.089045152707655,40.60031124879329,NaN,NaN,50
1668038400,1.00192,1.00246,1.00154,1.00224,1322,3190.2,-843440,-845833,12.873256768465202,48.18277599504439,40.96557972040078,NaN,NaN,50
1668040200,1.00224,1.00272,1.00171,1.00209,1478,2952.45,-844918,-845107.6,12.504886719270065,47.25630976155421,41.271823062661504,NaN,NaN,50
1668042000,1.00209,1.00292,1.00209,1.00278,2002,2602.7,-842916,-844337.4,12.341583367379412,51.84338867621043,42.075096065483514,NaN,NaN,50
1668043800,1.00278,1.00283,1.00189,1.00238,2221,2328.35,-845137,-844234.6,11.9665516852556,49.17350436707061,42.863437013167854,NaN,NaN,50
1668045600,1.00238,1.0025,1.00102,1.00119,2171,2171.8,-847308,-844743.8,11.502798290987142,42.209198715626876,43.229411046886575,NaN,NaN,50
1668047400,1.00119,1.00196,1.00112,1.0017,1986,2080.95,-845322,-845120.2,11.07217013916643,45.754999098631686,43.992850920143816,NaN,NaN,50
1668049200,1.0017,1.00245,1.00151,1.00191,1560,2011.45,-843762,-844889,10.426599167133668,47.191781130703255,44.50569029285792,NaN,NaN,50
1668051000,1.00191,1.00294,1.00186,1.00264,1495,1948.65,-842267,-844759.2,10.325383834591024,51.955669358513234,45.397347777364594,NaN,NaN,50
1668052800,1.00264,1.0029,1.00232,1.00256,1223,1802.05,-843490,-844429.8,10.231398168658568,51.40834412724307,46.08872335932291,NaN,NaN,50
1668054600,1.00256,1.00292,1.00237,1.00288,1057,1698.15,-842433,-843454.8,10.1659583201272,53.5176765488576,47.003731039921,NaN,NaN,50
1668056400,1.00288,1.00374,1.0026,1.00364,1767,1694.05,-840666,-842523.6,10.94185099348331,58.16277089956747,48.28686562656253,NaN,NaN,50
1668058200,1.00364,1.00384,1.00324,1.00347,1547,1608,-842213,-842213.8,11.756414161957677,56.79554279147672,49.40167633772348,NaN,NaN,50
1668060000,1.00347,1.0039,1.0029,1.00294,2022,1571.95,-844235,-842607.4,12.009774278230733,52.64092538151444,50.15585228605154,NaN,NaN,50
1668061800,1.00294,1.0043,1.00287,1.00318,2203,1555.4,-842032,-842315.8,12.656241441061567,54.27216397376718,50.74036077327008,NaN,NaN,50
1668063600,1.00318,1.00318,1.00056,1.00062,3493,1668.2,-845525,-842934.2,12.817186124347565,38.88623855812839,50.076322384918946,NaN,NaN,50
1668065400,1.00062,1.00106,0.99964,0.99978,3320,1788.8,-848845,-844570,13.653635721982413,35.345420278735205,49.22554456471759,NaN,NaN,50
1668067200,0.99978,1.00142,0.99941,0.99994,4250,1945,-844595,-845046.4,14.025919788610555,36.53090346498707,48.13179562105877,NaN,NaN,50
1668069000,0.99994,1.00026,0.99864,0.99912,3220,2017.1,-847815,-845762.4,14.92101201521043,33.17376381629467,46.98895701028906,NaN,NaN,50
1668070800,0.99912,0.99918,0.99758,0.99778,3225,2122.55,-851040,-847564,16.3985978034115,28.55553977907408,46.01369565767815,NaN,NaN,50
1668072600,0.99778,0.998,0.99594,0.99614,3020,2229.1,-854060,-849271,18.554126509371173,24.128320137125158,44.468932874713396,NaN,NaN,50
1668074400,0.99614,0.99694,0.99364,0.99418,3884,2357.2,-857944,-851090.8,21.33654257714354,20.11458524903766,42.534847454594434,NaN,NaN,50
1668076200,0.99418,0.99553,0.99409,0.99552,3062,2436.4,-854882,-853148.2,23.92021464007502,28.831142756333506,40.88309555443873,NaN,NaN,50
1668078000,0.99552,0.99578,0.99354,0.99526,3663,2519.45,-858545,-855294.2,26.48233318654733,28.18845212793633,39.22453184020253,NaN,NaN,50
1668079800,0.99526,0.9953,0.99428,0.99448,2301,2523.45,-860846,-857255.4,28.861443265414476,26.294736058179666,37.2800360908684,NaN,NaN,50
1668081600,0.99448,0.99516,0.99422,0.99456,2306,2530.2,-858540,-858151.4,31.089999768151777,26.83762562420914,35.042525714057085,NaN,NaN,50
1668083400,0.99456,0.99513,0.99418,0.99492,2421,2551.95,-856119,-857786.4,33.17312900336656,29.359166435127676,33.08278454574644,NaN,NaN,50
1668085200,0.99492,0.99656,0.99424,0.99588,3591,2653.5,-852528,-857315.6,33.31523268798963,35.721245724471416,31.874235998814793,NaN,NaN,50
1668087000,0.99588,1.016,0.99568,1.01227,15302,3343.85,-837226,-853051.8,35.14592997071283,75.79780475985852,33.41178176924989,NaN,NaN,50
1668088800,1.01227,1.01548,1.011,1.01443,11126,3839,-826100,-846102.6,36.845863161812936,77.76530016325258,36.18885759818733,NaN,NaN,50
1668090600,1.01443,1.01679,1.013,1.01639,12561,4414.2,-813539,-837102.4,38.575707535165975,79.4016578385933,39.335731709605774,NaN,NaN,50
1668092400,1.01639,1.01744,1.01422,1.01737,10661,4858.9,-802878,-826454.2,40.25662632315479,80.18681387497192,42.45401102460469,NaN,NaN,50
1668094200,1.01737,1.01854,1.01584,1.01813,9206,5241.85,-793672,-814683,41.94367786357604,80.79809395874749,45.855748891922744,NaN,NaN,50
1668096000,1.01813,1.01815,1.01472,1.01604,7782,5529.85,-801454,-807528.6,42.94087323704072,74.03364482800767,49.104184966846574,NaN,NaN,50
1668097800,1.01604,1.01792,1.01594,1.01746,5314,5685.4,-796140,-801536.6,43.86684036954363,75.53246093445456,52.775909309512954,NaN,NaN,50
1668099600,1.01746,1.01761,1.01529,1.01584,3556,5688.55,-799696,-798768,44.37364619910352,70.53065724378305,56.37705730913763,NaN,NaN,50
1668101400,1.01584,1.01584,1.01288,1.01428,4800,5762.55,-804496,-799091.6,43.6327138165009,65.99834013432726,59.03185712185147,NaN,NaN,50
1668103200,1.01428,1.01618,1.01428,1.01492,4701,5785.1,-799795,-800316.2,43.02382850513459,66.93703451934768,61.79961300695229,NaN,NaN,50
1668105000,1.01492,1.01588,1.01446,1.01583,3470,5797.6,-796325,-799290.4,42.458435001723004,68.27803900318402,64.79842036016689,NaN,NaN,50
1668106800,1.01583,1.01688,1.01571,1.01678,2700,5771.35,-793625,-798787.4,42.184422222799576,69.66144670773463,67.85726472327585,NaN,NaN,50
1668108600,1.01678,1.01822,1.0166,1.01812,2400,5740.35,-791225,-797093.2,42.24774278412873,71.54637015626818,70.87063641764303,NaN,NaN,50
1668110400,1.01812,1.01898,1.01782,1.01871,2285,5660.4,-788940,-793982,42.478927450487184,72.36062247555925,73.48773475700645,NaN,NaN,50
1668112200,1.01871,1.01976,1.01846,1.01968,2420,5628.3,-786520,-791327,42.86788811440175,73.69349578912716,73.33742697338278,NaN,NaN,50
1668114000,1.01968,1.0222,1.01952,1.02155,4046,5647.45,-782474,-788556.8,43.71644779474093,76.08757638247258,73.21758956046992,NaN,NaN,50
1668115800,1.02155,1.02172,1.02035,1.02076,1804,5622.6,-784278,-786687.4,44.5043960693416,73.06247339269156,72.76479067147694,NaN,NaN,50
1668117600,1.02076,1.02076,1.01982,1.02029,446,5529.6,-784724,-785387.2,44.8828702416186,71.24757648641031,72.1262737151511,NaN,NaN,50
1668119400,1.02029,1.02046,1.01951,1.01984,5221,5669.6,-789945,-785588.2,45.02319342847846,69.46829935749042,71.31700267220417,NaN,NaN,50
1668121200,1.01984,1.02044,1.01884,1.01971,2170,5598.55,-792115,-786707.2,44.69295366613341,68.93273149342923,70.95265171973428,NaN,NaN,50
1668123000,1.01971,1.0199,1.01893,1.01916,1238,4895.35,-793353,-788883,44.38630245824158,66.59354942177626,70.31415804025725,NaN,NaN,50
1668124800,1.01916,1.01962,1.0188,1.01898,2080,4443.05,-795433,-791114,44.00343985737516,65.8065003108029,69.9767182593301,NaN,NaN,50
1668126600,1.01898,1.01907,1.01756,1.01851,3002,3965.1,-798435,-793856.2,42.74106660536693,63.689846146462216,69.81182583162546,NaN,NaN,50
1668128400,1.01851,1.01902,1.01798,1.01815,3389,3601.5,-801824,-796232,41.56886287135927,62.04370097428566,69.46230200697816,NaN,NaN,50
1668130200,1.01815,1.01815,1.01632,1.01663,3549,3318.65,-805373,-798883.6,39.35986258108209,55.51893646944384,68.55093754028245,NaN,NaN,50
1668132000,1.01663,1.01924,1.01663,1.01854,2580,3058.55,-802793,-800771.6,37.82386913922238,61.06049622794067,67.93658393458288,NaN,NaN,50
1668133800,1.01854,1.01984,1.01816,1.01944,2470,2916.35,-800323,-801749.6,36.665537121537405,63.37585441235627,67.3529756671606,NaN,NaN,50
1668135600,1.01944,1.01956,1.01846,1.01856,2213,2849.2,-802536,-802569.8,35.58994310511564,59.641616168671646,66.44447521666864,NaN,NaN,50
1668137400,1.01856,1.01894,1.01818,1.01842,2079,2713.15,-804615,-803128,34.38166673264742,59.045548721033185,65.39819328323335,NaN,NaN,50
1668139200,1.01842,1.01844,1.01778,1.01822,1254,2540.8,-805869,-803227.2,32.956400871369915,58.151434348314,64.11704028079346,NaN,NaN,50
1668141000,1.01822,1.01944,1.01818,1.01922,1604,2447.5,-804265,-803521.6,32.17000197259367,61.30643427829245,63.27732320119351,NaN,NaN,50
1668142800,1.01922,1.02129,1.01894,1.02116,2332,2429.1,-801933,-803843.6,32.270353760321775,66.57169148956083,62.94333141570424,NaN,NaN,50
1668144600,1.02116,1.02232,1.02062,1.02191,4059,2512.05,-797874,-802911.2,32.75259668558917,68.36397600105066,62.86445117595854,NaN,NaN,50
1668146400,1.02191,1.02348,1.02168,1.0219,3469,2571.25,-801343,-802256.8,33.59438563066065,68.31138528759448,62.820069304113204,NaN,NaN,50
1668148200,1.0219,1.02192,1.0208,1.02176,2622,2581.35,-803965,-801876,33.66558858520045,67.52817304262848,62.88682813417409,NaN,NaN,50
1668150000,1.02176,1.02352,1.02113,1.02321,4197,2588.9,-799768,-800976.6,34.28648190250559,71.20991970878038,63.27278666260104,NaN,NaN,50
1668151800,1.02321,1.02534,1.02296,1.02447,4356,2716.5,-795412,-799672.4,35.38587443672962,73.97164873025265,64.0072011328718,NaN,NaN,50
1668153600,1.02447,1.02506,1.02264,1.02448,4815,2934.95,-790597,-798217,36.15570075248007,73.99297147263985,64.86072045418281,NaN,NaN,50
1668155400,1.02448,1.0274,1.02408,1.02704,4720,2909.9,-785877,-795123.8,37.470640456731765,78.78450218561464,66.52254657676643,NaN,NaN,50
1668157200,1.02704,1.02718,1.02478,1.02492,4699,3036.35,-790576,-792446,38.69165589639405,67.66625638505626,66.99438658798898,NaN,NaN,50
1668159000,1.02492,1.02702,1.02408,1.02692,4573,3203.1,-786003,-789693,39.25841993830168,71.72079540239346,67.59045380156307,NaN,NaN,50
1668160800,1.02692,1.028,1.02556,1.02568,6194,3408.8,-792197,-789050,40.058699322923545,66.1798055669629,68.05746733001244,NaN,NaN,50
1668162600,1.02568,1.02765,1.02542,1.02558,4970,3507.2,-797167,-790364,40.68428282214723,65.73871631679835,68.53555072970995,NaN,NaN,50
1668164400,1.02558,1.02788,1.02547,1.02732,4014,3538.45,-793153,-791819.2,41.33457563833392,69.54260402540595,69.3492057066451,NaN,NaN,50
1668166200,1.02732,1.02949,1.02723,1.0291,4174,3569.7,-788979,-791499.8,42.3873723052704,72.86198821634015,70.17460241650564,NaN,NaN,50
1668168000,1.0291,1.03052,1.02842,1.02998,4130,3647.2,-784849,-791269,43.61407888276317,74.35030153715135,70.73021741990496,NaN,NaN,50
1668169800,1.02998,1.0314,1.02892,1.0309,4555,3751.45,-780294,-788888.4,44.94980439610474,75.84195508389436,71.26435878296523,NaN,NaN,50
1668171600,1.0309,1.03243,1.03025,1.03135,5790,3930.3,-774504,-784355.8,46.402855689015574,76.5600017111394,71.8535456703613,NaN,NaN,50
1668173400,1.03135,1.0317,1.03024,1.03118,4996,4076.15,-779500,-781625.2,47.7423698835182,75.64527000951733,72.43333831085336,NaN,NaN,50
1668175200,1.03118,1.03236,1.02958,1.0297,5291,4278,-784791,-780787.6,48.9862044926992,68.02519780108102,72.20585817458911,NaN,NaN,50
1668177000,1.0297,1.02992,1.02658,1.02886,7797,4587.65,-792588,-782335.4,47.5086828444313,64.07971516807741,71.4992914915766,NaN,NaN,50
1668178800,1.02886,1.03135,1.02753,1.03122,9224,4932.25,-783364,-782949.4,46.66306521892015,69.44223918534806,71.17423918534146,NaN,NaN,50
1668180600,1.03122,1.0327,1.02996,1.03266,6818,5070.2,-776546,-783357.8,46.31256693367575,72.17212621977833,70.70192661635316,NaN,NaN,50
1668182400,1.03266,1.0333,1.03151,1.03214,6029,5198.2,-782575,-783972.8,46.16732867049305,69.74894267002486,70.85068992242235,NaN,NaN,50
1668184200,1.03214,1.03392,1.03122,1.0333,5184,5326.3,-777391,-782492.8,46.2155096300561,72.00685865439172,70.8711230118508,NaN,NaN,50
1668186000,1.0333,1.03398,1.03291,1.03397,3382,5285.55,-774009,-778777,46.2783615880271,73.24882978540353,71.37605331316799,NaN,NaN,50
1668187800,1.03397,1.03452,1.03293,1.0342,3057,5220.6,-770952,-776294.6,46.50371775796893,73.68052262182556,71.9433251920985,NaN,NaN,50
1668189600,1.0342,1.03539,1.03381,1.03516,2637,5111.7,-768315,-774648.4,46.970192576726596,75.46054342781531,72.36603514941346,NaN,NaN,50
1668191400,1.03516,1.03596,1.03456,1.03572,2458,4998.6,-765857,-771304.8,47.56384310397575,76.46064443290142,72.62308202202497,NaN,NaN,50
1668193200,1.03572,1.03607,1.03536,1.03596,2829,4905.1,-763028,-768432.2,48.14653686799258,76.89524293711159,72.80486355059357,NaN,NaN,50
1668195000,1.03596,1.03642,1.0349,1.03624,2998,4826.35,-760030,-765636.4,48.21538805518456,77.41904527345656,72.917512849848,NaN,NaN,50
1668196800,1.03624,1.03626,1.03483,1.03568,3182,4675.75,-763212,-764088.4,48.20573127174649,73.81472234725183,72.72142146671317,NaN,NaN,50
1668198600,1.03568,1.03611,1.03532,1.03575,2671,4560.8,-760541,-762533.6,48.19676425855399,73.97780751487896,72.60231700281044,NaN,NaN,50
1668200400,1.03575,1.03599,1.03547,1.03585,1257,4422.95,-759284,-761219,48.18843774630381,74.22477872332648,73.04514421154225,NaN,NaN,50
1668202200,1.03585,1.03586,1.03526,1.03542,1201,4274.3,-760485,-760710.4,47.91378494296808,71.09995924899832,73.54659021732232,NaN,NaN,50
1668376800,1.03542,1.03542,1.03128,1.03181,1142,4124.9,-761627,-761029.8,44.82908638017019,51.498316074356865,72.26488142368008,NaN,NaN,50
1668378600,1.03181,1.03346,1.03159,1.03194,935,3943.9,-760692,-760525.8,41.96472342900072,52.011392556766125,70.8248290191792,NaN,NaN,50
1668380400,1.03194,1.03328,1.03146,1.03281,3397,3824.25,-757295,-759876.6,39.39148262005392,55.41088971068358,69.80068237922626,NaN,NaN,50
1668382200,1.03281,1.03346,1.03269,1.0327,2377,3693.3,-759672,-759954.2,36.861248927760364,54.88151795604347,68.57744375791567,NaN,NaN,50
1668384000,1.0327,1.03366,1.03242,1.03256,3198,3588.65,-762870,-760431.2,34.71189933006901,54.1721658298352,67.21482490394651,NaN,NaN,50
1668385800,1.03256,1.03344,1.0324,1.03328,3006,3349.1,-759864,-760078.6,32.731539441175656,57.233617580016826,66.04004597238874,NaN,NaN,50
1668387600,1.03328,1.03498,1.03272,1.0332,4799,3127.85,-764663,-760872.8,31.128496060673527,56.779745257534195,64.70570324594009,NaN,NaN,50
1668389400,1.0332,1.03333,1.03214,1.03274,4018,2987.85,-768681,-763150,29.155724862591757,54.122026157840814,63.11008765486434,NaN,NaN,50
1668391200,1.03274,1.03306,1.032,1.03249,3361,2854.45,-772042,-765624,27.207586734754447,52.6788518169945,61.380345431998826,NaN,NaN,50
1668393000,1.03249,1.03308,1.03164,1.03258,2464,2718.45,-769578,-766965.6,25.433486390142257,53.16304711638702,59.64777413506529,NaN,NaN,50
1668394800,1.03258,1.03335,1.03222,1.03308,2847,2691.7,-766731,-768339,23.685954528049432,55.864899358669206,58.3656439215951,NaN,NaN,50
1668396600,1.03308,1.03346,1.03223,1.03269,2227,2650.2,-768958,-769198,22.163024002512604,53.282990886560476,56.887442733858066,NaN,NaN,50
1668398400,1.03269,1.03272,1.03054,1.03077,2264,2631.55,-771222,-769706.2,21.794564013167097,42.79647680493712,54.64256402540168,NaN,NaN,50
1668400200,1.03077,1.03148,1.03064,1.03124,1853,2601.3,-769369,-769171.6,21.452422594489125,45.61797166892018,52.8224220553961,NaN,NaN,50
1668402000,1.03124,1.0313,1.03008,1.03008,2184,2569.05,-771553,-769566.6,21.536583686311754,40.330641502891524,52.02473101457715,NaN,NaN,50
1668403800,1.03008,1.03084,1.02978,1.03004,2605,2549.4,-774158,-771052,21.822727192614806,40.15779642415872,51.17804557653376,NaN,NaN,50
1668405600,1.03004,1.03116,1.03004,1.0311,2377,2509.15,-771781,-771616.6,21.716807061645945,46.67930738010751,50.55436112434976,NaN,NaN,50
1668407400,1.0311,1.03272,1.03076,1.03249,2200,2485.6,-769581,-771288.4,20.24874936891082,53.79082775043758,50.4764546810922,NaN,NaN,50
1668409200,1.03249,1.03288,1.0316,1.03201,2914,2568.45,-772495,-771913.6,19.02219536973573,51.2489047815653,50.26765032050149,NaN,NaN,50
1668411000,1.03201,1.03279,1.03122,1.03278,3151,2665.95,-769344,-771471.8,17.79097490341563,54.92842398220177,50.10299363494327,NaN,NaN,50
1668412800,1.03278,1.03508,1.03252,1.03336,4770,2847.35,-764574,-769555,18.096686199049465,57.528726813072296,50.15649231748171,NaN,NaN,50
1668414600,1.03336,1.03486,1.03257,1.03446,4570,3029.1,-760004,-767199.6,18.380560973566595,62.00574162482067,50.7196148508374,NaN,NaN,50
1668416400,1.03446,1.03448,1.03154,1.03204,4673,3092.9,-764677,-766218.8,17.69426331930788,49.61462765427021,50.5007416963571,NaN,NaN,50
1668418200,1.03204,1.03313,1.03084,1.03128,4123,3180.2,-768800,-765479.8,16.483251696774786,46.473627704158524,50.022926024055074,NaN,NaN,50
1668420000,1.03128,1.03182,1.02882,1.03044,4275,3234.05,-773075,-766226,16.59611467940264,43.217034355096,49.119507095228414,NaN,NaN,50
1668421800,1.03044,1.03083,1.02875,1.0293,3419,3254.7,-776494,-768610,16.741401726112628,39.20211602583128,48.11373031946204,NaN,NaN,50
1668423600,1.0293,1.02943,1.02811,1.02834,2921,3160.8,-779415,-772492.2,17.246938254508624,36.15595629999673,47.63940742625201,NaN,NaN,50
1668425400,1.02834,1.02864,1.02752,1.02841,2823,3101.05,-776592,-774875.2,18.04034519269087,36.543154324481684,46.99120618736355,NaN,NaN,50
1668427200,1.02841,1.0285,1.02716,1.02839,3202,3093.1,-779794,-777074,18.969756143217303,36.47508902711105,46.71580958195066,NaN,NaN,50
1668429000,1.02839,1.03362,1.02817,1.03341,4817,3210.75,-774977,-777454.4,18.82048110743248,57.74795007710566,47.97224912858973,NaN,NaN,50
1668430800,1.03341,1.03356,1.03152,1.0318,6033,3370.05,-781010,-778357.6,18.681868574203715,51.76117666844464,48.33523979204238,NaN,NaN,50
1668432600,1.0318,1.03254,1.03072,1.03178,4741,3495.75,-785751,-779624.8,18.034222764991675,51.68948853273002,48.1851441336347,NaN,NaN,50
1668434400,1.03178,1.03262,1.03066,1.03084,4309,3598,-790060,-782318.4,17.475766968213737,48.30336299057249,47.97474829142093,NaN,NaN,50
1668436200,1.03084,1.0318,1.02974,1.03134,5754,3793.05,-784306,-783220.8,16.358213112467492,50.1731456398494,47.635085552681474,NaN,NaN,50
1668438000,1.03134,1.03356,1.03127,1.03276,5553,3961.5,-778753,-783976,16.270700100380623,55.13598269443249,47.464175258492915,NaN,NaN,50
1668439800,1.03276,1.03361,1.03195,1.033,6138,4138.15,-772615,-782297,16.21446608552656,55.9348404818003,47.030539462562885,NaN,NaN,50
1668441600,1.033,1.03414,1.03248,1.03404,3886,4213.6,-768729,-778892.6,16.43396780129028,59.31554056712802,47.7234618134813,NaN,NaN,50
1668443400,1.03404,1.03512,1.03276,1.03358,5446,4375.9,-774175,-775715.6,17.112006428956374,57.22431408732439,48.491367983707434,NaN,NaN,50
1668445200,1.03358,1.03492,1.03332,1.03412,4113,4435.85,-770062,-772866.8,17.741613726074895,59.04952127951113,49.62225990687993,NaN,NaN,50
1668447000,1.03412,1.03466,1.0332,1.03356,2694,4413,-772756,-771667.4,18.22239273472047,56.363602456129755,50.84808036618697,NaN,NaN,50
1668448800,1.03356,1.0354,1.03338,1.03535,2556,4302.3,-770200,-771184.4,19.053041187492433,62.27106216158471,52.71344507058611,NaN,NaN,50
1668450600,1.03535,1.0355,1.03469,1.03532,2216,4184.6,-772416,-771921.8,19.875757008804143,62.11927635133728,54.54031092964723,NaN,NaN,50
1668452400,1.03532,1.03586,1.03494,1.03518,1935,4047.7,-774351,-771957,20.829391083503133,61.367523709304386,56.31834197837532,NaN,NaN,50
1668454200,1.03518,1.03536,1.03462,1.03534,1518,3917.45,-772833,-772511.2,21.378787564417973,61.93448951119764,56.6173805093819,NaN,NaN,50
1668456000,1.03534,1.03552,1.03378,1.0344,1983,3802.85,-774816,-772923.2,21.055530864988235,56.67228641292791,56.96817406255928,NaN,NaN,50
1668457800,1.0344,1.03451,1.03286,1.03286,1897,3726.75,-776713,-774225.8,19.94805434903169,49.28437250851258,56.796380060829456,NaN,NaN,50
1668459600,1.03286,1.03334,1.0326,1.03309,1056,3633.5,-775657,-774874,18.70409181329391,50.325905072272846,56.94084735237948,NaN,NaN,50
1668461400,1.03309,1.03313,1.0327,1.03271,792,3531.95,-776449,-775293.6,17.548983744394544,48.55180988626365,56.82503765569478,NaN,NaN,50
1668463200,1.03271,1.03331,1.03271,1.03278,697,3406.7,-775752,-775877.4,16.632640329269712,48.90910572205813,56.38026072909662,NaN,NaN,50
1668465000,1.03278,1.03292,1.0323,1.0323,712,3201.45,-776464,-776207,15.497768106539963,46.523189369049256,55.70799993532869,NaN,NaN,50
1668466800,1.0323,1.03282,1.03156,1.03217,1482,2973.9,-777946,-776453.6,15.096835271349654,45.870530783199555,54.74764209361951,NaN,NaN,50
1668468600,1.03217,1.03268,1.03178,1.03198,844,2779.05,-778790,-777080.2,14.724540495815793,44.87956167921363,53.86587406446875,NaN,NaN,50
1668470400,1.03198,1.03246,1.03182,1.03198,1717,2649.45,-778790,-777548.4,14.378838204248634,44.87956167921363,52.85373409301893,NaN,NaN,50
1668472200,1.03198,1.03253,1.03126,1.03188,1802,2451.85,-780592,-778516.4,14.573223904165225,44.2954429075877,51.99172269669449,NaN,NaN,50
1668474000,1.03188,1.03286,1.03148,1.03234,2428,2295.6,-778164,-778856.4,14.349256735650235,47.66948196467804,50.94875268262973,NaN,NaN,50
1668475800,1.03234,1.0324,1.03122,1.03196,2488,2113.1,-780652,-779397.6,14.39060686889084,45.23213734931135,49.7425284681993,NaN,NaN,50
1668477600,1.03196,1.03278,1.03156,1.03222,2276,2032.6,-778376,-779314.8,13.949501387350596,47.220590960901724,48.73203327188484,NaN,NaN,50
1668479400,1.03222,1.03274,1.03166,1.03207,2296,1875.1,-780672,-779691.2,13.539903440206084,46.17890714579479,47.60663453149891,NaN,NaN,50
1668481200,1.03207,1.03236,1.03168,1.0321,1788,1758.85,-778884,-779349.6,13.159562489286177,46.43342196890723,46.87528707121172,NaN,NaN,50
1668483000,1.0321,1.03239,1.03138,1.03204,1510,1699.65,-780394,-779795.6,13.163421024188526,45.965250568601455,46.638206932646646,NaN,NaN,50
1668484800,1.03204,1.03234,1.03165,1.03191,1652,1654.45,-782046,-780074.4,13.167003949454994,44.908720987858054,46.251265212331305,NaN,NaN,50
1668486600,1.03191,1.0323,1.03178,1.03212,1123,1599.8,-780923,-780583.8,13.170330951488143,47.02692524514623,46.14234488082291,NaN,NaN,50
1668488400,1.03212,1.03337,1.03198,1.0331,1877,1596.9,-779046,-780258.6,12.864547321456962,55.60534231788122,46.62064749481028,NaN,NaN,50
1668490200,1.0331,1.0335,1.03278,1.0332,1554,1598.7,-777492,-779980.2,12.742705151196141,56.38155504914193,47.32481647195976,NaN,NaN,50
1668492000,1.0332,1.03359,1.03277,1.03356,2012,1600.15,-775480,-778997.4,12.745262607705786,59.150557666418955,48.273389820761146,NaN,NaN,50
1668493800,1.03356,1.0344,1.0333,1.03404,1791,1594.85,-773689,-777326,13.683231022644382,62.563088762835264,49.536498898162684,NaN,NaN,50
1668495600,1.03404,1.03854,1.0339,1.03786,4087,1746.4,-769602,-775061.8,16.950141917605162,78.18328850242109,51.91533652839179,NaN,NaN,50
1668497400,1.03786,1.04181,1.03768,1.04074,7500,2081.8,-762102,-771673,20.78933706685651,83.70387034657062,54.73022420260485,NaN,NaN,50
1668499200,1.04074,1.04173,1.03937,1.0404,6869,2390.4,-768971,-769968.8,24.354303991161338,81.09495193543341,57.11775777194452,NaN,NaN,50
1668501000,1.0404,1.04146,1.04,1.04074,4363,2572.95,-764608,-767794.4,27.66463042087296,81.70891071078255,59.72324158347818,NaN,NaN,50
1668502800,1.04074,1.04092,1.03881,1.03954,3960,2696.85,-768568,-766770.2,29.37095159239841,72.73113405627956,61.54542323314802,NaN,NaN,50
1668504600,1.03954,1.04066,1.0389,1.0401,3912,2850.25,-764656,-765781,30.955392680243467,74.15810521187733,63.543937380725346,NaN,NaN,50
1668506400,1.0401,1.04148,1.03954,1.04141,4202,2974.5,-760454,-765451.4,32.71132472941034,77.16805333715337,65.73926819274293,NaN,NaN,50
1668508200,1.04141,1.04376,1.0414,1.0428,4454,3107.1,-756000,-762857.2,34.969499703957894,79.84993328559398,68.15960267252811,NaN,NaN,50
1668510000,1.0428,1.04368,1.0419,1.04262,4101,3190.75,-760101,-761955.8,37.06637646603777,78.56299765155941,70.56347957707821,NaN,NaN,50
1668511800,1.04262,1.0427,1.04092,1.04111,3365,3234.6,-763466,-760935.4,37.96078289269248,68.5778345806868,72.10283024390253,NaN,NaN,50
1668513600,1.04111,1.04153,1.03974,1.04082,3566,3299.1,-767032,-761410.6,37.67815130882286,66.82129579808719,72.90396977820296,NaN,NaN,50
1668515400,1.04082,1.04124,1.04023,1.04074,3942,3381.4,-770974,-763514.6,37.41570769522964,66.31666549210136,73.61362052412862,NaN,NaN,50
1668517200,1.04074,1.04135,1.03922,1.0396,5655,3574.75,-776629,-767640.4,36.274903815990264,59.42922229111623,73.63352514017843,NaN,NaN,50
1668519000,1.0396,1.04815,1.03958,1.04385,13722,4185.35,-762907,-768201.6,37.485870844284605,71.36792105388545,74.26244173239631,NaN,NaN,50
1668520800,1.04385,1.04446,1.04132,1.04168,9595,4582.5,-772502,-770008.8,38.61034022770077,61.428342987828046,73.06565990992537,NaN,NaN,50
1668522600,1.04168,1.04254,1.03807,1.04004,10451,5048.9,-782953,-773193,37.649516404423785,55.1741749170566,71.02782452210293,NaN,NaN,50
1668524400,1.04004,1.04073,1.03822,1.03998,7922,5351.15,-790875,-777173.2,36.75732285423801,54.953735096344985,69.16059474788234,NaN,NaN,50
1668526200,1.03998,1.04087,1.0361,1.03684,9099,5728.4,-799974,-781842.2,34.840712328595345,44.85383906256979,66.52808963015285,NaN,NaN,50
1668528000,1.03684,1.03894,1.03608,1.03796,6701,5962.85,-793273,-787915.4,33.05130498136346,48.490322204641906,64.7966030693216,NaN,NaN,50
1668529800,1.03796,1.03898,1.03696,1.03715,5295,6138.05,-798568,-793128.6,31.406808182676453,46.12155741838574,62.79399251264363,NaN,NaN,50
1668531600,1.03715,1.03735,1.03482,1.03728,4742,6170.8,-793826,-795303.2,29.48921891650877,46.572658068786836,60.608607136331734,NaN,NaN,50
1668533400,1.03728,1.03865,1.03678,1.03848,3997,5995.65,-789829,-795094,27.653228334738557,50.6777586367264,58.52488037569834,NaN,NaN,50
1668535200,1.03848,1.03888,1.03128,1.03254,5953,5949.85,-795782,-794255.6,27.384621160130457,35.95210842682994,55.481245431074804,NaN,NaN,50
1668537000,1.03254,1.03354,1.02932,1.03094,13123,6387.85,-808905,-797382,27.639928307514772,33.157285654740434,52.95120622207863,NaN,NaN,50
1668538800,1.03094,1.03431,1.02802,1.03232,12364,6808.05,-796541,-796976.6,28.183706537043214,37.65870540574372,50.868164051196956,NaN,NaN,50
1668540600,1.03232,1.03659,1.03179,1.03641,8461,7035.5,-788080,-795827.4,27.673087522951377,48.6879068861116,49.60896700791197,NaN,NaN,50
1668542400,1.03641,1.03776,1.03592,1.03632,6288,7139.8,-794368,-796735.2,26.72428348914902,48.48463548839016,48.82721080771724,NaN,NaN,50
1668544200,1.03632,1.03682,1.03528,1.03538,4247,7129.45,-798615,-797301.8,26.03483099391577,46.309935401978514,47.0373546897239,NaN,NaN,50
1668546000,1.03538,1.03584,1.03436,1.03497,2322,7040.5,-800937,-795708.2,25.66862463919199,45.35438153903266,45.889214586238516,NaN,NaN,50
1668547800,1.03497,1.035,1.03456,1.03481,1225,6933.5,-802162,-796832.4,25.328575881234194,44.964465373776406,45.159949618861354,NaN,NaN,50
1668549600,1.03481,1.03528,1.03429,1.03468,378,6774.1,-802540,-799724.4,24.8740739385578,44.62874728579997,44.42245048953671,NaN,NaN,50
1668551400,1.03468,1.03482,1.03444,1.03454,1472,6650.6,-804012,-801653.2,24.45203642035829,44.24561835933054,44.37900615359105,NaN,NaN,50
1668553200,1.03454,1.03516,1.03398,1.0342,1570,6446.35,-805582,-803046.6,24.232053662427724,43.274006259677485,44.006412157522156,NaN,NaN,50
1668555000,1.0342,1.03612,1.0342,1.03576,1878,5854.15,-803704,-803600,23.48530343978675,48.82661596078069,44.19963062483608,NaN,NaN,50
1668556800,1.03576,1.03613,1.03362,1.0339,2856,5517.2,-806560,-804479.6,23.032825039889598,43.374974379994775,43.97122464706522,NaN,NaN,50
1668558600,1.0339,1.03534,1.03358,1.03445,4047,5197,-802513,-804474.2,22.62981087778403,45.31917102073342,43.58846838878001,NaN,NaN,50
1668560400,1.03445,1.035,1.03374,1.03457,3644,4983.1,-798869,-803445.6,22.255583441543152,45.756774256982155,44.2888016623623,NaN,NaN,50
1668562200,1.03457,1.0348,1.03309,1.03438,5171,4786.7,-804040,-803137.2,22.213576225864,45.14078717924108,45.144766056969495,NaN,NaN,50
1668564000,1.03438,1.03872,1.03417,1.03814,5320,4717.65,-798720,-802140.4,21.266038992529598,57.37113697473897,46.5527968833263,NaN,NaN,50
1668565800,1.03814,1.03857,1.03728,1.0377,3510,4628.4,-802230,-801274.4,20.386182990147656,55.80330771954294,47.06103979999996,NaN,NaN,50
1668567600,1.0377,1.0378,1.03592,1.03648,2967,4539.65,-805197,-801811.2,19.00635715095178,51.593232245916624,47.283082425537565,NaN,NaN,50
1668569400,1.03648,1.03648,1.03528,1.03537,2377,4458.65,-807574,-803552.2,18.03968955698327,48.041849434417806,47.4067905707118,NaN,NaN,50
1668571200,1.03537,1.03564,1.03377,1.03496,2831,4302.55,-810405,-804825.2,17.828220716139906,46.76147063585776,47.507296934770736,NaN,NaN,50
1668573000,1.03496,1.03558,1.03442,1.03452,2387,3765.75,-812792,-807639.6,17.63185679249964,45.364184444820474,47.53584829698816,NaN,NaN,50
1668574800,1.03452,1.03787,1.0341,1.03708,4739,3384.5,-808053,-808804.2,16.541795921701596,53.98032417100631,48.203818074502905,NaN,NaN,50
1668576600,1.03708,1.03751,1.03673,1.03737,2908,3106.85,-805145,-808793.8,15.529596541674842,54.84897577401524,48.96120074698039,NaN,NaN,50
1668578400,1.03737,1.03834,1.03659,1.03832,3183,2951.6,-801962,-807671.4,15.007555646486779,57.66789252993915,49.98933548057051,NaN,NaN,50
1668580200,1.03832,1.0387,1.03744,1.03787,3309,2904.7,-805271,-806644.6,14.701293546104935,55.887948268110826,50.49371635966552,NaN,NaN,50
1668582000,1.03787,1.03967,1.03754,1.03836,5554,3066.3,-799717,-804029.6,14.88384225593701,57.428784980325894,51.49755997397488,NaN,NaN,50
1668583800,1.03836,1.04148,1.03752,1.04027,4346,3222.35,-795371,-801493.2,15.811421859405646,62.87273673292174,52.75138609627404,NaN,NaN,50
1668585600,1.04027,1.04208,1.03926,1.03983,6234,3515.15,-801605,-800785.2,16.898329289188148,60.939430694718084,53.83586155611233,NaN,NaN,50
1668587400,1.03983,1.0408,1.03874,1.0406,4065,3644.8,-797540,-799900.8,17.540150783012855,63.079037585142466,55.11716515653386,NaN,NaN,50
1668589200,1.0406,1.04246,1.04043,1.0412,3428,3737.7,-794112,-797669,18.76570619270301,64.70157941198106,55.64076818776543,NaN,NaN,50
1668591000,1.0412,1.04255,1.04063,1.042,3447,3816.15,-790665,-795858.6,19.935886498366624,66.79678410045227,56.426016500687524,NaN,NaN,50
1668592800,1.042,1.04386,1.04154,1.04268,3705,3858.6,-786960,-794176.4,21.474349219735235,68.50788874402252,57.63420625055223,NaN,NaN,50
1668594600,1.04268,1.04326,1.04188,1.04282,3598,3836.15,-783362,-790527.8,22.902921746720374,68.86365751420415,59.12147825625125,NaN,NaN,50
1668596400,1.04282,1.04319,1.04178,1.04276,3055,3806.7,-786417,-788303.2,24.142930717382008,68.5064624202421,60.674691955135856,NaN,NaN,50
1668598200,1.04276,1.04277,1.04115,1.04166,3452,3720.75,-789869,-787454.6,24.74432316339786,62.142465007096206,61.873140566726974,NaN,NaN,50
1668600000,1.04166,1.04216,1.04128,1.04167,3338,3621.65,-786531,-786627.8,25.302759006126855,62.1768641786305,62.4586077101287,NaN,NaN,50
1668601800,1.04167,1.04282,1.04092,1.04196,4134,3652.85,-782397,-785715.2,26.122527459908234,63.22058220004653,63.05657959770237,NaN,NaN,50
1668603600,1.04196,1.0423,1.04024,1.04142,4236,3716.3,-786633,-786369.4,26.24984199886428,59.90565557009521,63.216419814856366,NaN,NaN,50
1668605400,1.04142,1.04163,1.03843,1.0391,9147,4054.8,-795780,-788242,24.935344011097044,48.20985047224765,62.66798425800901,NaN,NaN,50
1668607200,1.0391,1.04104,1.03863,1.04012,6771,4251.8,-789009,-788070,23.71473873674175,52.59221807119898,62.32251519307137,NaN,NaN,50
1668609000,1.04012,1.04088,1.03726,1.03883,8629,4563.9,-797638,-790291.4,22.39247435941511,47.157392115726694,61.19999057755744,NaN,NaN,50
1668610800,1.03883,1.03934,1.0373,1.03814,6417,4647.8,-804055,-794623,21.164657437611808,44.507999672288015,60.02631693309815,NaN,NaN,50
1668612600,1.03814,1.04056,1.03768,1.04038,6292,4817,-797763,-796849,20.116021977050096,53.618196428863115,59.350542564792484,NaN,NaN,50
1668614400,1.04038,1.04128,1.03984,1.04058,4334,4874.55,-793429,-796378.8,19.582798335350393,54.33898778842017,58.61035744882385,NaN,NaN,50
1668616200,1.04058,1.04068,1.0391,1.03945,3702,4894.2,-797131,-798003.2,18.540281033688164,49.64471727711711,57.38520981858562,NaN,NaN,50
1668618000,1.03945,1.03972,1.03837,1.03916,2905,4761.75,-800036,-798482.8,17.36515537213357,48.48704268285001,55.95514938564473,NaN,NaN,50
1668619800,1.03916,1.03989,1.03714,1.0384,3432,4716.05,-803468,-798365.4,17.036079325516067,45.49299787682841,54.2858165544036,NaN,NaN,50
1668621600,1.0384,1.03862,1.03624,1.03664,3627,4585.7,-807095,-800231.8,17.223291036359026,39.422061411124936,52.20835933946667,NaN,NaN,50
1668623400,1.03664,1.03676,1.03548,1.03668,2848,4524.85,-804247,-802395.4,17.782141868253092,39.619277093380255,50.59956020277267,NaN,NaN,50
1668625200,1.03668,1.03757,1.03666,1.03738,2005,4453.7,-802242,-803417.6,17.662460277778802,43.109774676677155,49.237625238347434,NaN,NaN,50
1668627000,1.03738,1.03926,1.0369,1.03925,3259,4444.3,-798983,-803207,16.403419566899405,51.22202030113677,48.38058510271102,NaN,NaN,50
1668628800,1.03925,1.03956,1.0383,1.03954,2753,4396.7,-796230,-801759.4,15.413380316190064,52.35663126127002,47.84136908065208,NaN,NaN,50
1668630600,1.03954,1.04048,1.0394,1.03978,2941,4363.85,-793289,-798998.2,15.04020364321687,53.3242677413982,48.206684599877114,NaN,NaN,50
1668632400,1.03978,1.03991,1.03895,1.03904,1787,4300.45,-795076,-797164,14.381322804137694,49.955302532318875,48.0183334899571,NaN,NaN,50
1668634200,1.03904,1.03944,1.03893,1.03944,1026,4179.15,-794050,-795525.6,13.755174893440621,51.730542229943474,48.34498706954401,NaN,NaN,50
1668636000,1.03944,1.03994,1.03906,1.03982,468,4035.65,-793582,-794445.4,13.50116828657856,53.42097391758324,48.9816280870651,NaN,NaN,50
1668637800,1.03982,1.03986,1.03923,1.03942,3612,4009.55,-797194,-794638.2,13.265305008778075,51.381161639243565,48.82183988780656,NaN,NaN,50
1668639600,1.03942,1.03985,1.03938,1.0396,1249,3860.2,-795945,-795169.4,13.046289107963341,52.26447999484672,48.67366075969418,NaN,NaN,50
1668641400,1.0396,1.03971,1.03916,1.03936,1035,3454.6,-796980,-795550.2,12.638298912714788,50.935684210944295,48.76587268353898,NaN,NaN,50
1668643200,1.03936,1.03952,1.03909,1.03922,1369,3184.5,-798349,-796410,12.191762480250867,50.134940404639295,48.88357966366679,NaN,NaN,50
1668645000,1.03922,1.03942,1.03856,1.03866,1852,2845.65,-800201,-797733.8,11.375034279211974,46.95514412840426,48.98801868163649,NaN,NaN,50
1668646800,1.03866,1.03913,1.03818,1.0385,2046,2627.1,-802247,-798744.4,10.966091712334322,46.056340413339605,49.461895753223246,NaN,NaN,50
1668648600,1.0385,1.0387,1.03741,1.03774,2189,2421.95,-804436,-800442.6,11.240915596873858,41.94882006647005,49.62829167987252,NaN,NaN,50
1668650400,1.03774,1.03798,1.03623,1.03658,2625,2336.5,-807061,-802458.8,12.336698048193227,36.58555754740021,49.16227617063845,NaN,NaN,50
1668652200,1.03658,1.03745,1.03657,1.03701,2147,2258.75,-804914,-803771.8,13.354210324418355,39.66501133293326,48.336775530052485,NaN,NaN,50
1668654000,1.03701,1.03705,1.03598,1.03654,2391,2233.05,-807305,-805192.6,14.687988540109043,37.5203137632303,47.277038565906786,NaN,NaN,50
1668655800,1.03654,1.03742,1.03617,1.0372,1611,2142,-805694,-805882,15.476658573609564,42.24304796977371,46.48552286793362,NaN,NaN,50
1668657600,1.0372,1.03788,1.0371,1.0378,1598,2040.55,-804096,-805814,15.669876343618098,46.22270474569583,46.21890874031768,NaN,NaN,50
1668659400,1.0378,1.03813,1.03698,1.0371,1414,1968.85,-805510,-805503.8,15.562764433591392,42.53997339722802,45.562439537980865,NaN,NaN,50
1668661200,1.0371,1.03835,1.03686,1.03815,1929,1965.05,-803581,-805237.2,15.209154655343045,49.09201349440837,45.253228079182655,NaN,NaN,50
1668663000,1.03815,1.03823,1.03744,1.03803,1997,1901.95,-805578,-804891.8,14.880802718398153,48.412582115002536,45.041186684594,NaN,NaN,50
1668664800,1.03803,1.03869,1.03771,1.03862,2181,1873.35,-803397,-804432.4,14.020764561951376,51.934835822434614,45.01764067227886,NaN,NaN,50
1668666600,1.03862,1.03929,1.03834,1.03878,2155,1834.05,-801242,-803861.6,13.47628139538473,52.87452715178971,45.15612945376781,NaN,NaN,50
1668668400,1.03878,1.03878,1.03702,1.03752,2862,1887.8,-804104,-803580.4,13.39033385984004,45.354633522785214,44.81467896220681,NaN,NaN,50
1668670200,1.03752,1.03951,1.03752,1.03928,3663,2019.65,-800441,-802952.4,12.55169484062122,54.98511776958479,45.38824850800542,NaN,NaN,50
1668672000,1.03928,1.04068,1.03861,1.03922,5093,2250.9,-805534,-802943.6,12.556678428255907,54.631639854310194,46.00076989664617,NaN,NaN,50
1668673800,1.03922,1.04022,1.03851,1.03863,4021,2271.35,-809555,-804175.2,12.458679211916422,51.149516868668364,46.65796252537462,NaN,NaN,50
1668675600,1.03863,1.03874,1.0378,1.03806,3330,2375.4,-812885,-806503.8,11.661842122025254,47.968516742905685,47.4710310393393,NaN,NaN,50
1668677400,1.03806,1.0381,1.03568,1.03639,4007,2524,-816892,-809061.4,12.344108766936005,40.10000077956944,47.50210171409902,NaN,NaN,50
1668679200,1.03639,1.03702,1.03526,1.03691,3088,2609.95,-813804,-811734,13.232430280013677,43.22305904148055,47.90944066254547,NaN,NaN,50
1668681000,1.03691,1.03698,1.03358,1.0338,3972,2715.95,-817776,-814182.4,14.934147054913652,32.35716507306765,47.20330616992361,NaN,NaN,50
1668682800,1.0338,1.03468,1.03322,1.03397,3426,2784.95,-814350,-815141.4,16.677492718408683,33.34359237171883,46.28336957178239,NaN,NaN,50
1668684600,1.03397,1.03514,1.03274,1.03466,4521,2901.55,-809829,-814530.2,18.510934263467497,37.33782711549216,45.911787694515546,NaN,NaN,50
1668686400,1.03466,1.0355,1.03392,1.03458,5255,3033.05,-815084,-814168.6,19.8222782271529,37.060540435011966,45.052396761701516,NaN,NaN,50
1668688200,1.03458,1.03469,1.03209,1.03326,5066,3179,-820150,-815437.8,21.82439043644247,32.7400949435,43.93293339230848,NaN,NaN,50
1668690000,1.03326,1.0334,1.0315,1.03334,6482,3383.55,-813668,-814616.2,23.89566015804811,33.24799914946769,42.59815934423941,NaN,NaN,50
1668691800,1.03334,1.03537,1.03108,1.03124,7563,3681.15,-821231,-815992.4,23.987597977169532,27.39908096811625,40.77848461683417,NaN,NaN,50
1668693600,1.03124,1.03282,1.03053,1.03272,5407,3871.6,-815824,-817191.4,24.332833870162265,35.950755206445066,40.10677902280987,NaN,NaN,50
1668695400,1.03272,1.03484,1.03252,1.0335,6614,4131.6,-809210,-816016.6,23.169151767369232,39.96436986788513,39.03386845840276,NaN,NaN,50
1668697200,1.0335,1.03498,1.03324,1.03495,5303,4300.3,-803907,-812768,21.99678261765164,46.656457200605196,38.464212554566686,NaN,NaN,50
1668699000,1.03495,1.03496,1.03209,1.03288,5760,4488.45,-809667,-811967.8,21.54232593296683,39.830610689423004,37.65571925604916,NaN,NaN,50
1668700800,1.03288,1.03333,1.03202,1.03266,4286,4593.7,-813953,-810512.2,21.15770998542313,39.17463649589567,37.0275849526913,NaN,NaN,50
1668702600,1.03266,1.03429,1.0319,1.03392,3577,4664.8,-810376,-809422.6,20.104251251667392,44.78345709232132,37.36211754645929,NaN,NaN,50
1668704400,1.03392,1.03522,1.03371,1.03383,4003,4721.85,-814379,-810456.4,18.822329990223004,44.46803549464433,37.451044435970985,NaN,NaN,50
1668706200,1.03383,1.0357,1.03378,1.03502,3331,4705.25,-811048,-811884.6,17.931313054460855,49.52975800991499,38.67765821717437,NaN,NaN,50
1668708000,1.03502,1.03657,1.03482,1.03592,2658,4583.5,-808390,-811629.2,17.620051392861637,53.01770409496083,40.082951911691644,NaN,NaN,50
1668709800,1.03592,1.03696,1.03585,1.03658,2100,4487.45,-806290,-810096.6,17.552699854001656,55.44921300812106,41.37662233259372,NaN,NaN,50
1668711600,1.03658,1.03689,1.0361,1.03614,1997,4420.8,-808287,-809678.8,17.490159139345955,53.46272412802408,42.54820688209458,NaN,NaN,50
1668713400,1.03614,1.03668,1.03592,1.03638,2137,4327.3,-806150,-808033,17.274915741979473,54.421882634412846,44.09690600287407,NaN,NaN,50
1668715200,1.03638,1.03678,1.03576,1.03604,2087,4277.25,-808237,-807470.8,16.930048628394513,52.76279407144158,45.49081992587221,NaN,NaN,50
1668717000,1.03604,1.03692,1.03592,1.03685,1930,4175.15,-806307,-807054.2,16.712596012594307,56.18941340884757,47.547272243067304,NaN,NaN,50
1668718800,1.03685,1.03697,1.03652,1.03658,953,4051.5,-807260,-807248.2,16.54931300463861,54.76336197120204,48.89102986912137,NaN,NaN,50
1668720600,1.03658,1.03694,1.03642,1.0365,658,3858.35,-807918,-807174.4,16.288590036672147,54.3234367748855,49.91667750533568,NaN,NaN,50
1668722400,1.0365,1.0365,1.036,1.03624,1468,3669,-809386,-807821.6,15.587319410288867,52.837837050857125,50.35820463749654,NaN,NaN,50
1668724200,1.03624,1.03652,1.03616,1.03644,2273,3529.35,-807113,-807596.8,14.955589994572286,53.88260695219561,51.36191865626601,NaN,NaN,50
1668726000,1.03644,1.03668,1.03633,1.03634,1283,3269.4,-808396,-808014.6,14.53198084737779,53.24745089008731,52.367119684422555,NaN,NaN,50
1668727800,1.03634,1.03642,1.03604,1.03608,974,2939.95,-809370,-808436.6,13.783632980953357,51.546131102502656,52.85016782800694,NaN,NaN,50
1668729600,1.03608,1.03717,1.03572,1.03694,1334,2736.3,-808036,-808460.2,13.860811370196972,56.497355159387354,53.709404946917154,NaN,NaN,50
1668731400,1.03694,1.0374,1.0367,1.03716,1464,2478.8,-806572,-807897.4,14.150616932980373,57.68846500369781,54.292169732187354,NaN,NaN,50
1668733200,1.03716,1.03781,1.03666,1.03746,2242,2325.75,-804330,-807340.8,14.797458063492783,59.323992060267365,54.74261887256639,NaN,NaN,50
1668735000,1.03746,1.03758,1.03619,1.03679,2761,2175.8,-807091,-807079.8,14.74970762276033,54.27784631062627,54.658949822745335,NaN,NaN,50
1668736800,1.03679,1.03773,1.03677,1.03773,2454,2084.2,-804637,-806133.2,14.856851824793468,59.48481517585947,55.08909918330501,NaN,NaN,50
1668738600,1.03773,1.0378,1.03648,1.03678,1945,2002.6,-806582,-805842.4,14.550248950336748,52.92489248523363,54.98217131550649,NaN,NaN,50
1668740400,1.03678,1.03736,1.03674,1.03702,1689,1886.9,-804893,-805506.6,14.265546281198363,54.296145982865966,55.09169645203681,NaN,NaN,50
1668742200,1.03702,1.0391,1.03684,1.03828,2153,1828,-802740,-805188.6,15.62320666763988,60.75882284387987,55.418082840253405,NaN,NaN,50
1668744000,1.03828,1.0383,1.03738,1.03752,1555,1772.85,-804295,-804629.4,16.883891312192716,55.64750330637036,55.48123579276542,NaN,NaN,50
1668745800,1.03752,1.03758,1.03613,1.03652,1736,1754.65,-806031,-804908.2,16.392342365963625,49.72055987401743,55.15245887127485,NaN,NaN,50
1668747600,1.03652,1.03701,1.03638,1.03664,1520,1730.8,-804511,-804494,15.935904058750896,50.40321995760271,54.978557650328106,NaN,NaN,50
1668749400,1.03664,1.03722,1.0362,1.03718,1813,1714.6,-802698,-804055,15.723572700181501,53.46511248011335,54.948736616607945,NaN,NaN,50
1668751200,1.03718,1.03738,1.0363,1.03663,1896,1705.05,-804594,-804425.8,15.689828292888851,50.07429131747253,54.72208236142118,NaN,NaN,50
1668753000,1.03663,1.0377,1.03598,1.03758,2091,1713.1,-802503,-804067.4,15.65849420040282,55.342624092427265,54.99326043213007,NaN,NaN,50
1668754800,1.03758,1.0386,1.03726,1.03755,3106,1820.75,-805609,-803983,16.515519355389436,55.144728874501254,54.89664426892392,NaN,NaN,50
1668756600,1.03755,1.03832,1.03672,1.03755,3049,1940.3,-805609,-804202.6,16.523394615955,55.144728874501254,54.71494883112417,NaN,NaN,50
1668758400,1.03755,1.03784,1.03422,1.03492,5299,2131.85,-810908,-805844.6,16.663919929384193,40.44165019852402,53.36621012671393,NaN,NaN,50
1668760200,1.03492,1.03591,1.03478,1.0357,3793,2207.85,-807115,-806348.8,16.79440772042559,45.115527503073636,52.71175878331731,NaN,NaN,50
1668762000,1.0357,1.03812,1.03486,1.03812,3725,2329.95,-803390,-806526.2,16.270470986933567,56.516971993060494,52.499769984545956,NaN,NaN,50
1668763800,1.03812,1.03962,1.0379,1.03816,3519,2457.2,-799871,-805378.6,16.735034246324144,56.67716977996504,52.76778979131249,NaN,NaN,50
1668765600,1.03816,1.03818,1.03605,1.03622,2644,2522.7,-802515,-804759.8,15.733378606552764,47.530985033431286,52.28456400921001,NaN,NaN,50
1668767400,1.03622,1.03788,1.03622,1.03692,2937,2596.35,-799578,-802493.8,14.803269798193625,50.626995122529706,51.56086202911357,NaN,NaN,50
1668769200,1.03692,1.03802,1.03647,1.03702,3096,2639.05,-796482,-800367.2,14.037851427613992,51.071166897868814,51.23398085707773,NaN,NaN,50
1668771000,1.03702,1.03744,1.03636,1.03664,2806,2641.3,-799288,-799546.8,13.239208946772735,49.257723458027336,51.200921113078444,NaN,NaN,50
1668772800,1.03664,1.03865,1.03658,1.03846,2881,2662.65,-796407,-798854,13.35000765475796,57.112463391485214,51.680152786927195,NaN,NaN,50
1668774600,1.03846,1.03848,1.03582,1.03614,2669,2698.85,-799076,-798166.2,12.823847958106235,47.10298259687489,51.22571493812445,NaN,NaN,50
1668776400,1.03614,1.03868,1.03566,1.0379,4102,2819.5,-794974,-797245.4,12.478173057629368,53.72828386198182,51.486714405589396,NaN,NaN,50
1668778200,1.0379,1.03836,1.0363,1.03646,4190,2921.35,-799164,-797781.8,12.157189221472278,48.38819619566179,50.98996955582043,NaN,NaN,50
1668780000,1.03646,1.037,1.03532,1.03585,4241,3055.65,-803405,-798605.2,11.55062036982852,46.289359653038765,50.35744318285883,NaN,NaN,50
1668781800,1.03585,1.03602,1.03302,1.03348,5732,3255.45,-809137,-801151.2,12.461646420417408,39.17894239647712,49.21702986299996,NaN,NaN,50
1668783600,1.03348,1.03545,1.03262,1.03517,4898,3424.35,-804239,-802183.8,13.516188083965172,45.59642097015596,49.58522777525938,NaN,NaN,50
1668785400,1.03517,1.03678,1.03494,1.03644,4223,3544.85,-800016,-803192.2,13.392402233138482,49.87651598319888,49.92529838098261,NaN,NaN,50
1668787200,1.03644,1.03718,1.03562,1.03586,3011,3600.6,-803027,-803964.8,12.975444217738888,48.018524555051506,49.31826642112484,NaN,NaN,50
1668789000,1.03586,1.036,1.03422,1.03483,3101,3651.1,-806128,-804509.4,13.412224100341122,44.82505800417666,48.471687008568516,NaN,NaN,50
1668790800,1.03483,1.03494,1.03303,1.03373,2842,3637.9,-808970,-804476,14.410255886511752,41.64008802714572,48.050908650976695,NaN,NaN,50
1668792600,1.03373,1.0347,1.03306,1.03334,2335,3602.2,-811305,-805889.2,15.336999687955913,40.540253010576976,47.330427071551505,NaN,NaN,50
1668794400,1.03334,1.03366,1.03258,1.03364,2162,3445.35,-809143,-807714.6,16.434903759116242,41.81340478592828,46.669158349270035,NaN,NaN,50
1668796200,1.03364,1.03373,1.03266,1.03312,1882,3349.8,-811025,-809314.2,17.387766083715654,40.206393189111346,46.022634758633174,NaN,NaN,50
1668798000,1.03312,1.03339,1.03247,1.03249,1603,3243.7,-812628,-810614.2,18.375054241037944,38.28652540077922,44.67792490215418,NaN,NaN,50
1668799800,1.03249,1.03288,1.03201,1.03284,1648,3150.15,-810980,-811016.2,19.540337505125027,40.00062138526107,44.170613387038905,NaN,NaN,50
1668801600,1.03284,1.03332,1.03262,1.03292,1749,3105.4,-809231,-810601.4,20.14597491454806,40.40804798205124,43.219167967043866,NaN,NaN,50
1668803400,1.03292,1.03298,1.03218,1.0325,2015,3059.3,-811246,-811022,20.968660126643705,38.91403995478291,42.54244252126681,NaN,NaN,50
1668805200,1.0325,1.03256,1.03195,1.03211,778,2943.4,-812024,-811221.8,21.867844808065207,37.526568942550746,41.91652889908909,NaN,NaN,50
1668807000,1.03211,1.03268,1.03138,1.03223,1535,2879.85,-810489,-810794,23.02962888497783,38.2560488559718,41.85060793191013,NaN,NaN,50
1668981600,1.03223,1.03262,1.03223,1.03252,73,2739.45,-810416,-810681.2,24.10842838496812,40.07705969235423,41.456367840638585,NaN,NaN,50
1668983400,1.03252,1.03262,1.03234,1.03252,177,2614.85,-810416,-810918.2,25.110170777816244,40.07705969235423,40.75640667700683,NaN,NaN,50
1668985200,1.03252,1.03314,1.03246,1.03265,1795,2499.5,-808621,-810393.2,25.322494523806565,40.98199464145319,40.25379739746409,NaN,NaN,50
1668987000,1.03265,1.03334,1.03264,1.03308,1254,2352.7,-807367,-809461.8,25.252010745217703,43.99474279344378,40.194489168126026,NaN,NaN,50
1668988800,1.03308,1.03332,1.03214,1.03216,1627,2222,-808994,-809162.8,25.58115786619714,39.364659006911445,40.031958523823576,NaN,NaN,50
1668990600,1.03216,1.03218,1.03112,1.0316,2159,2043.35,-811153,-809310.2,26.579317992368217,36.82423239858178,39.766528480109635,NaN,NaN,50
1668992400,1.0316,1.03167,1.03024,1.03062,2527,1924.8,-813680,-809963,27.997563261528175,32.831144143631874,39.12493843423132,NaN,NaN,50
1668994200,1.03062,1.03188,1.03004,1.03118,3098,1868.55,-810582,-810355.2,29.01726547533025,37.03294279931139,38.89826340638847,NaN,NaN,50
1668996000,1.03118,1.0312,1.02884,1.03017,2375,1836.75,-812957,-811473.2,30.577883046935163,33.020828615826275,38.52214220746326,NaN,NaN,50
1668997800,1.03017,1.03018,1.02882,1.02884,2342,1798.8,-815299,-812734.2,32.03637927725981,28.62320310910583,37.70946947345217,NaN,NaN,50
1668999600,1.02884,1.02994,1.02882,1.02978,1588,1736.1,-813711,-813245.8,33.39069720541842,35.19246635998168,37.33692792901862,NaN,NaN,50
1669001400,1.02978,1.03026,1.02954,1.03016,1392,1688.95,-812319,-812973.6,34.140131321746836,37.689151092516965,37.249435867428204,NaN,NaN,50
1669003200,1.03016,1.03038,1.02894,1.02904,1429,1652.3,-813748,-813606.8,35.18424046463882,33.58264712254973,36.96772716599956,NaN,NaN,50
1669005000,1.02904,1.02904,1.02768,1.02813,2226,1669.5,-815974,-814210.2,36.754771377937566,30.659633105544742,36.425126040969054,NaN,NaN,50
1669006800,1.02813,1.02824,1.02752,1.02794,2431,1710.9,-818405,-814831.4,38.280305744065906,30.071111587979217,35.71041546208512,NaN,NaN,50
1669008600,1.02794,1.02836,1.02723,1.02824,2254,1741.2,-816151,-815319.4,39.81985970830783,32.28143328769333,35.15358500460935,NaN,NaN,50
1669010400,1.02824,1.02872,1.0277,1.02786,2464,1776.95,-818615,-816578.6,40.654748871778054,30.947095506417696,34.43680649496395,NaN,NaN,50
1669012200,1.02786,1.02808,1.02575,1.02592,2898,1821.1,-821513,-818131.6,42.23720081508363,25.2164909358969,33.09550279085346,NaN,NaN,50
1669014000,1.02592,1.0266,1.02528,1.02638,3128,1938.6,-818385,-818613.8,43.858147686036276,28.592956938665424,32.32609550026446,NaN,NaN,50
1669015800,1.02638,1.02736,1.02502,1.02553,3246,2024.15,-821631,-819259,44.298859108182235,26.2357595022567,31.569776007669805,NaN,NaN,50
1669017600,1.02553,1.02734,1.02553,1.02668,4522,2246.6,-817109,-819450.6,44.708091143032064,34.14588551708367,31.663686105773504,NaN,NaN,50
1669019400,1.02668,1.02671,1.02512,1.02548,3199,2397.7,-820308,-819789.2,45.27908145284221,30.473653284943936,31.19516542617583,NaN,NaN,50
1669021200,1.02548,1.02592,1.02338,1.02347,3699,2492.9,-824007,-820288,46.47312929871426,25.522422721591468,30.65956500515906,NaN,NaN,50
1669023000,1.02347,1.02418,1.02262,1.02268,3686,2614.5,-827693,-822149.6,47.81156138617539,23.880163738832934,30.320776478710993,NaN,NaN,50
1669024800,1.02268,1.02434,1.02268,1.02362,3168,2691.55,-824525,-822728.4,48.832286769567865,29.678375703497835,29.926912860390722,NaN,NaN,50
1669026600,1.02362,1.02408,1.02264,1.02402,2644,2715.8,-821881,-823682.8,49.79375112974482,32.05029885661804,29.524137700683657,NaN,NaN,50
1669028400,1.02402,1.02422,1.02338,1.02396,2304,2704.65,-824185,-824458.2,50.4703553830447,31.876614838341638,29.402278251811648,NaN,NaN,50
1669030200,1.02396,1.02464,1.02324,1.02346,2719,2685.7,-826904,-825037.6,50.45216472240395,30.398255941349092,29.383608454369096,NaN,NaN,50
1669032000,1.02346,1.024,1.02282,1.02392,3010,2717.45,-823894,-824277.8,50.64034380236869,33.455919002791134,29.625380412569946,NaN,NaN,50
1669033800,1.02392,1.02447,1.02342,1.02396,3515,2776.1,-820379,-823448.6,50.10452085778617,33.728554744195435,29.728746230891527,NaN,NaN,50
1669035600,1.02396,1.02536,1.02326,1.02526,3763,2884.85,-816616,-822395.6,48.41063361728222,42.03988669063597,30.52108845833569,NaN,NaN,50
1669037400,1.02526,1.02562,1.02439,1.02544,3343,2982.4,-813273,-820213.2,46.51720204470228,43.103884271658906,31.798759410890117,NaN,NaN,50
1669039200,1.02544,1.0255,1.02388,1.02481,3808,3101.35,-817081,-818248.6,45.14821567893595,40.31439744052168,32.63600516102271,NaN,NaN,50
1669041000,1.02481,1.02566,1.02398,1.0256,4797,3229.9,-812284,-815926.6,43.66752754847431,45.11131199601824,33.984258910577104,NaN,NaN,50
1669042800,1.0256,1.02628,1.02442,1.02482,3946,3305.65,-816230,-815096.8,41.51341417095304,41.559764155322014,34.51382167045127,NaN,NaN,50
1669044600,1.02482,1.0259,1.02394,1.02397,3944,3390.15,-820174,-815808.4,39.93400647712802,38.04468425305035,35.054609596744584,NaN,NaN,50
1669046400,1.02397,1.02507,1.02392,1.02427,2860,3409.95,-817314,-816616.6,38.4849574755059,39.97436688929207,36.08689132300891,NaN,NaN,50
1669048200,1.02427,1.02454,1.0232,1.02374,2728,3401.45,-820042,-817208.8,37.74585324155926,37.73808536809892,37.07674286795649,NaN,NaN,50
1669050000,1.02374,1.0238,1.02227,1.02254,2814,3385.75,-822856,-819323.2,37.717307322014406,33.20826365424749,37.32887772158146,NaN,NaN,50
1669051800,1.02254,1.0237,1.02254,1.02326,2164,3331.65,-820692,-820215.6,37.69080039672275,38.015754845543604,37.75498172079043,NaN,NaN,50
1669053600,1.02326,1.02438,1.02304,1.02364,2103,3210.7,-818589,-819898.6,36.704618854020204,40.451880030891836,38.36750066311544,NaN,NaN,50
1669055400,1.02364,1.02408,1.02325,1.0235,1582,3129.85,-820171,-820470,35.788878850082135,39.830773426968825,39.041251912088285,NaN,NaN,50
1669057200,1.0235,1.02485,1.0235,1.02474,1912,3040.5,-818259,-820113.4,33.929424247498595,47.5171734987079,40.0456272332252,NaN,NaN,50
1669059000,1.02474,1.02482,1.02389,1.02396,1992,2955.8,-820251,-819592.4,32.20278783081388,43.7326440205876,40.760205038681775,NaN,NaN,50
1669060800,1.02396,1.0245,1.02324,1.02358,1899,2892.35,-822150,-819884,31.24687776479706,41.9785130305322,40.75582120581722,NaN,NaN,50
1669062600,1.02358,1.02465,1.0235,1.0242,2356,2877.95,-819794,-820125,30.152566730661494,45.79848756477332,40.94829286961111,NaN,NaN,50
1669064400,1.0242,1.02427,1.02372,1.02386,1035,2814.5,-820829,-820256.6,29.136420770392757,44.08441727061227,41.217580000331864,NaN,NaN,50
1669066200,1.02386,1.02416,1.02376,1.02416,861,2721.6,-819968,-820598.4,28.192856664428927,46.0046799138966,41.281391994466034,NaN,NaN,50
1669068000,1.02416,1.02444,1.02389,1.02414,485,2595.35,-820453,-820638.8,26.871822856130617,45.89153012694664,41.59080384958208,NaN,NaN,50
1669069800,1.02414,1.02431,1.024,1.02426,1093,2474.25,-819360,-820080.8,25.645148605567904,46.73798777028624,42.211754100813216,NaN,NaN,50
1669071600,1.02426,1.02467,1.02404,1.02404,1207,2346.45,-820567,-820235.4,23.924937049365393,45.33767408716682,42.594847472089974,NaN,NaN,50
1669073400,1.02404,1.02454,1.02403,1.02454,596,2209.1,-819971,-820063.8,22.34316366720143,49.07225421733309,43.40443096132099,NaN,NaN,50
1669075200,1.02454,1.02541,1.02421,1.0252,1868,2112.1,-818103,-819690.8,21.868957348164294,53.580548848075715,44.85959418945158,NaN,NaN,50
1669077000,1.0252,1.0255,1.02487,1.02536,1641,1954.3,-816462,-818892.6,21.541690964781363,54.629114962412274,46.04626276922791,NaN,NaN,50
1669078800,1.02536,1.02684,1.02514,1.02642,1943,1854.15,-814519,-817924.4,22.60503700029217,60.92635577512868,47.50872532238769,NaN,NaN,50
1669080600,1.02642,1.02683,1.02556,1.02608,2212,1767.55,-816731,-817157.2,23.592429747552206,58.138963632308524,48.81645319419766,NaN,NaN,50
1669082400,1.02608,1.02662,1.02586,1.02632,1910,1720.05,-814821,-816127.2,24.509294441436527,59.54589362978427,49.67564748927456,NaN,NaN,50
1669084200,1.02632,1.02658,1.02582,1.02649,2092,1688.25,-812729,-815052.4,25.277309426144594,60.55713159702241,50.87739660187704,NaN,NaN,50
1669086000,1.02649,1.02677,1.02618,1.02657,1581,1626.6,-811148,-813989.6,26.184327170106712,61.0505527936317,52.23968515638415,NaN,NaN,50
1669087800,1.02657,1.02659,1.02603,1.02615,1016,1569.2,-812164,-813518.6,26.68736868657199,57.01778132045811,53.04106328179021,NaN,NaN,50
1669089600,1.02615,1.02615,1.02578,1.02589,1119,1520,-813283,-812829,26.600831011360004,54.61277088858619,53.79308854021691,NaN,NaN,50
1669091400,1.02589,1.0263,1.02582,1.02606,1270,1504.4,-812013,-812267.4,26.713336992050817,55.92192134889266,54.50146292843091,NaN,NaN,50
1669093200,1.02606,1.02616,1.02514,1.02518,1660,1491.8,-813673,-812456.2,25.441780539304048,48.17550857359305,54.66460424604851,NaN,NaN,50
1669095000,1.02518,1.0254,1.02458,1.02537,1827,1483.55,-811846,-812595.8,23.902959161038954,49.79262640668928,54.882792720077305,NaN,NaN,50
1669096800,1.02537,1.02596,1.02512,1.02526,2012,1489.2,-813858,-812934.6,22.751490130501402,48.84239938649701,55.13313024145803,NaN,NaN,50
1669098600,1.02526,1.02561,1.02467,1.02474,1609,1451.85,-815467,-813371.4,21.25309966680476,44.51738706964241,54.80778258805156,NaN,NaN,50
1669100400,1.02474,1.02538,1.02462,1.02494,2206,1510.4,-813261,-813621,19.935392463639044,46.480362468939155,54.300626418113225,NaN,NaN,50
1669102200,1.02494,1.0268,1.02489,1.0266,2180,1576.35,-811081,-813102.6,20.095776129563887,59.339086106081176,54.63705292837529,NaN,NaN,50
1669104000,1.0266,1.02816,1.02537,1.02726,4046,1754.4,-807035,-812140.4,21.35881790905229,63.13185607894724,54.79458866436233,NaN,NaN,50
1669105800,1.02726,1.0279,1.02624,1.02716,3517,1875.6,-810552,-811479.2,22.531642418577235,62.185382647606936,55.08361859402651,NaN,NaN,50
1669107600,1.02716,1.02738,1.02618,1.02653,3121,1971.3,-813673,-811120.4,23.520791734122586,56.444163272880886,54.86206642567627,NaN,NaN,50
1669109400,1.02653,1.02864,1.02652,1.02688,3856,2134.3,-809817,-810431.6,25.287759600968666,58.72410878585013,54.73113622487824,NaN,NaN,50
1669111200,1.02688,1.02902,1.0267,1.02807,2763,2179.05,-807054,-809626.2,27.13982138804964,65.36282586032769,55.03915572964224,NaN,NaN,50
1669113000,1.02807,1.02842,1.02758,1.02804,1619,2177.95,-808673,-809953.8,28.859593047481972,65.0786512835366,55.61493215557642,NaN,NaN,50
1669114800,1.02804,1.0291,1.02736,1.02868,2968,2229.2,-805705,-808984.4,30.826131410607477,68.24998363582002,56.58901878037883,NaN,NaN,50
1669116600,1.02868,1.02868,1.02617,1.02702,2759,2256.55,-808464,-807942.6,30.791154589854486,54.44029170004482,56.48318809117542,NaN,NaN,50
1669118400,1.02702,1.02703,1.0256,1.02596,2829,2302.5,-811293,-808237.8,30.021928259171816,47.790534514004186,56.45568994406193,NaN,NaN,50
1669120200,1.02596,1.02717,1.02586,1.02715,2839,2339.85,-808454,-808517.8,29.42477567510678,54.50854868697683,56.792541535511035,NaN,NaN,50
1669122000,1.02715,1.02768,1.02695,1.02728,3604,2441,-804850,-807753.2,29.28685394697372,55.18693548399417,57.24572268533226,NaN,NaN,50
1669123800,1.02728,1.02767,1.02596,1.02605,3405,2560.45,-808255,-808263.2,27.932358385939455,47.90750226911972,57.48787377100921,NaN,NaN,50
1669125600,1.02605,1.02642,1.02542,1.02625,3175,2663.25,-805080,-807586.4,26.096916149806653,49.0835606479278,57.67381649807982,NaN,NaN,50
1669127400,1.02625,1.02696,1.0255,1.02654,4318,2815.65,-800762,-805480.2,24.9035432052201,50.81743475569619,57.065127115909455,NaN,NaN,50
1669129200,1.02654,1.02848,1.02636,1.02806,3765,2920.9,-796997,-803188.8,24.970371701087352,58.746938271534646,56.751918701094276,NaN,NaN,50
1669131000,1.02806,1.02886,1.02744,1.02833,4215,3040.3,-792782,-800775.2,25.279269746868334,59.9811902896567,56.59447638981212,NaN,NaN,50
1669132800,1.02833,1.02848,1.02716,1.02748,2946,3087,-795728,-798269.8,25.236784048137096,54.45731657104768,56.45255876825261,NaN,NaN,50
1669134600,1.02748,1.02756,1.02669,1.0275,2526,3132.85,-793202,-795894.2,24.65801659489483,54.56334705582465,56.15536150182221,NaN,NaN,50
1669136400,1.0275,1.02784,1.02714,1.02746,1824,3113.75,-795026,-794747,24.341949594040027,54.291104828303695,55.36452428524907,NaN,NaN,50
1669138200,1.02746,1.0296,1.02741,1.02958,1515,3080.5,-793511,-794049.8,25.199469717601314,64.42288515533124,55.31768384752012,NaN,NaN,50
1669140000,1.02958,1.02966,1.02896,1.02966,1689,2962.65,-791822,-793857.8,26.02921089593762,64.74049942563816,55.0670064039357,NaN,NaN,50
1669141800,1.02966,1.03082,1.02952,1.03052,1385,2856.05,-790437,-792799.6,27.399524205124752,68.04331380610276,56.038650840082695,NaN,NaN,50
1669143600,1.03052,1.03057,1.02939,1.0297,1331,2766.55,-791768,-792512.8,28.50820358941383,62.072828543821,57.058814699355324,NaN,NaN,50
1669145400,1.0297,1.02986,1.02906,1.02956,1149,2631.2,-792917,-792091,29.115327762907,61.08728936078487,57.528724747484475,NaN,NaN,50
1669147200,1.02956,1.02999,1.02938,1.02962,1195,2552.8,-791722,-791733.2,29.756698792887313,61.370363942597656,57.970398208813286,NaN,NaN,50
1669149000,1.02962,1.03045,1.0296,1.03006,1548,2549.25,-790174,-791403.6,30.62498469840383,63.46909107584498,59.081940266436526,NaN,NaN,50
1669150800,1.03006,1.03062,1.0299,1.0305,1162,2458.95,-789012,-791118.6,31.53065882798179,65.48832257593338,60.253708975579784,NaN,NaN,50
1669152600,1.0305,1.03055,1.03014,1.03026,721,2357.05,-789733,-790711.6,32.37164194830418,63.42885134369583,61.154524446151186,NaN,NaN,50
1669154400,1.03026,1.03046,1.03018,1.03042,202,2225.7,-789531,-790034.4,33.1525548457464,64.23632329967884,61.54662337673291,NaN,NaN,50
1669156200,1.03042,1.03062,1.03034,1.03041,326,2100.05,-789857,-789661.4,33.98861973658897,64.14100214632234,61.84375279506618,NaN,NaN,50
1669158000,1.03041,1.03077,1.03024,1.03077,1283,1984,-788574,-789341.4,34.870964416321556,66.09175015366507,62.67478376525313,NaN,NaN,50
1669159800,1.03077,1.03109,1.0306,1.03108,618,1844.65,-787956,-789130.2,35.913457672480746,67.72021195055973,63.61455982916278,NaN,NaN,50
1669161600,1.03108,1.03214,1.03108,1.0316,1121,1741.95,-786835,-788550.6,37.49744638039708,70.29711001864135,64.75784591418689,NaN,NaN,50
1669163400,1.0316,1.03161,1.0304,1.03055,821,1567.1,-787656,-788175.6,37.76730608884966,59.89895168968353,64.43470780949777,NaN,NaN,50
1669165200,1.03055,1.03136,1.03004,1.03028,2476,1502.65,-790132,-788230.6,37.44097241226667,57.541935481124206,63.92052467060391,NaN,NaN,50
1669167000,1.03028,1.03137,1.0301,1.03111,1982,1391,-788150,-788145.8,37.146094810362335,62.43544669378086,63.51996273400949,NaN,NaN,50
1669168800,1.03111,1.03152,1.03082,1.03118,1447,1316.05,-786703,-787895.2,37.00012695189209,62.824599957192824,63.57366069210748,NaN,NaN,50
1669170600,1.03118,1.03249,1.03109,1.0324,1261,1252.8,-785442,-787616.6,37.59458268327126,68.87633206709653,64.13002088541545,NaN,NaN,50
1669172400,1.0324,1.0324,1.03161,1.0317,1213,1222.25,-786655,-787416.4,38.1465772909805,62.58138467247568,64.21652236612103,NaN,NaN,50
1669174200,1.0317,1.03224,1.0312,1.03157,1071,1200.05,-787726,-786935.2,37.915247003031006,61.457994871982066,64.07287263727368,NaN,NaN,50
1669176000,1.03157,1.03157,1.03105,1.03108,946,1162.9,-788672,-787039.6,37.435823953648836,57.28396287335008,63.48684694423201,NaN,NaN,50
1669177800,1.03108,1.03172,1.03102,1.0317,797,1133.5,-787875,-787274,37.13179324249226,60.90229894471497,63.30637891573338,NaN,NaN,50
1669179600,1.0317,1.03312,1.03142,1.03298,1351,1134.5,-786524,-787490.4,37.91874236967311,67.09863335056562,63.51082963365392,NaN,NaN,50
1669181400,1.03298,1.03305,1.03234,1.03275,1400,1147.05,-787924,-787744.2,38.649480844912475,65.102079461232,63.57947801329032,NaN,NaN,50
1669183200,1.03275,1.03296,1.03221,1.03238,1243,1149.45,-789167,-788032.4,39.0787339264408,61.91060773854581,63.280824983638944,NaN,NaN,50
1669185000,1.03238,1.03362,1.03238,1.03314,1477,1145.9,-787690,-787836,39.928371484601456,65.63696280041556,63.13202147291437,NaN,NaN,50
1669186800,1.03314,1.0346,1.03281,1.03352,2604,1218,-785086,-787278.2,41.257680648576205,67.35657530120228,62.921983278811574,NaN,NaN,50
1669188600,1.03352,1.03488,1.03322,1.03432,2690,1316.45,-782396,-786452.6,42.62627487759442,70.68280708998039,63.69225866454707,NaN,NaN,50
1669190400,1.03432,1.03432,1.03271,1.0331,3806,1496.65,-786202,-786108.2,42.9615275630243,60.55008605476989,63.90712656266462,NaN,NaN,50
1669192200,1.0331,1.03364,1.03108,1.03138,3148,1637.75,-789350,-786144.8,40.96432031785508,49.72686195535588,62.99937050991998,NaN,NaN,50
1669194000,1.03138,1.03182,1.03021,1.03148,3105,1728.85,-786245,-785855.8,38.18993400413658,50.28327922165745,62.10356188595317,NaN,NaN,50
1669195800,1.03148,1.03267,1.03088,1.03253,2840,1839.95,-783405,-785519.6,36.35060981656791,55.81333837786675,61.170490908151045,NaN,NaN,50
1669197600,1.03253,1.03253,1.02966,1.02977,2655,1916.65,-786060,-786252.4,33.99077545401561,42.44778837020438,59.73237688656024,NaN,NaN,50
1669199400,1.02977,1.03126,1.02975,1.0312,1886,1969.9,-784174,-785846.8,31.79950068878848,49.23132677238766,58.85904345087492,NaN,NaN,50
1669201200,1.0312,1.03178,1.03076,1.03176,1897,1940.95,-782277,-784432.2,29.769422968962772,51.6354572260884,58.4555787617848,NaN,NaN,50
1669203000,1.03176,1.03251,1.03102,1.03198,1922,1937.95,-780355,-783254.2,28.499866200953555,52.585391853124406,57.86151396952833,NaN,NaN,50
1669204800,1.03198,1.03271,1.0315,1.03192,2296,1980.4,-782651,-783103.4,27.482160730766665,52.28378106409178,56.8033102347802,NaN,NaN,50
1669206600,1.03192,1.03296,1.03176,1.03234,2772,2055.95,-779879,-781867.2,26.74149097329936,54.261420677042615,56.02897746448095,NaN,NaN,50
1669208400,1.03234,1.03282,1.03174,1.03236,3562,2173.4,-776317,-780295.8,26.029750733737327,54.35842857794575,55.489536095866676,NaN,NaN,50
1669210200,1.03236,1.03406,1.03178,1.0332,6328,2436.25,-769989,-777838.2,26.32370143560904,58.35360384172598,54.96929617024598,NaN,NaN,50
1669212000,1.0332,1.03418,1.03272,1.03301,4315,2604.7,-774304,-776628,26.678808919619208,57.13534629686756,54.239208384222074,NaN,NaN,50
1669213800,1.03301,1.03754,1.03268,1.03674,7210,2925.35,-767094,-773516.6,28.636676137520244,70.26135143559183,54.2091044089086,NaN,NaN,50
1669215600,1.03674,1.03736,1.03438,1.03544,6813,3198.45,-773907,-772322.2,30.454695696999778,63.01833637328828,54.38540800308848,NaN,NaN,50
1669217400,1.03544,1.0384,1.03544,1.03764,6000,3428.45,-767907,-770640.2,32.49184788899698,68.86735405193295,55.75258600998684,NaN,NaN,50
1669219200,1.03764,1.03788,1.03618,1.0362,3860,3559.3,-771767,-770995.8,34.383489210137235,61.95970412535607,56.586616360251035,NaN,NaN,50
1669221000,1.0362,1.03678,1.03554,1.03636,2901,3630.5,-768866,-769908.2,35.338430224142996,62.41085473327095,57.05786752849419,NaN,NaN,50
1669222800,1.03636,1.03688,1.03568,1.03641,2269,3613.75,-766597,-769808.8,36.268969907083545,62.56028716875402,58.49447458553345,NaN,NaN,50
1669224600,1.03641,1.03736,1.03613,1.0364,2244,3591.45,-768841,-768795.6,37.34403824728251,62.506766179226396,59.4427202574505,NaN,NaN,50
1669226400,1.0364,1.0369,1.03594,1.03688,2197,3511,-766644,-768543,38.084999941867714,64.09462115710053,60.332660538237086,NaN,NaN,50
1669228200,1.03688,1.03794,1.03672,1.03754,1779,3442.55,-764865,-767162.6,39.23261397380885,66.21341918369092,61.30609106184898,NaN,NaN,50
1669230000,1.03754,1.04052,1.03672,1.0398,8282,3701.4,-756583,-764706,41.10855597273679,72.25172635597195,62.73237286841185,NaN,NaN,50
1669231800,1.0398,1.04017,1.03883,1.04008,4448,3781.8,-752135,-761813.6,42.85050211459844,72.89798565442601,64.0635560810821,NaN,NaN,50
1669233600,1.04008,1.04013,1.03914,1.03996,3148,3806.45,-755283,-759102,44.46802353204141,72.12271949330679,65.33243400360787,NaN,NaN,50
1669235400,1.03996,1.04034,1.03961,1.04027,2533,3838.8,-752750,-756323.2,46.03048026992221,72.92382146497076,66.37316383383964,NaN,NaN,50
1669237200,1.04027,1.04034,1.03956,1.03966,1197,3803.8,-753947,-754139.6,47.40704796420392,68.73794175456923,67.20192065224691,NaN,NaN,50
1669239000,1.03966,1.03998,1.03934,1.03954,787,3747.05,-754734,-753769.8,48.34555819605191,67.9120929694534,67.03411647609417,NaN,NaN,50
1669240800,1.03954,1.03992,1.03932,1.03961,265,3645.5,-754469,-754236.6,49.18481932593952,68.15246356031861,67.40083984659633,NaN,NaN,50
1669242600,1.03961,1.04012,1.03938,1.03958,1050,3559.4,-755519,-754283.8,50.04782701123579,67.91764605825651,67.33300356133373,NaN,NaN,50
1669244400,1.03958,1.04193,1.03958,1.04176,1811,3471.85,-753708,-754475.4,51.46477034696718,74.73094973208764,68.24523539038599,NaN,NaN,50
1669246200,1.04176,1.04188,1.04116,1.0418,1298,3220.35,-752410,-754168,52.780503444432036,74.83654633547938,69.13278479054372,NaN,NaN,50
1669248000,1.0418,1.04192,1.04052,1.04074,1610,3085.1,-754020,-754025.2,52.987629104114156,66.862574756968,69.44009104684473,NaN,NaN,50
1669249800,1.04074,1.04167,1.04071,1.04152,1625,2805.85,-752395,-753610.4,53.179960073818975,69.44274688181021,69.93551823988642,NaN,NaN,50
1669251600,1.04152,1.04224,1.04146,1.04156,2702,2600.3,-749693,-752445.2,53.610225926963274,69.57358394569667,70.32687272478616,NaN,NaN,50
1669253400,1.04156,1.04252,1.04113,1.04236,1799,2390.25,-747894,-751282.4,53.472719401641754,72.14262664042803,70.75038754312452,NaN,NaN,50
1669255200,1.04236,1.04296,1.04177,1.04246,1794,2286.95,-746100,-750020.4,53.56419530205706,72.45570060218778,70.76495713213993,NaN,NaN,50
1669257000,1.04246,1.04356,1.04246,1.0432,1298,2206.8,-744802,-748176.8,53.92483145999086,74.71983925210634,70.89508953197425,NaN,NaN,50
1669258800,1.0432,1.04424,1.04306,1.044,1579,2172.3,-743223,-746342.4,54.53846928756315,76.92785520677619,71.23831351150777,NaN,NaN,50
1669260600,1.044,1.0448,1.04338,1.0446,1356,2127.9,-741867,-744777.2,55.31490959444872,78.44823198084315,71.6329142626415,NaN,NaN,50
1669262400,1.0446,1.0446,1.0432,1.04346,1066,2071.35,-742933,-743785,55.72847128344074,69.12745511773558,71.66073664572482,NaN,NaN,50
1669264200,1.04346,1.04485,1.04326,1.04464,1300,2047.4,-741633,-742891.6,56.216566103030615,72.73811566996989,72.00545255290457,NaN,NaN,50
1669266000,1.04464,1.04469,1.04371,1.04394,1519,1709.25,-743152,-742561.6,56.6697970069355,67.68122941032937,71.97179297076248,NaN,NaN,50
1669267800,1.04394,1.04424,1.04335,1.0434,1525,1563.1,-744677,-742852.4,56.40699555891317,63.98563721026221,71.69093519590574,NaN,NaN,50
1669269600,1.0434,1.04389,1.04298,1.04312,1957,1503.55,-746634,-743805.8,55.49438864022404,62.092407730182366,70.78818219576966,NaN,NaN,50
1669271400,1.04312,1.04383,1.04296,1.04305,1901,1471.95,-748535,-744926.2,54.61055946226997,61.60168290607399,69.84283480795499,NaN,NaN,50
1669273200,1.04305,1.04397,1.04273,1.04334,2668,1545.5,-745867,-745773,53.359472159417734,62.90949955498168,69.5604722935274,NaN,NaN,50
1669275000,1.04334,1.0436,1.04152,1.04162,2717,1642,-748584,-746859.4,50.311844972587025,51.669122294866995,68.2909276801743,NaN,NaN,50
1669276800,1.04162,1.0417,1.04002,1.04086,3822,1819.85,-752406,-748405.2,47.5714662834578,47.6203180664505,66.72283726022815,NaN,NaN,50
1669278600,1.04086,1.0421,1.04041,1.04062,2547,1894.7,-754953,-750069,44.5832288274244,46.38423287131738,64.88295199100597,NaN,NaN,50
1669280400,1.04062,1.0425,1.04062,1.0418,2840,1946.15,-752113,-750784.6,41.41477090807904,52.8627525269686,63.48345569991888,NaN,NaN,50
1669282200,1.0418,1.04256,1.04128,1.04195,2567,2009.6,-749546,-751520.4,38.53694844636179,53.62978943148162,61.97702356987425,NaN,NaN,50
1669284000,1.04195,1.04293,1.04044,1.04045,2994,2078.8,-752540,-752311.6,36.56904697792295,45.6329986705427,59.74167667442901,NaN,NaN,50
1669285800,1.04045,1.04092,1.03927,1.04054,3198,2157.45,-749342,-751698.8,35.7100039747207,46.15181855849591,57.4347900014042,NaN,NaN,50
1669287600,1.04054,1.04076,1.03822,1.03836,2908,2167.75,-752250,-751158.2,35.60384563848488,36.95304150435108,55.13661760044817,NaN,NaN,50
1669289400,1.03836,1.04088,1.03818,1.04048,2847,2220.15,-749403,-750616.2,35.35622876010883,47.84075370644414,53.358234603053475,NaN,NaN,50
1669291200,1.04048,1.04113,1.0398,1.04026,2446,2252.75,-751849,-751076.8,34.808203973804524,46.9349371872796,51.87635658712135,NaN,NaN,50
1669293000,1.04026,1.04144,1.03983,1.04122,2862,2330.95,-748987,-750366.2,33.90653841718411,51.27070105984028,50.9681468620912,NaN,NaN,50
1669294800,1.04122,1.04194,1.0408,1.04115,3186,2411.3,-752173,-750932.4,32.46184313492515,50.94384230090907,50.17182076000025,NaN,NaN,50
1669296600,1.04115,1.04257,1.0408,1.04229,2426,2464.8,-749747,-750431.8,30.419641341697666,55.877228865164405,49.76293118564958,NaN,NaN,50
1669298400,1.04229,1.04276,1.04165,1.04268,2852,2554.1,-746895,-749930.2,28.321040787286382,57.45360140507818,49.37322417494219,NaN,NaN,50
1669300200,1.04268,1.0427,1.04159,1.04222,2425,2610.35,-749320,-749424.4,26.43727472138731,54.9594854176244,49.608250112282,NaN,NaN,50
1669302000,1.04222,1.0423,1.04079,1.04096,2240,2646.4,-751560,-749939,25.50423283325454,48.720569379119695,49.68683949175837,NaN,NaN,50
1669303800,1.04096,1.04238,1.04042,1.04096,2539,2697.1,-751560,-749816.4,24.977276936432393,48.7205693791197,49.853720670887114,NaN,NaN,50
1669305600,1.04096,1.04146,1.04021,1.04058,2043,2701.4,-753603,-750587.6,24.677691863990354,46.85997809266201,49.42495106843664,NaN,NaN,50
1669307400,1.04058,1.04116,1.04032,1.04072,1203,2666.5,-752400,-751688.6,24.399505725294173,47.65313377072042,48.99804709266799,NaN,NaN,50
1669309200,1.04072,1.04091,1.04023,1.04068,1026,2584.4,-753426,-752509.8,24.230986677447856,47.43528512576355,49.12678183946947,NaN,NaN,50
1669311000,1.04068,1.04098,1.04018,1.04092,757,2486.4,-752669,-752731.6,23.960150901617837,48.94345665912556,49.32618456094302,NaN,NaN,50
1669312800,1.04092,1.04105,1.04032,1.04034,361,2313.35,-753030,-753025.6,23.588818847623035,45.5426921414566,49.939731035021985,NaN,NaN,50
1669314600,1.04034,1.04057,1.04012,1.04056,309,2201.45,-752721,-752849.2,23.482511917621736,47.04570428444737,49.88294179059365,NaN,NaN,50
1669316400,1.04056,1.04072,1.04045,1.04053,289,2073.9,-753010,-752971.2,23.103571806467645,46.8557920853828,49.877288569029595,NaN,NaN,50
1669318200,1.04053,1.04136,1.04041,1.04136,573,1974.2,-752437,-752773.4,21.665785671130962,52.56145100260896,49.96948499351307,NaN,NaN,50
1669320000,1.04136,1.04143,1.0406,1.04085,658,1857.4,-753095,-752858.6,20.220908699708716,49.07497468974272,49.835994449858326,NaN,NaN,50
1669321800,1.04085,1.04137,1.0408,1.04137,895,1742.25,-752200,-752692.6,18.879237226245206,52.53226414109557,49.59706839813913,NaN,NaN,50
1669323600,1.04137,1.04137,1.04083,1.04108,884,1641.05,-753084,-752765.2,17.633399429457658,50.474225663134575,49.098541559428874,NaN,NaN,50
1669325400,1.04108,1.04125,1.04099,1.04118,560,1526.7,-752524,-752668,16.476550046726366,51.18441243291075,48.82889348909218,NaN,NaN,50
1669327200,1.04118,1.04119,1.04091,1.04095,74,1408.1,-752598,-752700.2,15.560247336582684,49.42877953741126,48.87947992897015,NaN,NaN,50
1669329000,1.04095,1.04104,1.04072,1.04086,314,1280.7,-752912,-752663.6,15.082809225395868,48.724503732401246,48.87976095420454,NaN,NaN,50
1669330800,1.04086,1.04098,1.04066,1.04068,766,1159.7,-753678,-752959.2,14.757398804041138,47.27373730139046,48.90931518339943,NaN,NaN,50
1669332600,1.04068,1.04088,1.04068,1.04076,488,1062.8,-753190,-752980.4,14.455231984211744,48.0145931033678,48.93513370715995,NaN,NaN,50
1669334400,1.04076,1.04115,1.03987,1.03994,1390,989.7,-754580,-753391.6,15.586915770579104,41.56743304828008,48.51600141591114,NaN,NaN,50
1669336200,1.03994,1.04066,1.03962,1.04057,1844,960.65,-752736,-753419.2,16.978426615633,47.41007328490275,48.406474032038076,NaN,NaN,50
1669338000,1.04057,1.04153,1.04036,1.04132,2053,951.3,-750683,-752973.4,16.301478856743127,53.385642482690294,48.966684770697626,NaN,NaN,50
1669339800,1.04132,1.04148,1.04048,1.04095,1760,912.35,-752443,-752726.4,15.67288450920253,50.34636746898041,49.202446426735705,NaN,NaN,50
1669341600,1.04095,1.04142,1.04083,1.04098,1590,889.7,-750853,-752259,15.089189757914836,50.5919781258467,49.46931685819741,NaN,NaN,50
1669343400,1.04098,1.04158,1.04085,1.04112,1667,912.9,-749186,-751180.2,14.203330176408215,51.79043081865256,49.4142439879148,NaN,NaN,50
1669345200,1.04112,1.04142,1.04046,1.041,1212,922.2,-750398,-750712.6,14.111881408880814,50.65621919138725,49.52719002374655,NaN,NaN,50
1669347000,1.041,1.04184,1.04098,1.04164,1222,945.45,-749176,-750411.2,13.149983293762629,56.16943566420372,49.786987989682856,NaN,NaN,50
1669348800,1.04164,1.04293,1.04162,1.04258,1536,1004.2,-747640,-749450.6,13.840036633833542,62.75216785457944,50.663983860500345,NaN,NaN,50
1669350600,1.04258,1.04258,1.04182,1.04216,1467,1062.1,-749107,-749101.4,14.480800449613676,58.52293731032584,51.18816420888714,NaN,NaN,50
1669352400,1.04216,1.04224,1.0411,1.04118,1231,1109.2,-750338,-749331.8,13.746870970825528,50.047260217197234,51.23234140030042,NaN,NaN,50
1669354200,1.04118,1.04147,1.04074,1.04112,1429,1152,-751767,-749605.6,13.025915250488953,49.57387897250333,51.29301106030771,NaN,NaN,50
1669356000,1.04112,1.04129,1.04074,1.04095,1559,1197.05,-753326,-750435.6,12.356456367319279,48.18325650137087,51.35797671744917,NaN,NaN,50
1669357800,1.04095,1.04236,1.04092,1.04202,1616,1233.1,-751710,-751249.6,12.740572300737337,56.46167852068239,51.96133996154307,NaN,NaN,50
1669359600,1.04202,1.04226,1.04111,1.0419,2240,1300.9,-753950,-752218.2,13.097251381768393,55.3928372641332,52.94886883410401,NaN,NaN,50
1669361400,1.0419,1.04224,1.04088,1.04092,2698,1407.8,-756648,-753480.2,13.0170374642011,47.486753420147586,52.9543459866215,NaN,NaN,50
1669363200,1.04092,1.04282,1.04078,1.0421,3807,1594.45,-752841,-753695,13.679943533365483,55.68783910033709,53.11878860216769,NaN,NaN,50
1669365000,1.0421,1.04268,1.04162,1.04226,2680,1712.75,-750161,-753062,14.295499169018125,56.67583544022921,53.570893457256894,NaN,NaN,50
1669366800,1.04226,1.04282,1.04122,1.04122,2748,1811.85,-752909,-753301.8,14.117937252247845,49.02440281062076,53.458923791883606,NaN,NaN,50
1669368600,1.04122,1.04201,1.03824,1.03935,4332,2004.05,-757241,-753960,15.5212250045127,38.864475706703736,52.535641283887266,NaN,NaN,50
1669370400,1.03935,1.042,1.03913,1.04198,2603,2064.7,-754638,-753558,16.82427791733007,53.469820991613055,52.736612841046245,NaN,NaN,50
1669372200,1.04198,1.04217,1.04144,1.04148,2167,2080.85,-756805,-754350.8,17.78336140960179,50.97645102798378,52.36568536703054,NaN,NaN,50
1669374000,1.04148,1.04148,1.04016,1.04051,1978,2077.1,-758783,-756075.2,19.548517318225052,46.451022740997026,51.201317858917506,NaN,NaN,50
1669375800,1.04051,1.04062,1.03889,1.039,2249,2101.55,-761032,-757699.8,21.836349373001056,40.433456785848605,49.90921210716913,NaN,NaN,50
1669377600,1.039,1.03976,1.03873,1.03921,2778,2160.95,-758254,-757902.4,24.033327900046014,41.56718618700205,49.303492533583764,NaN,NaN,50
1669379400,1.03921,1.03944,1.03759,1.03788,2841,2219.65,-761095,-759193.8,26.542897087970186,36.7911519893818,48.39044060621794,NaN,NaN,50
1669381200,1.03788,1.03835,1.03612,1.03646,4243,2371.2,-765338,-760900.4,29.344131925353974,32.497837950297125,47.27005356685553,NaN,NaN,50
1669383000,1.03646,1.03748,1.03623,1.03727,3442,2482.2,-761896,-761523,31.945278560067493,37.01307964718508,45.88086793303429,NaN,NaN,50
1669384800,1.03727,1.03737,1.03548,1.0362,3479,2579.35,-765375,-762391.6,34.5739120820367,33.79701272777204,44.33830903757992,NaN,NaN,50
1669386600,1.0362,1.03888,1.03591,1.03816,4099,2710.95,-761276,-762996,35.098118014537924,43.484181266140276,44.0524110265794,NaN,NaN,50
1669388400,1.03816,1.03906,1.03766,1.03884,3000,2799.4,-758276,-762432.2,35.382094390478706,46.41379136829677,43.38997904571937,NaN,NaN,50
1669390200,1.03884,1.04072,1.03873,1.04068,3459,2900.9,-754817,-760328,33.99922717994172,53.445981009475844,43.15927515780841,NaN,NaN,50
1669392000,1.04068,1.04116,1.03934,1.0395,3453,2995.6,-758270,-759602.8,32.34074579536855,49.00455097322707,43.15785716942315,NaN,NaN,50
1669393800,1.0395,1.04082,1.03916,1.04012,2556,3042.6,-755714,-757670.6,30.925090040529067,51.294773616047564,44.04573559151914,NaN,NaN,50
1669395600,1.04012,1.04094,1.03985,1.04066,2125,3036.85,-753589,-756133.2,29.49950296115581,53.263516799111066,44.03099957776901,NaN,NaN,50
1669397400,1.04066,1.0409,1.04,1.04059,1922,2998.05,-755511,-755580.2,28.175743530309212,52.964642541617685,44.17301325731428,NaN,NaN,50
1669399200,1.04059,1.04062,1.0397,1.04026,978,2856.6,-756489,-755914.6,27.191491776271352,51.49758838203372,44.53348223167405,NaN,NaN,50
1669401000,1.04026,1.0406,1.03983,1.04016,2760,2860.6,-759249,-756110.4,26.277543718950486,51.03626051375331,45.29082535509581,NaN,NaN,50
1669402800,1.04016,1.04085,1.03995,1.0406,4507,2948.55,-754742,-755916,25.135614021081082,53.03005420666451,46.10960164221456,NaN,NaN,50
1669404600,1.0406,1.04146,1.04058,1.04116,1179,2790.9,-753563,-755910.8,23.396329077904078,55.512954269478826,47.44687323365007,NaN,NaN,50
1669406400,1.04116,1.0414,1.0409,1.0413,1375,2729.5,-752188,-755246.2,21.781278773525433,56.13720658073692,49.13539956439576,NaN,NaN,50
1669408200,1.0413,1.04144,1.0409,1.0409,1121,2677.2,-753309,-754610.2,20.234714077492026,53.813740115196346,50.33544674068228,NaN,NaN,50
1669410000,1.0409,1.04108,1.04079,1.041,1130,2634.8,-752179,-753196.2,18.933577945358678,54.32273149576558,51.801569509824674,NaN,NaN,50
1669411800,1.041,1.04101,1.03862,1.03965,316,2538.15,-752495,-752746.8,19.73186359694991,46.82107065486063,52.03991875187613,NaN,NaN,50
1669586400,1.03965,1.03965,1.03732,1.03752,186,2408.55,-752681,-752570.4,21.252372678469882,37.92278127173017,51.4334180306928,NaN,NaN,50
1669588200,1.03752,1.03804,1.03705,1.03767,1827,2357.85,-750854,-752303.6,22.806398518275685,38.804802153550696,50.38761954098386,NaN,NaN,50
1669590000,1.03767,1.03814,1.03713,1.03716,1428,2217.1,-752282,-752098.2,24.113798802168166,36.88582536128596,49.52199628298807,NaN,NaN,50
1669591800,1.03716,1.03726,1.03656,1.03672,1662,2128.1,-753944,-752451.2,25.64480467931933,35.265502679451075,48.37704835894546,NaN,NaN,50
1669593600,1.03672,1.03834,1.03658,1.03828,1926,2050.45,-752018,-752355.8,25.6808888807173,44.56359162484487,47.75562513221216,NaN,NaN,50
1669595400,1.03828,1.0384,1.03771,1.03784,2175,1954.25,-754193,-752658.2,25.64311511143473,42.70062567790654,47.0224810705185,NaN,NaN,50
1669597200,1.03784,1.03806,1.03632,1.03633,2895,1949,-757088,-753905,26.489264716971068,36.98619076768515,45.98595266949361,NaN,NaN,50
1669599000,1.03633,1.03638,1.03412,1.03484,3166,1934.35,-760254,-755499.4,28.254290808054055,32.381225702059666,44.65345018294406,NaN,NaN,50
1669600800,1.03484,1.03584,1.03434,1.0353,3116,1917.5,-757138,-756138.2,29.893243606916837,35.069013525996354,43.370518705753476,NaN,NaN,50
1669602600,1.0353,1.0365,1.0353,1.0361,2457,1912.55,-754681,-756670.8,30.64940591784883,39.5679692116373,42.23159120162194,NaN,NaN,50
1669604400,1.0361,1.03615,1.03529,1.03534,1318,1872.2,-755999,-757032,31.356469396923263,36.948773056211586,40.86098880701299,NaN,NaN,50
1669606200,1.03534,1.03565,1.03512,1.0355,1395,1845.85,-754604,-756535.2,32.101004570662866,37.881038367413446,39.722938682171346,NaN,NaN,50
1669608000,1.0355,1.03598,1.03515,1.03596,1270,1860.45,-753334,-755151.2,32.37196844150254,40.60031060684308,38.74276576153403,NaN,NaN,50
1669609800,1.03596,1.03631,1.03569,1.03622,1478,1796.35,-751856,-754094.8,32.20821181620017,42.14198352008192,38.40854525190698,NaN,NaN,50
1669611600,1.03622,1.03624,1.03502,1.03505,1546,1648.3,-753402,-753839,32.48345531534554,37.43364786593629,38.373607151493125,NaN,NaN,50
1669613400,1.03505,1.03558,1.0347,1.03508,1644,1671.55,-751758,-752990.8,32.93154669151246,37.626079099751585,38.28941264765034,NaN,NaN,50
1669615200,1.03508,1.03637,1.03482,1.03607,2396,1722.6,-749362,-751942.4,32.34884563213981,43.7719875332628,38.781281374220114,NaN,NaN,50
1669617000,1.03607,1.03754,1.03604,1.03718,2239,1778.5,-747123,-750700.2,30.573653635377028,49.750427581702624,39.81591886723809,NaN,NaN,50
1669618800,1.03718,1.03837,1.03704,1.03758,3028,1873.4,-744095,-749148,28.588945225859945,51.74169199748219,40.328640322426466,NaN,NaN,50
1669620600,1.03758,1.03852,1.03708,1.0374,3159,2015.55,-747254,-747918.4,26.8729256647193,50.76676246199978,40.904792949861694,NaN,NaN,50
1669622400,1.0374,1.04087,1.03676,1.04066,4789,2245.7,-742465,-746059.8,26.886246554093635,63.99774470670583,42.83418965979174,NaN,NaN,50
1669624200,1.04066,1.04407,1.04056,1.04391,6236,2466.15,-736229,-743433.2,28.23689675415253,72.05933717558588,45.66834047932934,NaN,NaN,50
1669626000,1.04391,1.04568,1.0433,1.04482,4935,2641.5,-731294,-740267.4,29.964096890229808,73.82657273722776,48.43673756584587,NaN,NaN,50
1669627800,1.04482,1.04542,1.04422,1.04478,3996,2758.2,-735290,-738506.4,31.56792558801586,73.60619112034787,50.868039130753765,NaN,NaN,50
1669629600,1.04478,1.04788,1.0439,1.04734,3997,2861.75,-731293,-735314.2,33.662062380210024,78.10994085739867,53.80812254512427,NaN,NaN,50
1669631400,1.04734,1.0482,1.04684,1.04742,3235,2914.75,-728058,-732432.8,35.67457799614196,78.2349284738255,56.69054326701085,NaN,NaN,50
1669633200,1.04742,1.0495,1.04724,1.0487,3802,2960.1,-724256,-730038.2,37.80553280875155,80.1844614971488,59.5179826163184,NaN,NaN,50
1669635000,1.0487,1.04968,1.04722,1.04742,4264,3015,-728520,-729483.4,39.81911235541622,73.1301942625463,61.73142624078014,NaN,NaN,50
1669636800,1.04742,1.04764,1.04588,1.04674,4174,3067.9,-732694,-728964.2,40.48164729802947,69.6257803709992,64.03086427685606,NaN,NaN,50
1669638600,1.04674,1.04774,1.04651,1.0473,3480,3119.05,-729214,-728548.4,41.12636995358425,70.86404022475622,66.40500435721354,NaN,NaN,50
1669640400,1.0473,1.04769,1.04442,1.04487,4572,3281.75,-733786,-729694,40.07552199577458,59.52428278529371,67.53016830378718,NaN,NaN,50
1669642200,1.04487,1.04656,1.04464,1.0463,3688,3396.4,-730098,-730862.4,39.09973460637989,63.251088732400824,68.49450124312276,NaN,NaN,50
1669644000,1.0463,1.0463,1.04358,1.04368,4637,3564.75,-734735,-732105.4,37.44158675763951,53.52669390002541,68.6220013790187,NaN,NaN,50
1669645800,1.04368,1.04508,1.0422,1.04301,6434,3812.55,-741169,-733800.4,35.03635589519497,51.352422712190744,68.66383425403234,NaN,NaN,50
1669647600,1.04301,1.04339,1.04098,1.0412,5077,3989.1,-746246,-737206.8,32.935654609929884,45.92514234106765,67.37293408505818,NaN,NaN,50
1669649400,1.0412,1.04184,1.0391,1.03984,6431,4228.45,-752677,-740985,31.86552466127967,42.30705434461796,65.24777102570333,NaN,NaN,50
1669651200,1.03984,1.04024,1.03792,1.03834,4897,4353.5,-757574,-746480.2,31.347289512041947,38.68688100366916,62.73779304473486,NaN,NaN,50
1669653000,1.03834,1.03864,1.03762,1.03853,3238,4403.45,-754336,-750400.4,30.98308787292406,39.39430057445843,60.29408657717131,NaN,NaN,50
1669654800,1.03853,1.03886,1.03685,1.03745,4972,4500.65,-759308,-754028.2,30.943389698928662,36.795498581683916,57.34305498604884,NaN,NaN,50
1669656600,1.03745,1.0385,1.03694,1.03698,2751,4480.25,-762059,-757190.8,30.906527108790083,35.69200569902088,54.304274787848506,NaN,NaN,50
1669658400,1.03698,1.03732,1.03561,1.03576,3015,4391.55,-765074,-759670.2,31.37886139649258,32.931239800244015,50.92904466664102,NaN,NaN,50
1669660200,1.03576,1.03659,1.03574,1.03614,2424,4200.95,-762650,-760685.4,31.817457520787762,34.62738464842336,48.17884397991795,NaN,NaN,50
1669662000,1.03614,1.03638,1.03504,1.03528,2012,4054.8,-764662,-762750.6,32.4861476870919,32.61696925211706,45.53535747142637,NaN,NaN,50
1669663800,1.03528,1.03551,1.03372,1.03378,1739,3941.95,-766401,-764169.2,33.55373257366443,29.409708155764918,42.5743337522127,NaN,NaN,50
1669665600,1.03378,1.03402,1.03302,1.03346,2083,3846.25,-768484,-765454.2,34.75997976149952,28.7599931562238,40.376884492993426,NaN,NaN,50
1669667400,1.03346,1.03406,1.03322,1.03356,1859,3777.45,-766625,-765764.4,35.842349082184164,29.285736647649813,37.950787915511214,NaN,NaN,50
1669669200,1.03356,1.03424,1.03338,1.03408,1198,3647.25,-765427,-766319.8,36.668310167849164,32.09218923257285,36.41975186783603,NaN,NaN,50
1669671000,1.03408,1.03425,1.03394,1.03406,823,3475.2,-766250,-766637.4,37.424748626166085,32.03952108559933,35.040258894508064,NaN,NaN,50
1669672800,1.03406,1.03436,1.0337,1.03426,1727,3352.85,-764523,-766261.8,38.2220401236929,33.21979050550543,34.13273376339647,NaN,NaN,50
1669674600,1.03426,1.03436,1.034,1.03424,538,3205.75,-765061,-765577.2,38.96238222853922,33.15777578393964,33.47921386620517,NaN,NaN,50
1669676400,1.03424,1.03469,1.03396,1.03454,1240,3039.15,-763821,-765016.4,39.24002374826893,35.114464517308505,33.22404126003655,NaN,NaN,50
1669678200,1.03454,1.03459,1.03417,1.03434,756,2892.55,-764577,-764846.4,39.497833730875094,34.391665613384234,32.86671019138839,NaN,NaN,50
1669680000,1.03434,1.03502,1.03426,1.03471,1332,2727.3,-763245,-764245.4,39.1746498680007,36.97625784001833,32.87962156698371,NaN,NaN,50
1669681800,1.03471,1.03506,1.03395,1.03404,1473,2479.25,-764718,-764284.4,39.06521566903772,34.33829027712376,32.78292760827677,NaN,NaN,50
1669683600,1.03404,1.03472,1.03341,1.03469,2826,2366.7,-761892,-763650.6,39.28206641302192,38.892999908695096,33.20876761602327,NaN,NaN,50
1669685400,1.03469,1.03628,1.03464,1.03598,3155,2202.9,-758737,-762633.8,37.63644938827017,46.78272986095402,34.07700655977546,NaN,NaN,50
1669687200,1.03598,1.0362,1.0355,1.03575,1841,2050.1,-760578,-761834,36.10837643671497,45.650996174460175,35.00800848279997,NaN,NaN,50
1669689000,1.03575,1.03616,1.03485,1.0349,1837,1980.05,-762415,-761668,35.17299921512366,41.64174406330284,35.881725333338395,NaN,NaN,50
1669690800,1.0349,1.03766,1.03472,1.03734,2814,1872.15,-759601,-760644.6,32.83469973953429,54.10280085520912,37.69192588326592,NaN,NaN,50
1669692600,1.03734,1.03833,1.03728,1.03788,2669,1868.05,-756932,-759652.6,30.860189031116164,56.32544373739731,39.6233335325336,NaN,NaN,50
1669694400,1.03788,1.03808,1.03753,1.03756,1920,1813.3,-758852,-759675.6,29.026714801870764,54.6369070032124,41.23367051615071,NaN,NaN,50
1669696200,1.03756,1.03946,1.0375,1.0393,1546,1769.4,-757306,-759021.2,28.34693847915233,61.411029384354286,43.33163539463321,NaN,NaN,50
1669698000,1.0393,1.03932,1.0381,1.03852,1664,1752,-758970,-758332.2,27.71571760805664,57.28155109513501,45.050332579606746,NaN,NaN,50
1669699800,1.03852,1.0388,1.038,1.03868,1752,1752.65,-757218,-757855.6,27.02259650109669,57.906825360297404,46.81812183506088,NaN,NaN,50
1669701600,1.03868,1.03897,1.03768,1.038,1795,1738.25,-759013,-758271.8,26.02998338004368,54.27105098290222,48.18644943974614,NaN,NaN,50
1669703400,1.038,1.03828,1.03522,1.03591,3581,1824.35,-762594,-759020.2,25.295806851520858,44.933028477989595,48.9394039300751,NaN,NaN,50
1669705200,1.03591,1.03748,1.03532,1.03698,3826,1955.75,-758768,-759312.6,24.61407150360681,49.70435603400876,49.84855380107441,NaN,NaN,50
1669707000,1.03698,1.03876,1.03597,1.03814,4318,2130.5,-754450,-758408.6,22.877414506635454,54.3248355992511,51.27616418122637,NaN,NaN,50
1669708800,1.03814,1.03814,1.0351,1.0367,4800,2284.15,-759250,-758815,21.898661993223346,48.382780310375686,51.95400563848927,NaN,NaN,50
1669710600,1.0367,1.03928,1.03657,1.03832,3840,2449.25,-755410,-758094.4,20.549301595034123,54.42261285548232,52.499711566669866,NaN,NaN,50
1669712400,1.03832,1.03874,1.0368,1.03731,3290,2551.75,-758700,-757315.6,19.296324082429845,50.458418261353984,52.84309885859085,NaN,NaN,50
1669714200,1.03731,1.0375,1.03561,1.03648,4159,2721.9,-762859,-758133.8,18.578846080641426,47.4026553959965,53.25459252521183,NaN,NaN,50
1669716000,1.03648,1.03855,1.03636,1.03766,3052,2807.9,-759807,-759205.2,17.3838054945179,51.86568164208514,53.094798295702965,NaN,NaN,50
1669717800,1.03766,1.03936,1.0374,1.03826,2904,2879.45,-756903,-758735.8,16.819819994291876,54.0029051894618,52.92890268513615,NaN,NaN,50
1669719600,1.03826,1.03862,1.03674,1.03742,2990,2887.65,-759893,-759632.4,15.796120535390715,50.61459172549752,52.64159445101365,NaN,NaN,50
1669721400,1.03742,1.03827,1.03707,1.03826,2367,2848.25,-757526,-759397.6,14.845542466411063,53.74033714886323,52.0936878627643,NaN,NaN,50
1669723200,1.03826,1.03838,1.03668,1.03674,2703,2891.35,-760229,-758871.6,13.914715778901545,47.83977886867312,51.41927556087416,NaN,NaN,50
1669725000,1.03674,1.03776,1.036,1.03754,3463,2972.65,-756766,-758263.4,13.562765181307151,50.89570783516311,50.91848145193599,NaN,NaN,50
1669726800,1.03754,1.03845,1.03614,1.03614,5396,3101.75,-762162,-759315.2,12.660391074824135,45.83486847061024,50.31589698677227,NaN,NaN,50
1669728600,1.03614,1.0367,1.03246,1.03302,5773,3256.95,-767935,-760923.6,13.931764995831204,37.00403461169218,49.749540282036754,NaN,NaN,50
1669730400,1.03302,1.03466,1.03257,1.03302,5606,3441.25,-767935,-763005.4,15.112326493909196,37.00403461169217,48.84237446615699,NaN,NaN,50
1669732200,1.03302,1.03474,1.03281,1.03399,5925,3660.2,-762010,-763361.6,16.13905513894089,41.09604464597284,47.89746082663712,NaN,NaN,50
1669734000,1.03399,1.03732,1.03392,1.0367,6434,3898.7,-755576,-763123.6,15.189413256710102,50.72599517310715,48.06483331683222,NaN,NaN,50
1669735800,1.0367,1.03715,1.03508,1.03562,5358,4079,-760934,-762878,14.307602937495798,47.40017551872341,47.56323064992087,NaN,NaN,50
1669737600,1.03562,1.03586,1.03312,1.03398,4980,4238.25,-765914,-762473.8,14.553762936230033,42.810106616720255,47.01692267530417,NaN,NaN,50
1669739400,1.03398,1.03577,1.03378,1.03552,3523,4235.35,-762391,-761365,14.782340077911824,47.91100625742781,47.0532334511207,NaN,NaN,50
1669741200,1.03552,1.03553,1.03361,1.03372,3061,4197.1,-765452,-762053.4,15.083899962603134,43.07497605617766,46.425325909270164,NaN,NaN,50
1669743000,1.03372,1.03476,1.03364,1.03403,2982,4130.3,-762470,-763432.2,15.36391985553078,44.121081769835854,45.71948137929689,NaN,NaN,50
1669744800,1.03403,1.03465,1.03318,1.03331,2851,4032.85,-765321,-764309.6,15.88737949857677,42.18217551117208,45.117165935416494,NaN,NaN,50
1669746600,1.03331,1.03387,1.03282,1.03379,2094,3945.55,-763227,-763772.2,16.577537179892683,43.95055473335569,44.417895762880235,NaN,NaN,50
1669748400,1.03379,1.03456,1.03312,1.03317,2724,3917.25,-765951,-764484.2,16.582754913428488,42.15698472578051,44.01198189553077,NaN,NaN,50
1669750200,1.03317,1.03344,1.03224,1.03276,2968,3857.7,-768919,-765177.6,17.115768910763364,40.96640448320856,43.30274594181973,NaN,NaN,50
1669752000,1.03276,1.03283,1.03202,1.03248,2132,3811.7,-771051,-766893.8,17.73727166450052,40.13282367757249,42.895457028031316,NaN,NaN,50
1669753800,1.03248,1.03309,1.03246,1.03256,1995,3766.25,-769056,-767640.8,18.055255070478772,40.5053137263603,43.145548393364756,NaN,NaN,50
1669755600,1.03256,1.03299,1.03244,1.03278,855,3659.5,-768201,-768635.6,18.36376936514122,41.58175850854968,43.472528671711714,NaN,NaN,50
1669757400,1.03278,1.03302,1.03257,1.0329,660,3574.15,-767541,-768953.6,18.61672906851741,42.19610576693902,43.55110446606644,NaN,NaN,50
1669759200,1.0329,1.03354,1.03286,1.03286,524,3465.2,-768065,-768782.8,18.269985070835276,42.03741018875457,42.93049125289841,NaN,NaN,50
1669761000,1.03286,1.0331,1.03259,1.03287,5383,3561.2,-762682,-767109,18.169799999166187,42.09604093265741,42.55162449675083,NaN,NaN,50
1669762800,1.03287,1.03306,1.0319,1.03246,1099,3346.35,-763781,-766054,18.61214157992504,40.29629468559657,42.372066501670574,NaN,NaN,50
1669764600,1.03246,1.03246,1.03206,1.03238,432,3079.3,-764213,-765256.4,19.022887333486832,39.93750351180921,41.802530591269246,NaN,NaN,50
1669766400,1.03238,1.03386,1.03208,1.03362,1905,2894.25,-762308,-764209.8,17.849539299841634,47.70923853204924,42.13354933954579,NaN,NaN,50
1669768200,1.03362,1.03434,1.03323,1.03432,2543,2725.15,-759765,-762549.8,16.833982789794444,51.52265688943297,42.66223327665987,NaN,NaN,50
1669770000,1.03432,1.03449,1.03378,1.03394,1889,2497.9,-761654,-762344.2,16.02876934411983,49.41584410551804,43.17892389054172,NaN,NaN,50
1669771800,1.03394,1.03532,1.03358,1.03478,2997,2379.85,-758657,-761319.4,16.000029473205164,53.903090121919,43.8898192754391,NaN,NaN,50
1669773600,1.03478,1.03522,1.0341,1.03416,1924,2227.05,-760581,-760593,15.973342450212973,50.3526301486818,44.47522251993205,NaN,NaN,50
1669775400,1.03416,1.03505,1.03402,1.0349,1572,2129.5,-759009,-759933.2,15.851321190913852,54.227855248200484,45.42246900314576,NaN,NaN,50
1669777200,1.0349,1.03504,1.03436,1.03459,1393,2046.1,-760402,-760060.6,15.738015735850382,52.38323217026466,46.2974981811952,NaN,NaN,50
1669779000,1.03459,1.03502,1.0345,1.03482,1223,1958.15,-759179,-759565.6,15.63280352757716,53.64317183435534,47.23591661748056,NaN,NaN,50
1669780800,1.03482,1.03567,1.03482,1.03536,1079,1869.55,-758100,-759454.2,16.188701764209476,56.550068155063435,48.305081592231545,NaN,NaN,50
1669782600,1.03536,1.03603,1.03536,1.0356,1387,1834.2,-756713,-758680.6,17.03228220771405,57.81615687011342,49.42079952817257,NaN,NaN,50
1669784400,1.0356,1.0361,1.03538,1.03588,1640,1780,-755073,-757893.4,17.87926207939861,59.30598791898662,50.654269366046286,NaN,NaN,50
1669786200,1.03588,1.03592,1.03486,1.03487,1640,1713.6,-756713,-757155.6,17.8362771194262,52.151106638542856,51.37248834503811,NaN,NaN,50
1669788000,1.03487,1.03541,1.03456,1.03462,1700,1692,-758413,-757002.4,17.35230194460997,50.526216568249495,52.103197050941894,NaN,NaN,50
1669789800,1.03462,1.03491,1.03358,1.03426,2002,1692.35,-760415,-757465.4,16.569658826551535,48.197420663141166,52.69319113317989,NaN,NaN,50
1669791600,1.03426,1.0357,1.03392,1.0352,2630,1781.1,-757785,-757679.8,15.841763177454574,54.14101456078915,53.15260370666131,NaN,NaN,50
1669793400,1.0352,1.03572,1.03484,1.03512,2403,1868.25,-760188,-758702.8,15.187678913757555,53.577600321854405,53.299385380405695,NaN,NaN,50
1669795200,1.03512,1.03602,1.03462,1.03514,3911,2037.6,-756277,-758615.6,14.914034020363417,53.707299920751765,53.605917938636686,NaN,NaN,50
1669797000,1.03514,1.03704,1.03417,1.03688,3033,1920.1,-753244,-757581.8,15.640855478487591,63.3112150198929,54.27792685992053,NaN,NaN,50
1669798800,1.03688,1.03814,1.03675,1.03724,3150,2022.65,-750094,-755517.6,17.131690651749434,64.93221165156424,55.31932553869785,NaN,NaN,50
1669800600,1.03724,1.0373,1.03568,1.03586,2655,2133.8,-752749,-754510.4,17.172970131656164,54.91589359141584,55.36847113464181,NaN,NaN,50
1669802400,1.03586,1.038,1.03575,1.03668,3057,2191.4,-749692,-752411.2,17.731238128442936,58.96638011496891,55.83869598783497,NaN,NaN,50
1669804200,1.03668,1.03684,1.03538,1.0354,2437,2186.1,-752129,-751581.6,17.821647471253698,51.2292093948046,55.66627009929562,NaN,NaN,50
1669806000,1.0354,1.03614,1.03466,1.03586,2703,2226.8,-749426,-750818,17.129652726715268,53.586197584904,55.45456505856995,NaN,NaN,50
1669807800,1.03586,1.0367,1.03544,1.03592,2183,2186.1,-747243,-750247.8,16.95320011354071,53.89915453654073,55.17477917760048,NaN,NaN,50
1669809600,1.03592,1.03644,1.03562,1.0364,2538,2216.8,-744705,-748639,16.78935125845005,56.430187575878534,54.96936486737847,NaN,NaN,50
1669811400,1.0364,1.03716,1.03586,1.03686,2599,2268.15,-742106,-747121.8,17.221030260543152,58.766548282837164,55.44189641339949,NaN,NaN,50
1669813200,1.03686,1.03922,1.03666,1.03848,4914,2444.2,-737192,-744134.4,18.87782876485436,65.73514014631829,56.528248097547255,NaN,NaN,50
1669815000,1.03848,1.03866,1.03574,1.03591,6241,2695.1,-743433,-742935.8,19.425678734659233,51.00752620900838,56.72896992225206,NaN,NaN,50
1669816800,1.03591,1.03928,1.03582,1.0381,4894,2885.85,-738539,-741195,20.28531979466852,59.3626972907811,57.10194726010862,NaN,NaN,50
1669818600,1.0381,1.04,1.03776,1.03854,6393,3136.15,-732146,-738683.2,21.461463870457578,60.80882776082288,57.61846350574923,NaN,NaN,50
1669820400,1.03854,1.03882,1.03355,1.0336,7479,3428.1,-739625,-738187,20.498385527408367,42.515613859618675,56.81905735852545,NaN,NaN,50
1669822200,1.0336,1.03398,1.02949,1.02986,8145,3753.35,-747770,-740302.6,21.270762423024188,34.14155490474458,54.735510207443426,NaN,NaN,50
1669824000,1.02986,1.03188,1.02904,1.03148,6105,3973.6,-741665,-739949,22.132102344943007,39.6833781014776,52.93202209672295,NaN,NaN,50
1669825800,1.03148,1.03248,1.03136,1.03218,3655,4056.25,-738010,-739843.2,22.546452201876804,41.956196645864324,52.00632945775499,NaN,NaN,50
1669827600,1.03218,1.03333,1.03161,1.03305,3432,4096.35,-734578,-740329.6,22.399743884974026,44.74308935949861,50.99038011807854,NaN,NaN,50
1669829400,1.03305,1.0331,1.03047,1.0315,3739,4163.15,-738317,-740068,22.703601166789873,40.96896258804467,50.25750534616712,NaN,NaN,50
1669831200,1.0315,1.03201,1.03126,1.03139,2622,4098.7,-740939,-738701.8,22.985754357047444,40.70654050304555,49.337529840320094,NaN,NaN,50
1669833000,1.03139,1.0379,1.03064,1.03724,12045,4549.3,-728894,-736147.6,22.30877767776312,56.62048854349805,49.53191084081704,NaN,NaN,50
1669834800,1.03724,1.04036,1.03632,1.03882,8800,4831.8,-720094,-732564.4,22.451314104256426,59.761696654465844,49.76987577500186,NaN,NaN,50
1669836600,1.03882,1.04152,1.03819,1.04136,6184,5008.25,-713910,-728430.8,22.905965378625236,64.24419306251289,50.161136116407256,NaN,NaN,50
1669838400,1.04136,1.04268,1.04077,1.0422,3725,5041.65,-710185,-722804.4,23.63485102585931,65.60864979712787,50.15210109146509,NaN,NaN,50
1669840200,1.0422,1.04288,1.04058,1.04076,3810,5110.3,-713995,-717415.6,24.36459413034638,61.29071794679661,50.886614787021394,NaN,NaN,50
1669842000,1.04076,1.04089,1.03988,1.04058,2154,5082.85,-716149,-714866.6,24.659053830603693,60.752481132874976,50.98588506145667,NaN,NaN,50
1669843800,1.04058,1.04084,1.04014,1.04072,1122,5029.8,-715027,-713853.2,24.93248069512834,61.039062731081714,51.00233041647516,NaN,NaN,50
1669845600,1.04072,1.04108,1.04022,1.04092,3219,5063.85,-711808,-713432.8,25.26650016016841,61.47187603264838,52.35634914312014,NaN,NaN,50
1669847400,1.04092,1.04112,1.0405,1.04088,1830,5025.4,-713638,-714123.4,25.590776843060368,61.32514415999318,54.29803408992361,NaN,NaN,50
1669849200,1.04088,1.04197,1.04088,1.04126,1939,4876.65,-711699,-713664.2,26.19457105960067,62.24709270476522,55.909727990158444,NaN,NaN,50
1669851000,1.04126,1.04306,1.04126,1.04235,2102,4669.7,-709597,-712353.8,27.11777797885234,64.83648496783465,57.544034298870606,NaN,NaN,50
1669852800,1.04235,1.04327,1.04222,1.04292,3019,4575.95,-706578,-710664,28.04338210680578,66.1442013046159,59.07268515209328,NaN,NaN,50
1669854600,1.04292,1.04396,1.04266,1.04381,2692,4390.9,-703886,-709079.6,29.128353045780877,68.13675962529369,61.013242083325345,NaN,NaN,50
1669856400,1.04381,1.0448,1.04288,1.04336,3808,4207.35,-707694,-707890.8,30.397776266814613,66.02099555636231,62.82141744427655,NaN,NaN,50
1669858200,1.04336,1.04357,1.04246,1.04262,3357,3967.95,-711051,-707761.2,31.223790758490992,62.57969133315309,63.24707478639476,NaN,NaN,50
1669860000,1.04262,1.04293,1.0419,1.0429,2499,3787.65,-708552,-707552.2,31.5238772075696,63.357963670784656,63.50395100184611,NaN,NaN,50
1669861800,1.0429,1.04308,1.04234,1.04261,2389,3724.35,-710941,-708424.8,31.86299314478193,61.92151389917619,63.33804534732206,NaN,NaN,50
1669863600,1.04261,1.04306,1.04232,1.0425,1946,3650.05,-712887,-710225,32.1595993699647,61.353306898080255,63.03409228310437,NaN,NaN,50
1669865400,1.0425,1.04329,1.0425,1.0432,1726,3549.4,-711161,-710918.4,32.53894181792223,63.639856572550784,63.20188789922967,NaN,NaN,50
1669867200,1.0432,1.0434,1.04262,1.0433,1562,3496.4,-709599,-710628,32.94289101763153,63.96783501798216,63.43155603388018,NaN,NaN,50
1669869000,1.0433,1.04426,1.04328,1.04394,1462,2967.25,-708137,-710545,33.71004992212129,66.07685402579068,63.79139826921652,NaN,NaN,50
1669870800,1.04394,1.04482,1.0438,1.04438,2510,2652.75,-705627,-709482.2,34.65824340978582,67.48588164070588,64.2209700983635,NaN,NaN,50
1669872600,1.04438,1.04515,1.04408,1.04458,2791,2483.1,-702836,-707472,35.674543317916125,68.13379324114418,64.70730217558855,NaN,NaN,50
1669874400,1.04458,1.04472,1.04408,1.04424,2325,2413.1,-705161,-706272,36.61825037546569,65.73563284586857,64.95648361423879,NaN,NaN,50
1669876200,1.04424,1.04564,1.04414,1.04562,2025,2323.85,-703136,-704979.4,37.8739806321864,70.30434156463002,65.34704479972417,NaN,NaN,50
1669878000,1.04562,1.04641,1.04446,1.04488,4060,2419.15,-707196,-704791.2,39.32022143613529,65.27796868446993,65.28517104114232,NaN,NaN,50
1669879800,1.04488,1.04498,1.03944,1.04036,5375,2631.8,-712571,-706180,36.60142416589944,44.39808107543737,63.58955114472401,NaN,NaN,50
1669881600,1.04036,1.0428,1.03933,1.0411,6333,2787.5,-706238,-706860.4,34.13877910129171,47.36634829288708,62.25707634019007,NaN,NaN,50
1669883400,1.0411,1.04465,1.04106,1.04442,4225,2907.25,-702013,-706230.8,32.54976902847188,58.15856848063191,61.94128185072428,NaN,NaN,50
1669885200,1.04442,1.04469,1.04269,1.04398,3682,2994.4,-705695,-706742.6,31.09430891423352,56.50495832722349,61.451781469041336,NaN,NaN,50
1669887000,1.04398,1.04426,1.0429,1.04416,3777,3078.15,-701918,-705687,29.742810236726474,57.04305134744112,61.103319858203115,NaN,NaN,50
1669888800,1.04416,1.045,1.04378,1.04428,3092,3081.8,-698826,-702938,28.889211370766848,57.421236156834496,60.82245766239985,NaN,NaN,50
1669890600,1.04428,1.0443,1.04184,1.04202,3277,3111.05,-702103,-702111,26.84207875519719,48.721549270993954,59.75686428371721,NaN,NaN,50
1669892400,1.04202,1.04346,1.04178,1.04342,2656,3053.45,-699447,-701597.8,24.977301050625915,53.42865688597719,59.004065845716866,NaN,NaN,50
1669894200,1.04342,1.04407,1.04288,1.04376,2691,3020.15,-696756,-699810,23.519103270681256,54.52052513740446,58.178613782260705,NaN,NaN,50
1669896000,1.04376,1.04499,1.04362,1.04497,2858,3038.1,-693898,-698206,22.70153126404131,58.27016279410665,57.52034815036076,NaN,NaN,50
1669897800,1.04497,1.04548,1.04442,1.04448,3547,3096,-697445,-697929.8,22.213605200888633,56.24772930250738,56.67134358331528,NaN,NaN,50
1669899600,1.04448,1.04762,1.04348,1.04707,4255,3211.45,-693190,-696147.2,22.775101621848442,63.46572859752692,56.509207565576595,NaN,NaN,50
1669901400,1.04707,1.05138,1.04604,1.04894,9679,3609.1,-683511,-692960,24.505782552430105,67.61936201639719,56.31742331213139,NaN,NaN,50
1669903200,1.04894,1.0509,1.04848,1.05051,6484,3855.2,-677027,-689014.2,26.112843416541647,70.63765365516896,56.700257952895605,NaN,NaN,50
1669905000,1.05051,1.05292,1.05006,1.05228,7348,4149.5,-669679,-684170.4,28.101302266536877,73.62278247638172,58.78773662439164,NaN,NaN,50
1669906800,1.05228,1.0534,1.04842,1.04924,10176,4532.8,-679855,-680652.4,28.81702983356562,61.96979272253056,59.83083979793761,NaN,NaN,50
1669908600,1.04924,1.05074,1.04714,1.04874,8788,4832.65,-688643,-679743,28.696803967461047,60.279825701739604,59.982358170873866,NaN,NaN,50
1669910400,1.04874,1.05024,1.04821,1.0491,5274,4980.1,-683369,-679714.6,28.58516566322109,61.102331441476345,60.31074196474908,NaN,NaN,50
1669912200,1.0491,1.05088,1.04906,1.04972,5218,5139.75,-678151,-679939.4,28.711007433132828,62.54099071915385,60.70345191987142,NaN,NaN,50
1669914000,1.04972,1.05003,1.04695,1.04991,4401,5156.8,-673750,-680753.6,27.567520614380598,62.992709619248686,61.101414310043864,NaN,NaN,50
1669915800,1.04991,1.05127,1.04988,1.05074,3954,5085.75,-669796,-678741.8,26.99776844775571,64.97946295825986,62.26269385913428,NaN,NaN,50
1669917600,1.05074,1.05192,1.05046,1.0508,3505,4944.35,-666291,-674271.4,26.713655993578055,65.1252188089702,63.098162567919495,NaN,NaN,50
1669919400,1.0508,1.05144,1.05028,1.05078,2876,4876.9,-669167,-671431,26.339482267647035,65.02806329730896,63.84870100791267,NaN,NaN,50
1669921200,1.05078,1.05128,1.04962,1.05066,3016,4843.6,-672183,-670237.4,25.582077065205223,64.40721045825583,64.2870615553519,NaN,NaN,50
1669923000,1.05066,1.05202,1.05038,1.05186,2938,4801.65,-669245,-669336.4,25.203614108894733,67.72562318441769,65.1069111183455,NaN,NaN,50
1669924800,1.05186,1.05206,1.05122,1.05176,2496,4771.85,-671741,-669725.4,24.870017340001574,67.16366218076968,65.37104923143427,NaN,NaN,50
1669926600,1.05176,1.05304,1.05174,1.05242,2344,4725.2,-669397,-670346.6,24.993494494306738,68.99239401573054,65.46912294567235,NaN,NaN,50
1669928400,1.05242,1.05258,1.05218,1.0524,1050,4644.9,-670447,-670602.6,25.108151851875814,68.86723023583022,65.3426641300053,NaN,NaN,50
1669930200,1.0524,1.05292,1.05238,1.0526,952,4557.95,-669495,-670065,25.370839766138715,69.46382141157167,65.04559548251886,NaN,NaN,50
1669932000,1.0526,1.0526,1.05208,1.05239,3036,4566.85,-672531,-670722.2,25.361482785615635,67.99055384943978,65.47564984872668,NaN,NaN,50
1669933800,1.05239,1.05258,1.05206,1.05234,963,4437.65,-673494,-671072.8,25.335145417741735,67.62280482561408,66.00014835757484,NaN,NaN,50
1669935600,1.05234,1.05396,1.052,1.05332,1765,4313.15,-671729,-671539.2,25.99569849653311,70.94046819154781,66.70287241115139,NaN,NaN,50
1669937400,1.05332,1.05338,1.05251,1.0528,1155,3886.95,-672884,-672026.6,26.60906921255367,67.0164034647021,67.02254475011911,NaN,NaN,50
1669939200,1.0528,1.0528,1.05138,1.05147,2082,3666.85,-674966,-673120.8,26.137788823982394,58.155714558959296,66.67704510295559,NaN,NaN,50
1669941000,1.05147,1.05157,1.05073,1.05102,1726,3385.75,-676692,-673953,25.161354532713943,55.48276933970898,65.99870984448766,NaN,NaN,50
1669942800,1.05102,1.05161,1.05066,1.05116,1734,2963.65,-674958,-674245.8,24.196527250197306,56.15790211899381,65.35818722377506,NaN,NaN,50
1669944600,1.05116,1.05174,1.05078,1.05135,2248,2636.65,-672710,-674442,23.390651227652384,57.10859785742676,64.79251112092633,NaN,NaN,50
1669946400,1.05135,1.05171,1.05052,1.05099,2313,2488.6,-675023,-674869.8,22.40187827747295,54.688783410142634,64.09833776034682,NaN,NaN,50
1669948200,1.05099,1.0513,1.0507,1.0512,2271,2341.25,-672752,-674427,21.48373196659205,55.86362340272687,63.25105206165462,NaN,NaN,50
1669950000,1.0512,1.05194,1.051,1.05194,1918,2217.1,-670834,-673255.4,21.13794005216338,59.81736697076846,62.72631668951168,NaN,NaN,50
1669951800,1.05194,1.0526,1.05186,1.05248,1356,2087.2,-669478,-672159.4,21.293951413422064,62.46009069976287,62.25972359551399,NaN,NaN,50
1669953600,1.05248,1.05262,1.052,1.0523,1298,1976.85,-670776,-671772.6,21.453103958851912,61.01948431650663,61.6991703155623,NaN,NaN,50
1669955400,1.0523,1.05258,1.05166,1.05236,1409,1903.5,-669367,-670641.4,21.19879557594459,61.33957481217386,61.11886698703388,NaN,NaN,50
1669957200,1.05236,1.05286,1.05217,1.05248,1510,1828.2,-667857,-669662.4,21.190486359689157,62.011456068389194,60.69178857410169,NaN,NaN,50
1669959000,1.05248,1.05281,1.05182,1.05232,2012,1781.9,-669869,-669469.4,20.752960978675514,60.5016656982311,60.183135779288634,NaN,NaN,50
1669960800,1.05232,1.05361,1.0523,1.05336,2210,1767.6,-667659,-669105.6,21.007939986788767,66.25310546933324,59.8483241562733,NaN,NaN,50
1669962600,1.05336,1.05353,1.05275,1.0528,1829,1741.85,-669488,-668848,21.244706208608218,61.09442369132866,59.42532560103234,NaN,NaN,50
1669964400,1.0528,1.05336,1.0524,1.05284,4111,1894.9,-665377,-668050,20.9991872176203,61.32606049316888,59.65177888204731,NaN,NaN,50
1669966200,1.05284,1.05427,1.05269,1.05296,3240,2009.3,-662137,-666906,21.522444422835257,62.055930558052054,60.12129039764325,NaN,NaN,50
1669968000,1.05296,1.0532,1.0513,1.0529,4157,2065.35,-666294,-666191,20.414455466235996,61.43165825877484,60.497987264770465,NaN,NaN,50
1669969800,1.0529,1.05452,1.05248,1.05356,4846,2259.5,-661448,-664948.8,20.39924262846213,65.538452261766,61.100119722223226,NaN,NaN,50
1669971600,1.05356,1.05402,1.05237,1.05266,3833,2362.9,-665281,-664107.4,20.270335306190848,56.675991307248715,61.242063143445094,NaN,NaN,50
1669973400,1.05266,1.05316,1.05156,1.05299,3803,2495.3,-661478,-663327.6,19.338662826888793,58.872085462254354,61.4569532905542,NaN,NaN,50
1669975200,1.05299,1.05305,1.05162,1.0527,2732,2527.8,-664210,-663742.2,18.4735383818226,56.17713580951129,61.19693677903583,NaN,NaN,50
1669977000,1.0527,1.05302,1.052,1.05293,2721,2577.55,-661489,-662781.2,17.67020853997542,57.826057236470085,60.86593438880063,NaN,NaN,50
1669978800,1.05293,1.05362,1.0523,1.05318,2285,2605.1,-659204,-662332.4,17.46404196743342,59.60524207271423,60.76491708567261,NaN,NaN,50
1669980600,1.05318,1.05394,1.05265,1.05374,1950,2590.2,-657254,-660727,17.544648928955766,63.33640811243912,60.90754803569155,NaN,NaN,50
1669982400,1.05374,1.05376,1.05265,1.05346,2708,2609.95,-659962,-660423.8,17.619498250369368,60.33553638603792,60.78783948695217,NaN,NaN,50
1669984200,1.05346,1.05448,1.05312,1.05378,3325,2662.65,-656637,-658909.2,18.2963390082894,62.52107154470821,60.932082761700535,NaN,NaN,50
1669986000,1.05378,1.0541,1.05306,1.05373,4256,2779.55,-660893,-658790,18.840530211919706,61.946718108323424,60.624483664485545,NaN,NaN,50
1669987800,1.05373,1.0538,1.04284,1.04624,15602,3491.85,-676495,-662248.2,21.310804299190863,24.95834974579165,58.043335525518614,NaN,NaN,50
1669989600,1.04624,1.04861,1.04452,1.04829,9162,3885.05,-667333,-664264,23.604630237371225,36.188873475110846,56.24782216708589,NaN,NaN,50
1669991400,1.04829,1.0491,1.04672,1.04706,8790,4254.1,-676123,-667496.2,25.363643581032193,32.997922273606164,54.17225014676834,NaN,NaN,50
1669993200,1.04706,1.04788,1.04498,1.04564,6466,4501.9,-682589,-672686.6,27.420835078313406,29.73788143558008,51.90840894511157,NaN,NaN,50
1669995000,1.04564,1.04798,1.045,1.04734,6946,4748.6,-675643,-675636.6,29.25352008080604,37.676315240946195,49.91825630076729,NaN,NaN,50
1669996800,1.04734,1.04918,1.04662,1.04908,5477,4911.95,-670166,-674370.8,30.04303197410823,44.57836281353486,49.054139979787735,NaN,NaN,50
1669998600,1.04908,1.05261,1.04896,1.05198,5591,5100.05,-664575,-673819.2,28.728244860268987,53.76804545490324,48.68956569354837,NaN,NaN,50
1670000400,1.05198,1.05342,1.05151,1.05302,4201,5104.55,-660374,-670669.4,27.113450311655207,56.55048730877328,48.716233657781366,NaN,NaN,50
1670002200,1.05302,1.0533,1.05252,1.05257,3433,5114.2,-663807,-666913,25.613998230799556,55.00782048937727,48.514931032989026,NaN,NaN,50
1670004000,1.05257,1.05302,1.05244,1.0528,2261,5019.4,-661546,-664093.6,24.259380692002217,55.673400406380146,48.23408519967944,NaN,NaN,50
1670005800,1.0528,1.05332,1.05184,1.05193,2208,4887.5,-663754,-662811.2,23.291382529313815,52.509126491237176,47.460707941022164,NaN,NaN,50
1670007600,1.05193,1.0521,1.05105,1.05189,2390,4815.35,-666144,-663125,22.76284201014808,52.36177108533648,46.89115327668634,NaN,NaN,50
1670009400,1.05189,1.05367,1.05154,1.05362,2552,4752.8,-663592,-663768.6,21.357103148963233,57.868671559712666,46.558838992043796,NaN,NaN,50
1670011200,1.05362,1.05404,1.05312,1.05369,2744,4753.4,-660848,-663176.8,19.850864048587024,58.079831369375015,46.28263279640463,NaN,NaN,50
1670013000,1.05369,1.05396,1.0531,1.05332,2956,4765.15,-663804,-663628.4,18.463510569489117,56.46880346922667,48.5333794909357,NaN,NaN,50
1670014800,1.05332,1.05406,1.05321,1.05396,1258,4713.8,-662546,-663386.8,17.1748605073561,58.60756153348088,50.13471435224784,NaN,NaN,50
1670016600,1.05396,1.05426,1.05339,1.05406,1805,4706.55,-660741,-662306.2,16.105645327067574,58.94696093897547,51.988217114059935,NaN,NaN,50
1670191200,1.05406,1.05406,1.05323,1.0539,91,4575.7,-660832,-661754.2,15.001867609585823,58.1257340105892,54.015920869417734,NaN,NaN,50
1670193000,1.0539,1.05436,1.05372,1.05406,1271,4473,-659561,-661496.8,14.188187338620025,58.7446991696875,55.5208054357564,NaN,NaN,50
1670194800,1.05406,1.0541,1.0531,1.05363,1865,4353.45,-661426,-661021.2,13.37674909689421,56.334640155143305,56.36053953158558,NaN,NaN,50
1670196600,1.05363,1.0544,1.05352,1.0544,1469,3646.8,-659957,-660503.4,12.449636753264636,59.53600180875285,56.772536414003405,NaN,NaN,50
1670198400,1.0544,1.05479,1.05398,1.05434,2421,3309.75,-662378,-660830.8,11.888012371249221,59.17195367233818,56.95978401140089,NaN,NaN,50
1670200200,1.05434,1.0547,1.05393,1.05429,1971,2968.8,-664349,-661534.2,11.323368239745257,58.84901372332425,57.23415495668282,NaN,NaN,50
1670202000,1.05429,1.05648,1.05418,1.05626,2392,2765.1,-661957,-662013.4,12.0421246196165,66.58662798108648,58.01367121201899,NaN,NaN,50
1670203800,1.05626,1.05742,1.05608,1.05682,2925,2564.05,-659032,-661534.6,13.23426811891369,68.40527292261216,59.14911024283149,NaN,NaN,50
1670205600,1.05682,1.05688,1.05576,1.05613,2280,2404.2,-661312,-661805.6,14.036680984831747,63.79763900213204,59.965957951174026,NaN,NaN,50
1670207400,1.05613,1.05724,1.05608,1.05707,1981,2223.7,-659331,-661196.2,14.989935592815007,67.05346767971477,60.62201481688846,NaN,NaN,50
1670209200,1.05707,1.05798,1.0567,1.0578,1851,2106.2,-657480,-659822.4,16.283254174501778,69.35819072485357,61.42761191370836,NaN,NaN,50
1670211000,1.0578,1.0583,1.05762,1.05804,1430,2006.05,-656050,-658641,17.653121505956605,70.0987693303043,62.40118090378534,NaN,NaN,50
1670212800,1.05804,1.05833,1.0579,1.05809,1178,1951.9,-654872,-657809,18.941535064306727,70.26003453138692,63.233500403635766,NaN,NaN,50
1670214600,1.05809,1.05833,1.05763,1.05812,1087,1895.85,-653785,-656303.6,19.81497793776524,70.36331475289157,64.0489542474869,NaN,NaN,50
1670216400,1.05812,1.05844,1.05784,1.05844,1289,1840.8,-652496,-654936.6,20.696869452711816,71.50023848896396,65.00427599594225,NaN,NaN,50
1670218200,1.05844,1.0585,1.05748,1.05832,1819,1804.15,-654315,-654303.6,21.05955307016095,70.40943005872363,65.83747105944484,NaN,NaN,50
1670220000,1.05832,1.05832,1.05714,1.05738,2004,1767.15,-656319,-654357.4,20.975429860238343,62.38109842639836,66.26936093596305,NaN,NaN,50
1670221800,1.05738,1.0577,1.05683,1.0569,2060,1722.35,-658379,-655058.8,20.52071967485881,58.70037314510796,66.20967317427413,NaN,NaN,50
1670223600,1.0569,1.05714,1.05534,1.05578,2890,1803.95,-661269,-656555.6,19.529444029922903,51.12087982009998,65.63459647054283,NaN,NaN,50
1670225400,1.05578,1.0565,1.05305,1.05392,3078,1867.6,-664347,-658925.8,20.174974307370913,41.530315753819096,64.39754661557818,NaN,NaN,50
1670227200,1.05392,1.05475,1.05336,1.05424,4608,2093.45,-659739,-660010.6,20.77439527928692,43.49439531139184,62.748101424885704,NaN,NaN,50
1670229000,1.05424,1.05548,1.05408,1.05545,3460,2202.9,-656279,-660002.6,20.59737938295698,50.29363576540013,61.45441305651342,NaN,NaN,50
1670230800,1.05545,1.05654,1.05522,1.05596,3699,2294.6,-652580,-658842.8,19.494670645924938,52.867911410032264,60.67371822850629,NaN,NaN,50
1670232600,1.05596,1.05608,1.05482,1.05594,3302,2386.25,-655882,-657765.4,18.763243775781127,52.752531324407805,59.652222774555796,NaN,NaN,50
1670234400,1.05594,1.05597,1.05259,1.05278,3195,2424.95,-659077,-656711.4,19.418503473382014,38.46766216329441,57.445756448730144,NaN,NaN,50
1670236200,1.05278,1.0538,1.0519,1.05364,3047,2478.75,-656030,-655969.6,20.357405850729386,42.99209452201937,55.5095653909955,NaN,NaN,50
1670238000,1.05364,1.0561,1.05293,1.05558,2447,2481.5,-653583,-655430.4,19.45582923689337,51.631962606507834,54.17898882493271,NaN,NaN,50
1670239800,1.05558,1.0577,1.05527,1.05646,2793,2474.9,-650790,-655072.4,18.46049238293011,54.96605510474628,53.0791845643509,NaN,NaN,50
1670241600,1.05646,1.05734,1.0561,1.05673,2922,2507,-647868,-653469.6,17.53625101853565,55.96892420584409,51.969804972699485,NaN,NaN,50
1670243400,1.05673,1.0595,1.05602,1.059,3349,2575.4,-644519,-650558,17.768124337233488,63.35715170173599,51.466070804343225,NaN,NaN,50
1670245200,1.059,1.0594,1.05812,1.0588,4655,2715.6,-649174,-649186.8,17.983435276024334,62.364251724417386,51.46486746848744,NaN,NaN,50
1670247000,1.0588,1.05918,1.05635,1.05658,4684,2878.3,-653858,-649241.8,17.035211738618354,52.52458959879197,51.02374007232201,NaN,NaN,50
1670248800,1.05658,1.05686,1.0556,1.05586,3628,3000.8,-657486,-650581,15.910302628702183,49.78128052976891,50.928054408726936,NaN,NaN,50
1670250600,1.05586,1.05667,1.05488,1.055,4694,3181.15,-662180,-653443.4,15.25976886675656,46.64734782714153,51.29355669967854,NaN,NaN,50
1670252400,1.055,1.055,1.05038,1.05288,8792,3556.3,-670972,-658734,16.475211410903796,39.967683043351904,51.04164868053282,NaN,NaN,50
1670254200,1.05288,1.05396,1.05172,1.05252,5917,3761.2,-676889,-664277,17.60383663046909,38.9477734658689,50.231229944852025,NaN,NaN,50
1670256000,1.05252,1.0538,1.05076,1.05144,4542,3888.1,-681431,-669791.6,18.958256358087887,35.98133143927383,49.02504566122642,NaN,NaN,50
1670257800,1.05144,1.05156,1.04906,1.04933,3464,3958.3,-684895,-675273.4,20.704270293682427,31.01171966893949,47.472130542978675,NaN,NaN,50
1670259600,1.04933,1.05158,1.04904,1.05122,4074,4017.5,-680821,-679001.6,22.325568948163074,39.12255661229354,47.51890871790719,NaN,NaN,50
1670261400,1.05122,1.05122,1.04922,1.04956,2489,3988.05,-683310,-681469.2,23.831060555895103,35.20735023841604,46.96285555479267,NaN,NaN,50
1670263200,1.04956,1.05063,1.04942,1.05042,1839,3849.6,-681471,-682385.6,25.22901704878913,38.633705403573074,46.034408611725894,NaN,NaN,50
1670265000,1.05042,1.05058,1.04951,1.04974,2093,3781.25,-683564,-682812.2,26.527119506476442,36.968992311474985,44.74890412649223,NaN,NaN,50
1670266800,1.04974,1.04992,1.04866,1.04881,2121,3702.35,-685685,-682970.2,28.02521586462017,34.76278503189148,43.23417989978133,NaN,NaN,50
1670268600,1.04881,1.04946,1.04818,1.04926,2345,3654.5,-683340,-683474,29.57446513658836,36.73030298414878,41.332262134239386,NaN,NaN,50
1670270400,1.04926,1.04974,1.04818,1.0482,2422,3615.85,-685762,-683964.4,30.737027990080097,34.119891520998436,39.314807833995175,NaN,NaN,50
1670272200,1.0482,1.04915,1.04804,1.04852,2354,3581.2,-683408,-684351.8,31.86957080155662,35.60770054195349,38.106458615649565,NaN,NaN,50
1670274000,1.04852,1.04918,1.04843,1.04912,1194,3518.55,-682214,-684081.8,32.888198713097474,38.41602050137554,37.294654327907175,NaN,NaN,50
1670275800,1.04912,1.04948,1.04902,1.04948,661,3411.95,-681553,-683255.4,33.491241999830166,40.10392152064756,36.82726673458618,NaN,NaN,50
1670277600,1.04948,1.04948,1.04898,1.04906,852,3308.45,-682405,-683068.4,34.070881602594305,38.76888243291086,36.741638119554686,NaN,NaN,50
1670279400,1.04906,1.04956,1.049,1.0495,922,3187.1,-681483,-682212.6,34.50788099100602,40.98531883449255,36.88717707445637,NaN,NaN,50
1670281200,1.0495,1.04986,1.04926,1.0498,1283,3018.5,-680200,-681571,34.52463960630349,42.513251086106855,37.35374276351587,NaN,NaN,50
1670283000,1.0498,1.04986,1.04954,1.04964,689,2818.75,-680889,-681306,34.540201177651134,41.89031841959029,38.1307855314195,NaN,NaN,50
1670284800,1.04964,1.05088,1.0495,1.05087,1457,2710.2,-679432,-680881.8,33.27610579039542,48.17684104254206,38.777520133580104,NaN,NaN,50
1670286600,1.05087,1.05115,1.05052,1.05108,1431,2547.05,-678001,-680001,31.797780461529996,49.187561123352836,39.77610662536131,NaN,NaN,50
1670288400,1.05108,1.0519,1.05044,1.05145,2354,2225.15,-675647,-678833.8,29.633700543356984,51.00083257967642,40.659472852225825,NaN,NaN,50
1670290200,1.05145,1.0516,1.05103,1.05104,2203,2039.45,-677850,-678363.8,27.624197762196328,48.91765988766196,41.51294910766775,NaN,NaN,50
1670292000,1.05104,1.05152,1.04934,1.04955,2367,1930.7,-680217,-678229.4,27.1974950236087,42.17554958388964,42.04243228995334,NaN,NaN,50
1670293800,1.04955,1.05024,1.04914,1.04976,3043,1909.65,-677174,-677777.8,26.943469422022602,43.36041213830454,42.51601151525018,NaN,NaN,50
1670295600,1.04976,1.05074,1.04976,1.05058,1469,1779.4,-675705,-677318.6,26.142120629353855,47.85365197448659,43.49699440478504,NaN,NaN,50
1670297400,1.05058,1.05094,1.0488,1.04927,2736,1791.75,-678441,-677877.4,26.10178840132214,42.106754947381475,43.961212576601326,NaN,NaN,50
1670299200,1.04927,1.04992,1.04914,1.04966,1776,1788.6,-676665,-677640.4,26.064337046721263,44.253183300436035,44.37815277653423,NaN,NaN,50
1670301000,1.04966,1.04975,1.04898,1.04908,1752,1771.55,-678417,-677280.4,26.14703749994659,41.77273875090271,44.49735400726673,NaN,NaN,50
1670302800,1.04908,1.04938,1.04858,1.04868,1952,1763.1,-680369,-677919.4,26.51575577653025,40.10325826728221,44.592666566864686,NaN,NaN,50
1670304600,1.04868,1.04952,1.04833,1.04941,2369,1764.3,-678000,-678378.4,27.036836515296407,44.46539836551338,44.841243676223314,NaN,NaN,50
1670306400,1.04941,1.04954,1.0476,1.04812,2215,1753.95,-680215,-678733.2,28.006529459102996,39.05286217048444,44.594073039393145,NaN,NaN,50
1670308200,1.04812,1.04907,1.04758,1.04845,2303,1751.4,-677912,-678982.6,28.91978108871124,41.03036000019583,44.53264743800783,NaN,NaN,50
1670310000,1.04845,1.04878,1.04765,1.048,3096,1846.5,-681008,-679500.8,29.76780045906175,39.16425602308951,43.88889136518979,NaN,NaN,50
1670311800,1.048,1.04981,1.04764,1.04906,3425,1984.7,-677583,-678943.6,29.01727072971389,45.45709749312872,43.62242967731664,NaN,NaN,50
1670313600,1.04906,1.05096,1.04874,1.0489,4133,2148.75,-681716,-679686.8,26.99721661987244,44.70539378430641,43.17275547764735,NaN,NaN,50
1670315400,1.0489,1.0501,1.0482,1.04906,4157,2310.5,-677559,-679155.6,25.637796574954713,45.67288343879776,42.94098573129991,NaN,NaN,50
1670317200,1.04906,1.0499,1.0479,1.04876,3239,2408.3,-680798,-679732.8,24.649946095347847,44.114303983767016,43.079468188434014,NaN,NaN,50
1670319000,1.04876,1.05027,1.0486,1.04943,2779,2512.8,-678019,-679135,23.313053205336544,48.35319461484511,43.43609550818691,NaN,NaN,50
1670320800,1.04943,1.0508,1.04916,1.05065,3029,2591.4,-674990,-678616.4,21.79131711663567,55.04038706932283,43.94943372924664,NaN,NaN,50
1670322600,1.05065,1.05085,1.04954,1.05016,2608,2650.25,-677598,-677792.8,20.431187948611147,52.12136694824212,44.66476315787954,NaN,NaN,50
1670324400,1.05016,1.05138,1.04946,1.05096,2638,2664.45,-674960,-677273,19.720031034877028,56.205103384608485,45.51847173532043,NaN,NaN,50
1670326200,1.05096,1.05228,1.05086,1.05169,2603,2684.45,-672357,-675584.8,19.87080468329048,59.59199233168154,46.79127556251892,NaN,NaN,50
1670328000,1.05169,1.05297,1.05132,1.05292,2825,2707.35,-669532,-673887.4,20.54012943428038,64.56457520055945,48.53851248632444,NaN,NaN,50
1670329800,1.05292,1.0533,1.05204,1.05256,2970,2703.7,-672502,-673389.8,21.396938092019706,62.153759200572864,49.80196683168583,NaN,NaN,50
1670331600,1.05256,1.05261,1.05142,1.05194,3329,2796.7,-675831,-673036.4,21.377598663053956,58.12816275665086,51.16448830212629,NaN,NaN,50
1670333400,1.05194,1.05214,1.05032,1.05136,3769,2848.35,-679600,-673964.4,20.137589140739472,54.56759976517437,52.131433999624754,NaN,NaN,50
1670335200,1.05136,1.05192,1.05056,1.05078,3584,2938.75,-683184,-676129.8,18.986151727161737,51.19077543274192,52.99047110031422,NaN,NaN,50
1670337000,1.05078,1.05166,1.0498,1.0501,5334,3117.85,-688518,-679927,18.098445990411474,47.480909231449544,53.135029081622854,NaN,NaN,50
1670338800,1.0501,1.05053,1.0489,1.04902,5386,3289.55,-693904,-684207.4,18.040241119523497,42.24447147433523,52.959248916624915,NaN,NaN,50
1670340600,1.04902,1.05096,1.04858,1.0499,5885,3465.35,-688019,-686645,17.519030289608946,47.34055776978929,53.078368511695736,NaN,NaN,50
1670342400,1.0499,1.05291,1.0499,1.05176,5473,3628.25,-682546,-687234.2,17.193448963541222,56.14796231875189,53.93791553562323,NaN,NaN,50
1670344200,1.05176,1.05238,1.04954,1.04956,3465,3686.35,-686011,-687799.6,16.561771052578212,46.28689059424611,53.79032239129473,NaN,NaN,50
1670346000,1.04956,1.04977,1.0481,1.04903,3178,3690.45,-689189,-687933.8,15.939698552290812,44.26975493102185,53.020991524273235,NaN,NaN,50
1670347800,1.04903,1.0491,1.04796,1.0482,2550,3646.7,-691739,-687500.8,15.463524855766556,41.23886145251815,52.24366970315009,NaN,NaN,50
1670349600,1.0482,1.04827,1.04636,1.04682,2568,3568.45,-694307,-688758.4,16.054831923794154,36.735514944646496,50.852984814581376,NaN,NaN,50
1670351400,1.04682,1.04754,1.04632,1.04638,2149,3468.05,-696456,-691540.4,16.62718970878469,35.40785577485195,49.12554648909355,NaN,NaN,50
1670353200,1.04638,1.04692,1.04594,1.0465,2113,3411.75,-694343,-693206.8,17.385948520341117,36.086289998941425,47.091383260406545,NaN,NaN,50
1670355000,1.0465,1.04685,1.04594,1.04633,2124,3379,-696467,-694662.4,18.09051027392923,35.517150766514575,45.188768372259524,NaN,NaN,50
1670356800,1.04633,1.04695,1.04622,1.04679,1202,3287.65,-695265,-695367.6,18.62996617018398,38.35049584020746,43.77607787822785,NaN,NaN,50
1670358600,1.04679,1.04719,1.0465,1.04696,1065,3210.5,-694200,-695346.2,18.84723179911412,39.410070280540396,42.693397200754006,NaN,NaN,50
1670360400,1.04696,1.04706,1.0465,1.04666,463,3101.75,-694663,-694987.6,19.04897845454925,38.16352687561955,41.76287944667383,NaN,NaN,50
1670362200,1.04666,1.04675,1.04646,1.04671,635,3003.35,-694028,-694924.6,19.27028876295827,38.512602673488615,41.122286121105184,NaN,NaN,50
1670364000,1.04671,1.04686,1.0466,1.04676,89,2866.55,-693939,-694419,19.321660149260637,38.88414951271412,40.88226312384654,NaN,NaN,50
1670365800,1.04676,1.04704,1.04658,1.04665,2658,2850.95,-696597,-694685.4,19.11060053469709,38.33532440956138,40.239032169544544,NaN,NaN,50
1670367600,1.04665,1.047,1.04653,1.04676,787,2723.85,-695810,-695007.4,18.968086908207898,39.25859893289996,39.03264907055512,NaN,NaN,50
1670369400,1.04676,1.04683,1.04646,1.04676,1012,2586,-695810,-695236.8,18.914584169886137,39.25859893289996,38.530628237601825,NaN,NaN,50
1670371200,1.04676,1.04682,1.0459,1.04606,1569,2485.25,-697379,-695907,19.466059257411302,35.352127301423366,37.89365483548765,NaN,NaN,50
1670373000,1.04606,1.04612,1.04564,1.04612,1352,2286.15,-696027,-696324.6,20.234592698163777,35.94052524420664,37.51520224917967,NaN,NaN,50
1670374800,1.04612,1.04624,1.04552,1.0458,1958,2114.75,-697985,-696602.2,20.948230893148214,34.15504448811504,37.330882930856,NaN,NaN,50
1670376600,1.0458,1.04744,1.04566,1.0473,2141,1927.55,-695844,-696609,19.680059663170148,47.35697773596932,38.18439164236439,NaN,NaN,50
1670378400,1.0473,1.04766,1.04695,1.04746,1980,1752.9,-693864,-696219.8,18.336402078655436,48.542146234067864,39.074095659159134,NaN,NaN,50
1670380200,1.04746,1.04758,1.0465,1.04658,1950,1677.15,-695814,-695906.8,17.539567006558514,42.830749462844075,39.59649556603982,NaN,NaN,50
1670382000,1.04658,1.04672,1.04581,1.04601,1592,1597.85,-697406,-696182.6,17.57159354320464,39.58212624440354,39.68446916633953,NaN,NaN,50
1670383800,1.04601,1.0468,1.04597,1.04672,1083,1524.5,-696323,-695850.2,17.48056695531246,45.161639442302466,40.095295535036826,NaN,NaN,50
1670385600,1.04672,1.04682,1.0463,1.04638,999,1446.05,-697322,-696145.8,17.36411754737886,43.1085875934221,40.44851415773701,NaN,NaN,50
1670387400,1.04638,1.04648,1.04588,1.04638,1162,1396.7,-697322,-696837.4,17.73662521252017,43.1085875934221,40.77679879487511,NaN,NaN,50
1670389200,1.04638,1.04711,1.04638,1.04664,1494,1365.75,-695828,-696840.2,17.080914362654813,45.3134160795839,41.23603212108009,NaN,NaN,50
1670391000,1.04664,1.04704,1.0462,1.04666,1891,1354.1,-693937,-696146.4,16.694129013274186,45.48842418498908,41.74696781932493,NaN,NaN,50
1670392800,1.04666,1.04683,1.04498,1.04512,2299,1408.95,-696236,-696129,17.589545763346738,35.94869743493325,41.51054628375588,NaN,NaN,50
1670394600,1.04512,1.04574,1.04476,1.04492,1909,1451.15,-698145,-696293.6,18.608940619371737,34.924326973379905,41.20095542950445,NaN,NaN,50
1670396400,1.04492,1.04594,1.04434,1.04582,3580,1607,-694565,-695742.2,19.90112633890784,42.82041664374311,41.73440466824157,NaN,NaN,50
1670398200,1.04582,1.04673,1.04568,1.04598,3350,1742.75,-691215,-694819.6,19.87315178874656,44.11856144226624,42.31855011096012,NaN,NaN,50
1670400000,1.04598,1.04664,1.04495,1.04644,4599,1968.25,-686616,-693355.4,20.48661786584019,47.78859522295575,43.29237516344874,NaN,NaN,50
1670401800,1.04644,1.04804,1.04554,1.0478,3875,2029.1,-682741,-690656.4,19.342234750617628,56.81820419477699,43.96817705336357,NaN,NaN,50
1670403600,1.0478,1.0481,1.04672,1.04798,3441,2161.8,-679300,-686887.4,18.21581153529584,57.85703993319441,44.63352660330118,NaN,NaN,50
1670405400,1.04798,1.04842,1.04657,1.04762,3119,2267.15,-682419,-684458.2,17.00572498982423,55.00682606956789,45.50324636092431,NaN,NaN,50
1670407200,1.04762,1.04987,1.04727,1.0487,3180,2347.7,-679239,-682063,17.193060358088914,61.184590550681996,47.046279525658484,NaN,NaN,50
1670409000,1.0487,1.05066,1.04841,1.04998,3274,2443.8,-675965,-679932.8,17.931630799147186,66.97260872375624,48.60420590290518,NaN,NaN,50
1670410800,1.04998,1.05048,1.04906,1.05002,2766,2484.2,-673199,-678024.4,18.61744620870129,67.13752392999345,50.32055849837457,NaN,NaN,50
1670412600,1.05002,1.05034,1.04893,1.04894,2568,2505.55,-675767,-677317.8,19.086439615982144,58.62569507164492,51.42892331824762,NaN,NaN,50
1670414400,1.04894,1.0509,1.04862,1.05061,2654,2539.25,-673113,-675456.6,19.942727688304,65.83805718268772,52.89496911132647,NaN,NaN,50
1670416200,1.05061,1.05394,1.05018,1.05366,3749,2629.2,-669364,-673481.6,22.28977713802827,74.5602802087864,54.97153025588342,NaN,NaN,50
1670418000,1.05366,1.05414,1.052,1.05238,4971,2798.15,-674335,-673155.6,24.542829384480346,66.84664566478284,57.17852655801553,NaN,NaN,50
1670419800,1.05238,1.05472,1.05233,1.05424,6019,3044.95,-668316,-672179,26.845567016774126,71.46618826992149,59.78865950776851,NaN,NaN,50
1670421600,1.05424,1.05498,1.05191,1.05218,5792,3284.6,-674108,-671847.2,28.452512348493936,61.28165871184798,61.107319655490286,NaN,NaN,50
1670423400,1.05218,1.05316,1.05157,1.05172,6333,3543.15,-680441,-673312.8,29.520982154022274,59.2511157556144,62.188216392158004,NaN,NaN,50
1670425200,1.05172,1.05292,1.0495,1.0524,9501,3943.5,-670940,-673628,28.39666423920259,61.29289205201291,63.152809022804945,NaN,NaN,50
1670427000,1.0524,1.05257,1.04965,1.05042,7167,4207.3,-678107,-674382.4,27.35265474687003,52.970180391452466,62.87795017971034,NaN,NaN,50
1670428800,1.05042,1.05106,1.04899,1.04911,4577,4321.2,-682684,-677256,25.806363487939954,48.29745979269446,62.19512302681749,NaN,NaN,50
1670430600,1.04911,1.05078,1.0488,1.05038,3614,4406.45,-679070,-678248.4,24.207954376369614,52.657648592698145,62.0273246356125,NaN,NaN,50
1670432400,1.05038,1.05222,1.04988,1.05156,3432,4399.05,-675638,-677287.8,23.754747386971165,56.34168062160549,61.68140249782132,NaN,NaN,50
1670434200,1.05156,1.0519,1.05083,1.05181,2742,4368.65,-672896,-677679,23.333912325386887,57.103303713909916,60.97645213997516,NaN,NaN,50
1670436000,1.05181,1.05288,1.05166,1.05182,2595,4268.45,-670301,-676117.8,23.5622400247274,57.13551554174124,60.26202296938572,NaN,NaN,50
1670437800,1.05182,1.05214,1.05103,1.05106,2130,4181.2,-672431,-674067.2,23.158944691007726,53.82731006731775,59.919281183362344,NaN,NaN,50
1670439600,1.05106,1.05202,1.05064,1.05176,1734,4095.85,-670697,-672392.6,22.418772143690354,56.33508237231856,59.24049726833598,NaN,NaN,50
1670441400,1.05176,1.05196,1.05104,1.05143,2053,4042.55,-672750,-671815,21.73146906403851,54.82336976517292,57.83071795093502,NaN,NaN,50
1670443200,1.05143,1.0517,1.05026,1.05074,1904,3978.75,-674654,-672166.6,20.356108543966986,51.699475860871146,56.74877725065561,NaN,NaN,50
1670445000,1.05074,1.05132,1.05056,1.05097,1645,3897.3,-673009,-672708.2,19.078988061043432,52.667646869963335,55.406024293515735,NaN,NaN,50
1670446800,1.05097,1.05125,1.05062,1.0511,608,3789.4,-672401,-672702.2,17.893090469757272,53.23819423460937,54.83149111657013,NaN,NaN,50
1670448600,1.0511,1.05114,1.0504,1.05064,816,3701.8,-673217,-673206.2,16.666679779805808,50.90015458543193,54.23499389012852,NaN,NaN,50
1670450400,1.05064,1.05111,1.05061,1.051,285,3583.35,-672932,-673242.6,15.527869853422303,52.65263713713724,53.61783282478026,NaN,NaN,50
1670452200,1.051,1.05121,1.05069,1.05093,3889,3590.35,-676821,-673676,14.483576116354907,52.26203008838704,53.56725066027558,NaN,NaN,50
1670454000,1.05093,1.05138,1.05092,1.05132,1159,3399.75,-675662,-674206.6,13.71767602311363,54.296362708762814,53.99574372570903,NaN,NaN,50
1670455800,1.05132,1.0515,1.05117,1.05119,601,3128.85,-676263,-674979,13.153725160071758,53.47827691519487,54.054360034458796,NaN,NaN,50
1670457600,1.05119,1.05154,1.0507,1.0507,1304,2904.45,-677567,-675849,12.424608459269326,50.39606729298736,53.629673368128934,NaN,NaN,50
1670459400,1.0507,1.05084,1.05017,1.05022,1104,2643,-678671,-676996.8,12.381373700142642,47.507535773142685,52.94426137235985,NaN,NaN,50
1670461200,1.05022,1.05044,1.04948,1.05003,2447,2290.3,-681118,-677856.2,13.056864350458994,46.37446656421527,52.17561501682228,NaN,NaN,50
1670463000,1.05003,1.05029,1.04987,1.05018,1811,2022.5,-679307,-678585.2,13.684105668609895,47.44025144274073,51.7193965436382,NaN,NaN,50
1670464800,1.05018,1.05069,1.04995,1.05032,1811,1884.2,-677496,-678831.8,13.64893400613522,48.46964750375048,51.15757976731191,NaN,NaN,50
1670466600,1.05032,1.05074,1.04949,1.04957,1653,1786.15,-679149,-679148.2,14.117218796884876,43.54896878608941,50.35226541166308,NaN,NaN,50
1670468400,1.04957,1.05043,1.04944,1.05017,1815,1705.3,-677334,-678880.8,14.605451230474916,48.08929200806394,50.09439513646257,NaN,NaN,50
1670470200,1.05017,1.0505,1.04995,1.05042,1344,1635.4,-675990,-677855.2,14.938480097767663,49.89749736876705,49.89652731494855,NaN,NaN,50
1670472000,1.05042,1.05046,1.04947,1.04964,1657,1588.5,-677647,-677523.2,15.785514623456246,44.6694374014516,49.28447325543728,NaN,NaN,50
1670473800,1.04964,1.05032,1.04951,1.0501,1447,1554.35,-676200,-677264,16.572046683024215,48.1216375573013,49.08600775342795,NaN,NaN,50
1670475600,1.0501,1.05017,1.0494,1.04968,1767,1556,-677967,-677027.6,17.428867281076993,45.34007242737795,48.563681702730854,NaN,NaN,50
1670477400,1.04968,1.05062,1.04968,1.05038,2046,1555.65,-675921,-676745,17.340149533513955,50.477919252886146,48.43624521448079,NaN,NaN,50
1670479200,1.05038,1.05112,1.05026,1.05094,1524,1536.65,-674397,-676426.4,16.40029285105737,54.18786297791039,48.42849523370562,NaN,NaN,50
1670481000,1.05094,1.05189,1.05089,1.05135,1795,1544.15,-672602,-675417.4,16.01873472030177,56.742950853163684,48.661686229274814,NaN,NaN,50
1670482800,1.05135,1.05208,1.05094,1.05202,2456,1636.55,-670146,-674206.6,15.902153627039835,60.60924769507061,49.39119911513791,NaN,NaN,50
1670484600,1.05202,1.05312,1.05198,1.05258,3189,1755.2,-666957,-672004.6,16.899015249068142,63.54233545149777,50.53654194930612,NaN,NaN,50
1670486400,1.05258,1.05258,1.0513,1.052,4506,1966.25,-671463,-671113,16.777602339909155,58.66964428165096,51.41476892912296,NaN,NaN,50
1670488200,1.052,1.05275,1.05124,1.05268,3392,1941.4,-668071,-669847.8,16.843522192876605,62.31806192950786,52.47746967817776,NaN,NaN,50
1670490000,1.05268,1.05268,1.05034,1.05062,2661,2016.5,-670732,-669473.8,15.694467071051315,48.38393949841586,52.471347677796714,NaN,NaN,50
1670491800,1.05062,1.05086,1.04896,1.04946,2793,2126.1,-673525,-670149.6,15.90160393822882,42.60671566978734,52.404043883775145,NaN,NaN,50
1670493600,1.04946,1.04986,1.04908,1.0495,2401,2180.95,-671124,-670983,16.093945314893645,42.86007930768103,52.030528690890655,NaN,NaN,50
1670495400,1.0495,1.05138,1.04908,1.05134,3325,2292,-667799,-670250.2,15.285047622580858,53.1135922390715,52.26024975305525,NaN,NaN,50
1670497200,1.05134,1.05142,1.04924,1.05023,2661,2302.7,-670460,-670728,14.571695147873465,47.5681160972113,52.4672982313238,NaN,NaN,50
1670499000,1.05023,1.0513,1.05012,1.05083,2255,2324.9,-668205,-670222.6,13.909296421359457,50.572234844909595,52.6423408947244,NaN,NaN,50
1670500800,1.05083,1.05216,1.05063,1.05189,3079,2388.3,-665126,-668542.8,14.11681251758947,55.43067631772127,53.363098315463205,NaN,NaN,50
1670502600,1.05189,1.05245,1.05144,1.05188,3453,2478.3,-668579,-668033.8,14.560807213370646,55.37537677843103,53.71291671014499,NaN,NaN,50
1670504400,1.05188,1.05236,1.05144,1.05203,4038,2589.45,-664541,-667382.2,14.97308800231031,56.083124872797825,53.8482925597798,NaN,NaN,50
1670506200,1.05203,1.0532,1.0511,1.05206,5580,2801.25,-658961,-665082.4,16.06383648818383,56.23263452493356,53.81184139347765,NaN,NaN,50
1670508000,1.05206,1.05344,1.05184,1.05288,5390,2987.9,-653571,-662155.6,17.260366004508374,60.21911400421716,53.783974701273834,NaN,NaN,50
1670509800,1.05288,1.05402,1.05175,1.0539,6544,3242.75,-647027,-658535.8,18.791562739605425,64.54511141378757,53.85560155572313,NaN,NaN,50
1670511600,1.0539,1.05451,1.05352,1.05444,4252,3367,-642775,-653375,20.53643587382362,66.61497525339774,54.42312519656219,NaN,NaN,50
1670513400,1.05444,1.05492,1.05368,1.05452,4817,3505.55,-637958,-648058.4,22.409490135142565,66.92306118906133,54.75205371510173,NaN,NaN,50
1670515200,1.05452,1.05482,1.05343,1.05466,3754,3617.05,-634204,-643107,23.73653483699171,67.48849269949861,56.11666465803621,NaN,NaN,50
1670517000,1.05466,1.0565,1.05466,1.05514,3107,3682.65,-631097,-638612.2,25.902594550426834,69.41871911266658,58.03180776109901,NaN,NaN,50
1670518800,1.05514,1.05564,1.05437,1.05458,2733,3696.5,-633830,-635972.8,27.478668139857408,64.5999635637863,59.5846566365351,NaN,NaN,50
1670520600,1.05458,1.05492,1.05392,1.05443,2427,3658.4,-636257,-634669.2,28.286878518601917,63.33182068180948,60.31453009673067,NaN,NaN,50
1670522400,1.05443,1.05521,1.05385,1.05506,2357,3550.95,-633900,-633857.6,29.21771741352756,66.32211982562966,61.6541017916177,NaN,NaN,50
1670524200,1.05506,1.0562,1.05506,1.05579,2435,3503.1,-631465,-633309.8,30.634061230247355,69.43275177108248,63.00128157205862,NaN,NaN,50
1670526000,1.05579,1.05595,1.05454,1.05535,3139,3527,-634604,-634011.2,31.21115534396169,65.50543685178886,63.72090732449202,NaN,NaN,50
1670527800,1.05535,1.05637,1.05496,1.05603,2574,3516.05,-632030,-633651.2,31.995999630154852,68.47334317296121,64.65647635267274,NaN,NaN,50
1670529600,1.05603,1.0561,1.0555,1.05595,1695,3480.75,-633725,-633144.8,32.724783610191366,67.73496608009341,65.48875072462242,NaN,NaN,50
1670531400,1.05595,1.05606,1.05531,1.05556,1943,3411.65,-635668,-633498.4,33.10721570966974,64.10574885508441,66.05111603391892,NaN,NaN,50
1670533200,1.05556,1.05592,1.05554,1.05564,760,3316.6,-634908,-634187,33.46233123061394,64.52562849778242,66.35872421203072,NaN,NaN,50
1670535000,1.05564,1.05574,1.05551,1.05552,531,3230.4,-635439,-634354,33.74002741226699,63.3289482040757,66.27185541133701,NaN,NaN,50
1670536800,1.05552,1.05575,1.05549,1.0556,69,3079.9,-635370,-635022,33.9608536636009,63.8108052786395,66.07155755599715,NaN,NaN,50
1670538600,1.0556,1.05592,1.05548,1.05564,2880,3051.25,-632490,-634775,34.31661153495238,64.06505852260526,65.86741450839314,NaN,NaN,50
1670540400,1.05564,1.05636,1.05554,1.05571,1308,2914.75,-631182,-633877.8,35.01841033884144,64.53464398058162,65.65642531418477,NaN,NaN,50
1670542200,1.05571,1.05577,1.05553,1.05558,695,2670.5,-631877,-633271.6,35.6486628934409,62.89096887183972,65.19015743984001,NaN,NaN,50
1670544000,1.05558,1.05587,1.0553,1.05538,1130,2457.5,-633007,-632785.2,35.730440475417105,60.3445353984014,64.88619828516964,NaN,NaN,50
1670545800,1.05538,1.05604,1.0552,1.05604,1364,2198.5,-631643,-632039.8,35.97586000979508,65.33292005202455,65.02913395447074,NaN,NaN,50
1670547600,1.05604,1.05848,1.05594,1.0583,3148,2143.3,-628495,-631240.8,37.79929002063822,76.31836690356832,65.74315160289493,NaN,NaN,50
1670549400,1.0583,1.05856,1.05736,1.05793,2730,2038.95,-631225,-631249.4,39.52766922238064,72.2800809900003,65.94653226138905,NaN,NaN,50
1670551200,1.05793,1.05808,1.0567,1.05686,2518,1977.15,-633743,-631622.6,39.95111869375482,62.054095296610704,65.70000786459062,NaN,NaN,50
1670553000,1.05686,1.05745,1.05664,1.05744,2003,1921.95,-631740,-631369.2,40.24149124995896,64.94888665043806,65.44826097012466,NaN,NaN,50
1670554800,1.05744,1.05826,1.05738,1.05815,2203,1895.45,-629537,-630948,41.01414289198,68.15184755049845,65.47803821801074,NaN,NaN,50
1670556600,1.05815,1.05842,1.05768,1.05806,1479,1848.05,-631016,-631452.2,41.82271202770217,67.31217054750756,65.70706833889811,NaN,NaN,50
1670558400,1.05806,1.05826,1.05775,1.05816,1453,1802.85,-629563,-631119.8,42.57352622515845,67.78707577501393,65.94002885870036,NaN,NaN,50
1670560200,1.05816,1.05827,1.0576,1.0576,1081,1735.15,-630644,-630500,42.97087908980999,62.32617770060229,65.86840239416655,NaN,NaN,50
1670562000,1.0576,1.05868,1.05746,1.05799,1889,1672.65,-628755,-629903,43.61778835764507,64.47272439190567,65.91568233082842,NaN,NaN,50
1670563800,1.05799,1.05826,1.05754,1.0577,1551,1621.5,-630306,-630056.8,44.21848982063478,61.659411079373506,65.74385037059757,NaN,NaN,50
1670565600,1.0577,1.05788,1.0572,1.05724,1498,1611.65,-631804,-630214.4,44.04545560028559,57.382171515686274,65.2329594802479,NaN,NaN,50
1670567400,1.05724,1.05774,1.05711,1.05761,1815,1605.25,-629989,-630299.6,43.69412425615095,59.797865358843765,65.0120235150339,NaN,NaN,50
1670569200,1.05761,1.05883,1.05692,1.05729,2880,1711.25,-632869,-630744.6,44.2249899394748,56.79921489401287,64.75878633614902,NaN,NaN,50
1670571000,1.05729,1.05772,1.05669,1.05681,3520,1860.7,-636389,-632271.4,44.25512777736253,52.542932680381966,63.84521580960312,NaN,NaN,50
1670572800,1.05681,1.0577,1.05636,1.05672,2995,2007,-639384,-634087,43.641187916905636,51.75974443215955,62.09102849021677,NaN,NaN,50
1670574600,1.05672,1.05718,1.05609,1.0561,3089,2017.45,-642473,-636220.8,42.568163194331134,46.605950113843924,60.25716199906275,NaN,NaN,50
1670576400,1.0561,1.05662,1.05486,1.05498,3163,2110.2,-645636,-639350.2,39.70722455007217,39.04303033454211,58.61351450177214,NaN,NaN,50
1670578200,1.05498,1.05616,1.05467,1.05572,2710,2210.95,-642926,-641361.6,36.93050034424094,45.35281194368916,57.2137948798615,NaN,NaN,50
1670580000,1.05572,1.05688,1.05526,1.05558,2355,2272.2,-645281,-643140,35.0801572339258,44.41608664429306,55.51838338656112,NaN,NaN,50
1670581800,1.05558,1.056,1.05528,1.05586,2225,2315.25,-643056,-643874.4,33.36198148863318,46.78347351116572,54.05204788396527,NaN,NaN,50
1670583600,1.05586,1.05646,1.05511,1.05588,3033,2309.5,-640023,-643384.4,32.275959271270196,46.957254696615365,52.56420352122252,NaN,NaN,50
1670585400,1.05588,1.05616,1.05532,1.05537,2822,2314.1,-642845,-642826.2,31.26751006943314,43.0928196927121,51.19039223494464,NaN,NaN,50
1670587200,1.05537,1.0566,1.05537,1.05636,3164,2346.4,-639681,-642177.2,30.80847107409155,51.446101233417636,50.25991915219549,NaN,NaN,50
1670589000,1.05636,1.05665,1.05502,1.05562,3650,2428.75,-643331,-641787.2,29.799209802072568,46.00959745745931,49.142075322058766,NaN,NaN,50
1670590800,1.05562,1.05664,1.05526,1.05601,4179,2527.55,-639152,-641006.4,28.862038620912084,49.0645531590777,48.54795972515816,NaN,NaN,50
1670592600,1.05601,1.05678,1.05036,1.0539,11738,3040.5,-650890,-643179.8,29.90065612704641,36.8995557492642,46.912366181616754,NaN,NaN,50
1670594400,1.0539,1.05504,1.05252,1.05372,6028,3269.25,-656918,-645994.4,30.865086668456854,36.07777002639762,45.4322629767871,NaN,NaN,50
1670596200,1.05372,1.0542,1.0529,1.05352,7102,3570.3,-664020,-650862.2,31.760629314052263,35.141292501076265,44.189288678265264,NaN,NaN,50
1670598000,1.05352,1.05592,1.05191,1.05231,8557,3903.7,-672577,-656711.4,30.705685829190653,30.057872741871932,42.63915498610186,NaN,NaN,50
1670599800,1.05231,1.05426,1.05224,1.05407,5448,4098.55,-667129,-662306.8,29.726095450390588,42.97862764035593,42.38006052370986,NaN,NaN,50
1670601600,1.05407,1.05434,1.05349,1.05434,3592,4203.25,-663537,-664836.2,28.734271348181085,44.66738036424719,42.78179981154593,NaN,NaN,50
1670603400,1.05434,1.0554,1.05392,1.05492,3806,4302.8,-659731,-665398.8,26.794800483516358,48.21533823140127,42.986265974953945,NaN,NaN,50
1670605200,1.05492,1.05502,1.05322,1.05329,2640,4290.8,-662371,-665069,25.55971761390163,40.379243243009164,42.697920017719376,NaN,NaN,50
1670607000,1.05329,1.05463,1.05329,1.05454,2363,4232.95,-660008,-662555.2,24.412854949259387,47.43463667793967,42.74443167248895,NaN,NaN,50
1670608800,1.05454,1.05502,1.05398,1.05496,2071,4186.75,-657937,-660716.8,22.96121204408685,49.59306677832952,42.93270396403996,NaN,NaN,50
1670610600,1.05496,1.0556,1.05472,1.05495,1574,4111,-659511,-659911.6,21.57450802823766,49.54090676872764,43.39328161232679,NaN,NaN,50
1670612400,1.05495,1.05524,1.05448,1.05482,2000,4052.85,-661511,-660267.6,20.0526834865527,48.822020021446455,43.20584724004313,NaN,NaN,50
1670614200,1.05482,1.05486,1.05436,1.0547,1746,4004.65,-663257,-660444.8,18.72119032991379,48.12777166971895,43.357145398061675,NaN,NaN,50
1670616000,1.0547,1.0548,1.05386,1.05387,1687,3971.25,-664944,-661432,17.977421304581178,43.518286427887276,42.960983488690935,NaN,NaN,50
1670617800,1.05387,1.05393,1.05302,1.05304,1869,3953.45,-666813,-663207.2,18.02256664274428,39.44934740749762,43.14311146427904,NaN,NaN,50
1670619600,1.05304,1.0533,1.0529,1.05314,597,3831.65,-666216,-664548.2,18.163261111918793,40.17511547319634,43.43577899619322,NaN,NaN,50
1670621400,1.05314,1.05373,1.05306,1.05336,1367,3758.9,-664849,-665215.8,17.766538486113646,41.82710418096482,43.91333697332812,NaN,NaN,50
1670796000,1.05336,1.05398,1.05318,1.05354,111,3606.25,-664738,-665512,17.099771003186166,43.208887946491274,44.8526952022295,NaN,NaN,50
1670797800,1.05354,1.05385,1.05328,1.05342,559,3451.7,-665297,-665582.6,16.480629769039222,42.48438170853589,44.81739192138521,NaN,NaN,50
1670799600,1.05342,1.05368,1.0525,1.05264,1101,3297.8,-666398,-665499.6,16.679758566052012,38.021675188522195,44.342698694547714,NaN,NaN,50
1670801400,1.05264,1.05271,1.05182,1.05208,1163,2769.05,-667561,-665768.6,17.44130766301008,35.16562719860629,43.410576477919506,NaN,NaN,50
1670803200,1.05208,1.05232,1.05156,1.05194,1607,2548,-669168,-666632.4,18.353707039473957,34.46854829746316,42.98838398180907,NaN,NaN,50
1670805000,1.05194,1.05232,1.05098,1.05138,2230,2304.4,-671398,-667964.4,19.633423333752663,31.756825296834705,41.86854031173015,NaN,NaN,50
1670806800,1.05138,1.05157,1.0506,1.05142,2755,2014.3,-668643,-668633.6,21.084330284313737,32.16732976929411,40.623844811084766,NaN,NaN,50
1670808600,1.05142,1.05182,1.05096,1.05126,2457,1864.75,-671100,-669574,22.039089611105062,31.35485817452495,39.324841340070286,NaN,NaN,50
1670810400,1.05126,1.0513,1.05064,1.05098,1694,1769.85,-672794,-670620.6,23.166065681648725,29.93015349380859,37.975422302381865,NaN,NaN,50
1670812200,1.05098,1.05203,1.05094,1.05132,1620,1660.55,-671174,-671021.8,23.10984332105062,33.860121136750536,36.956304407169846,NaN,NaN,50
1670814000,1.05132,1.05164,1.05118,1.05146,1363,1596.7,-669811,-670704.4,23.057636843352377,35.4651610660497,36.381081167038595,NaN,NaN,50
1670815800,1.05146,1.0517,1.05121,1.05151,1173,1537.2,-668638,-670703.4,22.916807213718833,36.061933286017826,36.13912301550432,NaN,NaN,50
1670817600,1.05151,1.05184,1.05142,1.0516,1020,1484.65,-667618,-670007,22.562362219695846,37.187872792832025,35.925748538335434,NaN,NaN,50
1670819400,1.0516,1.052,1.05157,1.05162,745,1443.2,-666873,-668822.8,21.973334732291097,37.45147243573208,35.613203413675954,NaN,NaN,50
1670821200,1.05162,1.05167,1.05083,1.05115,1511,1418.75,-668384,-668264.8,22.24149000084969,33.855748945747536,34.945122056479974,NaN,NaN,50
1670823000,1.05115,1.05168,1.05115,1.05164,1346,1398.75,-667038,-667710.2,22.4731189794197,40.29199791108094,34.788523213804616,NaN,NaN,50
1670824800,1.05164,1.05188,1.05088,1.0513,1608,1394.8,-668646,-667711.8,22.971641347916936,37.56085912825451,34.75560778092835,NaN,NaN,50
1670826600,1.0513,1.05282,1.05119,1.05226,1941,1398.4,-666705,-667529.2,21.89564880032881,48.23103236360404,35.68885100699962,NaN,NaN,50
1670828400,1.05226,1.05318,1.05147,1.05302,3286,1532.85,-663419,-666838.4,20.40142568380924,54.81431452244846,37.14212002307,NaN,NaN,50
1670830200,1.05302,1.0537,1.0523,1.05264,3359,1632.45,-666778,-666517.2,19.529630568857982,51.30148110017901,38.53816686616602,NaN,NaN,50
1670832000,1.05264,1.05328,1.05202,1.05308,3956,1824.7,-662822,-665674,18.33337377291192,54.90514536558577,40.16229655161543,NaN,NaN,50
1670833800,1.05308,1.05514,1.05301,1.05452,3704,1981.95,-659118,-663768.4,19.05314662325533,64.23340569816571,42.510764231875484,NaN,NaN,50
1670835600,1.05452,1.05526,1.05444,1.05476,3427,2098.25,-655691,-661565.6,19.813481019072015,65.51382475806949,45.05245503646555,NaN,NaN,50
1670837400,1.05476,1.05649,1.05461,1.05594,3436,2211.9,-652255,-659332.8,21.35134200855198,71.00912381403168,47.70595522769992,NaN,NaN,50
1670839200,1.05594,1.05614,1.05548,1.05566,2312,2247.15,-654567,-656890.6,22.779355784497664,68.23077165929364,50.0463559843602,NaN,NaN,50
1670841000,1.05566,1.0567,1.05548,1.05646,2026,2236.95,-652541,-654834.4,24.44236146686299,71.64448687127528,52.587966954735734,NaN,NaN,50
1670842800,1.05646,1.05678,1.0559,1.05658,2033,2200.85,-650508,-653112.4,26.03367331606261,72.12828069891356,55.08371037659869,NaN,NaN,50
1670844600,1.05658,1.05742,1.05634,1.05658,2853,2220.65,-650508,-652075.8,27.87389751484261,72.12828069891356,57.56062525254023,NaN,NaN,50
1670846400,1.05658,1.05745,1.05636,1.0571,2260,2248.95,-648248,-651274.4,29.599157254831436,74.3294313425729,60.451602566599185,NaN,NaN,50
1670848200,1.0571,1.05714,1.05537,1.05556,3009,2318.4,-651257,-650612.4,29.622549451352402,59.37440072850047,61.814631339272005,NaN,NaN,50
1670850000,1.05556,1.0572,1.05534,1.05704,3216,2411.05,-648041,-649712.4,29.691315588957178,66.3760573801512,63.872859785836056,NaN,NaN,50
1670851800,1.05704,1.05776,1.05633,1.05716,3034,2504.1,-645007,-648612.2,30.18315314180126,66.87455938281138,65.204540287208,NaN,NaN,50
1670853600,1.05716,1.05766,1.05596,1.05596,3895,2647.85,-648902,-648291,30.075358736261936,57.667259873747525,65.40832209801509,NaN,NaN,50
1670855400,1.05596,1.05604,1.05496,1.05556,4952,2858.2,-653854,-649412.2,28.65043110854442,54.95136324028741,65.66902796516568,NaN,NaN,50
1670857200,1.05556,1.05803,1.0554,1.05556,4838,3024.55,-653854,-649931.6,28.84234278009961,54.95136324028742,65.67232924193009,NaN,NaN,50
1670859000,1.05556,1.0556,1.05206,1.05238,5894,3251.95,-659748,-652273,27.349018647529167,38.314175951770075,63.82095568861611,NaN,NaN,50
1670860800,1.05238,1.053,1.05176,1.05292,4522,3397.65,-655226,-654316.8,26.147221408349115,41.55036978369908,62.10928033330394,NaN,NaN,50
1670862600,1.05292,1.05497,1.05278,1.05443,4119,3506.55,-651107,-654757.8,24.837022336790504,49.52472725641477,60.57468057918845,NaN,NaN,50
1670864400,1.05443,1.05485,1.05306,1.05312,3028,3493.65,-654135,-654814,23.620408913200365,43.92571059432382,58.83860478883347,NaN,NaN,50
1670866200,1.05312,1.05378,1.05287,1.05342,2318,3441.6,-651817,-654406.6,22.35046374085095,45.44676524135702,56.96733895812502,NaN,NaN,50
1670868000,1.05342,1.05354,1.0517,1.05208,4429,3465.25,-656246,-653706.2,21.15141931381747,40.2012428487299,54.686836254540474,NaN,NaN,50
1670869800,1.05208,1.05236,1.05162,1.05225,2516,3405.85,-653730,-653407,20.09112256737355,41.12959258033391,52.472644246070494,NaN,NaN,50
1670871600,1.05225,1.05234,1.05108,1.0518,2225,3345.75,-655955,-654376.6,19.468801493047863,39.38652048676731,49.976722042084376,NaN,NaN,50
1670873400,1.0518,1.05262,1.05142,1.05223,2207,3284.3,-653748,-654299.2,18.6575273260257,41.91950132338793,48.729943513147774,NaN,NaN,50
1670875200,1.05223,1.05344,1.05208,1.05308,2172,3277.3,-651576,-654251,17.39950315712171,46.664280453094165,47.32195944692942,NaN,NaN,50
1670877000,1.05308,1.0538,1.05298,1.0536,2025,3277.25,-649551,-652912,16.503466692670578,49.38827304353587,46.072938994124016,NaN,NaN,50
1670878800,1.0536,1.05372,1.05334,1.05364,735,3212.35,-648816,-651929.2,15.6714328328231,49.601502247672414,45.49681344940437,NaN,NaN,50
1670880600,1.05364,1.05394,1.05342,1.05378,610,3100.2,-648206,-650379.4,15.079348340848926,50.389315847107284,45.17095292132008,NaN,NaN,50
1670882400,1.05378,1.05378,1.05327,1.05352,1665,3070.45,-649871,-649604,14.38282105028143,48.86173309981423,44.73597933985771,NaN,NaN,50
1670884200,1.05352,1.0537,1.0535,1.05369,436,2941.8,-649435,-649175.8,13.736045709040187,49.93054047786554,45.56571966315024,NaN,NaN,50
1670886000,1.05369,1.05404,1.05368,1.05376,662,2814.1,-648773,-649020.2,13.459262923385445,50.390324238600755,46.19714498135751,NaN,NaN,50
1670887800,1.05376,1.05422,1.05366,1.05413,657,2695.25,-648116,-648880.2,13.373346807355944,52.85470305895918,46.435000395824964,NaN,NaN,50
1670889600,1.05413,1.05434,1.05372,1.05392,1126,2556.8,-649242,-649087.4,13.410903122299484,51.29717185866334,46.96153334327779,NaN,NaN,50
1670891400,1.05392,1.05479,1.0539,1.05445,1489,2383.65,-647753,-648663.8,13.87807611630615,54.908670198225735,47.63738369733984,NaN,NaN,50
1670893200,1.05445,1.05474,1.05416,1.05432,2269,2255.2,-650022,-648781.2,14.311879610740913,53.85379348539668,48.61256588567318,NaN,NaN,50
1670895000,1.05432,1.05494,1.05404,1.05466,2123,2066.65,-647899,-648606.4,14.914619332545348,56.22260726048693,49.69063836282697,NaN,NaN,50
1670896800,1.05466,1.055,1.05448,1.05458,1491,1915.1,-649390,-648861.2,15.535941797056427,55.500687333899876,50.84165028047929,NaN,NaN,50
1670898600,1.05458,1.05544,1.05453,1.05466,1539,1786.1,-647851,-648583,16.555191204868226,56.10763564439182,51.85508844626528,NaN,NaN,50
1670900400,1.05466,1.05484,1.05374,1.05405,1786,1724,-649637,-648959.8,16.245260725412066,50.456449388476486,52.12595765593545,NaN,NaN,50
1670902200,1.05405,1.05424,1.05336,1.05346,1352,1675.7,-650989,-649153.2,15.43173998259644,45.66558838415021,51.86005160883648,NaN,NaN,50
1670904000,1.05346,1.05362,1.05314,1.05362,1172,1512.85,-649817,-649536.8,14.382077967819429,47.1316272458885,51.683631965851916,NaN,NaN,50
1670905800,1.05362,1.05416,1.05351,1.05414,1095,1441.8,-648722,-649403.2,14.074442014287456,51.69350924905418,51.77678863741955,NaN,NaN,50
1670907600,1.05414,1.05438,1.05364,1.05404,1211,1391.1,-649933,-649819.6,14.043401897655583,50.785954028623486,51.914232989477355,NaN,NaN,50
1670909400,1.05404,1.05517,1.05383,1.05511,1597,1360.6,-648336,-649559.4,14.834509881184893,59.066903015200424,52.56683031357271,NaN,NaN,50
1670911200,1.05511,1.05548,1.05472,1.05515,1520,1328,-646816,-648724.8,15.853570193659412,59.34232239971158,53.20625875365205,NaN,NaN,50
1670913000,1.05515,1.05536,1.05458,1.0547,1631,1308.3,-648447,-648450.8,16.56733117363232,54.86943854643206,53.35016843132869,NaN,NaN,50
1670914800,1.0547,1.056,1.05462,1.05544,2622,1402.65,-645825,-647871.4,17.81498439842168,60.184185331541855,53.98495510796287,NaN,NaN,50
1670916600,1.05544,1.05605,1.0548,1.05515,2917,1518,-648742,-647633.2,19.016891142994123,57.334612980403286,54.15823673526126,NaN,NaN,50
1670918400,1.05515,1.05608,1.0546,1.05476,3446,1607.05,-652188,-648403.6,19.766151187265862,53.655343689116364,54.14406174981267,NaN,NaN,50
1670920200,1.05476,1.05492,1.05316,1.05475,3640,1767.25,-655828,-650206,18.357929236739785,53.560434370130835,53.953906543358656,NaN,NaN,50
1670922000,1.05475,1.05476,1.05355,1.05366,2558,1862.05,-658386,-652193.8,17.05029456839414,44.351394786807184,53.15752850428061,NaN,NaN,50
1670923800,1.05366,1.05438,1.05312,1.05436,3096,1984,-655290,-654086.8,16.35901788755501,50.26544139239414,52.74022891485221,NaN,NaN,50
1670925600,1.05436,1.05437,1.05281,1.05343,2906,2073,-658196,-655977.6,16.07314487913247,43.63112124977592,52.2527054763736,NaN,NaN,50
1670927400,1.05343,1.05394,1.05281,1.05354,2501,2123.6,-655695,-656679,15.807691371311547,44.563130118638114,52.173958457408446,NaN,NaN,50
1670929200,1.05354,1.05462,1.05332,1.0544,1974,2108.85,-653721,-656257.6,14.762300158428054,51.33745357637472,52.474374623871746,NaN,NaN,50
1670931000,1.0544,1.05454,1.05354,1.05358,2359,2120.65,-656080,-655796.4,13.79157974646481,45.61391444203069,52.040117851941496,NaN,NaN,50
1670932800,1.05358,1.05478,1.05328,1.05468,2905,2191.35,-653175,-655373.4,13.089041975630234,53.158339243347186,52.20957393870748,NaN,NaN,50
1670934600,1.05468,1.05525,1.0538,1.05486,3202,2274.5,-649973,-653728.8,12.538449449555145,54.27609307643352,51.86737322879556,NaN,NaN,50
1670936400,1.05486,1.05678,1.05398,1.05577,4947,2432.55,-645026,-651595,13.645623657267606,59.5334089833508,51.881022270484074,NaN,NaN,50
1670938200,1.05577,1.06622,1.05577,1.06464,15860,3157.95,-629166,-646684,17.83008445405406,81.66398247458218,53.79491826535194,NaN,NaN,50
1670940000,1.06464,1.06736,1.06446,1.06596,9754,3587.05,-619412,-639350.4,21.862360461501066,83.1415542158884,55.43473032851955,NaN,NaN,50
1670941800,1.06596,1.06628,1.06308,1.06456,9058,3985.2,-628470,-634409.4,24.511960772066814,76.13408081673622,56.77754945968619,NaN,NaN,50
1670943600,1.06456,1.06505,1.06265,1.06304,8842,4366.75,-637312,-631877.2,26.646880391670486,69.30434338096461,57.89533515196107,NaN,NaN,50
1670945400,1.06304,1.06419,1.06208,1.06364,8278,4700.8,-629034,-628678.8,28.19579972723918,70.43190576344409,59.10044025148345,NaN,NaN,50
1670947200,1.06364,1.06588,1.0634,1.06576,5615,4905.55,-623419,-627529.4,30.045626969552757,74.05798031679076,61.222339217910836,NaN,NaN,50
1670949000,1.06576,1.06588,1.06248,1.06295,5487,5098.35,-628906,-629428.2,31.08792356418591,63.02524757074775,62.133753944936096,NaN,NaN,50
1670950800,1.06295,1.06382,1.06188,1.0623,5374,5235.95,-634280,-630590.2,31.628913751470726,60.77001017991684,63.357960297089015,NaN,NaN,50
1670952600,1.0623,1.06298,1.06108,1.06146,4898,5335,-639178,-630963.4,31.576571559969874,57.88723280306173,64.30968191740499,NaN,NaN,50
1670954400,1.06146,1.06246,1.06104,1.0623,3991,5362.25,-635187,-632194,31.499857665985374,59.934062855446115,64.92372543733866,NaN,NaN,50
1670956200,1.0623,1.0628,1.06168,1.06204,3705,5365.5,-638892,-635288.6,31.561583669837884,58.978540674303474,65.87834159678671,NaN,NaN,50
1670958000,1.06204,1.06248,1.06181,1.06246,3126,5393.9,-635766,-636660.6,31.618900673415208,60.08556624464328,66.37314352545071,NaN,NaN,50
1670959800,1.06246,1.0641,1.06238,1.06362,2732,5375.7,-633034,-636411.4,32.29498512686214,63.0513438142755,66.99994714958228,NaN,NaN,50
1670961600,1.06362,1.06363,1.06265,1.06351,2950,5377.9,-635984,-635772.6,32.922777833634285,62.576512514837226,67.2173116875456,NaN,NaN,50
1670963400,1.06351,1.06382,1.06255,1.0627,2703,5388,-638687,-636472.6,33.57825595461446,59.05002696336734,65.60202915103027,NaN,NaN,50
1670965200,1.0627,1.0632,1.0627,1.06284,988,5338.7,-637699,-636234,34.18691420981034,59.47511631912253,63.911569301261274,NaN,NaN,50
1670967000,1.06284,1.06332,1.06278,1.06317,628,5252.15,-637071,-636495,34.803655686346545,60.515570746285036,62.795961439086184,NaN,NaN,50
1670968800,1.06317,1.06354,1.06305,1.06338,865,5150.15,-636206,-637129.4,35.47445587720042,61.198290059365114,62.2169576304005,NaN,NaN,50
1670970600,1.06338,1.06344,1.063,1.06334,1903,5085.2,-638109,-637554.4,36.037138208863965,60.98199662157892,61.54196412026728,NaN,NaN,50
1670972400,1.06334,1.06364,1.0621,1.06236,1538,4914.75,-639647,-637746.4,35.51750748706253,55.78040243630051,60.236422843089414,NaN,NaN,50
1670974200,1.06236,1.06284,1.06236,1.06244,1002,4171.85,-638645,-637935.6,35.034993245389764,56.10952202542773,59.74244244699513,NaN,NaN,50
1670976000,1.06244,1.0634,1.06234,1.06268,1696,3768.95,-636949,-637911.2,34.935089023179415,57.14013517995819,59.4831656612838,NaN,NaN,50
1670977800,1.06268,1.06383,1.06254,1.0636,2245,3428.3,-634704,-637610.8,35.096151503584416,60.92766456300105,59.70033935842232,NaN,NaN,50
1670979600,1.0636,1.06393,1.06308,1.06322,2646,3118.5,-637350,-637459,35.30508039700875,58.623275798634594,59.60671171150721,NaN,NaN,50
1670981400,1.06322,1.06388,1.06317,1.06348,2315,2820.35,-635035,-636536.6,35.49908579804563,59.745124124675726,59.66146767224809,NaN,NaN,50
1670983200,1.06348,1.06386,1.06309,1.0632,2188,2649,-637223,-636252.2,35.5596561406911,57.92373001789323,59.5070507989088,NaN,NaN,50
1670985000,1.0632,1.06328,1.06266,1.06278,1680,2458.65,-638903,-636643,34.97698349260317,55.2050612514247,58.94660204441946,NaN,NaN,50
1670986800,1.06278,1.06284,1.06242,1.06254,980,2238.95,-639883,-637678.8,34.090701872162654,53.655319972733494,58.30937400569776,NaN,NaN,50
1670988600,1.06254,1.06292,1.06249,1.06262,1276,2057.85,-638607,-637930.2,33.34203366985437,54.117689298932696,57.957064172523864,NaN,NaN,50
1670990400,1.06262,1.06268,1.06218,1.06236,986,1907.6,-639593,-638841.8,32.17809855941965,52.29173370225394,57.443965414176105,NaN,NaN,50
1670992200,1.06236,1.0625,1.06196,1.06241,1132,1778.95,-638461,-639089.4,30.77130281560594,52.62278995078703,56.880195357354815,NaN,NaN,50
1670994000,1.06241,1.06291,1.06233,1.06286,1173,1681.3,-637288,-638766.4,29.91869555374401,55.60841972456895,56.480918904869384,NaN,NaN,50
1670995800,1.06286,1.06304,1.06249,1.0626,1597,1624.55,-638885,-638566.8,29.26719309192491,53.510211171347045,55.94721994413853,NaN,NaN,50
1670997600,1.0626,1.0639,1.06258,1.06358,2525,1603.3,-636360,-638117.4,29.493672944868234,59.684877507364995,56.226111020643145,NaN,NaN,50
1670999400,1.06358,1.06405,1.0634,1.06375,2207,1578.5,-634153,-637029.4,29.833619013364377,60.66096150064591,56.55121384030159,NaN,NaN,50
1671001200,1.06375,1.06426,1.06222,1.06222,3599,1709.05,-637752,-636887.6,28.37143998821042,49.13155590400885,55.97917246344806,NaN,NaN,50
1671003000,1.06222,1.06314,1.06199,1.063,3413,1848.3,-634339,-636297.8,26.72109131020196,53.93804388169307,55.47991384335462,NaN,NaN,50
1671004800,1.063,1.06376,1.0619,1.06309,4575,2033.8,-629764,-634473.6,25.852277964887882,54.47258970882832,55.183436265511325,NaN,NaN,50
1671006600,1.06309,1.06447,1.06308,1.06421,3713,2124.3,-626051,-632411.8,25.704051416943035,60.60026890788429,55.24451803574051,NaN,NaN,50
1671008400,1.06421,1.06544,1.0639,1.06534,3873,2241.05,-622178,-630016.8,26.312334816954046,65.6269996227391,55.794751578943746,NaN,NaN,50
1671010200,1.06534,1.06651,1.06489,1.06622,3543,2368.1,-618635,-626193.4,27.53484333838839,68.94939518958562,56.77648971738381,NaN,NaN,50
1671012000,1.06622,1.06686,1.06548,1.06648,4847,2525.65,-613788,-622083.2,28.859913984291076,69.87584961877845,57.935098977815585,NaN,NaN,50
1671013800,1.06648,1.06721,1.06534,1.06698,3100,2568.4,-610688,-618268,30.2758312245897,71.62896506541455,59.18590438970715,NaN,NaN,50
1671015600,1.06698,1.06709,1.0648,1.06547,3330,2602.6,-614018,-615861.4,30.80363406759315,60.22923246333906,59.75286858692751,NaN,NaN,50
1671017400,1.06547,1.06553,1.06453,1.06518,2723,2623,-616741,-614774,30.916435565939608,58.30988369946576,60.15908956897599,NaN,NaN,50
1671019200,1.06518,1.06522,1.06436,1.06478,2857,2656.45,-619598,-614966.6,30.781400752951686,55.67446688492749,60.16380722328732,NaN,NaN,50
1671021000,1.06478,1.06508,1.06386,1.06456,3325,2738.7,-622923,-616793.6,29.970821791370067,54.222899350808575,60.214713521820286,NaN,NaN,50
1671022800,1.06456,1.06534,1.06432,1.06444,3748,2877.1,-626671,-619990.2,29.44815944896048,53.404987973672235,59.76614998369937,NaN,NaN,50
1671024600,1.06444,1.06474,1.06362,1.06466,4228,3024.7,-622443,-621675.2,28.052969698193188,54.752534861868085,59.344119509500956,NaN,NaN,50
1671026400,1.06466,1.06492,1.06362,1.06388,4205,3185.65,-626648,-623656.6,26.93731930513566,49.30780053940424,59.3567084120292,NaN,NaN,50
1671028200,1.06388,1.06512,1.06318,1.06428,4991,3378.6,-621657,-624068.4,25.350851653205602,51.946831952646626,59.214478988525876,NaN,NaN,50
1671030000,1.06428,1.06572,1.06412,1.06552,3533,3496.6,-618124,-623108.6,24.500095860633987,59.06187803864398,59.54228529779842,NaN,NaN,50
1671031800,1.06552,1.06616,1.06442,1.0647,3919,3612.7,-622043,-622183,24.12660195366863,53.42807018628485,59.02998538911275,NaN,NaN,50
1671033600,1.0647,1.066,1.06418,1.06594,3992,3686.05,-618051,-621304.6,23.455508115705477,59.68989887650097,58.60590676438146,NaN,NaN,50
1671035400,1.06594,1.06611,1.06532,1.06542,3343,3742.85,-621394,-620253.8,22.944668788553074,56.272916685125494,57.70044401406288,NaN,NaN,50
1671037200,1.06542,1.06678,1.06496,1.06598,3117,3718.75,-618277,-619577.8,23.115444956130148,58.9952741560291,56.923260052437925,NaN,NaN,50
1671039000,1.06598,1.06658,1.06514,1.06514,2812,3688.7,-621089,-620170.8,23.274022826023142,53.6042665784682,55.635781589084615,NaN,NaN,50
1671040800,1.06514,1.06708,1.06506,1.06654,2451,3582.5,-618638,-619489.8,23.876827824614214,60.141669535646464,55.62952709424943,NaN,NaN,50
1671042600,1.06654,1.06848,1.06644,1.06776,3338,3563.75,-615300,-618939.6,25.43559129850233,64.79674296284182,56.092874184490576,NaN,NaN,50
1671044400,1.06776,1.06797,1.06308,1.06526,14216,4080.9,-629516,-620564,23.95679178375058,51.51862416347234,55.79602827581521,NaN,NaN,50
1671046200,1.06526,1.06788,1.06206,1.0664,17957,4801.6,-611559,-619220.4,23.275376161054442,55.951300212919094,55.91948548025168,NaN,NaN,50
1671048000,1.0664,1.06951,1.06618,1.06664,10895,5104,-600664,-615135.4,21.79995585704728,56.8458503652997,56.165261365367925,NaN,NaN,50
1671049800,1.06664,1.06856,1.06626,1.06792,5498,5223.9,-595166,-610441,20.429922717612055,61.353639686317855,56.63676885282863,NaN,NaN,50
1671051600,1.06792,1.06864,1.06761,1.06803,1328,5123.8,-593838,-606148.6,19.216206484262603,61.72367120881668,57.523616757786655,NaN,NaN,50
1671053400,1.06803,1.0688,1.06802,1.06822,872,5031.25,-592966,-598838.6,18.21181457959911,62.39346185712159,58.26980460810629,NaN,NaN,50
1671055200,1.06822,1.06832,1.0681,1.06817,100,4893.4,-593066,-595140,17.279164953840148,62.08556833560163,58.485782486460415,NaN,NaN,50
1671057000,1.06817,1.0683,1.06804,1.06812,165,4735.4,-593231,-593653.4,16.35549962433725,61.757371074938604,59.08073254993567,NaN,NaN,50
1671058800,1.06812,1.06817,1.06733,1.06794,1183,4607.15,-594414,-593503,15.540592486420044,60.517119679114245,59.139819750122335,NaN,NaN,50
1671060600,1.06794,1.068,1.06741,1.06761,779,4434.7,-595193,-593774,14.783893001211212,58.20910808042598,59.27811913550094,NaN,NaN,50
1671062400,1.06761,1.06761,1.06668,1.06732,1363,4292.6,-596556,-594492,14.733146228669177,56.18132968063097,59.07712310154393,NaN,NaN,50
1671064200,1.06732,1.06828,1.06714,1.06791,1562,4121.15,-594994,-594877.6,13.979769263115541,59.288634869466854,59.48314940804384,NaN,NaN,50
1671066000,1.06791,1.06802,1.06684,1.06688,2900,4089.5,-597894,-595810.2,13.554776111339088,52.31412663587938,58.92403920091762,NaN,NaN,50
1671067800,1.06688,1.06688,1.06598,1.06627,2504,4018.75,-600398,-597007,13.884114667478501,48.66306712144003,57.77163378367464,NaN,NaN,50
1671069600,1.06627,1.06652,1.06548,1.06555,1912,3914.75,-602310,-598430.4,14.567232587130624,44.697791809572195,57.28443147268177,NaN,NaN,50
1671071400,1.06555,1.06622,1.06548,1.06584,1648,3830,-600662,-599251.6,15.201556369664736,46.58570303801307,56.61546024590276,NaN,NaN,50
1671073200,1.06584,1.06598,1.06548,1.06556,1440,3746.15,-602102,-600673.2,15.790571310589272,44.9887656419767,55.76852562280827,NaN,NaN,50
1671075000,1.06556,1.06576,1.06542,1.06548,1202,3665.65,-603304,-601755.2,16.389905929765927,44.51919688058938,54.56606542239909,NaN,NaN,50
1671076800,1.06548,1.06554,1.06478,1.06516,984,3592.3,-604288,-602533.2,17.48340097532878,42.60367609656869,53.200351485809946,NaN,NaN,50
1671078600,1.06516,1.06528,1.06467,1.06478,1035,3477.15,-605323,-603135.8,18.586711881441794,40.381685138529,51.628081720196185,NaN,NaN,50
1671080400,1.06478,1.06528,1.06458,1.06521,1211,2826.9,-604112,-603825.8,19.686099877611547,43.94442079131593,50.332285467032925,NaN,NaN,50
1671082200,1.06521,1.06592,1.06468,1.06586,1323,1995.2,-602789,-603963.2,19.68386229232466,48.9141644574685,49.41491356578506,NaN,NaN,50
1671084000,1.06586,1.066,1.06535,1.06597,1558,1528.35,-601231,-603548.6,19.560528782680183,49.72646838118315,48.64415275878998,NaN,NaN,50
1671085800,1.06597,1.0661,1.06534,1.06548,1625,1334.7,-602856,-603262.2,19.288107270157603,46.20220142838272,47.78651656935832,NaN,NaN,50
1671087600,1.06548,1.06568,1.065,1.0655,2448,1390.7,-600408,-602279.2,19.421581747561063,46.36927718265869,47.08565567664602,NaN,NaN,50
1671089400,1.0655,1.06557,1.06402,1.06411,3018,1498,-603426,-602142,20.48147290991879,37.62383986765905,45.53817031937403,NaN,NaN,50
1671091200,1.06411,1.0647,1.06334,1.06379,4192,1702.6,-607618,-603107.8,21.98439287174144,35.9431514046135,44.36881494571218,NaN,NaN,50
1671093000,1.06379,1.06434,1.06204,1.0622,4625,1925.6,-612243,-605310.2,24.153934445945797,29.009059677157936,42.96495727112061,NaN,NaN,50
1671094800,1.0622,1.06225,1.06057,1.06068,4370,2084.95,-616613,-608061.6,26.795008202688514,24.202218668467154,41.500987761041664,NaN,NaN,50
1671096600,1.06068,1.0623,1.06061,1.06218,3270,2209.5,-613343,-610648.6,29.170339485317676,35.55156472325015,40.7128350242729,NaN,NaN,50
1671098400,1.06218,1.06262,1.0616,1.0624,3024,2292.55,-610319,-612027.2,30.8714976617451,37.04055325522219,40.14510556807614,NaN,NaN,50
1671100200,1.0624,1.06277,1.06156,1.06158,2659,2347.4,-612978,-613099.2,32.213009911467,33.89703132288692,39.386379456811675,NaN,NaN,50
1671102000,1.06158,1.06178,1.06067,1.06174,2949,2349.85,-610029,-612656.4,33.89825351873476,35.0552063197416,38.84720304418117,NaN,NaN,50
1671103800,1.06174,1.06246,1.06143,1.06244,2452,2347.25,-607577,-610849.2,34.44615561925142,40.00756879077895,38.82048044791331,NaN,NaN,50
1671105600,1.06244,1.06244,1.0614,1.06212,4753,2489.3,-612330,-610646.6,34.97296371392649,38.55999191059525,38.435878385004685,NaN,NaN,50
1671107400,1.06212,1.0628,1.0616,1.0623,2889,2551.35,-609441,-610471,34.926176880571234,39.87776847408883,37.790421529049,NaN,NaN,50
1671109200,1.0623,1.06468,1.0614,1.06398,5856,2772.15,-603585,-608592.4,32.68262230710863,50.540363111254294,37.84855686691122,NaN,NaN,50
1671111000,1.06398,1.06683,1.06388,1.06528,7688,3096.45,-595897,-605766,31.725345493878486,56.90882938715701,38.613316006823666,NaN,NaN,50
1671112800,1.06528,1.07362,1.06484,1.07066,8661,3480.3,-587236,-601697.8,33.30557795579528,72.62074557911806,40.48842089228505,NaN,NaN,50
1671114600,1.07066,1.0713,1.06854,1.06991,8581,3857.6,-595817,-598395.2,34.7729366704323,68.8518002905877,42.71898949392281,NaN,NaN,50
1671116400,1.06991,1.07048,1.06373,1.06408,8812,4237.65,-604629,-597432.8,33.27538197338389,47.99836701784178,43.58007632343912,NaN,NaN,50
1671118200,1.06408,1.06569,1.06235,1.06485,6873,4515.15,-597756,-596267,31.27975297786531,50.14604297381023,45.08986084462857,NaN,NaN,50
1671120000,1.06485,1.06568,1.06346,1.06477,5527,4713.6,-603283,-597744.2,29.426668910598064,49.91538411660651,46.92651551949566,NaN,NaN,50
1671121800,1.06477,1.06543,1.06285,1.06372,4248,4844.75,-607531,-601803.2,27.429411221406525,46.868219490536234,47.73484800287324,NaN,NaN,50
1671123600,1.06372,1.06386,1.05929,1.06085,4839,4964.3,-612370,-605113.8,26.72551754240705,39.72906018237109,47.926884211955304,NaN,NaN,50
1671125400,1.06085,1.0617,1.05961,1.0599,3601,4993.45,-615971,-607382.2,26.07190198333611,37.68290134654061,48.19730349935914,NaN,NaN,50
1671127200,1.0599,1.06078,1.05924,1.06062,3108,4939.25,-612863,-610403.6,25.59519642415884,40.196807133157414,48.564560700317415,NaN,NaN,50
1671129000,1.06062,1.06239,1.06038,1.06225,2268,4821.4,-610595,-611866,24.351594328895256,45.55186953560565,48.96058218209074,NaN,NaN,50
1671130800,1.06225,1.06288,1.06218,1.06238,1997,4702.75,-608598,-612079.4,22.966060706858613,45.967431896978056,49.48968503826095,NaN,NaN,50
1671132600,1.06238,1.06372,1.06191,1.06308,2496,4664.05,-606102,-610825.8,21.36346416087846,48.257457658035555,50.088234265685706,NaN,NaN,50
1671134400,1.06308,1.06383,1.06291,1.06291,2021,4613.9,-608123,-609256.2,19.92730963606259,47.728406995656016,49.88738025742869,NaN,NaN,50
1671136200,1.06291,1.06298,1.06214,1.06251,1834,4572.65,-609957,-608675,18.792099662538657,46.438360231876466,49.13948960348008,NaN,NaN,50
1671138000,1.06251,1.06264,1.062,1.06248,774,4463.9,-610731,-608702.2,17.807407327733912,46.33720129409059,47.26209358312097,NaN,NaN,50
1671139800,1.06248,1.0628,1.06231,1.06267,755,4379.05,-609976,-608977.8,16.800697202848756,47.12282157559055,45.71002367490689,NaN,NaN,50
1671141600,1.06267,1.06285,1.06229,1.06284,642,4173.5,-609334,-609624.2,15.835323992880548,47.858357817519654,45.700023017741024,NaN,NaN,50
1671143400,1.06284,1.06309,1.06281,1.06306,1094,4083.75,-608240,-609647.6,14.784816845917303,48.84996616017516,45.607446102481376,NaN,NaN,50
1671145200,1.06306,1.0633,1.0627,1.0629,662,3824.05,-608902,-609436.6,13.78759378906325,48.13302972629876,45.480135074602245,NaN,NaN,50
1671147000,1.0629,1.06392,1.06282,1.06388,656,3472.45,-608246,-608939.6,13.271200922543855,52.71094543457791,45.89747264203379,NaN,NaN,50
1671148800,1.06388,1.06425,1.06372,1.0642,1255,3102.15,-606991,-608342.6,13.005804927612594,54.13449208890725,46.92643206392923,NaN,NaN,50
1671150600,1.0642,1.06435,1.06346,1.0641,1355,2740.85,-608346,-608145,12.552010778659394,53.591564124619154,48.06276511950626,NaN,NaN,50
1671152400,1.0641,1.06452,1.06388,1.06408,2490,2424.75,-610836,-608664.2,12.252757965139152,53.47604812801528,49.01128233342468,NaN,NaN,50
1671154200,1.06408,1.06473,1.06392,1.0642,2500,2206.1,-608336,-608551,12.130578897020651,54.11512221724269,49.622943239255896,NaN,NaN,50
1671156000,1.0642,1.06538,1.06412,1.0652,2229,2041.2,-606107,-608123.2,12.486555753949883,59.15083790201043,50.56461509675821,NaN,NaN,50
1671157800,1.0652,1.06626,1.06499,1.0651,2389,1948.25,-608496,-608424.2,13.38989448400115,58.45990730002659,51.29336149975758,NaN,NaN,50
1671159600,1.0651,1.06535,1.06456,1.0648,1623,1787.45,-610119,-608778.8,13.795704917444992,56.33397296289413,51.908044783131736,NaN,NaN,50
1671161400,1.0648,1.06496,1.06456,1.06479,1299,1672.35,-611418,-608895.2,14.172528891357134,56.260528516688034,52.60962823204685,NaN,NaN,50
1671163200,1.06479,1.06516,1.06458,1.06466,1390,1586.45,-612808,-609789.6,14.669651011863635,55.25205373934657,53.24640340670799,NaN,NaN,50
1671165000,1.06466,1.06495,1.06438,1.06464,1481,1547.1,-614289,-611426,14.90030236540107,55.088450042440606,53.81537686862585,NaN,NaN,50
1671166800,1.06464,1.06481,1.06414,1.0644,1549,1524.7,-615838,-612894.4,14.833659255473112,53.0581387593938,54.186789793045435,NaN,NaN,50
1671168600,1.0644,1.06458,1.06406,1.06455,1828,1491.3,-614010,-613672.6,14.675483604603128,54.194418277709424,54.56853637286931,NaN,NaN,50
1671170400,1.06455,1.06512,1.06424,1.06509,1857,1483.1,-612153,-613819.6,15.022795664457986,58.12425580435757,55.282195378444946,NaN,NaN,50
1671172200,1.06509,1.06607,1.06501,1.06562,1939,1488.35,-610214,-613300.8,16.094990225915424,61.60592271787722,55.91755089868061,NaN,NaN,50
1671174000,1.06562,1.06633,1.0653,1.0656,3008,1600.05,-613222,-613087.4,17.275624654126815,61.39846908991192,56.436406398752375,NaN,NaN,50
1671175800,1.0656,1.0658,1.06308,1.06315,3673,1745.95,-616895,-613298.8,16.1172958095238,42.5125990637982,55.645051751550874,NaN,NaN,50
1671177600,1.06315,1.06421,1.06255,1.06294,4199,1923.8,-621094,-614715.6,15.474888932588565,41.33884873936094,54.77810893807557,NaN,NaN,50
1671179400,1.06294,1.06606,1.06293,1.06556,4346,2086.4,-616748,-615634.6,15.293596924345223,57.211562273948985,54.9992832278403,NaN,NaN,50
1671181200,1.06556,1.06573,1.06267,1.06283,4294,2268,-621042,-617800.2,14.902918067305656,43.8863038321449,53.908959365707055,NaN,NaN,50
1671183000,1.06283,1.063,1.06102,1.06121,4227,2446.55,-625269,-620209.6,14.380124077344217,38.200430940205635,52.461853911434126,NaN,NaN,50
1671184800,1.06121,1.06248,1.06093,1.06237,3423,2554.95,-621846,-621199.8,13.95556826486165,43.813821899580645,51.56755740691174,NaN,NaN,50
1671186600,1.06237,1.06288,1.06193,1.06236,3029,2638.65,-624875,-621956,13.23380763363032,43.77690615743781,50.675870095536716,NaN,NaN,50
1671188400,1.06236,1.06396,1.06204,1.06362,3015,2664.9,-621860,-622978.4,12.825687270397854,49.545328813788394,50.26824688656827,NaN,NaN,50
1671190200,1.06362,1.0639,1.06292,1.06353,2525,2666.15,-624385,-623647,12.446718361681992,49.15736822918539,49.84459818562147,NaN,NaN,50
1671192000,1.06353,1.06384,1.06305,1.06324,2750,2692.2,-627135,-624020.2,12.09481866073155,47.85698780844998,49.47308740341121,NaN,NaN,50
1671193800,1.06324,1.06324,1.06172,1.06218,3198,2732.65,-630333,-625717.6,11.800726217877296,43.343631274927176,48.69803118892677,NaN,NaN,50
1671195600,1.06218,1.06266,1.06135,1.0625,3877,2845.35,-626456,-626033.8,11.799732670722507,45.02908202970094,47.76266163359414,NaN,NaN,50
1671197400,1.0625,1.0636,1.06189,1.06343,3920,2976.4,-622536,-626169,10.986487205038156,49.711337154989145,46.91304837910214,NaN,NaN,50
1671199200,1.06343,1.0642,1.0617,1.0622,5472,3180.5,-628008,-626893.6,10.640943445387483,44.33291133828364,45.69407996827156,NaN,NaN,50
1671201000,1.0622,1.0649,1.0621,1.06435,8419,3527.4,-619589,-625384.4,10.828809333278892,53.752033173197475,46.4968966903715,NaN,NaN,50
1671202800,1.06435,1.06438,1.0614,1.06224,6470,3773.45,-626059,-624529.6,10.39198687509083,45.59777853314322,46.80110596135596,NaN,NaN,50
1671204600,1.06224,1.06264,1.0608,1.06166,6708,4017.45,-632767,-625791.8,9.80065117437628,43.638097439803666,45.831572758917,NaN,NaN,50
1671206400,1.06166,1.06247,1.05982,1.05996,4737,4161.45,-637504,-628785.4,9.970852379183222,38.42536609366491,45.441505777597,NaN,NaN,50
1671208200,1.05996,1.06132,1.05976,1.06091,3905,4259.75,-633599,-629903.6,10.171156964023295,42.554996302522866,45.752546160619666,NaN,NaN,50
1671210000,1.06091,1.06193,1.06056,1.06157,3528,4285.75,-630071,-632000,9.803769887258369,45.29975163559765,45.85868399890659,NaN,NaN,50
1671211800,1.06157,1.06192,1.06042,1.06051,3076,4255.9,-633147,-633417.6,9.5758858875477,41.84187771009289,45.72046768123909,NaN,NaN,50
1671213600,1.06051,1.06119,1.0603,1.06098,2187,4155.3,-630960,-633056.2,9.465522195630008,43.88715546532555,45.31631244206318,NaN,NaN,50
1671215400,1.06098,1.06174,1.06084,1.0615,1988,4037.4,-628972,-631349.8,8.825243727162412,46.14382314104254,45.10105922148155,NaN,NaN,50
1671217200,1.0615,1.06154,1.06032,1.06042,1828,3914.1,-630800,-630790,8.701610465709674,42.33565028289445,44.70667796965615,NaN,NaN,50
1671219000,1.06042,1.06044,1.05953,1.05995,2163,3810.9,-632963,-631368.4,9.235851702681023,40.75917470635326,44.52207392904372,NaN,NaN,50
1671220800,1.05995,1.06048,1.05954,1.06034,2715,3775.5,-630248,-630788.6,9.687910369501363,42.66699366208127,44.35335333135661,NaN,NaN,50
1671222600,1.06034,1.06064,1.0592,1.05925,3163,3782.2,-633411,-631278.8,10.38698130862067,38.896698314345784,43.58087912845351,NaN,NaN,50
1671224400,1.05925,1.05962,1.0586,1.05863,1330,3697.95,-634741,-632432.6,11.50138883254781,36.899358235762655,43.04991104970201,NaN,NaN,50
1671226200,1.05863,1.05918,1.05848,1.05848,1453,3644.35,-636194,-633511.4,12.626724324512903,36.41219955549065,41.81135150558009,NaN,NaN,50
1671400800,1.05848,1.05981,1.05848,1.05936,137,3513.7,-636057,-634130.2,12.869308234966766,41.307822392255176,41.50492606694523,NaN,NaN,50
1671402600,1.05936,1.05947,1.05911,1.0592,2398,3473.7,-638455,-635771.6,13.094564723245355,40.694356629470356,41.294658866207136,NaN,NaN,50
1671404400,1.0592,1.05952,1.05876,1.0589,1675,3363.6,-640130,-637115.4,13.62652921355447,39.50955372924747,41.37210084017732,NaN,NaN,50
1671406200,1.0589,1.05902,1.05826,1.05844,1388,3237,-641518,-638470.8,14.554455339492694,37.69720274689842,41.025115586204144,NaN,NaN,50
1671408000,1.05844,1.05982,1.05821,1.05959,2294,3078.1,-639224,-639076.8,14.363266396186875,44.545767611057705,40.97125958445129,NaN,NaN,50
1671409800,1.05959,1.05998,1.05944,1.05994,2252,2769.75,-636972,-639259.8,13.990268260160384,46.47422427929295,41.302141482251294,NaN,NaN,50
1671411600,1.05994,1.06044,1.05964,1.05978,2188,2555.65,-639160,-639400.8,13.095087729968307,45.69196337004472,41.431056332588376,NaN,NaN,50
1671413400,1.05978,1.06066,1.05976,1.06066,1935,2317,-637225,-638819.8,12.309177675877104,50.615503500243165,41.75046207253128,NaN,NaN,50
1671415200,1.06066,1.06132,1.0602,1.06104,2239,2192.1,-634986,-637513.4,12.289692688073243,52.613318562452086,42.48458123535682,NaN,NaN,50
1671417000,1.06104,1.06124,1.0605,1.06088,1679,2080.8,-636665,-637001.6,12.271599485112517,51.66558325845488,43.26361041764979,NaN,NaN,50
1671418800,1.06088,1.06104,1.06046,1.06074,1255,1967.15,-637920,-637191.2,12.198073801650718,50.8032491032751,43.844771520592204,NaN,NaN,50
1671420600,1.06074,1.06089,1.06021,1.06087,1010,1863.85,-636910,-636741.2,11.767967329816369,51.61089655459182,44.752928537752645,NaN,NaN,50
1671422400,1.06087,1.06112,1.0606,1.06084,961,1802.55,-637871,-636870.4,11.657888395938668,51.40118559501822,45.78877334912804,NaN,NaN,50
1671424200,1.06084,1.06103,1.06054,1.06064,1134,1759.85,-639005,-637674.2,11.46133007384249,49.94419037926052,46.75534412225445,NaN,NaN,50
1671426000,1.06064,1.06082,1.06034,1.06042,1025,1719.7,-640030,-638347.2,10.958004661724342,48.32161891499934,47.25632958816475,NaN,NaN,50
1671427800,1.06042,1.06079,1.06014,1.06076,1060,1664.55,-638970,-638557.2,10.177100187170126,50.97255372820539,47.990486523788675,NaN,NaN,50
1671429600,1.06076,1.0619,1.06038,1.06184,1705,1614.05,-637265,-638628.2,10.896254238548837,58.29143809916034,49.332049693068164,NaN,NaN,50
1671431400,1.06184,1.06342,1.06143,1.06291,2115,1561.65,-635150,-638084,12.874818744761605,64.02188764110662,51.21238432836875,NaN,NaN,50
1671433200,1.06291,1.0638,1.06272,1.06336,2348,1612.55,-632802,-636843.4,14.96790986208454,66.12953548846022,52.7540820338975,NaN,NaN,50
1671435000,1.06336,1.0635,1.06215,1.06243,2792,1679.5,-635594,-635956.2,16.03692645515377,58.50198026419157,53.61320746139025,NaN,NaN,50
1671436800,1.06243,1.0648,1.0624,1.06385,4123,1878.8,-631471,-634456.4,17.90334352344636,65.11780220604793,55.00076737824763,NaN,NaN,50
1671438600,1.06385,1.0644,1.06295,1.0642,2927,1905.25,-628544,-632712.2,19.636445086860903,66.53400222665677,56.13780300156288,NaN,NaN,50
1671440400,1.0642,1.0658,1.06358,1.06514,3904,2016.7,-624640,-630610.2,21.985273041257443,70.05082231224014,57.3833389836906,NaN,NaN,50
1671442200,1.06514,1.06516,1.06166,1.06181,3834,2139,-628474,-629744.6,21.888226012893572,50.00378114251273,57.26463883255188,NaN,NaN,50
1671444000,1.06181,1.06353,1.06181,1.06265,3154,2182,-625320,-627689.8,21.79811091512712,53.61022400418918,57.465137039760016,NaN,NaN,50
1671445800,1.06265,1.06283,1.0613,1.06194,2668,2202.8,-627988,-626993.2,21.192979689928773,50.3070282993548,57.37200359295738,NaN,NaN,50
1671447600,1.06194,1.06196,1.06096,1.06161,2779,2232.35,-630767,-627437.8,20.29399894033809,48.801933057915114,57.186342697450016,NaN,NaN,50
1671449400,1.06161,1.06162,1.06043,1.06062,2685,2269.85,-633452,-629200.2,18.952369780207615,44.50056340748768,56.79751219946625,NaN,NaN,50
1671451200,1.06062,1.06098,1.06033,1.06076,2684,2292.1,-630768,-629659,17.611570899832937,45.235661193424825,56.577086647925206,NaN,NaN,50
1671453000,1.06076,1.06155,1.06038,1.06064,3103,2363.3,-633871,-631369.2,16.89729107868989,44.68927745287674,56.12828119968744,NaN,NaN,50
1671454800,1.06064,1.06104,1.05974,1.06012,3644,2482.75,-637515,-633274.6,15.781389624640232,42.304695884663865,54.98637104150912,NaN,NaN,50
1671456600,1.06012,1.06082,1.0599,1.06062,3410,2602.75,-634105,-633942.2,14.745195417308407,45.32564797990616,53.650925351423375,NaN,NaN,50
1671458400,1.06062,1.06134,1.06039,1.06099,2953,2702.35,-631152,-633482.2,14.12317680802149,47.51567460176319,52.321363859516445,NaN,NaN,50
1671460200,1.06099,1.06119,1.05991,1.06033,4505,2870.9,-635657,-634460,13.190349383960928,44.1207108236114,51.294130328046435,NaN,NaN,50
1671462000,1.06033,1.06157,1.06027,1.06118,3959,3017.6,-631698,-634025.4,12.562076519378579,49.158882973660795,50.154207525733064,NaN,NaN,50
1671463800,1.06118,1.0612,1.0576,1.05796,4660,3197.6,-636358,-633794,13.514130638295665,35.93939751068264,47.9688786174492,NaN,NaN,50
1671465600,1.05796,1.06134,1.05796,1.06112,3763,3300.5,-632595,-633492,14.25324839084837,50.11644607113011,46.54499460022705,NaN,NaN,50
1671467400,1.06112,1.06288,1.06062,1.06234,3423,3365.9,-629172,-633096,13.521168970857833,54.31966064316995,46.85327170741685,NaN,NaN,50
1671469200,1.06234,1.06311,1.06189,1.0624,2809,3388.95,-626363,-631237.2,12.654636347352302,54.52261378233006,46.91844240585549,NaN,NaN,50
1671471000,1.0624,1.06302,1.06184,1.0625,2239,3361.3,-624124,-629722.4,11.891208485688185,54.88240111060212,47.24525474951601,NaN,NaN,50
1671472800,1.0625,1.06264,1.06148,1.06182,2095,3259.9,-626219,-627694.6,11.48618898963042,51.87689289031888,47.46489473754485,NaN,NaN,50
1671474600,1.06182,1.062,1.06128,1.0614,1807,3203.9,-628026,-626780.8,11.279615666005375,50.05364553855414,47.86154346119246,NaN,NaN,50
1671476400,1.0614,1.06146,1.06058,1.06065,2434,3130.4,-630460,-627038.4,11.656342365734844,46.884804863622115,47.97933943763512,NaN,NaN,50
1671478200,1.06065,1.06095,1.06011,1.06044,2453,3061.35,-632913,-628348.4,12.35923151560435,46.006537084697165,48.073429411336576,NaN,NaN,50
1671480000,1.06044,1.06081,1.06008,1.0608,2199,3013.6,-630714,-629666.4,13.03465410301143,47.8113765084985,48.46676374161048,NaN,NaN,50
1671481800,1.0608,1.06094,1.06034,1.06046,1715,2965.95,-632429,-630908.4,13.500223339267245,46.239313796470874,48.53202558565083,NaN,NaN,50
1671483600,1.06046,1.0608,1.06032,1.06075,479,2850.95,-631950,-631693.2,13.950166024403805,47.81541682116664,48.55343574417964,NaN,NaN,50
1671485400,1.06075,1.06087,1.06058,1.06079,382,2735.8,-631568,-631914.8,14.27015274019269,48.0416839900234,48.8335052560662,NaN,NaN,50
1671487200,1.06079,1.06079,1.06052,1.0607,136,2608.4,-631704,-631673,14.628120630231594,47.542195188168506,48.718027557102474,NaN,NaN,50
1671489000,1.0607,1.06081,1.06062,1.06078,1398,2523.15,-630306,-631591.4,14.928702892888237,48.059145480367256,49.58372384065137,NaN,NaN,50
1671490800,1.06078,1.06118,1.0605,1.0611,2334,2457.65,-627972,-630700,14.620029865752148,50.17427503385638,49.587854480846104,NaN,NaN,50
1671492600,1.0611,1.06129,1.06094,1.06124,840,2329.15,-627132,-629736.4,14.162046417548835,51.11224878405258,49.3587536337663,NaN,NaN,50
1671494400,1.06124,1.06124,1.06024,1.0605,1595,2261.25,-628727,-629168.2,14.585235469503283,46.16526220537221,48.76179994969788,NaN,NaN,50
1671496200,1.0605,1.06054,1.05978,1.06003,1541,2113.05,-630268,-628881,15.457086471204034,43.29882349232994,47.93440154839273,NaN,NaN,50
1671498000,1.06003,1.06042,1.0598,1.06014,2020,2016.1,-628248,-628469.4,16.266662401354733,44.17250868898822,47.384088391154826,NaN,NaN,50
1671499800,1.06014,1.06076,1.0598,1.06052,2186,1892.4,-626062,-628087.4,16.41078815415345,47.199271679033316,47.1802045440462,NaN,NaN,50
1671501600,1.06052,1.0608,1.06032,1.06043,1776,1793.05,-627838,-628228.6,16.473405643785025,46.555480953236895,47.156681407590106,NaN,NaN,50
1671503400,1.06043,1.06156,1.06036,1.06147,1662,1705,-626176,-627718.4,15.299226241770207,54.31078193964439,47.74984175437205,NaN,NaN,50
1671505200,1.06147,1.06524,1.06029,1.0617,11494,2139.25,-614682,-624601.2,17.305608367101406,55.83705653673005,48.32310461353144,NaN,NaN,50
1671507000,1.0617,1.06214,1.06022,1.06084,6947,2374.65,-621629,-623277.4,19.078406187602052,49.21662796620816,48.53576991136982,NaN,NaN,50
1671508800,1.06084,1.06155,1.0605,1.06076,4755,2507.65,-626384,-623341.8,20.72457559235265,48.63889978895636,48.5945901233548,NaN,NaN,50
1671510600,1.06076,1.0616,1.06038,1.06076,3672,2600.9,-626384,-623051,22.07833260369754,48.63889978895636,48.63724839470716,NaN,NaN,50
1671512400,1.06076,1.06125,1.05908,1.05931,3396,2649,-629780,-623771.8,21.66621593691919,39.01251841706298,48.02798576819962,NaN,NaN,50
1671514200,1.05931,1.05944,1.0579,1.05866,3241,2688.4,-633021,-627439.6,20.12141991443776,35.610136962672584,47.13877087407857,NaN,NaN,50
1671516000,1.05866,1.06007,1.05831,1.05998,3820,2769.45,-629201,-628954,19.215678442766695,45.924149049963674,46.835190446657656,NaN,NaN,50
1671517800,1.05998,1.06019,1.05902,1.05936,4929,2930.15,-634130,-630503.2,18.474504764590012,42.48208901390976,46.218750463076034,NaN,NaN,50
1671519600,1.05936,1.06138,1.05919,1.06131,4657,3139.05,-629473,-631121,18.690815496354638,54.127553840808645,46.78748557989292,NaN,NaN,50
1671521400,1.06131,1.06156,1.05994,1.06113,4700,3354.95,-634173,-631999.6,19.0157457032851,53.05962943123382,47.48468600410034,NaN,NaN,50
1671523200,1.06113,1.06252,1.06041,1.06065,5417,3619,-639590,-633313.4,19.935729104732804,50.21448361540892,47.91625564170182,NaN,NaN,50
1671525000,1.06065,1.06345,1.06065,1.06338,5541,3826.15,-634049,-634283,21.30204251991988,62.523117774077875,49.010816077062145,NaN,NaN,50
1671526800,1.06338,1.0635,1.06246,1.06337,4660,3942.45,-638709,-635198.8,22.597127675183813,62.46219970088145,50.147010273322465,NaN,NaN,50
1671528600,1.06337,1.06384,1.06246,1.06372,4116,4106.25,-634593,-636222.8,23.98346287160717,63.791930210519176,50.82423514981351,NaN,NaN,50
1671530400,1.06372,1.06379,1.06248,1.06324,4110,4232,-638703,-637128.8,25.270774125428858,60.620381711573955,51.16590123373094,NaN,NaN,50
1671532200,1.06324,1.064,1.06286,1.06288,3350,4322.45,-642053,-637621.4,26.588450999313633,58.280080779492074,51.813290720394086,NaN,NaN,50
1671534000,1.06288,1.0632,1.06207,1.06318,3137,4378.3,-638916,-638594.8,26.71519584046817,59.677118199575695,52.60173489258118,NaN,NaN,50
1671535800,1.06318,1.06461,1.06317,1.0643,2928,4415.4,-635988,-638050.6,27.70468745043918,64.4616873449328,53.73193400372235,NaN,NaN,50
1671537600,1.0643,1.06439,1.06279,1.06298,3686,4510.9,-639674,-639066.8,28.15040066424144,56.02429466241684,54.947060878390474,NaN,NaN,50
1671539400,1.06298,1.06318,1.06104,1.06136,3571,4606.35,-643245,-639975.2,26.751992771978667,47.761769945001525,55.81503466284254,NaN,NaN,50
1671541200,1.06136,1.06148,1.05941,1.05988,4080,4235.65,-647325,-641029.6,25.467048074319308,41.70968921857598,55.51400181774343,NaN,NaN,50
1671543000,1.05988,1.06171,1.0596,1.06157,4222,4099.4,-643103,-641867,24.089858601596084,49.56817163723649,56.020150576552474,NaN,NaN,50
1671544800,1.06157,1.06157,1.05984,1.06146,4442,4083.75,-647545,-644178.4,22.811039805495945,49.10413629858943,55.66133503782254,NaN,NaN,50
1671546600,1.06146,1.06362,1.06084,1.06358,7073,4253.8,-640472,-644338,22.231705132732962,57.384407251362816,55.97024773926032,NaN,NaN,50
1671548400,1.06358,1.06586,1.06282,1.0652,6834,4425.7,-633638,-642416.6,22.838944790096193,62.41623923772092,56.84180171228261,NaN,NaN,50
1671550200,1.0652,1.06548,1.0634,1.06402,5999,4563.6,-639637,-640879,23.40281018621919,57.125244316639304,56.45623932246556,NaN,NaN,50
1671552000,1.06402,1.0642,1.06203,1.06228,4502,4597.7,-644139,-641086.2,22.827885410839546,50.34771456368757,55.59091895552314,NaN,NaN,50
1671553800,1.06228,1.0636,1.06138,1.06352,4542,4578.35,-639597,-639496.6,21.82685117419414,54.49146277949795,54.92659985330734,NaN,NaN,50
1671555600,1.06352,1.06379,1.06193,1.0623,3873,4539.15,-643470,-640096.2,21.011533746959117,50.06449103858221,54.172607662379356,NaN,NaN,50
1671557400,1.0623,1.0624,1.06104,1.06151,3059,4457.1,-646529,-642674.4,19.613514007882923,47.38021453301471,53.39404578763098,NaN,NaN,50
1671559200,1.06151,1.06172,1.06056,1.06084,3039,4338.2,-649568,-644660.6,18.436340275321296,45.16832309792678,52.35770328037034,NaN,NaN,50
1671561000,1.06084,1.06168,1.0606,1.06064,2127,4167.5,-651695,-646171.8,17.343250380799784,44.50048467540411,50.931903089689726,NaN,NaN,50
1671562800,1.06064,1.06122,1.05993,1.0609,2030,4036,-649665,-648185.4,16.798777514755287,45.626013558850765,50.18916872514929,NaN,NaN,50
1671564600,1.0609,1.0623,1.06073,1.06216,2179,3939.15,-647486,-648988.6,15.732055672547402,50.83014505404876,50.408338375795516,NaN,NaN,50
1671566400,1.06216,1.06216,1.06152,1.06208,1959,3831.6,-649445,-649571.8,14.741528247640076,50.49966163091346,51.036193548105345,NaN,NaN,50
1671568200,1.06208,1.06254,1.06138,1.06154,1751,3751.65,-651196,-649897.4,14.111303735925048,48.220633433312145,50.9399408192536,NaN,NaN,50
1671570000,1.06154,1.06292,1.06148,1.06282,938,3641.7,-650258,-649610,13.812306651450907,53.56954108407246,51.25889830393096,NaN,NaN,50
1671571800,1.06282,1.06289,1.0621,1.06213,795,3535.05,-651053,-649887.6,13.534666501582059,50.53874561422112,50.76992247270657,NaN,NaN,50
1671573600,1.06213,1.0629,1.06213,1.0626,2062,3453.85,-648991,-650188.6,13.285210096574549,52.509702151442966,50.062312680829564,NaN,NaN,50
1671575400,1.0626,1.06268,1.06232,1.06248,546,3302.6,-649537,-650207,13.053572006210429,51.94060424195067,49.69198124692324,NaN,NaN,50
1671577200,1.06248,1.06284,1.06244,1.06264,1198,3158.5,-648339,-649635.6,12.98962450347401,52.6770531727252,49.85836257614021,NaN,NaN,50
1671579000,1.06264,1.06267,1.06242,1.06254,1150,3004.9,-649489,-649481.8,12.904957028856451,52.13928621776684,49.69034996458798,NaN,NaN,50
1671580800,1.06254,1.06264,1.06224,1.06227,2035,2884.55,-651524,-649576,12.58926801231371,50.63620570932765,49.73118672678408,NaN,NaN,50
1671582600,1.06227,1.06255,1.06178,1.06206,1816,2621.7,-653340,-650445.8,11.710864756308851,49.442337546842936,49.878481227771815,NaN,NaN,50
1671584400,1.06206,1.06256,1.06168,1.06211,2898,2424.9,-650442,-650626.8,10.978012846297892,49.7461460893153,50.20546858429957,NaN,NaN,50
1671586200,1.06211,1.06216,1.06138,1.062,3195,2284.7,-653637,-651686.4,10.671647724256053,49.04784885154992,50.530280311167125,NaN,NaN,50
1671588000,1.062,1.06258,1.06186,1.06225,1681,2143.65,-651956,-652179.8,9.996982473371355,50.740256714070426,50.895583393682806,NaN,NaN,50
1671589800,1.06225,1.06228,1.06136,1.0614,1447,1988.9,-653403,-652555.6,9.823311220126328,45.23835401820427,50.49616974826535,NaN,NaN,50
1671591600,1.0614,1.06172,1.06133,1.06146,1609,1875.7,-651794,-652246.4,9.69889198362494,45.6860555671186,50.15234074370858,NaN,NaN,50
1671593400,1.06146,1.06168,1.06132,1.06166,988,1772.15,-650806,-652319.2,9.596486821776425,47.23460379572782,50.081910055309706,NaN,NaN,50
1671595200,1.06166,1.06174,1.06097,1.06098,1310,1685.7,-652116,-652015,9.96058860209698,42.7696898454084,49.310492109690834,NaN,NaN,50
1671597000,1.06098,1.06107,1.0607,1.06082,1043,1631.5,-653159,-652255.6,10.63391490699266,41.76921790355714,48.68409727321484,NaN,NaN,50
1671598800,1.06082,1.06107,1.06076,1.06101,1190,1589.5,-651969,-651968.8,11.259146475824364,43.46058706905608,48.0377319101872,NaN,NaN,50
1671600600,1.06101,1.06178,1.0608,1.06176,1089,1535,-650880,-651786,10.614472729474715,49.67451358089046,47.875868291540044,NaN,NaN,50
1671602400,1.06176,1.06178,1.06106,1.06134,1581,1516.1,-652461,-652117,10.015847107864326,46.58671064570535,47.44084382532434,NaN,NaN,50
1671604200,1.06134,1.06174,1.06099,1.0614,1502,1503.65,-650959,-651885.6,9.572852640350707,47.09267324432867,47.08037147007877,NaN,NaN,50
1671606000,1.0614,1.06268,1.06111,1.06265,2632,1588.35,-648327,-650919.2,10.021546073811319,56.36603523546155,47.48964500765975,NaN,NaN,50
1671607800,1.06265,1.06348,1.06261,1.06318,2329,1665.05,-645998,-649725,11.32744830104345,59.59943479927644,48.21515195426215,NaN,NaN,50
1671609600,1.06318,1.06374,1.06204,1.06207,3184,1721.15,-649182,-649385.4,11.605726544643405,51.064746381348726,48.30933768940739,NaN,NaN,50
1671611400,1.06207,1.06366,1.06168,1.06342,3392,1863.45,-645790,-648051.2,11.330421778988526,58.79345905431588,49.005452703890676,NaN,NaN,50
1671613200,1.06342,1.06366,1.06247,1.06254,2922,1949.65,-648712,-647601.8,11.074781639451855,52.92553891642763,49.16154428977334,NaN,NaN,50
1671615000,1.06254,1.06276,1.06126,1.06146,2699,2027.1,-651411,-648218.6,11.283017581698845,46.75768662134011,49.27006804714018,NaN,NaN,50
1671616800,1.06146,1.0628,1.06132,1.0628,2452,2047.95,-648959,-648810.8,11.418308830304671,53.93133419703372,49.859016520705545,NaN,NaN,50
1671618600,1.0628,1.06288,1.06138,1.06192,2421,2078.2,-651380,-649250.4,11.421631897169918,49.239335723179,50.00221165838063,NaN,NaN,50
1671620400,1.06192,1.0621,1.06118,1.06168,2685,2067.55,-654065,-650905.4,11.672223488367928,48.0125059012603,50.37669851951291,NaN,NaN,50
1671622200,1.06168,1.06178,1.06047,1.06058,2533,2034.45,-656598,-652482.6,12.695781052996713,42.754510474095284,50.447076560265636,NaN,NaN,50
1671624000,1.06058,1.06206,1.06048,1.06192,2497,2075.25,-654101,-653020.6,13.17479275929375,49.945747553377956,50.91030230914577,NaN,NaN,50
1671625800,1.06192,1.06317,1.06168,1.06304,3153,2160.55,-650948,-653418.4,12.406560841131823,55.030589259818605,51.292879143354924,NaN,NaN,50
1671627600,1.06304,1.06454,1.06276,1.06386,3672,2263.7,-647276,-652597.6,13.05542645728874,58.365401252485306,52.13421418669634,NaN,NaN,50
1671629400,1.06386,1.06446,1.06244,1.06288,3661,2397.35,-650937,-651972,13.251313773760751,53.28010630400618,52.576173690959024,NaN,NaN,50
1671631200,1.06288,1.06288,1.06063,1.06139,4814,2572.55,-655751,-651802.6,13.013008488156903,46.62809175912272,51.880606299791964,NaN,NaN,50
1671633000,1.06139,1.06155,1.06024,1.06042,4887,2764.75,-660638,-653110,13.107026187491225,42.87521289652062,50.68601902102369,NaN,NaN,50
1671634800,1.06042,1.06194,1.05964,1.06186,5292,2969.85,-655346,-653989.6,13.653819739966544,49.38772049156933,50.56623145746802,NaN,NaN,50
1671636600,1.06186,1.06334,1.06112,1.06154,4792,3155,-660138,-656562,12.79234427044599,48.07605044794016,49.80070227129833,NaN,NaN,50
1671638400,1.06154,1.0616,1.06051,1.061,3392,3245.55,-663530,-659080.6,12.47965339013694,45.862488408906586,49.296198663618256,NaN,NaN,50
1671640200,1.061,1.06139,1.05953,1.05978,3351,3338,-666881,-661306.6,12.889852514477182,41.24233002818573,48.902244621250084,NaN,NaN,50
1671642000,1.05978,1.06034,1.05904,1.05944,2991,3355.95,-669872,-663153.4,13.58921377343498,40.031982421844496,47.909433780165145,NaN,NaN,50
1671643800,1.05944,1.06058,1.05934,1.06006,2614,3370.2,-667258,-665535.8,13.993665049693686,43.299737140885064,47.48517673857272,NaN,NaN,50
1671645600,1.06006,1.06036,1.05932,1.06006,2752,3348.6,-667258,-666959.8,14.383660061462583,43.299737140885064,47.14855039854592,NaN,NaN,50
1671647400,1.06006,1.0612,1.05998,1.06095,1810,3269.5,-665448,-667343.4,13.878253964212298,48.01569269654668,47.52434912872103,NaN,NaN,50
1671649200,1.06095,1.06199,1.06095,1.0616,2494,3248.1,-662954,-666558,13.080583152088337,51.207562575873034,47.614478773184956,NaN,NaN,50
1671651000,1.0616,1.062,1.06091,1.06143,2382,3232.25,-665336,-665650.8,12.302727957091562,50.33703842239138,47.27922514194017,NaN,NaN,50
1671652800,1.06143,1.06146,1.0608,1.06112,1694,3194.35,-667030,-665605.2,11.472556199509325,48.710853550247386,46.58961459178031,NaN,NaN,50
1671654600,1.06112,1.06166,1.06108,1.0611,1878,3167.2,-668908,-665935.2,10.901203374535232,48.60176296676902,46.255447210549086,NaN,NaN,50
1671656400,1.0611,1.06128,1.06084,1.06093,934,3079.65,-669842,-666814,10.133636080550499,47.625416584172775,46.32668469805266,NaN,NaN,50
1671658200,1.06093,1.0611,1.06048,1.06052,664,2986.2,-670506,-668324.4,9.80326488586928,45.26373209728662,46.497293212393096,NaN,NaN,50
1671660000,1.06052,1.06099,1.06052,1.06078,1318,2927.25,-669188,-669094.8,9.496491633665292,47.05668305572052,46.330790538403896,NaN,NaN,50
1671661800,1.06078,1.06078,1.06051,1.06062,899,2814.55,-670087,-669706.2,9.223268502630866,46.056869632779886,46.186563337321026,NaN,NaN,50
1671663600,1.06062,1.06108,1.06054,1.06101,730,2667.45,-669357,-669796,8.571274690798196,48.90652537553465,46.40399454922302,NaN,NaN,50
1671665400,1.06101,1.06118,1.0607,1.0608,561,2512.45,-669918,-669811.2,8.08514231775859,47.45288088357961,46.8476053246083,NaN,NaN,50
1671667200,1.0608,1.06102,1.06059,1.06072,1299,2336.7,-671217,-669953.4,7.538158695968186,46.88121063364054,47.33683591116516,NaN,NaN,50
1671669000,1.06072,1.06184,1.0606,1.06181,1623,2173.5,-669594,-670034.6,8.027070361710843,54.860448971927134,48.16260104195387,NaN,NaN,50
1671670800,1.06181,1.0628,1.06136,1.06264,2368,2027.3,-667226,-669462.4,9.439855942944178,59.81103253306287,49.34197928425228,NaN,NaN,50
1671672600,1.06264,1.063,1.06242,1.06296,2271,1901.25,-664955,-668582,10.926953299212467,61.561377096064064,50.3095281699321,NaN,NaN,50
1671674400,1.06296,1.06334,1.06258,1.06306,1988,1831.05,-662967,-667191.8,12.599575919455411,62.11664155929402,51.08874809731931,NaN,NaN,50
1671676200,1.06306,1.06319,1.06276,1.06288,1714,1749.2,-664681,-665884.6,14.152725495395286,60.42463029605137,51.809290374009315,NaN,NaN,50
1671678000,1.06288,1.06356,1.06288,1.06324,1160,1657.65,-663521,-664670,15.917723737697544,62.617812309767416,52.80264457111789,NaN,NaN,50
1671679800,1.06324,1.06446,1.06323,1.06434,1793,1616.6,-661728,-663570.4,18.223734208996582,68.38335672271808,54.21561555368569,NaN,NaN,50
1671681600,1.06434,1.0646,1.06382,1.06388,1396,1548.8,-663124,-663204.2,20.457347231224663,63.94203826968108,55.381088531222,NaN,NaN,50
1671683400,1.06388,1.0645,1.06354,1.06446,1086,1512.6,-662038,-663018.4,21.986819191552456,66.8642590865862,56.92398331617197,NaN,NaN,50
1671685200,1.06446,1.06477,1.06424,1.06474,1531,1464.45,-660507,-662183.6,23.615890479603475,68.20393560661026,58.43450135552123,NaN,NaN,50
1671687000,1.06474,1.06486,1.06384,1.06402,1219,1406.3,-661726,-661824.6,24.36029129307468,61.336687668022265,59.52591692946712,NaN,NaN,50
1671688800,1.06402,1.0649,1.064,1.06478,1857,1414.45,-659869,-661452.8,25.088915027179944,65.30746149147467,60.697412366319966,NaN,NaN,50
1671690600,1.06478,1.06498,1.0641,1.06446,1425,1391.8,-661294,-661086.8,25.844053851545652,62.40148506335525,61.76516980773251,NaN,NaN,50
1671692400,1.06446,1.0647,1.06366,1.06382,2123,1451.25,-663417,-661362.6,25.667949982315935,56.94400713135902,62.48394098614098,NaN,NaN,50
1671694200,1.06382,1.06461,1.0635,1.06392,1988,1517.45,-661429,-661547,25.202668686475988,57.56844710750092,62.67736942439626,NaN,NaN,50
1671696000,1.06392,1.06595,1.0634,1.06482,3452,1624.15,-657977,-660797.2,26.133203292903794,62.797852317572904,62.8907136947184,NaN,NaN,50
1671697800,1.06482,1.06497,1.06262,1.06362,3065,1732.45,-661042,-661031.8,25.725021611790133,53.35576263976722,62.304598376411484,NaN,NaN,50
1671699600,1.06362,1.06388,1.06292,1.06303,2902,1841.05,-663944,-661561.8,25.345995765041728,49.42123691267015,61.397783758795505,NaN,NaN,50
1671701400,1.06303,1.06522,1.0629,1.06464,2629,1944.45,-661315,-661141.4,26.155273171680943,58.42973513086686,61.255291246996606,NaN,NaN,50
1671703200,1.06464,1.06564,1.06396,1.06423,2391,1999.05,-663706,-661596.8,27.19851866031165,55.70860602266385,60.76177651220349,NaN,NaN,50
1671705000,1.06423,1.06512,1.06278,1.06282,2523,2044.05,-666229,-663247.2,26.52535492739633,47.51353836244224,59.27107520075522,NaN,NaN,50
1671706800,1.06282,1.06298,1.06214,1.06236,2239,2037.6,-668468,-664732.4,25.167737043731435,45.178543751012974,57.93082559227893,NaN,NaN,50
1671708600,1.06236,1.06258,1.0614,1.06156,2054,2026.75,-670522,-666048,23.5842545420574,41.37070724710709,56.10985760374471,NaN,NaN,50
1671710400,1.06156,1.06241,1.06142,1.06236,2692,2061.95,-667830,-667351,22.113877933360083,46.24950913184603,54.54168428411869,NaN,NaN,50
1671712200,1.06236,1.0639,1.06206,1.06368,2395,2096,-665435,-667696.8,21.688187919209337,53.17353287414858,53.958601798842,NaN,NaN,50
1671714000,1.06368,1.06376,1.06308,1.06316,2630,2169.5,-668065,-668064,21.29290433464078,50.41817911179097,52.89508162886459,NaN,NaN,50
1671715800,1.06316,1.06316,1.06036,1.06113,6259,2392.8,-674324,-669235.2,20.961796144932187,41.39930579643307,51.39492596694158,NaN,NaN,50
1671717600,1.06113,1.06186,1.0595,1.05958,4617,2553.85,-678941,-670919,21.1766890383255,36.09069678124167,49.905403799076055,NaN,NaN,50
1671719400,1.05958,1.06092,1.0586,1.06083,5576,2778.35,-673365,-672026,21.8649442024765,42.49479303279244,48.828714222311156,NaN,NaN,50
1671721200,1.06083,1.06112,1.05904,1.05937,5074,2955.5,-678439,-674626.8,22.307051837383522,37.73813696690387,47.038734554406226,NaN,NaN,50
1671723000,1.05937,1.06044,1.05904,1.06021,5022,3145.65,-673417,-675697.2,22.717580355511473,41.77623998245758,46.21162579316983,NaN,NaN,50
1671724800,1.06021,1.0606,1.05945,1.0595,3798,3242.7,-677215,-676275.4,22.92330484781667,39.44741132412969,45.499209679702645,NaN,NaN,50
1671726600,1.0595,1.05992,1.05834,1.05873,3055,3324.2,-680270,-676541.2,23.78058134924694,37.036114545199695,43.97109392358357,NaN,NaN,50
1671728400,1.05873,1.05874,1.05821,1.05854,2340,3335.05,-682610,-678390.2,24.648976322578278,36.444134111252694,42.59506021562562,NaN,NaN,50
1671730200,1.05854,1.0589,1.05823,1.05844,2229,3347.1,-684839,-679670.2,25.25906392876986,36.11692619794262,41.78101648958994,NaN,NaN,50
1671732000,1.05844,1.05884,1.05772,1.05796,2220,3285.5,-687059,-682398.6,26.135224449399825,34.51504421420769,41.0193379512467,NaN,NaN,50
1671733800,1.05796,1.05826,1.0577,1.05794,2339,3249.2,-689398,-684835.2,26.960997358930772,34.44648937066165,40.52475096007202,NaN,NaN,50
1671735600,1.05794,1.05858,1.05743,1.05754,2702,3239.2,-692100,-687201.2,27.285472903027923,33.033312518342655,39.58073691625036,NaN,NaN,50
1671737400,1.05754,1.05968,1.05734,1.0593,3069,3261.2,-689031,-688485.4,26.24618025177613,43.93262557499118,38.92067210916769,NaN,NaN,50
1671739200,1.0593,1.06034,1.05884,1.06014,3483,3315.8,-685548,-688627.2,24.601223109184552,48.26086038796082,38.76657791460839,NaN,NaN,50
1671741000,1.06014,1.06021,1.05954,1.05979,2635,3321.4,-688183,-688852,23.07376290534952,46.64508882330443,39.14127670224207,NaN,NaN,50
1671742800,1.05979,1.06001,1.05918,1.05925,1105,3264.7,-689288,-688830,22.0059281844681,44.187041583241665,39.719587045242065,NaN,NaN,50
1671744600,1.05925,1.05989,1.05916,1.05972,735,3198.75,-688553,-688120.6,21.034215183737807,46.81409922048391,40.02810891579146,NaN,NaN,50
1671746400,1.05972,1.05986,1.05964,1.05976,120,3070.15,-688433,-688001,20.131910254488243,47.042558273202495,40.69271043766993,NaN,NaN,50
1671748200,1.05976,1.06002,1.05974,1.05984,298,2965.3,-688135,-688518.4,19.082712324963964,47.52801887881633,41.10355178740984,NaN,NaN,50
1671750000,1.05984,1.06016,1.05984,1.06005,1786,2923.1,-686349,-688151.6,17.919599829479342,48.853450500655775,41.77541172859027,NaN,NaN,50
1671751800,1.06005,1.06029,1.05998,1.06016,820,2651.15,-685529,-687399.8,16.65994908594562,49.572004882218415,42.670832466948745,NaN,NaN,50
1671753600,1.06016,1.06042,1.05986,1.05988,1086,2474.6,-686615,-687012.2,15.633491277639294,47.73369637257323,43.47722977132878,NaN,NaN,50
1671755400,1.05988,1.06012,1.05889,1.05894,1782,2284.9,-688397,-687005,15.602552024892159,42.090553380523446,43.903917427227405,NaN,NaN,50
1671757200,1.05894,1.05988,1.05868,1.05974,2305,2146.45,-686092,-686596.4,15.806030698921209,47.75182427886355,44.849401717559964,NaN,NaN,50
1671759000,1.05974,1.06035,1.05962,1.0602,2808,2035.75,-683284,-685983.4,15.279319611738797,50.73420151740322,46.01280972804151,NaN,NaN,50
1671760800,1.0602,1.0608,1.0602,1.06077,1852,1938.45,-681432,-685164,14.20695521301727,54.221243258652954,47.52623335234939,NaN,NaN,50
1671762600,1.06077,1.06124,1.06077,1.06082,1833,1877.35,-679599,-683760.8,13.766066837752748,54.525304630427506,48.28285328488055,NaN,NaN,50
1671764400,1.06082,1.06118,1.06072,1.06104,1469,1833.8,-678130,-681707.4,13.283808654138046,55.91284829283532,48.82942384951445,NaN,NaN,50
1671766200,1.06104,1.06106,1.06062,1.06076,982,1771.45,-679112,-680311.4,12.683644425828374,53.66837054934618,49.331086829945995,NaN,NaN,50
1671768000,1.06076,1.061,1.06072,1.06093,825,1701.7,-678287,-679312,12.126349070969395,54.85333397093098,50.092964857638094,NaN,NaN,50
1671769800,1.06093,1.06104,1.06043,1.06058,1142,1641.85,-679429,-678911.4,11.382150027285531,51.909726367696464,50.456938225296135,NaN,NaN,50
1671771600,1.06058,1.06065,1.06042,1.06065,875,1550.5,-678554,-678702.4,10.707449563146103,52.45921400232106,50.84384220594746,NaN,NaN,50
1671773400,1.06065,1.06096,1.0603,1.06036,1116,1452.85,-679670,-679010.4,10.329307415528847,49.91465017826947,51.01431587019412,NaN,NaN,50
1671775200,1.06036,1.06076,1.0602,1.06054,1198,1338.6,-678472,-678882.4,9.794185704918114,51.48756019001121,51.20246656229093,NaN,NaN,50
1671777000,1.06054,1.06114,1.06053,1.06074,1313,1272.5,-677159,-678656.8,9.928203437231565,53.24454351879202,51.464790750617624,NaN,NaN,50
1671778800,1.06074,1.06197,1.06058,1.06158,1940,1314.25,-675219,-677814.8,11.16412142562595,59.82562967111062,52.32850027194172,NaN,NaN,50
1671780600,1.06158,1.06308,1.06146,1.06286,2228,1388.9,-672991,-676702.2,13.363645772200222,67.36400137325484,54.133746557136824,NaN,NaN,50
1671782400,1.06286,1.06286,1.0602,1.0603,2866,1526.2,-675857,-675939.6,13.395067396857593,47.97491446233466,54.1496815702419,NaN,NaN,50
1671784200,1.0603,1.06096,1.05991,1.06051,2402,1631.4,-673455,-674936.2,13.043372109617083,49.264949746522134,54.04473501517897,NaN,NaN,50
1671786000,1.06051,1.06078,1.05962,1.06048,2184,1651.3,-675639,-674632.2,12.344625242234306,49.07772645977224,53.67734095811606,NaN,NaN,50
1671787800,1.06048,1.06114,1.05994,1.06098,1801,1700.35,-673838,-674356,12.112745285595015,52.329392535937245,53.520490094223895,NaN,NaN,50
1671789600,1.06098,1.06218,1.06074,1.06201,2064,1749.25,-671774,-674112.6,12.923691234343309,58.24451321522361,53.687037588680205,NaN,NaN,50
1671791400,1.06201,1.06228,1.06138,1.06196,1849,1752.6,-673623,-673665.8,13.764744768534667,57.86912786183086,53.9870916824291,NaN,NaN,50
1671793200,1.06196,1.0627,1.06141,1.06234,1825,1728.6,-671798,-673334.4,14.910890384731232,59.980164996757416,54.35329389855957,NaN,NaN,50
1671795000,1.06234,1.06236,1.06099,1.06138,1717,1674.05,-673515,-672909.6,15.343429677661625,52.78445305789218,54.41577437643069,NaN,NaN,50
1671796800,1.06138,1.06189,1.06106,1.06113,1538,1658.35,-675053,-673152.6,15.745073306811278,51.066330179041266,54.31628267476784,NaN,NaN,50
1671798600,1.06113,1.06242,1.06052,1.06213,2089,1671.15,-672964,-673390.6,15.32116468987759,57.08380254652587,54.828364986786156,NaN,NaN,50
1671800400,1.06213,1.06252,1.06138,1.06149,2513,1723.35,-675477,-673761.4,15.043881260189135,52.62362889071263,54.90951275112197,NaN,NaN,50
1671802200,1.06149,1.06332,1.0595,1.06082,9400,2144.25,-684877,-676377.2,15.2834903620713,48.363379476677196,54.5608581766852,NaN,NaN,50
1671804000,1.06082,1.06196,1.06005,1.06072,5762,2391.1,-690639,-679802,15.505984528104738,47.74213018678869,53.69775107066221,NaN,NaN,50
1671805800,1.06072,1.06135,1.05924,1.06098,6303,2649.15,-684336,-681658.6,16.40038381562045,49.556446353683825,52.42578285497856,NaN,NaN,50
1671807600,1.06098,1.06226,1.06072,1.062,7151,2962.95,-677185,-682502.8,16.088417770240838,56.00906459778551,52.99965072179648,NaN,NaN,50
1671809400,1.062,1.06322,1.0607,1.06138,5473,3180.8,-682658,-683939,15.074390201388214,51.68151793457034,53.1722627352285,NaN,NaN,50
1671811200,1.06138,1.06238,1.06097,1.06208,4036,3322.7,-678622,-682688,14.132793173167919,55.830983830931835,53.6546382617399,NaN,NaN,50
1671813000,1.06208,1.06256,1.0617,1.06206,3140,3414.05,-681762,-680912.6,13.44287430078385,55.683845854562804,53.894242070213146,NaN,NaN,50
1671814800,1.06206,1.0625,1.062,1.0624,2377,3435.9,-679385,-679922.4,12.802235347855786,57.72361468077332,53.857035032038134,NaN,NaN,50
1671816600,1.0624,1.06302,1.0619,1.06204,2133,3431.15,-681518,-680789,12.760236291807656,54.84512180890972,53.64103459968662,NaN,NaN,50
1671818400,1.06204,1.06218,1.06128,1.06176,1821,3378.9,-683339,-680925.2,11.965894083228948,52.64615579144534,53.11717679930719,NaN,NaN,50
1671820200,1.06176,1.06188,1.06062,1.06094,1590,3338.3,-684929,-682186.6,11.70193586712083,46.7363185957289,52.68516719486695,NaN,NaN,50
1671822000,1.06094,1.06159,1.0606,1.06132,1684,3313.3,-683245,-682483.2,11.477613468870524,49.561987331740525,52.57771413434547,NaN,NaN,50
1671823800,1.06132,1.06232,1.0612,1.06208,1286,3287.55,-681959,-682998,10.905855797012217,54.73418473721386,52.409884290823186,NaN,NaN,50
1671825600,1.06208,1.06214,1.0615,1.0615,1302,3249.45,-683261,-683346.6,10.374937958858073,50.479826435492946,52.25675554402177,NaN,NaN,50
1671827400,1.0615,1.06178,1.06134,1.06162,1256,3219.8,-682005,-683079.8,9.679385951141354,51.32284766061303,52.46814612858862,NaN,NaN,50
1671829200,1.06162,1.06201,1.06148,1.0615,659,3161.5,-682664,-682626.8,9.32237838954609,50.39886924302457,52.657913204034045,NaN,NaN,50
1671831000,1.0615,1.06176,1.06126,1.06162,1429,3147.1,-681235,-682224.8,8.69000134783706,51.34225165039429,52.78547072522764,NaN,NaN,50
1672092000,1.06162,1.06374,1.06162,1.06372,114,3075.9,-681121,-682057.2,10.09750550258172,64.1812110601829,53.36919547254173,NaN,NaN,50
1672093800,1.06372,1.06373,1.06356,1.0637,137,2978.3,-681258,-681656.6,11.40447364627319,64.00798733509464,54.24965757257919,NaN,NaN,50
1672095600,1.0637,1.064,1.06312,1.06385,1274,2916.35,-679984,-681252.4,11.999634400688027,64.7758541230584,54.88857687915965,NaN,NaN,50
1672097400,1.06385,1.06458,1.06384,1.064,1062,2499.45,-678922,-680504,13.053161206871424,65.56696924251838,55.594514264013625,NaN,NaN,50
1672099200,1.064,1.06462,1.06348,1.06402,2086,2315.65,-676836,-679624.2,13.531897316493113,65.67765699286379,56.16266014344865,NaN,NaN,50
1672101000,1.06402,1.06448,1.06376,1.06427,1466,2073.8,-675370,-678474,13.976437989713256,67.1012894566808,57.038100689718014,NaN,NaN,50
1672102800,1.06427,1.06501,1.06427,1.06495,1296,1781.05,-674074,-677037.2,14.882720221044995,70.6654259645159,58.32519141636591,NaN,NaN,50
1672104600,1.06495,1.06536,1.06415,1.0652,1582,1586.5,-672492,-675538.8,16.026505718284863,71.87193636061014,60.12059268528599,NaN,NaN,50
1672106400,1.0652,1.06606,1.06448,1.06468,1362,1452.8,-673854,-674525.2,17.634201391130514,65.80897977323644,61.28109214539284,NaN,NaN,50
1672108200,1.06468,1.06502,1.06434,1.06475,1086,1350.1,-672768,-673711.6,18.89695453844149,66.22206304994498,62.10165488201649,NaN,NaN,50
1672110000,1.06475,1.06478,1.06394,1.06396,1186,1290.55,-673954,-673428.4,19.424131351211464,57.74315718075933,62.620464220964095,NaN,NaN,50
1672111800,1.06396,1.06418,1.06356,1.06402,1206,1244.2,-672748,-673163.2,19.33687096582275,58.18110114274591,63.110339469687865,NaN,NaN,50
1672113600,1.06402,1.06452,1.06392,1.06446,717,1189,-672031,-673071,19.594951737285395,61.34493732382139,63.89220147545907,NaN,NaN,50
1672115400,1.06446,1.0646,1.06418,1.06457,757,1147.35,-671274,-672555,19.914365678481076,62.116578306581836,64.66179623661533,NaN,NaN,50
1672117200,1.06457,1.065,1.06428,1.06462,813,1103.8,-670461,-672093.6,20.60361276145079,62.48318205573026,64.54050845058299,NaN,NaN,50
1672119000,1.06462,1.06573,1.06456,1.06556,1047,1091.85,-669414,-671185.6,21.870302592277074,68.62946041516845,64.87061367058827,NaN,NaN,50
1672120800,1.06556,1.06619,1.06532,1.0654,1309,1092.2,-670723,-670780.6,23.38979459609039,66.6285689695142,65.00295044533512,NaN,NaN,50
1672122600,1.0654,1.0665,1.06539,1.0664,1176,1088.2,-669547,-670283.8,25.01817215176341,72.10295951090151,65.46980689307676,NaN,NaN,50
1672124400,1.0664,1.0668,1.06546,1.06626,1873,1148.9,-671420,-670313,26.733365045777436,70.36269161064659,65.80445222291839,NaN,NaN,50
1672126200,1.06626,1.06646,1.06436,1.06456,1441,1149.5,-672861,-670793,26.488208742297164,53.482413867916236,64.8316753951495,NaN,NaN,50
1672128000,1.06456,1.0658,1.06384,1.0656,2738,1280.7,-670123,-670934.8,25.54901135187182,59.83125561154822,64.05780608422323,NaN,NaN,50
1672129800,1.0656,1.0656,1.06448,1.06518,2176,1382.65,-672299,-671250,24.676899489333998,56.47879715716865,62.95829614112027,NaN,NaN,50
1672131600,1.06518,1.06558,1.06481,1.06526,2120,1424.95,-670179,-671376.4,23.867081331263158,56.97333367448485,62.32717856263802,NaN,NaN,50
1672133400,1.06526,1.0664,1.06516,1.06606,1680,1455.85,-668499,-670792.2,23.964867131292092,61.66452367904637,62.001640036145254,NaN,NaN,50
1672135200,1.06606,1.06696,1.06518,1.06661,1992,1451.15,-666507,-669521.4,24.5453940047661,64.52796821580255,62.486269395791204,NaN,NaN,50
1672137000,1.06661,1.06672,1.06611,1.06658,1730,1464.35,-668237,-669144.2,25.084454672991967,64.24607943537673,62.91948213097912,NaN,NaN,50
1672138800,1.06658,1.06692,1.06614,1.06662,1336,1466.35,-666901,-668064.6,25.762512082304035,64.46895435953974,63.142626204959,NaN,NaN,50
1672140600,1.06662,1.0667,1.06526,1.06546,1843,1479.4,-668744,-667777.6,24.97162495628674,53.96338887714448,62.56025553142776,NaN,NaN,50
1672142400,1.06546,1.06576,1.06486,1.06488,1862,1504.4,-670606,-668199,23.684605926048867,49.61032013865247,61.640765394493634,NaN,NaN,50
1672144200,1.06488,1.06501,1.06322,1.06353,2276,1563.9,-672882,-669474,23.249420675340396,41.26618884051455,59.686245996304066,NaN,NaN,50
1672146000,1.06353,1.0636,1.06196,1.06291,3539,1681.55,-676421,-671110.8,23.784661546856505,38.09703796913562,57.64827949627702,NaN,NaN,50
1672147800,1.06291,1.0637,1.06252,1.06276,3615,1802,-680036,-673737.8,24.156009328549686,37.34969514665366,55.165903470259316,NaN,NaN,50
1672149600,1.06276,1.06297,1.06115,1.0621,3177,1925,-683213,-676631.6,25.341068827312892,34.17317678372616,52.580938125479285,NaN,NaN,50
1672151400,1.0621,1.06295,1.0614,1.06262,3854,2079.85,-679359,-678382.2,26.44148121902158,38.60365797431754,51.51816984736509,NaN,NaN,50
1672153200,1.06262,1.06546,1.06242,1.06492,3941,2236.25,-675418,-678889.4,24.8460747096333,53.508587250107674,51.06655067869077,NaN,NaN,50
1672155000,1.06492,1.06522,1.0642,1.06498,4235,2395.65,-671183,-677841.8,23.36462580805847,53.82351893342793,50.87688794842357,NaN,NaN,50
1672156800,1.06498,1.0654,1.06462,1.06511,2608,2460.6,-668575,-675549.6,21.831400097271736,54.54202506914731,50.703223048042325,NaN,NaN,50
1672158600,1.06511,1.06604,1.06494,1.06529,2564,2530,-666011,-672109.2,20.68265518161317,55.572819899531446,50.26810134950555,NaN,NaN,50
1672160400,1.06529,1.06532,1.06396,1.06428,2231,2547.9,-668242,-669885.8,19.62663809181506,48.875691655607426,49.1500815952059,NaN,NaN,50
1672162200,1.06428,1.06438,1.06337,1.06376,1638,2557.75,-669880,-668778.2,19.094048635325333,45.814465216470786,47.833537722426904,NaN,NaN,50
1672164000,1.06376,1.06414,1.06358,1.06401,1651,2503.4,-668229,-668187.4,18.599501282870584,47.51641742361063,46.622642227003396,NaN,NaN,50
1672165800,1.06401,1.06515,1.06388,1.06488,1598,2474.5,-666631,-667798.6,17.337972391927796,53.04381528429747,46.55695839894289,NaN,NaN,50
1672167600,1.06488,1.06566,1.06442,1.06444,1938,2465.4,-668569,-668310.2,16.58934677141337,50.166238636872194,46.59666686310145,NaN,NaN,50
1672169400,1.06444,1.06446,1.06376,1.06416,2049,2483.85,-670618,-668785.4,15.501333184723082,48.36802798599896,47.1039410877789,NaN,NaN,50
1672171200,1.06416,1.06469,1.06395,1.0641,2005,2484.5,-672623,-669334,14.500163519814043,47.97121339573009,47.80923933253565,NaN,NaN,50
1672173000,1.0641,1.0644,1.06385,1.06412,1569,2476.45,-671054,-669899,13.476565505190688,48.12399083903298,48.57883188199132,NaN,NaN,50
1672174800,1.06412,1.06416,1.06394,1.0641,488,2434.05,-671542,-670881.2,12.526081634469,47.972289062869066,49.56448275907295,NaN,NaN,50
1672176600,1.0641,1.06411,1.06364,1.0638,475,2365.65,-672017,-671570.8,11.927925442056452,45.64781366419644,50.06763673692144,NaN,NaN,50
1672178400,1.0638,1.06454,1.0638,1.06438,67,2275.9,-671950,-671837.2,11.24386877768239,50.62863609753038,49.86192594030878,NaN,NaN,50
1672180200,1.06438,1.0644,1.06418,1.06422,98,2167,-672048,-671722.2,10.608673303620765,49.28682446967646,49.53787633575511,NaN,NaN,50
1672182000,1.06422,1.06422,1.06308,1.06377,1129,2046.5,-673177,-672146.8,10.825585942508257,45.62439198445604,48.90090254399144,NaN,NaN,50
1672183800,1.06377,1.06391,1.06355,1.06372,613,1896.4,-673790,-672596.4,11.027004821475213,45.22229247963485,48.16157915685598,NaN,NaN,50
1672185600,1.06372,1.06429,1.06284,1.06284,2197,1847.4,-675987,-673390.4,11.860100287547645,38.749395035064694,47.43827225538864,NaN,NaN,50
1672187400,1.06284,1.06292,1.0625,1.06284,1912,1750.3,-675987,-674197.8,12.916685938548781,38.749395035064694,46.93362438528821,NaN,NaN,50
1672189200,1.06284,1.06385,1.06272,1.06384,2350,1670.75,-673637,-674515.6,12.711242401522425,48.46999424756561,47.001737015570704,NaN,NaN,50
1672191000,1.06384,1.06432,1.0637,1.06422,2003,1559.15,-671634,-674207,11.99677302983894,51.61255461319496,46.899504110491954,NaN,NaN,50
1672192800,1.06422,1.06422,1.06371,1.06386,1873,1522.4,-673507,-674150.4,11.333337184704275,48.58934624384823,46.786868939561664,NaN,NaN,50
1672194600,1.06386,1.06406,1.06354,1.06367,1419,1465.15,-674926,-673938.2,10.906242302492423,47.02379884736565,46.69085257251643,NaN,NaN,50
1672196400,1.06367,1.06424,1.06354,1.06392,1068,1407,-673858,-673512.4,10.283357614050972,49.33686633524016,46.78839921105287,NaN,NaN,50
1672198200,1.06392,1.06394,1.0632,1.06378,1812,1415.7,-675670,-673919,10.107713513961894,48.07106955325104,46.7846191192113,NaN,NaN,50
1672200000,1.06378,1.0643,1.06372,1.06409,1258,1396.05,-674412,-674474.6,9.469597291962135,51.064926287446326,47.005521778109674,NaN,NaN,50
1672201800,1.06409,1.06449,1.06362,1.06418,1327,1382.5,-673085,-674390.2,8.954090977255287,51.931386707450464,47.454348424056384,NaN,NaN,50
1672203600,1.06418,1.0647,1.06406,1.06462,1410,1356.1,-671675,-673740,8.745962750988742,56.03036996041011,47.840186557119225,NaN,NaN,50
1672205400,1.06462,1.0647,1.06432,1.0646,1164,1311.85,-672839,-673536.2,8.552700826598379,55.79745844004904,48.30523184071727,NaN,NaN,50
1672207200,1.0646,1.06526,1.06444,1.06506,1244,1273.8,-671595,-672721.2,9.091490478755643,59.92381172286517,49.32661896488935,NaN,NaN,50
1672209000,1.06506,1.06506,1.06454,1.06463,1380,1264.35,-672975,-672433.8,9.591795155758819,54.7761935715364,50.00904047145374,NaN,NaN,50
1672210800,1.06463,1.06548,1.0644,1.06528,2026,1341.25,-670949,-672006.6,10.566741777824081,60.324482593466406,51.55011815419672,NaN,NaN,50
1672212600,1.06528,1.06543,1.06444,1.06457,2023,1418.65,-672972,-672266,11.472049355456113,52.7165199566017,52.547769934306515,NaN,NaN,50
1672214400,1.06457,1.06481,1.06408,1.06442,3092,1569.9,-676064,-672911,11.625633349676102,51.24606119295422,52.7460604304057,NaN,NaN,50
1672216200,1.06442,1.0646,1.06343,1.0636,2194,1674.7,-678258,-674243.6,10.891601404390752,44.01768721384724,52.20356990188086,NaN,NaN,50
1672218000,1.0636,1.06378,1.06278,1.06312,2346,1735.55,-680604,-675769.4,11.085646143797913,40.42330687540795,51.6202813755637,NaN,NaN,50
1672219800,1.06312,1.064,1.06302,1.06372,2070,1808.4,-678534,-677286.4,10.914195015810009,46.32361590221633,51.57026830805303,NaN,NaN,50
1672221600,1.06372,1.06413,1.06342,1.06402,1847,1790.9,-676687,-678029.4,10.546663331322213,49.04113615292158,51.549144723601714,NaN,NaN,50
1672223400,1.06402,1.06433,1.06294,1.0634,2203,1805.45,-678890,-678594.6,10.854347529162197,44.07481137144024,51.263697710615226,NaN,NaN,50
1672225200,1.0634,1.06454,1.06314,1.06418,2085,1792.2,-676805,-678304,10.783569184762207,50.82213937656716,51.24635578840957,NaN,NaN,50
1672227000,1.06418,1.06522,1.06385,1.06466,2659,1825,-674146,-677012.4,10.341417136856439,54.46312455552658,51.42719420612929,NaN,NaN,50
1672228800,1.06466,1.06495,1.06368,1.06477,2302,1846.45,-671844,-675674.4,9.675222636058708,55.280242689060024,51.37361368674714,NaN,NaN,50
1672230600,1.06477,1.06577,1.06462,1.06462,2984,1924.7,-674828,-675302.6,10.123628956030494,53.86092796068204,51.23529008107807,NaN,NaN,50
1672232400,1.06462,1.06499,1.06381,1.06414,2776,2010.1,-677604,-675045.4,9.406735812382399,49.482714367705654,50.48949741285238,NaN,NaN,50
1672234200,1.06414,1.0645,1.06338,1.06417,2719,2055.45,-674885,-674661.4,9.264083101781372,49.757603871600885,50.13102671999985,NaN,NaN,50
1672236000,1.06417,1.06576,1.06394,1.06536,2777,2131.4,-672108,-674253.8,9.514172766378001,59.23370670554519,50.05311415657691,NaN,NaN,50
1672237800,1.06536,1.06746,1.06526,1.06574,4894,2309.75,-667214,-673327.8,11.082356764343125,61.71677817620074,50.69598974369113,NaN,NaN,50
1672239600,1.06574,1.06619,1.06411,1.06418,4743,2476.4,-671957,-672753.6,11.269915154985132,48.62322678607985,50.50864442891439,NaN,NaN,50
1672241400,1.06418,1.06426,1.06115,1.06186,5683,2702.35,-677640,-672760.8,11.69856767553035,36.29185381482675,49.956799186127206,NaN,NaN,50
1672243200,1.06186,1.06256,1.0613,1.06172,3698,2825.05,-681338,-674051.4,12.096602158893766,35.70341388435344,49.61966397248045,NaN,NaN,50
1672245000,1.06172,1.06275,1.06164,1.06214,2589,2885.5,-678749,-675379.6,12.299690868063342,38.903875222843844,49.08968249538241,NaN,NaN,50
1672246800,1.06214,1.0633,1.0616,1.06291,2267,2897.55,-676482,-677233.2,12.009186813346599,44.370920410371376,48.75609565662883,NaN,NaN,50
1672248600,1.06291,1.06297,1.06203,1.06292,2430,2917.9,-674052,-677652.2,11.739433048252481,44.440453519531914,48.78221295292109,NaN,NaN,50
1672250400,1.06292,1.06358,1.06284,1.0633,2484,2887.5,-671568,-676437.8,10.949181622423085,47.14410961116346,48.51949654110655,NaN,NaN,50
1672252200,1.0633,1.06344,1.062,1.062,2133,2884.45,-673701,-674910.4,10.881029360700165,39.97695313761001,47.48477001125536,NaN,NaN,50
1672254000,1.062,1.06276,1.0616,1.06252,2275,2880.9,-671426,-673445.8,11.112876671961407,43.66616375602175,46.655192944609766,NaN,NaN,50
1672255800,1.06252,1.06264,1.06148,1.06172,2031,2878.95,-673457,-672840.8,11.417806889635576,39.630488894646646,45.63873301132152,NaN,NaN,50
1672257600,1.06172,1.06178,1.06098,1.0611,1958,2884.5,-675415,-673113.4,12.072930271235748,36.79246285196831,44.73228647448314,NaN,NaN,50
1672259400,1.0611,1.06136,1.06081,1.06082,1574,2853.05,-676989,-674197.6,12.80625990477319,35.55415580927426,43.71775447003124,NaN,NaN,50
1672261200,1.06082,1.06128,1.06067,1.06128,865,2792.05,-676124,-674682.2,13.593547826525842,39.1759935515486,42.2850606733172,NaN,NaN,50
1672263000,1.06128,1.06132,1.06106,1.06122,529,2685.55,-676653,-675727.6,14.272735831561395,38.869149847299234,40.653087221252804,NaN,NaN,50
1672264800,1.06122,1.06146,1.06097,1.06138,57,2573.3,-676596,-676355.4,14.713267911523682,40.2139279665482,40.05242301985768,NaN,NaN,50
1672266600,1.06138,1.06166,1.06124,1.06162,558,2452,-676038,-676480,14.845346993320868,42.26556742355561,40.47911684905261,NaN,NaN,50
1672268400,1.06162,1.0625,1.06158,1.06248,2123,2419.35,-673915,-675865.2,13.909627329544087,49.01703249218103,41.43008960675458,NaN,NaN,50
1672270200,1.06248,1.06293,1.06223,1.0629,1139,2340.35,-672776,-675195.6,13.2673575438781,51.97097742007456,42.36345404941392,NaN,NaN,50
1672272000,1.0629,1.06293,1.06237,1.06248,1488,2275.9,-674264,-674717.8,12.670964171473969,48.91861485496815,42.688289366885115,NaN,NaN,50
1672273800,1.06248,1.06374,1.06234,1.06341,1303,2096.35,-672961,-673990.8,12.96722621414364,55.19386520420621,43.45639020150471,NaN,NaN,50
1672275600,1.06341,1.06342,1.0627,1.06308,1983,1958.35,-674944,-673772,13.242326682336905,52.719001741466286,43.85459678224063,NaN,NaN,50
1672277400,1.06308,1.06333,1.0628,1.06282,1880,1768.2,-676824,-674353.8,13.497777117087791,50.78678753976248,44.62672781096581,NaN,NaN,50
1672279200,1.06282,1.0633,1.06282,1.06292,1225,1644.55,-675599,-674918.4,13.734981092213616,51.52271951961006,45.18791036550783,NaN,NaN,50
1672281000,1.06292,1.06297,1.06256,1.06256,1244,1577.3,-676843,-675434.2,13.527451382768676,48.699358680526295,45.83568677878494,NaN,NaN,50
1672282800,1.06256,1.0628,1.06214,1.06237,1381,1533,-678224,-676486.8,12.686510394293832,47.22837979492665,46.58110941756769,NaN,NaN,50
1672284600,1.06237,1.06244,1.062,1.06233,1222,1472.6,-679446,-677387.2,11.862569899882063,46.907151838839965,47.39203770539381,NaN,NaN,50
1672286400,1.06233,1.06235,1.06195,1.06208,803,1388.55,-680249,-678072.2,11.174185221025157,44.853750906157636,47.7975918021516,NaN,NaN,50
1672288200,1.06208,1.06262,1.06192,1.06254,829,1323.35,-679420,-678836.4,10.650970349783798,49.25550831635358,48.5394745499412,NaN,NaN,50
1672290000,1.06254,1.06291,1.06232,1.06256,919,1255.55,-678501,-679168,10.606818032328162,49.44445348123746,49.19879780099044,NaN,NaN,50
1672291800,1.06256,1.0627,1.06214,1.06249,1059,1206.95,-679560,-679435.2,10.241877924124289,48.760125312416704,49.662694793051934,NaN,NaN,50
1672293600,1.06249,1.0627,1.06186,1.06196,1247,1171.4,-680807,-679707.4,9.604324717991924,43.815461803999874,49.29115402961043,NaN,NaN,50
1672295400,1.06196,1.06198,1.06112,1.06142,1515,1168.45,-682322,-680122,10.106859345378929,39.428309968519876,48.39524921164224,NaN,NaN,50
1672297200,1.06142,1.062,1.06122,1.06158,1733,1211.85,-680589,-680355.8,10.53601341688576,41.30363849055819,47.8513223284701,NaN,NaN,50
1672299000,1.06158,1.0625,1.06132,1.06234,1691,1269.95,-678898,-680435.2,10.038388031883924,49.32869421492675,47.432381543521565,NaN,NaN,50
1672300800,1.06234,1.06422,1.06225,1.06387,2913,1412.75,-675985,-679720.2,11.181085710176937,60.91427006139547,48.01775785208793,NaN,NaN,50
1672302600,1.06387,1.06428,1.06295,1.06303,2473,1508.5,-678458,-679250.4,12.29829281075316,53.660220474409506,48.22300306170558,NaN,NaN,50
1672304400,1.06303,1.06444,1.06303,1.06363,2473,1526,-675985,-677983,13.490460608062554,57.54894034095271,48.653447406087196,NaN,NaN,50
1672306200,1.06363,1.06582,1.06354,1.06563,2582,1598.15,-673403,-676545.8,15.691526790610673,67.37651717592321,49.98753015575841,NaN,NaN,50
1672308000,1.06563,1.06565,1.06394,1.06414,2424,1644.95,-675827,-675931.6,17.73537396011964,56.82247111802706,50.67282239312272,NaN,NaN,50
1672309800,1.06414,1.06418,1.06316,1.06362,2139,1686.75,-677966,-676327.8,18.35637171139057,53.66318725322277,51.155396351292914,NaN,NaN,50
1672311600,1.06362,1.06393,1.06327,1.06354,1445,1659.85,-679411,-676518.4,18.933012480427863,53.17337003712771,51.74965486064792,NaN,NaN,50
1672313400,1.06354,1.0641,1.06336,1.06382,1709,1651.3,-677702,-676861.8,19.628015446519072,54.7308159611362,52.140748263846675,NaN,NaN,50
1672315200,1.06382,1.06424,1.06366,1.06398,1787,1679.4,-675915,-677364.2,20.406983568977697,55.63878315725812,52.58320038356244,NaN,NaN,50
1672317000,1.06398,1.06534,1.06377,1.06525,2144,1724.4,-673771,-676953,22.031297974944625,62.13134115381092,53.53828722937631,NaN,NaN,50
1672318800,1.06525,1.06542,1.06451,1.06462,2975,1804.1,-676746,-676709,23.596533268452692,57.62576241736938,54.52473727318842,NaN,NaN,50
1672320600,1.06462,1.06672,1.06455,1.0655,5020,1994,-671726,-675172,25.838903139045943,61.79353071677482,56.12225304092092,NaN,NaN,50
1672322400,1.0655,1.0663,1.06486,1.06578,4244,2166.05,-667482,-673128,27.921103733168245,63.039200887179106,57.67479321210812,NaN,NaN,50
1672324200,1.06578,1.06702,1.06391,1.06447,5487,2398.95,-672969,-672538.8,28.270381249235733,54.14472681493493,58.01879554068013,NaN,NaN,50
1672326000,1.06447,1.06547,1.06365,1.06526,4717,2588.85,-668252,-671435,28.21079731546084,57.99385910875916,57.81019475834897,NaN,NaN,50
1672327800,1.06526,1.06698,1.06498,1.06669,4688,2770.3,-663564,-668798.6,29.202397219436172,63.90082495389329,58.54166650688352,NaN,NaN,50
1672329600,1.06669,1.0671,1.0657,1.06632,3749,2895.4,-667313,-667916,30.193455064414206,61.49138386636363,58.823269615841454,NaN,NaN,50
1672331400,1.06632,1.06708,1.0663,1.06662,2504,2944.85,-664809,-667381.4,31.11372306332238,62.71883315288212,58.490577899909944,NaN,NaN,50
1672333200,1.06662,1.06708,1.06647,1.06692,1767,2946.55,-663042,-665396,31.968257633737114,63.9560965002073,59.00012257006567,NaN,NaN,50
1672335000,1.06692,1.06906,1.06658,1.0682,2585,2991.25,-660457,-663837,33.81631199237705,68.72523661378646,60.07598323867736,NaN,NaN,50
1672336800,1.0682,1.06834,1.0674,1.06772,2573,2974.25,-663030,-663730.2,35.53236246825699,65.23919316267992,60.93782774764538,NaN,NaN,50
1672338600,1.06772,1.068,1.06712,1.06749,1852,2943.2,-664882,-663244,36.66582019985458,63.57511026833798,61.569563055302645,NaN,NaN,50
1672340400,1.06749,1.06794,1.06743,1.06759,1755,2907.3,-663127,-662907.6,37.71831666490947,64.00500814691426,62.16715055456381,NaN,NaN,50
1672342200,1.06759,1.0679,1.06735,1.0678,1917,2874.05,-661210,-662541.2,38.5513729055783,64.94078693837966,62.36782525346158,NaN,NaN,50
1672344000,1.0678,1.0678,1.06657,1.06696,2220,2863.85,-663430,-663135.8,38.014001044829044,58.40056018085273,62.42316795085325,NaN,NaN,50
1672345800,1.06696,1.06724,1.06667,1.0668,1736,2843.7,-665166,-663563,37.51501288841902,57.21850661426906,62.09638051495998,NaN,NaN,50
1672347600,1.0668,1.06715,1.06636,1.06641,1211,2832,-666377,-663862,36.550063802849984,54.331794328491846,61.474422903625175,NaN,NaN,50
1672349400,1.06641,1.06641,1.06602,1.0661,507,2771.9,-666884,-664613.4,35.126710293204376,52.08252836648929,61.327123014450486,NaN,NaN,50
1672351200,1.0661,1.0664,1.0661,1.06618,45,2684.8,-666839,-665739.2,33.805024891390595,52.62756469572631,60.943816270662424,NaN,NaN,50
1672353000,1.06618,1.0663,1.06598,1.0661,435,2599.35,-667274,-666508,32.37957460641291,51.990707634416374,60.0930936049855,NaN,NaN,50
1672354800,1.0661,1.0662,1.06544,1.06554,775,2489.35,-668049,-667084.6,30.215333059166618,47.64437416021281,59.10402148311759,NaN,NaN,50
1672356600,1.06554,1.06608,1.06554,1.06604,672,2271.95,-667377,-667284.6,28.20568019386649,51.53975216503705,58.30551569827151,NaN,NaN,50
1672358400,1.06604,1.06668,1.06602,1.06609,1098,2114.65,-666279,-667163.6,27.161731113462366,51.92495602106098,57.44614852118963,NaN,NaN,50
1672360200,1.06609,1.06684,1.06592,1.06683,1107,1895.65,-665172,-666830.2,26.39389908535928,57.33082637187956,56.632262075339135,NaN,NaN,50
1672362000,1.06683,1.06698,1.06572,1.06615,1538,1736.7,-666710,-666717.4,25.330782671796232,51.590012754660236,55.65732061762344,NaN,NaN,50
1672363800,1.06615,1.06636,1.06588,1.06606,1615,1583.05,-668325,-666772.6,24.34360314491626,50.864049797144375,54.7493877268239,NaN,NaN,50
1672365600,1.06606,1.06606,1.0655,1.06572,1308,1461,-669633,-667223.8,22.75064567648422,48.10979914615201,53.614015655340886,NaN,NaN,50
1672367400,1.06572,1.06596,1.06552,1.06588,842,1377.9,-668791,-667726.2,21.271470884368753,49.49574493635972,52.510798369482316,NaN,NaN,50
1672369200,1.06588,1.06614,1.06573,1.06614,773,1328.2,-668018,-668295.4,20.20978043475674,51.75095828135825,52.03582680523271,NaN,NaN,50
1672371000,1.06614,1.06633,1.06574,1.06592,811,1239.5,-668829,-668719.2,19.546269613698566,49.72751768127157,51.50075616716146,NaN,NaN,50
1672372800,1.06592,1.06592,1.06551,1.06585,738,1147.75,-669567,-668967.6,18.461580423480157,49.07008854430864,51.124920039719804,NaN,NaN,50
1672374600,1.06585,1.06596,1.06516,1.06553,628,1086.55,-670195,-669080,17.49006649770994,46.07147235889126,50.69555889631994,NaN,NaN,50
1672376400,1.06553,1.06569,1.06545,1.06564,877,1042.65,-669318,-669185.4,16.58794642378045,47.26445699756086,50.3124797750224,NaN,NaN,50
1672378200,1.06564,1.0658,1.06423,1.06434,1390,1016.3,-670708,-669723.4,17.5387867645499,36.880769439353514,49.233198475375055,NaN,NaN,50
1672380000,1.06434,1.06505,1.0641,1.0643,1765,993.55,-672473,-670452.2,18.568500797690703,36.61422592568617,48.44533074433745,NaN,NaN,50
1672381800,1.0643,1.06478,1.06406,1.06446,1360,974.75,-671113,-670761.4,19.571424382921677,38.5279978472285,47.51591972163682,NaN,NaN,50
1672383600,1.06446,1.06494,1.0642,1.06423,1449,986.65,-672562,-671234.8,20.125776416692904,36.807601789968224,46.4361087051302,NaN,NaN,50
1672385400,1.06423,1.06514,1.06386,1.06512,2072,1064.9,-670490,-671469.2,21.07376757136425,46.72162289444456,45.67830845674199,NaN,NaN,50
1672387200,1.06512,1.06641,1.06499,1.06593,3132,1219.25,-667358,-670799.2,19.57800115796619,53.822260760729236,45.83775474288977,NaN,NaN,50
1672389000,1.06593,1.06747,1.06593,1.06712,2705,1332.75,-664653,-669235.2,19.50371850620761,61.86366594660277,46.62344161070822,NaN,NaN,50
1672390800,1.06712,1.06714,1.06569,1.06574,2718,1429.9,-667371,-668486.8,19.070622374952013,50.812948319844004,46.81652369454337,NaN,NaN,50
1672392600,1.06574,1.0666,1.06515,1.06548,2374,1515,-669745,-667923.4,17.90379553194933,49.03570773368295,46.78366389435217,NaN,NaN,50
1672394400,1.06548,1.06684,1.06534,1.06684,2043,1562.25,-667702,-667365.8,17.12055896604501,57.42421581648464,47.18889657543263,NaN,NaN,50
1672396200,1.06684,1.06762,1.06644,1.06698,2136,1613.7,-665566,-667007.4,17.26661302897761,58.187176287631935,47.793157904458376,NaN,NaN,50
1672398000,1.06698,1.06894,1.06696,1.06884,2209,1647.25,-663357,-666748.2,18.517684102317208,66.7199924678,49.05386532756489,NaN,NaN,50
1672399800,1.06884,1.0699,1.06755,1.06762,3058,1719.4,-666415,-666557,20.2916202095864,58.314028787964794,49.92833364392728,NaN,NaN,50
1672401600,1.06762,1.06812,1.0672,1.06784,2549,1781.45,-663866,-665381.2,21.436412017189927,59.30959705346551,50.788700790777625,NaN,NaN,50
1672403400,1.06784,1.0688,1.06716,1.06723,2984,1888.55,-666850,-665210.8,22.922946027411697,55.36155951356624,52.108757224649956,NaN,NaN,50
1672405200,1.06723,1.06804,1.06474,1.0649,3988,2049.3,-670838,-666265.2,21.631135147035444,43.46101282707113,52.59781343189174,NaN,NaN,50
1672407000,1.0649,1.06698,1.06454,1.06688,3710,2194.25,-667128,-667019.4,20.26032490839547,52.755113269281026,53.61403596203835,NaN,NaN,50
1672408800,1.06688,1.06793,1.06616,1.06762,4195,2367.1,-662933,-666323,19.717336206273835,55.68696526944117,54.96256192485784,NaN,NaN,50
1672410600,1.06762,1.07012,1.06728,1.06884,6954,2683.4,-655979,-664745.6,20.500607028347293,60.08479480615788,55.91707420426593,NaN,NaN,50
1672412400,1.06884,1.06896,1.06704,1.06744,5252,2902.15,-661231,-663621.8,21.00598841544121,53.52060943467653,55.89552768097645,NaN,NaN,50
1672414200,1.06744,1.06858,1.06594,1.06722,7194,3192.35,-668425,-663139.2,20.518161768696004,52.54906959530678,55.23019937016959,NaN,NaN,50
1672416000,1.06722,1.06888,1.06712,1.06848,4795,3343.85,-663630,-662439.6,20.24862992865167,57.32685622464048,55.695478506226486,NaN,NaN,50
1672417800,1.06848,1.06972,1.0681,1.06968,2708,3411.25,-660922,-662037.4,20.490554211637527,61.32124130276514,56.57301661830378,NaN,NaN,50
1672419600,1.06968,1.07078,1.06964,1.07017,2888,3483.2,-658034,-662448.4,21.266695816235888,62.850387797881005,56.96060033126067,NaN,NaN,50
1672421400,1.07017,1.07116,1.07017,1.07109,3586,3558.9,-654448,-661091.8,22.171596509452087,65.60023446967134,57.490104487120625,NaN,NaN,50
1672423200,1.07109,1.07118,1.07005,1.0707,4873,3645.95,-659321,-659271,22.891177580119496,63.455923218936974,57.25695668363041,NaN,NaN,50
1672425000,1.0707,1.07133,1.07022,1.07024,3091,3665.25,-662412,-659027.4,23.640171361144272,60.92624795411613,57.44354376692694,NaN,NaN,50
1672426800,1.07024,1.07028,1.06952,1.06992,2509,3654.8,-664921,-659827.2,23.598080695871367,59.15942362304946,57.4328170933258,NaN,NaN,50
1672428600,1.06992,1.07095,1.06984,1.06998,2384,3655.3,-662537,-660727.8,23.965207006520206,59.39717941046332,57.721075657389875,NaN,NaN,50
1672430400,1.06998,1.07033,1.06923,1.0703,2395,3672.9,-660142,-661866.6,23.684795748060456,60.71087576383642,58.95320872430169,NaN,NaN,50
1672432200,1.0703,1.07084,1.07005,1.07055,2326,3682.4,-657816,-661565.6,23.751948906014743,61.75204592502427,59.59584677114049,NaN,NaN,50
1672434000,1.07055,1.07076,1.07004,1.07045,1235,3633.7,-659051,-660893.4,23.80353887688254,61.05507317968793,59.979283050443826,NaN,NaN,50
1672435800,1.07045,1.07047,1.06974,1.07039,1397,3550.65,-660448,-659998.8,23.517087861830348,60.613028303529966,60.01701401454183,NaN,NaN,50
1672614000,1.07039,1.07039,1.06962,1.07,13,3423.85,-660461,-659583.6,23.1146934557336,57.68929421990532,60.31477721348675,NaN,NaN,50
1672615800,1.07,1.07062,1.07,1.07057,12,3275.25,-660449,-659645,22.9278930202997,60.67492679110295,60.895195584615045,NaN,NaN,50
1672617600,1.07057,1.07057,1.06983,1.07,15,3076.6,-660464,-660174.6,22.541581213899743,56.389729838350284,60.828257985594306,NaN,NaN,50
1672619400,1.07,1.07089,1.06937,1.07072,61,2894.15,-660403,-660445,21.618602104942124,60.212277674165655,60.749046297837204,NaN,NaN,50
1672621200,1.07072,1.0709,1.07064,1.07069,25,2685.65,-660428,-660441,20.77169355287813,59.97638314671731,60.543760251325516,NaN,NaN,50
1672623000,1.07069,1.07069,1.0694,1.06985,48,2340.35,-660476,-660444,19.95044807427097,53.639701653282536,59.689436478726314,NaN,NaN,50
1672624800,1.06985,1.06985,1.069,1.06952,25,2079,-660501,-660454.4,19.556114818800662,51.34463140182428,58.824344206075416,NaN,NaN,50
1672626600,1.06952,1.06956,1.06929,1.06951,10,1719.8,-660511,-660463.8,19.189948224435376,51.27303858842289,58.13482925138304,NaN,NaN,50
1672628400,1.06951,1.06956,1.06951,1.06956,3,1480.2,-660508,-660484.8,18.84993638681047,51.636158335538646,57.597453159417974,NaN,NaN,50
1672630200,1.06956,1.07034,1.06924,1.06958,80,1348.8,-660428,-660484.8,17.54052815991441,51.790916683748165,57.05414867893832,NaN,NaN,50
1672632000,1.06958,1.07041,1.06947,1.07035,37,1206.25,-660391,-660467.8,16.333998782148683,57.437730689917295,56.82035260222982,NaN,NaN,50
1672633800,1.07035,1.07035,1.07012,1.07024,7,1027.3,-660398,-660447.2,15.213650074223365,56.42100896996412,56.43956424829695,NaN,NaN,50
1672635600,1.07024,1.07024,1.06891,1.06933,81,787.7,-660479,-660440.8,15.438261575122251,48.7353316820868,55.559582712754015,NaN,NaN,50
1672637400,1.06933,1.07008,1.06852,1.06968,355,650.9,-660124,-660364,16.005574119129975,51.4733296733517,54.906747096312706,NaN,NaN,50
1672639200,1.06968,1.07011,1.06939,1.06945,182,534.55,-660306,-660339.6,16.487680164263335,49.59864070905151,54.32884327410887,NaN,NaN,50
1672641000,1.06945,1.06976,1.06783,1.06922,610,445.85,-660916,-660444.6,18.15552165930111,47.7266960125092,53.40396964706646,NaN,NaN,50
1672642800,1.06922,1.06935,1.06716,1.0681,99,331.05,-661015,-660568,20.102997359134527,39.8411772051442,52.221930173266024,NaN,NaN,50
1672644600,1.0681,1.06851,1.06636,1.06786,1565,293,-662580,-660988.2,22.32696110613396,38.37789544462072,50.66233144258424,NaN,NaN,50
1672646400,1.06786,1.06813,1.06712,1.06768,1025,282.5,-663605,-661684.4,24.39207029977629,37.2722216319418,49.04060562010027,NaN,NaN,50
1672648200,1.06768,1.06985,1.06753,1.06798,1168,271.05,-662437,-662110.6,24.041175763658888,40.35642473754426,48.091800126118976,NaN,NaN,50
1672650000,1.06798,1.07001,1.06792,1.06843,1916,366.2,-660521,-662031.6,23.53951063633868,44.74506589328876,47.620402589795006,NaN,NaN,50
1672651800,1.06843,1.06848,1.06772,1.06791,1247,427.95,-661768,-662182.2,23.233637671115304,40.991565857125636,46.88601168041663,NaN,NaN,50
1672653600,1.06791,1.06898,1.06784,1.06824,710,462.7,-661058,-661877.8,22.372616891801847,44.19112275431254,46.35422342461476,NaN,NaN,50
1672655400,1.06824,1.06872,1.0675,1.06841,739,496.6,-660319,-661220.6,21.872924229601722,45.820896169379644,45.927793387874146,NaN,NaN,50
1672657200,1.06841,1.06856,1.06804,1.06821,564,523.55,-660883,-660909.8,21.40892390041589,44.18605730716987,44.981245289106475,NaN,NaN,50
1672659000,1.06821,1.06866,1.06796,1.06848,510,546.65,-660373,-660880.2,20.84732283928995,46.938446154952224,44.303919373748485,NaN,NaN,50
1672660800,1.06848,1.06872,1.06771,1.06844,620,576.4,-660993,-660725.2,20.578791692514784,46.57203121098929,44.14939791152723,NaN,NaN,50
1672662600,1.06844,1.06876,1.06784,1.06824,843,618.05,-661836,-660880.8,20.27082432087231,44.6933957746118,43.6651169187601,NaN,NaN,50
1672664400,1.06824,1.06865,1.06778,1.06846,1004,668.1,-660832,-660983.4,20.05181126741078,47.21571107424793,43.49490765913127,NaN,NaN,50
1672666200,1.06846,1.06856,1.06767,1.0679,793,703.75,-661625,-661131.8,19.97633176111248,41.968850926236975,43.083633010111825,NaN,NaN,50
1672668000,1.0679,1.06822,1.06788,1.0681,711,737.45,-660914,-661240,19.906243648121198,44.34746801060836,43.40551092478783,NaN,NaN,50
1672669800,1.0681,1.0682,1.06702,1.06726,639,769.05,-661553,-661352,20.78970267325848,37.411562278082236,43.33648712717794,NaN,NaN,50
1672671600,1.06726,1.06738,1.0665,1.06664,846,807.3,-662399,-661464.6,22.07664857671524,33.27491582073263,43.05096528352015,NaN,NaN,50
1672673400,1.06664,1.0669,1.06586,1.06606,852,832.15,-663251,-661948.4,23.767120389520873,29.939789480121334,42.306919907989936,NaN,NaN,50
1672675200,1.06606,1.06718,1.06533,1.06544,1940,920.05,-665191,-662661.6,25.69264743075039,26.84259674871032,41.028172111948614,NaN,NaN,50
1672677000,1.06544,1.0658,1.06516,1.06554,940,936.55,-664251,-663329,27.588826513267676,28.133924289514212,40.109769142833514,NaN,NaN,50
1672678800,1.06554,1.06621,1.0655,1.06601,957,979.45,-663294,-663677.2,28.545588903072854,34.02805747620906,39.383835908683274,NaN,NaN,50
1672680600,1.06601,1.06618,1.06592,1.0661,544,928.4,-662750,-663747.4,29.434011122177665,35.12529523375167,38.61986441328128,NaN,NaN,50
1672682400,1.0661,1.06614,1.06526,1.06526,652,909.75,-663402,-663777.6,30.770262494981814,30.094366774984977,37.61331508955379,NaN,NaN,50
1672684200,1.06526,1.0656,1.06526,1.06528,197,861.2,-663205,-663380.4,32.0110673411571,30.35015685279471,36.42843728225682,NaN,NaN,50
1672686000,1.06528,1.06547,1.06504,1.06532,767,803.75,-662438,-663017.8,33.32914822096479,30.894781191306578,35.308633709422345,NaN,NaN,50
1672687800,1.06532,1.06614,1.06526,1.06579,338,758.3,-662100,-662779,33.176548507626144,37.11683607384766,34.76745087365348,NaN,NaN,50
1672689600,1.06579,1.06641,1.06572,1.06619,237,734.65,-661863,-662601.6,32.54139832869613,41.91049860261316,34.38850712567956,NaN,NaN,50
1672691400,1.06619,1.0671,1.06619,1.06658,210,708.2,-661653,-662251.8,30.827930155091916,46.215556993774385,34.69184327336081,NaN,NaN,50
1672693200,1.06658,1.06744,1.06654,1.06683,57,682.85,-661596,-661930,28.748818049706266,48.83331079530987,35.01226061512521,NaN,NaN,50
1672695000,1.06683,1.06683,1.06616,1.06638,26,658.65,-661622,-661766.8,27.312579035377283,44.623231022529026,35.52737981115712,NaN,NaN,50
1672696800,1.06638,1.06689,1.06638,1.06662,100,632.65,-661522,-661651.2,25.887103179199066,47.23596714012369,36.52459776254219,NaN,NaN,50
1672698600,1.06662,1.0668,1.0665,1.06674,151,598.05,-661371,-661552.8,24.56344702703358,48.543236524529036,37.853415408571315,NaN,NaN,50
1672700400,1.06674,1.06835,1.06502,1.06644,2901,692.9,-664272,-662076.6,24.29053344152444,45.50769198058104,39.18663649656208,NaN,NaN,50
1672702200,1.06644,1.06776,1.0664,1.06768,1826,744.55,-662446,-662246.6,24.037113683551663,57.372973229676056,41.275139992287926,NaN,NaN,50
1672704000,1.06768,1.06785,1.06668,1.06688,2002,809.1,-664448,-662811.8,23.899848591785695,49.833858776513615,42.40412579945254,NaN,NaN,50
1672705800,1.06688,1.06752,1.06682,1.06706,1436,848.95,-663012,-663109.8,23.77238814943158,51.38188494599967,43.56531077889883,NaN,NaN,50
1672707600,1.06706,1.06744,1.06551,1.06562,3761,994.7,-666773,-664190.2,22.468023015470145,40.59070633498155,44.31504931889857,NaN,NaN,50
1672709400,1.06562,1.066,1.06506,1.066,2857,1094.95,-663916,-664119,21.778057773110486,43.93683217804969,45.28552612784536,NaN,NaN,50
1672711200,1.066,1.06678,1.06578,1.06666,1764,1086.15,-662152,-664060.2,20.322836473806262,49.280148409015,46.59876664339596,NaN,NaN,50
1672713000,1.06666,1.06779,1.0666,1.06767,2478,1163.05,-659674,-663105.4,20.024007224308445,56.165298595915736,47.959371109257965,NaN,NaN,50
1672714800,1.06767,1.06788,1.06688,1.06719,2137,1222.05,-661811,-662865.2,19.83121175341026,52.51661097577049,48.71695056448349,NaN,NaN,50
1672716600,1.06719,1.06766,1.06711,1.06726,1602,1274.95,-660209,-661552.4,19.65218738757623,52.99617139483431,49.2012801645592,NaN,NaN,50
1672718400,1.06726,1.06804,1.06709,1.06782,1340,1309.35,-658869,-660543,19.868317775889256,56.7586619417505,49.76737667501925,NaN,NaN,50
1672720200,1.06782,1.06803,1.0667,1.06674,1296,1364.3,-660165,-660145.6,19.483789363565744,48.66764793500534,50.05626359733899,NaN,NaN,50
1672722000,1.06674,1.06709,1.06598,1.06637,1614,1406.65,-661779,-660566.6,18.168191618750058,46.23593076617411,49.98483242777115,NaN,NaN,50
1672723800,1.06637,1.0666,1.06592,1.06636,2101,1494.8,-663880,-660980.4,16.87141646260863,46.16878724246394,49.81522890762365,NaN,NaN,50
1672725600,1.06636,1.06679,1.06602,1.0663,1840,1574.95,-665720,-662082.6,15.912116670641325,45.73959410940496,49.83179334539678,NaN,NaN,50
1672727400,1.0663,1.06632,1.06516,1.06524,2475,1688.2,-668195,-663947.8,15.587686043061849,38.86560245632612,48.50983829015751,NaN,NaN,50
1672729200,1.06524,1.06573,1.065,1.0657,3258,1848.25,-664937,-664902.2,15.462981756753535,42.87759250294633,48.01296212775985,NaN,NaN,50
1672731000,1.0657,1.06588,1.06201,1.06238,4556,2074.75,-669493,-666445,17.559532843417163,28.394233517930488,46.37098702575491,NaN,NaN,50
1672732800,1.06238,1.06284,1.05696,1.05763,8542,2496.85,-678035,-669276,21.06475021288155,18.67488657927956,44.805571328919044,NaN,NaN,50
1672734600,1.05763,1.05799,1.05508,1.05518,6702,2824.4,-684737,-673079.4,24.64568481904461,15.691390198198661,42.788039758929685,NaN,NaN,50
1672736400,1.05518,1.05544,1.05341,1.05482,7149,3036.8,-691886,-677817.6,28.208941521911562,15.304482568999106,40.361206484642835,NaN,NaN,50
1672738200,1.05482,1.0561,1.05434,1.05476,4792,3185.1,-696678,-684165.8,30.932427824921398,15.237048378155151,37.437760040517084,NaN,NaN,50
1672740000,1.05476,1.0555,1.0535,1.05378,4362,3303.1,-701040,-690475.2,33.60674118089354,14.141066969215771,34.6966497543346,NaN,NaN,50
1672741800,1.05378,1.05458,1.05256,1.05311,4053,3433.95,-705093,-695886.8,36.2434441303496,13.429842529778355,31.87048340683061,NaN,NaN,50
1672743600,1.05311,1.0533,1.05195,1.05266,3379,3414.85,-708472,-700633.8,38.787215353166104,12.958431934898599,28.741895549198325,NaN,NaN,50
1672745400,1.05266,1.0536,1.05256,1.05284,3201,3432.05,-705271,-703310.8,40.86162072352355,14.25496052482653,26.283846448471273,NaN,NaN,50
1672747200,1.05284,1.05404,1.0524,1.054,3594,3523.55,-701677,-704310.6,42.35997213652975,22.288565699894505,24.57332037230844,NaN,NaN,50
1672749000,1.054,1.05492,1.0535,1.05358,3679,3583.6,-705356,-705173.8,42.92604432022482,21.50301045991928,22.81147917355525,NaN,NaN,50
1672750800,1.05358,1.05596,1.05304,1.05556,5799,3766.7,-699557,-704066.6,42.55757891462042,33.41703108302755,21.931296100242573,NaN,NaN,50
1672752600,1.05556,1.057,1.0554,1.05603,5174,3945.3,-694383,-701248.8,41.40540902090927,35.90390776280714,21.71974647927693,NaN,NaN,50
1672754400,1.05603,1.05746,1.05554,1.05716,3979,4077.25,-690404,-698275.4,39.994817125544365,41.55584637406231,21.6253360414995,NaN,NaN,50
1672756200,1.05716,1.05974,1.05668,1.05742,8452,4435.05,-681952,-694330.4,37.228279930645876,42.805528399922636,22.654714247356083,NaN,NaN,50
1672758000,1.05742,1.05822,1.05642,1.05688,7777,4743.2,-689729,-691205,34.80161328328789,40.851754694649514,24.238776255596797,NaN,NaN,50
1672759800,1.05688,1.05728,1.05546,1.05554,6550,4965.65,-696279,-690549.4,33.061389941366684,36.410581273004645,25.718718475225792,NaN,NaN,50
1672761600,1.05554,1.05568,1.05376,1.0555,5067,5127,-701346,-691942,32.238974655377156,36.28377540155526,27.21723939183695,NaN,NaN,50
1672763400,1.0555,1.05587,1.054,1.05581,4791,5242.8,-696555,-693172.2,31.347592180087453,38.08349389003484,28.849128356971214,NaN,NaN,50
1672765200,1.05581,1.05592,1.05502,1.05522,3014,5230.6,-699569,-696695.6,30.484366891188124,35.99936585590834,30.410435420306396,NaN,NaN,50
1672767000,1.05522,1.05539,1.054,1.05463,2482,5126.9,-702051,-699160,30.164815912780004,33.99582641210837,31.879434269044253,NaN,NaN,50
1672768800,1.05463,1.05566,1.05432,1.05564,2143,4806.95,-699908,-699885.8,29.65862359382862,40.137823354967324,33.820819370477736,NaN,NaN,50
1672770600,1.05564,1.05606,1.05536,1.05567,2140,4578.85,-697768,-699170.2,28.873859403047142,40.31548122828481,35.68228513501047,NaN,NaN,50
1672772400,1.05567,1.0562,1.05552,1.05616,2494,4346.1,-695274,-698914,28.032291172164875,43.276586331411195,37.18142946583309,NaN,NaN,50
1672774200,1.05616,1.05682,1.05586,1.05664,3070,4260,-692204,-697441,26.751461894865685,46.09775357168167,38.93819683095897,NaN,NaN,50
1672776000,1.05664,1.05688,1.05564,1.05615,2557,4169.75,-694761,-695983,25.705363206342163,43.70792792665324,39.67326089121796,NaN,NaN,50
1672777800,1.05615,1.05639,1.05506,1.05516,2408,4087.5,-697169,-695435.2,25.107920433480007,39.27742285995288,39.914226255299795,NaN,NaN,50
1672779600,1.05516,1.0554,1.05478,1.05501,1204,3978.75,-698373,-695556.2,24.730488028786613,38.638347155663794,39.70583345398561,NaN,NaN,50
1672781400,1.05501,1.05517,1.05465,1.0549,878,3862.6,-699251,-696351.6,24.46474734520183,38.148152087151814,39.37316371735913,NaN,NaN,50
1672783200,1.0549,1.0549,1.05466,1.05481,209,3693.35,-699460,-697802.8,24.217988139015958,37.72642590085614,39.14992594637388,NaN,NaN,50
1672785000,1.05481,1.05491,1.0546,1.05486,6221,3820.45,-693239,-697498.4,24.033187526347675,38.13560178931706,39.27314169753906,NaN,NaN,50
1672786800,1.05486,1.05546,1.05408,1.05448,2791,3670.05,-696030,-697270.6,23.236198008518596,36.18940836517453,39.266401194940435,NaN,NaN,50
1672788600,1.05448,1.05478,1.05424,1.05456,1400,3481.35,-694630,-696522,22.4961363133916,36.91927439509145,39.183242659587336,NaN,NaN,50
1672790400,1.05456,1.05579,1.05452,1.05558,1906,3377.7,-692724,-695216.6,21.041341063139328,45.48154224273321,39.86054097293197,NaN,NaN,50
1672792200,1.05558,1.05614,1.05557,1.05582,1503,3030.25,-691221,-693568.8,20.02086588104795,47.29432298455691,40.81043358524972,NaN,NaN,50
1672794000,1.05582,1.05658,1.05572,1.05617,1828,2732.8,-689393,-692799.6,19.473829342400105,49.9100579181897,41.50845033976561,NaN,NaN,50
1672795800,1.05617,1.05699,1.05607,1.05669,2295,2520.05,-687098,-691013.2,19.32214136596518,53.59492477117117,42.45698202140034,NaN,NaN,50
1672797600,1.05669,1.05696,1.05642,1.05678,1763,2354.85,-685335,-689154.2,19.181288244989897,54.22261604331266,43.238841286536164,NaN,NaN,50
1672799400,1.05678,1.05694,1.05616,1.0565,1592,2194.9,-686927,-687994.8,18.713730153922555,51.87183372625322,43.65127558329128,NaN,NaN,50
1672801200,1.0565,1.05692,1.05648,1.0568,1191,2103.75,-685736,-686897.8,18.279569069360022,54.16470606933855,44.398188307768805,NaN,NaN,50
1672803000,1.0568,1.05699,1.0567,1.05691,1156,2037.45,-684580,-685935.2,17.953733677587863,55.011041675144405,45.522018223139625,NaN,NaN,50
1672804800,1.05691,1.057,1.05658,1.05674,977,1979.15,-685557,-685627,17.46953744803421,53.37087554790195,46.57434167972807,NaN,NaN,50
1672806600,1.05674,1.05746,1.0566,1.0573,1559,1950.1,-683998,-685359.6,17.556118304687836,57.831075080543705,47.980264750684626,NaN,NaN,50
1672808400,1.0573,1.05785,1.05666,1.05686,2105,1930.65,-686103,-685194.8,18.052601280978674,53.50088163202796,49.10701158862547,NaN,NaN,50
1672810200,1.05686,1.05714,1.05647,1.05694,1681,1861.2,-684422,-684932,18.19148529232924,54.17276163154671,50.252523005927586,NaN,NaN,50
1672812000,1.05694,1.05752,1.05664,1.05734,1946,1830.65,-682476,-684511.2,18.734011648496892,57.48091469438078,51.77334488658517,NaN,NaN,50
1672813800,1.05734,1.05736,1.05598,1.057,2309,1825.7,-684785,-684356.8,18.166564118882267,53.918047188475406,52.987542943255455,NaN,NaN,50
1672815600,1.057,1.05864,1.05671,1.05848,3349,1932.95,-681436,-683844.4,18.91005465556768,64.29319838241462,54.33123266751841,NaN,NaN,50
1672817400,1.05848,1.06061,1.05846,1.05938,5191,2148.6,-676245,-681872.8,20.86756540099117,68.88146070651695,55.87317107622984,NaN,NaN,50
1672819200,1.05938,1.06309,1.05903,1.06218,7849,2530.6,-668396,-678667.6,23.65120024050969,78.246756755848,57.89722099320544,NaN,NaN,50
1672821000,1.06218,1.06354,1.06082,1.06157,7048,2571.95,-675444,-677261.2,26.370586798710484,73.08622643933478,59.28945682664569,NaN,NaN,50
1672822800,1.06157,1.06263,1.06056,1.06254,4368,2650.8,-671076,-674519.4,28.56808970690684,75.8174466944767,60.831944730300265,NaN,NaN,50
1672824600,1.06254,1.06302,1.06107,1.06108,3273,2744.45,-674349,-673102,30.742763998989858,65.1076769187373,61.777362101191976,NaN,NaN,50
1672826400,1.06108,1.06197,1.06084,1.06148,2324,2765.35,-672025,-672258,32.454628154162826,66.50372171875928,62.65872036186489,NaN,NaN,50
1672828200,1.06148,1.0623,1.06148,1.06208,2691,2824.75,-669334,-672445.6,34.17410313278565,68.5372142671175,63.62487554700582,NaN,NaN,50
1672830000,1.06208,1.06245,1.061,1.06113,2402,2853.45,-671736,-671704,35.10920495269082,62.10809776637596,64.2489628483254,NaN,NaN,50
1672831800,1.06113,1.06116,1.06025,1.06046,2466,2862,-674202,-672329.2,35.02502523785715,57.97743512627434,64.25941713730616,NaN,NaN,50
1672833600,1.06046,1.06113,1.06005,1.06034,2830,2915.35,-677032,-672865.8,34.704396669970265,57.243114244348476,64.52671946675763,NaN,NaN,50
1672835400,1.06034,1.06102,1.05988,1.06072,3060,2988.75,-673972,-673255.2,34.19525455683151,59.01344857920925,64.87248282016209,NaN,NaN,50
1672837200,1.06072,1.06146,1.0595,1.06137,4518,3155.1,-669454,-673279.2,34.02998968544027,61.918027029191585,65.18941941550572,NaN,NaN,50
1672839000,1.06137,1.06198,1.06084,1.06106,4462,3320.4,-673916,-673715.2,34.21874984633005,59.74349708125046,65.60552297927536,NaN,NaN,50
1672840800,1.06106,1.06188,1.06023,1.06122,4412,3492.15,-669504,-672775.6,33.59738381369209,60.5142786696362,65.33560014264833,NaN,NaN,50
1672842600,1.06122,1.06285,1.06054,1.06246,5303,3679.35,-664201,-670209.4,33.67269451776892,65.95476808711805,65.12655066983413,NaN,NaN,50
1672844400,1.06246,1.06253,1.05814,1.05982,9852,4066.7,-674053,-670225.6,31.374179667935266,50.12099261765116,63.11756751710578,NaN,NaN,50
1672846200,1.05982,1.0608,1.0585,1.06032,6847,4325,-667206,-669776,29.239844450232592,52.449328850231645,61.64350340359841,NaN,NaN,50
1672848000,1.06032,1.06108,1.05927,1.06076,5054,4480.4,-662152,-667423.2,27.484842756571474,54.46375995003636,60.118240064709816,NaN,NaN,50
1672849800,1.06076,1.06208,1.06042,1.06189,4102,4570.05,-658050,-665132.4,26.606503956732347,59.23954961170921,59.69908811420781,NaN,NaN,50
1672851600,1.06189,1.06201,1.06074,1.06096,3085,4556.85,-661135,-664519.2,25.790903642596014,54.20122320844695,58.820338220614076,NaN,NaN,50
1672853400,1.06096,1.06176,1.06048,1.06074,2680,4431.3,-663815,-662471.6,24.76863569904996,53.051750445195566,57.71423366190537,NaN,NaN,50
1672855200,1.06074,1.06129,1.05992,1.05996,2546,4166.15,-666361,-662302.6,23.266003400698917,49.077725153559,56.78349276098987,NaN,NaN,50
1672857000,1.05996,1.06052,1.05956,1.05999,2282,3927.85,-664079,-662688,21.67771270460101,49.23523388498869,56.15904981518376,NaN,NaN,50
1672858800,1.05999,1.06068,1.05852,1.05978,7828,4100.85,-671907,-665459.4,21.086292887506968,48.11335694850805,55.5069242940523,NaN,NaN,50
1672860600,1.05978,1.06068,1.05966,1.06058,4151,4144.75,-667756,-666783.6,20.537117343062498,52.54912487760764,55.04518688679504,NaN,NaN,50
1672862400,1.06058,1.06102,1.06015,1.0605,3380,4197.55,-671136,-668247.8,19.660748757330886,52.06974108778809,54.3417378909805,NaN,NaN,50
1672864200,1.0605,1.06085,1.06013,1.06034,2678,4196.9,-673814,-669738.4,18.86570148121888,51.066356539820376,53.72194213802121,NaN,NaN,50
1672866000,1.06034,1.0608,1.06009,1.06062,830,4118.3,-672984,-671519.4,18.167409728162813,52.781181661142654,53.16957806598596,NaN,NaN,50
1672867800,1.06062,1.06074,1.06022,1.06044,968,4043.4,-673952,-671928.4,17.518995957467894,51.530980643280586,52.139307534283276,NaN,NaN,50
1672869600,1.06044,1.06106,1.06011,1.06106,161,3909.95,-673791,-673135.4,16.498407007862777,55.44564695782566,52.51963998715289,NaN,NaN,50
1672871400,1.06106,1.06106,1.06026,1.06072,2947,3904.3,-676738,-674255.8,15.550717268943743,52.921389404984865,52.553358598206685,NaN,NaN,50
1672873200,1.06072,1.06088,1.0603,1.06058,1392,3748,-678130,-675119,14.670719654233208,51.87413811243268,52.368385609806424,NaN,NaN,50
1672875000,1.06058,1.06116,1.06054,1.06061,677,3558.75,-677453,-676012.8,13.800835731477216,52.09291293218043,51.857911561268665,NaN,NaN,50
1672876800,1.06061,1.06261,1.06032,1.06261,1989,3437.6,-675464,-676315.2,14.637937705907847,63.88109457600615,52.54933094466575,NaN,NaN,50
1672878600,1.06261,1.06312,1.06176,1.06294,2534,3299.15,-672930,-676143,15.852067952454266,65.39418460261942,53.43093338448174,NaN,NaN,50
1672880400,1.06294,1.06316,1.0623,1.06233,2027,2907.9,-674957,-675786.8,17.013107759662187,60.36052573107212,54.236847711446956,NaN,NaN,50
1672882200,1.06233,1.06246,1.06185,1.06202,2277,2679.4,-677234,-675607.6,17.36445245751657,57.92050490801834,54.857224213091925,NaN,NaN,50
1672884000,1.06202,1.06204,1.06096,1.06102,2307,2542.05,-679541,-676025.2,16.463321001299036,50.78825143227071,55.04828810478926,NaN,NaN,50
1672885800,1.06102,1.06198,1.06092,1.06178,1719,2422.9,-677822,-676496.8,15.575867241054194,55.29392051401752,55.244344935961394,NaN,NaN,50
1672887600,1.06178,1.06197,1.06117,1.06122,1799,2358.6,-679621,-677835,14.751803035112557,51.54878089881492,55.20713349389188,NaN,NaN,50
1672889400,1.06122,1.06143,1.06064,1.06072,1285,2288.85,-680906,-679024.8,14.110308778585784,48.3968656906006,55.01645557609046,NaN,NaN,50
1672891200,1.06072,1.06117,1.06062,1.06074,1366,2229.85,-679540,-679486,13.540327743336524,48.53242660637309,54.71297307217835,NaN,NaN,50
1672893000,1.06074,1.06106,1.06036,1.06044,1210,2176.25,-680750,-679727.8,13.351200118789095,46.55674496471183,54.35767052370915,NaN,NaN,50
1672894800,1.06044,1.06072,1.06016,1.06038,1491,1859.4,-682241,-680611.6,13.4322731647852,46.15208433181002,53.693844621850886,NaN,NaN,50
1672896600,1.06038,1.06108,1.06021,1.06108,1474,1725.55,-680767,-680840.8,12.91460592328971,51.45356479753266,53.58900000703288,NaN,NaN,50
1672898400,1.06108,1.06202,1.0609,1.06145,1951,1654.1,-678816,-680422.8,12.834898433145847,54.029842233190834,53.74297887280132,NaN,NaN,50
1672900200,1.06145,1.06162,1.0603,1.06032,1732,1606.8,-680548,-680624.4,11.928154263047697,46.00082628769233,53.30782982676646,NaN,NaN,50
1672902000,1.06032,1.06098,1.06016,1.0608,2392,1684.9,-678156,-680105.6,11.248752864832769,49.43799155900526,52.27617961126639,NaN,NaN,50
1672903800,1.0608,1.06123,1.05902,1.06056,3220,1797.5,-681376,-679932.6,11.893089997892012,47.799692830495545,51.019430198971826,NaN,NaN,50
1672905600,1.06056,1.0628,1.06051,1.06197,4878,2033.35,-676498,-679078.8,11.429255130979728,56.84728394023533,50.7684843567692,NaN,NaN,50
1672907400,1.06197,1.06259,1.06146,1.062,4024,2087.2,-672474,-677810.4,10.998551325989746,57.017983937495124,50.7040185731604,NaN,NaN,50
1672909200,1.062,1.06208,1.06097,1.06184,2906,2162.9,-675380,-676776.8,10.367164172914814,55.75131276194786,51.058522953851615,NaN,NaN,50
1672911000,1.06184,1.0629,1.0618,1.06234,3029,2280.5,-672351,-675615.8,10.307578182188305,58.82935388826468,51.311053909154985,NaN,NaN,50
1672912800,1.06234,1.06261,1.06162,1.06178,2677,2314.9,-675028,-674346.2,10.046146833071482,54.27548573517717,51.505818540323716,NaN,NaN,50
1672914600,1.06178,1.062,1.06098,1.06188,2293,2302.85,-672735,-673593.6,9.551721981403782,54.946164870320366,51.97362562458942,NaN,NaN,50
1672916400,1.06188,1.06221,1.06053,1.06054,2215,2312.25,-674950,-674088.8,9.541558219376098,45.34754200255851,51.74613386717409,NaN,NaN,50
1672918200,1.06054,1.06144,1.06032,1.06112,2058,2301.3,-672892,-673591.2,9.736443640041728,49.46274331571651,51.953705177960146,NaN,NaN,50
1672920000,1.06112,1.06166,1.0605,1.06122,2489,2310.4,-670403,-673201.6,9.641551733327391,50.15956222030772,52.23995359856712,NaN,NaN,50
1672921800,1.06122,1.06175,1.05982,1.05996,3027,2375.8,-673430,-672882,10.225589885007853,42.25402213563037,51.58284340843124,NaN,NaN,50
1672923600,1.05996,1.06084,1.05782,1.05802,7258,2648.75,-680688,-674472.6,12.209158134308959,33.49950710130538,50.116390899010845,NaN,NaN,50
1672925400,1.05802,1.05802,1.05514,1.05524,7758,2972.4,-688446,-677171.8,15.209706772813053,25.383487639414184,48.643723852705264,NaN,NaN,50
1672927200,1.05524,1.05621,1.05472,1.05504,5612,3184.7,-694058,-681405,18.13421558269768,24.915806881393706,46.89213923287587,NaN,NaN,50
1672929000,1.05504,1.05552,1.05358,1.05394,7061,3477.25,-701119,-687548.2,21.19436919016153,22.46427274415359,45.08246636956573,NaN,NaN,50
1672930800,1.05394,1.05677,1.0524,1.05286,8663,3835.85,-709782,-694818.6,22.7140138005147,20.347431282794645,42.4753340368914,NaN,NaN,50
1672932600,1.05286,1.0533,1.0515,1.05184,6011,4062.7,-715793,-701839.6,24.46145055976259,18.56784678714726,39.72889566900941,NaN,NaN,50
1672934400,1.05184,1.05319,1.05176,1.05314,4775,4203.9,-711018,-706354,26.084070407635636,27.295512512393515,37.69633850832696,NaN,NaN,50
1672936200,1.05314,1.0532,1.05178,1.05212,4211,4327.85,-715229,-710588.2,27.579712669248412,25.028860901778913,35.28201758072083,NaN,NaN,50
1672938000,1.05212,1.0532,1.05188,1.05272,3298,4373.15,-711931,-712750.6,28.96852334074599,28.77563794020449,33.46059988107993,NaN,NaN,50
1672939800,1.05272,1.05332,1.05206,1.053,2627,4343.5,-709304,-712655,30.106372137214244,30.520699070160163,31.71592375249706,NaN,NaN,50
1672941600,1.053,1.05433,1.05293,1.05372,3590,4279.1,-705714,-710639.2,29.964258780185528,34.935254371967915,30.972188921740585,NaN,NaN,50
1672943400,1.05372,1.05432,1.05343,1.0536,3706,4263.2,-709420,-710319.6,29.832296377230293,34.54133792856361,29.906374251229664,NaN,NaN,50
1672945200,1.0536,1.05387,1.05308,1.05317,2781,4256.95,-712201,-709714,29.938123682160402,33.10103556273771,28.68790806140324,NaN,NaN,50
1672947000,1.05317,1.05356,1.05292,1.05302,2835,4247.25,-715036,-710335,30.141515132709777,32.590515012323664,27.99765755259561,NaN,NaN,50
1672948800,1.05302,1.05308,1.0523,1.05241,2603,4243.55,-717639,-712002,30.72443174149412,30.528461970867895,27.785440043278648,NaN,NaN,50
1672950600,1.05241,1.05259,1.052,1.052,2623,4260.05,-720262,-714911.6,31.44646507339754,29.191545121204413,28.05744414912081,NaN,NaN,50
1672952400,1.052,1.0523,1.05158,1.05191,1257,4212.15,-721519,-717331.4,32.36304799796407,28.89243783296166,28.34148921708995,NaN,NaN,50
1672954200,1.05191,1.05218,1.05175,1.05215,648,4141.65,-720871,-719065.4,33.21416071363299,30.925001746237385,28.945827002953077,NaN,NaN,50
1672956000,1.05215,1.05257,1.0521,1.05246,58,4020.1,-720813,-720220.8,33.39628631812871,33.56650211856322,29.89004634836511,NaN,NaN,50
1672957800,1.05246,1.05254,1.05207,1.05222,1405,3939,-722218,-721136.6,33.587725407852425,32.52935705551111,30.887297081819675,NaN,NaN,50
1672959600,1.05222,1.05264,1.05216,1.05254,1099,3631.05,-721119,-721308,33.598654161123626,35.39563751371885,31.465877439057202,NaN,NaN,50
1672961400,1.05254,1.05255,1.05196,1.05208,800,3283.15,-721919,-721388,33.77753616560857,33.21147695486111,32.05035001427736,NaN,NaN,50
1672963200,1.05208,1.05252,1.05192,1.05246,1436,3074.35,-720483,-721310.4,33.97842080546094,36.68713647774931,32.61545705267342,NaN,NaN,50
1672965000,1.05246,1.05318,1.05246,1.05296,1698,2806.2,-718785,-720904.8,33.00141091780272,41.03523195660368,33.366495115990816,NaN,NaN,50
1672966800,1.05296,1.05326,1.05244,1.05258,2104,2478.25,-720889,-720639,31.962466978438016,38.851434050738156,33.646222235902975,NaN,NaN,50
1672968600,1.05258,1.05267,1.05226,1.05252,1408,2248.1,-722297,-720874.6,31.206329325507948,38.50301441563616,33.929199127836725,NaN,NaN,50
1672970400,1.05252,1.05343,1.0525,1.05312,1157,2067.2,-721140,-720718.8,29.290101401022277,43.91921040109214,34.7019259020049,NaN,NaN,50
1672972200,1.05312,1.05312,1.05262,1.05268,1086,1910.95,-722226,-721067.4,27.51074689971415,41.06307913121397,35.30710905335421,NaN,NaN,50
1672974000,1.05268,1.05366,1.05264,1.05331,1946,1843.35,-720280,-721366.4,26.00425104213806,46.43441207195312,36.44324834628887,NaN,NaN,50
1672975800,1.05331,1.05363,1.05296,1.05324,1395,1781.75,-721675,-721523.6,24.60536203153169,45.93349447257446,37.63910187138673,NaN,NaN,50
1672977600,1.05324,1.05346,1.05278,1.05318,888,1646.65,-722563,-721576.8,23.014060254499835,45.48060681643542,38.823971084491994,NaN,NaN,50
1672979400,1.05318,1.05326,1.05246,1.05246,652,1493.95,-723215,-721991.8,21.70522535037168,40.3405413680126,39.49650962890451,NaN,NaN,50
1672981200,1.05246,1.05252,1.05152,1.05156,1147,1412.25,-724362,-722419,21.703523418507206,35.01364317955492,39.599876847546774,NaN,NaN,50
1672983000,1.05156,1.05191,1.05108,1.05146,2023,1371.65,-726385,-723640,22.163214306180134,34.46901053986083,39.73842352500032,NaN,NaN,50
1672984800,1.05146,1.0522,1.05143,1.05188,1896,1336.3,-724489,-724202.8,22.08401026318309,38.77644687793731,39.97990990815879,NaN,NaN,50
1672986600,1.05188,1.05224,1.05106,1.05127,1626,1286.45,-726115,-724913.2,22.408604484551102,35.16147853213896,40.119195735107205,NaN,NaN,50
1672988400,1.05127,1.05226,1.05095,1.05142,3035,1375.35,-723080,-724886.2,22.8258656690298,36.72363354567263,40.12180266853029,NaN,NaN,50
1672990200,1.05142,1.05218,1.0507,1.05126,3162,1501.05,-726242,-725262.2,23.47637632087721,35.73463914702934,39.74318889641784,NaN,NaN,50
1672992000,1.05126,1.0531,1.05112,1.05188,4117,1704,-722125,-724410.2,22.487499717199665,42.227360799071924,39.984326521298826,NaN,NaN,50
1672993800,1.05188,1.05266,1.05156,1.05186,2751,1771.3,-724876,-724487.6,21.569257156641942,42.079672809676495,40.23980212087314,NaN,NaN,50
1672995600,1.05186,1.05196,1.04964,1.05076,3129,1872.8,-728005,-724865.6,22.590690145315268,34.858505939266436,39.59260894502844,NaN,NaN,50
1672997400,1.05076,1.05158,1.05049,1.05073,2825,1974.05,-730830,-726415.6,23.53916363479764,34.683692984749214,39.136938505995246,NaN,NaN,50
1672999200,1.05073,1.0516,1.0503,1.05045,2784,2041.45,-733614,-727890,24.567605048715194,33.01930624120831,38.178716660942044,NaN,NaN,50
1673001000,1.05045,1.0516,1.05045,1.05076,2415,2077.3,-731199,-729704.8,25.522586361638638,36.64426598158944,37.5152003401574,NaN,NaN,50
1673002800,1.05076,1.05114,1.05034,1.05079,2526,2098.4,-728673,-730464.2,26.503304899094086,36.99960350656939,36.909414389452685,NaN,NaN,50
1673004600,1.05079,1.05098,1.04922,1.04942,2350,2145.5,-731023,-731067.8,28.23217073909111,29.00045219805854,36.09940802017025,NaN,NaN,50
1673006400,1.04942,1.04966,1.04834,1.0491,2817,2228.5,-733840,-731669.8,30.322020837460535,27.504673218576116,35.563053022957476,NaN,NaN,50
1673008200,1.0491,1.04966,1.04866,1.04948,3202,2334.3,-730638,-731074.6,32.26259592880357,31.990577907737887,35.38602212066298,NaN,NaN,50
1673010000,1.04948,1.05014,1.0489,1.04968,4208,2447.4,-726430,-730120.8,33.163769580361894,34.29503845864389,35.06592151928488,NaN,NaN,50
1673011800,1.04968,1.05452,1.04833,1.05428,13117,3033.5,-713313,-727048.8,32.14644635477279,64.27702228728725,37.14560321608118,NaN,NaN,50
1673013600,1.05428,1.05434,1.05186,1.05209,7349,3356.55,-720662,-724976.6,31.20178907386863,52.09022925715729,38.243217195472944,NaN,NaN,50
1673015400,1.05209,1.05336,1.05009,1.05094,7773,3712.6,-728435,-723895.6,29.074786965886222,47.04600018312816,39.05117155519429,NaN,NaN,50
1673017200,1.05094,1.05998,1.05094,1.05816,13436,4327.05,-714999,-720767.8,29.851812575003322,67.99841435880835,40.89196109517546,NaN,NaN,50
1673019000,1.05816,1.06126,1.058,1.06016,8052,4628.5,-706947,-716871.2,30.90915756586269,71.37695129899947,42.984623844412816,NaN,NaN,50
1673020800,1.06016,1.06144,1.05968,1.06044,6258,4846.6,-700689,-714346.4,31.937304140628157,71.82541512634157,45.62511735777532,NaN,NaN,50
1673022600,1.06044,1.06226,1.06038,1.06188,4315,4981.05,-696374,-709488.8,33.104412852957346,74.07508129293653,48.43878795121727,NaN,NaN,50
1673024400,1.06188,1.06238,1.06164,1.06224,2490,4953.8,-693884,-702578.6,34.21954202162672,74.62067002880997,51.410313936045966,NaN,NaN,50
1673026200,1.06224,1.06382,1.06212,1.06376,2383,4914.85,-691501,-697879,35.617387075141174,76.8371590652029,54.28123487058979,NaN,NaN,50
1673028000,1.06376,1.06396,1.06296,1.06348,2124,4815.2,-693625,-695214.6,36.949222665625925,75.5285921033796,57.03330548464766,NaN,NaN,50
1673029800,1.06348,1.06436,1.06322,1.06378,2018,4778.55,-691607,-693398.2,38.285821644246425,76.00019905544323,60.390430260175144,NaN,NaN,50
1673031600,1.06378,1.0648,1.06378,1.06442,1947,4719.45,-689660,-692055.4,39.6376572523469,77.01775230628954,63.92707876644039,NaN,NaN,50
1673033400,1.06442,1.0648,1.06416,1.06456,1700,4663.2,-687960,-690870.6,40.89293317415447,77.24503088345523,67.15953969327734,NaN,NaN,50
1673035200,1.06456,1.06478,1.06428,1.06474,1605,4604.25,-686355,-689841.4,42.058546530118655,77.55240337908462,70.24935147330882,NaN,NaN,50
1673037000,1.06474,1.06482,1.06433,1.06463,1480,4557.5,-687835,-688683.4,43.15298457016984,76.86905033719036,71.1487820483019,NaN,NaN,50
1673038800,1.06463,1.06463,1.06431,1.06444,932,4477.8,-688767,-688115.4,44.14536910744938,75.62943672747036,72.83015401046711,NaN,NaN,50
1673040600,1.06444,1.06455,1.06423,1.06444,795,4400.05,-688767,-687936.8,44.96515336712156,75.62943672747036,74.87182804934871,NaN,NaN,50
1673215200,1.06444,1.06444,1.06395,1.06412,181,4268.25,-688948,-688134.4,45.359023566014784,73.31991260483751,75.25193506692221,NaN,NaN,50
1673217000,1.06412,1.0642,1.06394,1.06414,535,4134.9,-688413,-688546,45.711115308303754,73.37463837128959,75.39462700065722,NaN,NaN,50
1673218800,1.06414,1.06574,1.06414,1.06566,1884,4018.7,-686529,-688284.8,46.65561722964874,77.20200099085521,75.77866884812249,NaN,NaN,50
1673220600,1.06566,1.0663,1.06516,1.06628,1645,3445.1,-684884,-687508.2,47.7196961962989,78.55607135848044,76.09873956708991,NaN,NaN,50
1673222400,1.06628,1.0668,1.06528,1.06538,2266,3190.95,-687150,-687184.8,48.866421620722264,71.88186903441222,75.90311092463294,NaN,NaN,50
1673224200,1.06538,1.06616,1.06515,1.06614,1464,2875.5,-685686,-686532.4,49.74502338271228,73.89856212567605,75.69321114323816,NaN,NaN,50
1673226000,1.06614,1.06663,1.06555,1.06631,2158,2311.6,-683528,-685555.4,50.72274884325856,74.34186290507218,75.60844477193048,NaN,NaN,50
1673227800,1.06631,1.06724,1.06604,1.06668,2611,2039.55,-680917,-684433,51.82762569014658,75.3241613801125,75.5601563665497,NaN,NaN,50
1673229600,1.06668,1.0674,1.06664,1.06702,2120,1832.65,-678797,-683215.6,52.90395676769241,76.22490758026237,75.50352460040492,NaN,NaN,50
1673231400,1.06702,1.0678,1.06694,1.06772,2219,1727.85,-676578,-681101.2,54.02913924966241,78.00505968301205,75.55781237180183,NaN,NaN,50
1673233200,1.06772,1.06772,1.06672,1.0672,1902,1698.45,-678480,-679660,54.706116844980976,73.59664058047551,75.27525788618689,NaN,NaN,50
1673235000,1.0672,1.06752,1.06662,1.06676,1419,1650.25,-679899,-678934.2,55.16274844821495,69.99215349128485,74.78405096862221,NaN,NaN,50
1673236800,1.06676,1.06762,1.06668,1.06754,1114,1599.75,-678785,-678507.8,55.63014263777439,72.55798476440722,74.56466154268914,NaN,NaN,50
1673238600,1.06754,1.06784,1.06741,1.06766,929,1545.3,-677856,-678319.6,56.16171363196065,72.94131343516267,74.37265273609573,NaN,NaN,50
1673240400,1.06766,1.0681,1.0673,1.06797,965,1496.2,-676891,-678382.2,56.769856589363975,73.95352072526713,74.41791045898356,NaN,NaN,50
1673242200,1.06797,1.06832,1.06764,1.06772,1532,1487.8,-678423,-678370.8,57.43060283316801,71.6265040176683,74.29304371943918,NaN,NaN,50
1673244000,1.06772,1.06864,1.06766,1.06796,1612,1488.15,-676811,-677753.2,58.180726723772324,72.52043983925962,73.95864649432521,NaN,NaN,50
1673245800,1.06796,1.06832,1.06756,1.0682,1675,1497.9,-675136,-677023.4,58.65433975898105,73.42221236811797,73.59194228072788,NaN,NaN,50
1673247600,1.0682,1.0695,1.06758,1.0678,3506,1626.6,-678642,-677180.6,59.57432742601769,69.3381451915331,73.41024772052224,NaN,NaN,50
1673249400,1.0678,1.06798,1.06682,1.06733,4586,1816.15,-683228,-678448,58.99494392855459,64.77861967973297,72.75882326009773,NaN,NaN,50
1673251200,1.06733,1.0698,1.06726,1.06907,4818,2048,-678410,-678445.4,59.26061699465179,72.0945896873393,72.59830374454539,NaN,NaN,50
1673253000,1.06907,1.06998,1.06878,1.06903,3681,2205.3,-682091,-679501.4,59.57148465108941,71.7257513317576,72.34127445537717,NaN,NaN,50
1673254800,1.06903,1.06938,1.06732,1.06782,3655,2293.85,-685746,-681623.4,57.82813310920274,61.4793222976549,71.28801836376236,NaN,NaN,50
1673256600,1.06782,1.06788,1.06603,1.06722,3241,2373.65,-688987,-683692.4,54.83873608789834,57.121704351512676,69.79635012579811,NaN,NaN,50
1673258400,1.06722,1.06733,1.06617,1.06648,3446,2432.65,-692433,-685533.4,52.06286742525855,52.20682859241686,68.26850641236535,NaN,NaN,50
1673260200,1.06648,1.06766,1.06644,1.06691,2994,2509.15,-689439,-687739.2,49.72783328878359,54.64869870420703,67.1725453561455,NaN,NaN,50
1673262000,1.06691,1.0685,1.06678,1.06836,2599,2531.2,-686840,-688689,48.13399217816879,61.74633842633772,66.40028490342625,NaN,NaN,50
1673263800,1.06836,1.06856,1.06748,1.06842,2238,2512.55,-684602,-688460.2,46.69347205062174,62.011277987554536,65.61956808573997,NaN,NaN,50
1673265600,1.06842,1.06886,1.06809,1.06879,2392,2526.15,-682210,-687104.8,45.55847916919099,63.68173039457932,64.88586877640512,NaN,NaN,50
1673267400,1.06879,1.06936,1.06842,1.06889,2757,2553.05,-679453,-684508.8,44.83086803638931,64.14067940662363,64.35116701847336,NaN,NaN,50
1673269200,1.06889,1.07227,1.06852,1.07186,4835,2699.7,-674618,-681544.6,45.50633932427884,74.46254226686209,64.48988862044496,NaN,NaN,50
1673271000,1.07186,1.07318,1.0717,1.07251,5161,2886.8,-669457,-678068,46.42652477107411,76.08498114938104,64.68008639053518,NaN,NaN,50
1673272800,1.07251,1.07322,1.07116,1.07169,4540,3058.1,-673997,-675947,46.66746896921875,70.03965338555929,64.7301941186799,NaN,NaN,50
1673274600,1.07169,1.07384,1.07122,1.07282,5170,3270.15,-668827,-673270.4,47.11652430080313,73.19980645904172,65.3317074600591,NaN,NaN,50
1673276400,1.07282,1.07462,1.0728,1.07452,4032,3423.5,-664795,-670338.8,47.797149853679564,77.1112612097141,65.69004114022873,NaN,NaN,50
1673278200,1.07452,1.07494,1.074,1.07402,3739,3533.85,-668534,-669122,48.53290676535306,73.70406167274817,65.83134902172806,NaN,NaN,50
1673280000,1.07402,1.0749,1.07402,1.07474,2924,3599.45,-665610,-668352.6,49.21610961190703,75.39035196425456,66.82499399791375,NaN,NaN,50
1673281800,1.07474,1.07608,1.07444,1.07582,3652,3698.3,-661958,-665944.8,50.22559682226607,77.70037913854324,68.29489933984449,NaN,NaN,50
1673283600,1.07582,1.076,1.074,1.0744,3061,3676.05,-665019,-665183.2,50.603941292005885,68.58471534522297,69.46474839361636,NaN,NaN,50
1673285400,1.0744,1.07506,1.07419,1.07502,2570,3575.25,-662449,-664714,50.95526115676427,70.22709802750943,70.57749120242367,NaN,NaN,50
1673287200,1.07502,1.07542,1.0746,1.07492,1632,3415.95,-664081,-663823.4,51.41964441241643,69.59511544204409,71.13811813211699,NaN,NaN,50
1673289000,1.07492,1.07536,1.07377,1.07432,3089,3386.35,-667170,-664135.4,50.754820483721886,65.77066901269072,71.40664606248386,NaN,NaN,50
1673290800,1.07432,1.07498,1.07418,1.0749,2852,3346.2,-664318,-664607.4,50.13748397850553,67.62287599709884,71.68815646266383,NaN,NaN,50
1673292600,1.0749,1.07529,1.07452,1.07518,2396,3303.95,-661922,-663988,49.73171736416207,68.50879716159143,72.00016487373294,NaN,NaN,50
1673294400,1.07518,1.0754,1.07422,1.07444,2558,3259.55,-664480,-664394.2,48.9370200895802,63.5589488903643,71.22133677541167,NaN,NaN,50
1673296200,1.07444,1.07451,1.07307,1.07312,3174,3268.55,-667654,-665108.8,46.780856975957185,55.81248033713419,69.77330100310833,NaN,NaN,50
1673298000,1.07312,1.07354,1.07302,1.0733,816,3179.4,-666838,-665042.4,44.722191690720194,56.589452705631835,68.81257238311352,NaN,NaN,50
1673299800,1.0733,1.07348,1.07312,1.07338,679,3101.45,-666159,-665410.6,42.81057392585726,56.95174878025075,67.65199683462845,NaN,NaN,50
1673301600,1.07338,1.07338,1.07281,1.0732,1440,3053.85,-667599,-666546,40.65029753603457,55.82286892935194,66.13139738603115,NaN,NaN,50
1673303400,1.0732,1.0734,1.07304,1.0733,4669,3149.45,-662930,-666236,38.664101253228004,56.34063106804126,64.8911523428378,NaN,NaN,50
1673305200,1.0733,1.07387,1.07284,1.07324,2148,3015.1,-665078,-665720.8,37.28163228325639,55.917169603802854,63.50021074566268,NaN,NaN,50
1673307000,1.07324,1.07354,1.0731,1.07327,952,2804.65,-664126,-665178.4,35.99791109685418,56.094859301556234,61.95695932873504,NaN,NaN,50
1673308800,1.07327,1.07382,1.07208,1.0723,2342,2694.75,-666468,-665240.2,33.464963128953265,49.19069805240648,60.57167237924814,NaN,NaN,50
1673310600,1.0723,1.07291,1.07226,1.07277,1671,2519.8,-664797,-664679.8,31.112940015902417,52.25695658595544,59.288090847708574,NaN,NaN,50
1673312400,1.07277,1.07374,1.07263,1.07358,2211,2428.75,-662586,-664611,29.8474847974401,57.06580124598631,58.393139833704446,NaN,NaN,50
1673314200,1.07358,1.074,1.07335,1.07364,2413,2362.45,-660173,-663630,28.930955386104536,57.40802436768947,57.79580807334721,NaN,NaN,50
1673316000,1.07364,1.07426,1.07311,1.07312,2222,2327.35,-662395,-663283.8,28.33518883880148,53.432893290539354,56.78223788002153,NaN,NaN,50
1673317800,1.07312,1.07332,1.07213,1.07312,2492,2269.35,-662395,-662469.2,26.50016226468771,53.432893290539354,55.70538760351781,NaN,NaN,50
1673319600,1.07312,1.07332,1.07258,1.07331,1497,2191.15,-660898,-661689.4,24.796209017296356,54.76034211868077,55.07691569125471,NaN,NaN,50
1673321400,1.07331,1.07344,1.07286,1.07324,1708,2148.05,-662606,-661693.4,23.35788447353171,54.14792199879992,54.95801866708798,NaN,NaN,50
1673323200,1.07324,1.0734,1.07279,1.07308,1387,2135.8,-663993,-662457.4,21.926351557850094,52.69722188889491,54.6800021801782,NaN,NaN,50
1673325000,1.07308,1.07336,1.07285,1.07306,1009,2031.8,-665002,-662978.8,20.597070993288593,52.507850316933244,54.36258086136981,NaN,NaN,50
1673326800,1.07306,1.07416,1.07296,1.07395,1482,1963.3,-663520,-663203.8,20.366737893450445,59.48513103947604,54.62417101209296,NaN,NaN,50
1673328600,1.07395,1.07442,1.07386,1.07428,1685,1927.75,-661835,-663391.2,20.438628778908004,61.73019752137041,55.00914004447361,NaN,NaN,50
1673330400,1.07428,1.07431,1.07358,1.07364,1753,1887.5,-663588,-663587.6,20.044429751682465,55.32692456876568,54.966979684828104,NaN,NaN,50
1673332200,1.07364,1.07365,1.07265,1.07341,2206,1839.1,-665794,-663947.8,18.858656587904058,53.19152412670445,54.75959860091012,NaN,NaN,50
1673334000,1.07341,1.07376,1.0722,1.07246,3521,1974.35,-669315,-664810.4,18.28772190986276,45.39760044004133,54.48866305716975,NaN,NaN,50
1673335800,1.07246,1.07397,1.07242,1.07318,3034,2092.1,-666281,-665362.6,17.463033226042672,51.23015325276955,54.41531996194219,NaN,NaN,50
1673337600,1.07318,1.07445,1.07314,1.07392,3911,2215.65,-662370,-665469.6,16.37359213239349,56.38660281988618,54.36680578864932,NaN,NaN,50
1673339400,1.07392,1.07474,1.07322,1.07386,3337,2149.05,-665707,-665893.4,15.723426106323886,55.87079438010897,54.25700364667928,NaN,NaN,50
1673341200,1.07386,1.07492,1.07292,1.07475,3654,2224.35,-662053,-665145.2,14.702046938966493,61.49716867507028,54.83302331700292,NaN,NaN,50
1673343000,1.07475,1.07518,1.0736,1.07461,2942,2323.85,-664995,-664281.2,14.09449399549173,60.196998907707,55.31617371822917,NaN,NaN,50
1673344800,1.07461,1.07462,1.0736,1.07374,2509,2332.2,-667504,-664525.8,13.530337690836594,52.735532653581906,55.17154447072211,NaN,NaN,50
1673346600,1.07374,1.07391,1.0734,1.07364,2236,2360.45,-669740,-665999.8,12.692433709540943,51.93863002419983,55.013737901107824,NaN,NaN,50
1673348400,1.07364,1.07426,1.07318,1.07407,2172,2358.5,-667568,-666372,12.422058471808187,55.081864523036785,55.18406951783224,NaN,NaN,50
1673350200,1.07407,1.07407,1.07336,1.07352,2056,2340.65,-669624,-667886.2,12.170995751056342,50.529812272718964,55.04278108610264,NaN,NaN,50
1673352000,1.07352,1.07356,1.07228,1.073,2714,2365.25,-672338,-669354.8,12.265801261936717,46.60801991347027,54.12298743424508,NaN,NaN,50
1673353800,1.073,1.07306,1.07155,1.07194,3030,2392.15,-675368,-670927.6,13.1586062625952,39.82290704600614,52.558180971719075,NaN,NaN,50
1673355600,1.07194,1.07241,1.07174,1.07179,3370,2485.8,-678738,-672727.2,13.987639477492362,38.95859651676023,51.38901468229011,NaN,NaN,50
1673357400,1.07179,1.07254,1.07122,1.07216,3386,2569.7,-675352,-674284,15.2795309542365,42.286055780949454,50.61005265759332,NaN,NaN,50
1673359200,1.07216,1.07512,1.07216,1.07448,6697,2835.2,-668655,-674090.2,15.120783174691743,57.81435457588333,51.49696366729632,NaN,NaN,50
1673361000,1.07448,1.07594,1.07321,1.07404,6981,3133.8,-675636,-674749.8,15.623663542515859,54.80277036186997,51.75215060366064,NaN,NaN,50
1673362800,1.07404,1.07532,1.07328,1.07332,5941,3356.75,-681577,-675991.6,16.090623884066826,50.195063502194245,51.30989779525407,NaN,NaN,50
1673364600,1.07332,1.07342,1.07218,1.07278,6355,3590.25,-687932,-677830.4,15.301847527314818,47.003121608978546,50.67649259731619,NaN,NaN,50
1673366400,1.07278,1.07421,1.07256,1.07344,4214,3713.3,-683718,-679503.6,15.232425686327103,51.0963858725632,49.93357953999425,NaN,NaN,50
1673368200,1.07344,1.07388,1.07242,1.07364,3969,3801.45,-679749,-681722.4,15.018395861495195,52.298706757733285,49.369415814996124,NaN,NaN,50
1673370000,1.07364,1.07416,1.07297,1.07402,2789,3764.85,-676960,-681987.2,15.057558816179512,54.58342224440092,49.50140792862606,NaN,NaN,50
1673371800,1.07402,1.07439,1.07308,1.07335,2091,3717.7,-679051,-681482,15.289815633183949,50.033166074679286,49.36530336080316,NaN,NaN,50
1673373600,1.07335,1.07365,1.0728,1.0729,2241,3634.2,-681292,-680154,15.160320376992251,47.187867591180975,48.80144643709917,NaN,NaN,50
1673375400,1.0729,1.07397,1.07278,1.07381,1830,3558.85,-679462,-679302.8,15.335884746096994,53.0076956085123,48.97843810394155,NaN,NaN,50
1673377200,1.07381,1.07433,1.07377,1.07398,1805,3466.4,-677657,-678884.4,15.821437112427178,54.02692562991917,49.50835994083076,NaN,NaN,50
1673379000,1.07398,1.07412,1.07364,1.07408,1969,3417.75,-675688,-678630,16.090237490257426,54.65002636826147,50.56743989242043,NaN,NaN,50
1673380800,1.07408,1.0744,1.07382,1.074,1770,3380.8,-677458,-678311.4,16.605060025772264,54.01924637544275,51.64320059661203,NaN,NaN,50
1673382600,1.074,1.07426,1.07306,1.07361,1581,3348.05,-679039,-677860.8,16.035784088262474,50.93289613095612,52.260832050183936,NaN,NaN,50
1673384400,1.07361,1.07376,1.07346,1.07368,717,3275.3,-678322,-677632.8,15.507170717717663,51.46885973614047,51.807582418773734,NaN,NaN,50
1673386200,1.07368,1.07376,1.07324,1.07342,566,3200.8,-678888,-677879,14.718413087897828,49.314208736422565,51.415542302670346,NaN,NaN,50
1673388000,1.07342,1.07378,1.0733,1.07358,497,3089.95,-678391,-678419.6,14.011547624404622,50.68245771336564,51.45035617489687,NaN,NaN,50
1673389800,1.07358,1.0737,1.07338,1.07364,4532,3165.05,-673859,-677699.8,13.355172551160932,51.21430548562831,51.751155023228996,NaN,NaN,50
1673391600,1.07364,1.07388,1.07329,1.07361,467,3019.9,-674326,-676757.2,13.00139999436974,50.91862864763729,51.73845807859144,NaN,NaN,50
1673393400,1.07361,1.07394,1.0736,1.07384,546,2877.9,-673780,-675848.8,12.76006346722052,53.15174180673671,51.799389153520245,NaN,NaN,50
1673395200,1.07384,1.07434,1.07374,1.07376,1379,2612,-675159,-675103,13.099533398196526,52.26106703902233,51.63350663885035,NaN,NaN,50
1673397000,1.07376,1.07455,1.07375,1.07452,1787,2352.3,-673372,-674099.2,13.691892560441307,59.2476194294842,52.291681878479274,NaN,NaN,50
1673398800,1.07452,1.07452,1.0728,1.07292,1847,2147.6,-675219,-674371.2,12.80238580921796,44.48674931322979,52.098744858625615,NaN,NaN,50
1673400600,1.07292,1.07344,1.07256,1.0731,1791,1919.4,-673428,-674191.6,12.316950180869217,46.11327181242005,51.6062860160476,NaN,NaN,50
1673402400,1.0731,1.07383,1.07284,1.07372,1384,1777.9,-672044,-673844.4,11.597974179011352,51.3957918812684,51.41834789114397,NaN,NaN,50
1673404200,1.07372,1.07378,1.0727,1.0727,1783,1668.6,-673827,-673578,10.822254316211104,43.790253459683456,50.642649826245545,NaN,NaN,50
1673406000,1.0727,1.07342,1.07266,1.07309,1174,1587.85,-672653,-673434.2,10.165150235017547,47.018563597302176,50.14260105637836,NaN,NaN,50
1673407800,1.07309,1.07369,1.07304,1.07337,1169,1541.75,-671484,-672687.2,9.764920988780725,49.27122593277339,50.02391032793674,NaN,NaN,50
1673409600,1.07337,1.07352,1.07322,1.07344,938,1476.6,-670546,-672110.8,9.393279545846532,49.845353283888755,49.907945581347334,NaN,NaN,50
1673411400,1.07344,1.074,1.07342,1.07388,953,1432.75,-669593,-671620.6,9.808217014978819,53.41434389952123,50.200812378711525,NaN,NaN,50
1673413200,1.07388,1.07458,1.0737,1.07448,1290,1407,-668303,-670515.8,10.960930053818974,57.821961113450875,50.71077690728905,NaN,NaN,50
1673415000,1.07448,1.0757,1.07446,1.07476,1896,1403.35,-666407,-669266.6,13.134367593131053,59.73645981533775,51.31950221655401,NaN,NaN,50
1673416800,1.07476,1.07552,1.07473,1.07529,1700,1399.85,-664707,-667911.2,15.15255959392084,63.1464314195053,52.19291670025887,NaN,NaN,50
1673418600,1.07529,1.07552,1.07458,1.07458,1639,1402.75,-666346,-667071.2,16.709735715252823,56.27113196149686,52.415730282741734,NaN,NaN,50
1673420400,1.07458,1.07574,1.07444,1.07572,2552,1494.5,-663794,-665911.4,18.368315433577216,63.19945653195316,53.19704381795108,NaN,NaN,50
1673422200,1.07572,1.07574,1.07436,1.07468,2812,1606.8,-666606,-665572,19.726971087742655,54.68696008831018,52.87128243643865,NaN,NaN,50
1673424000,1.07468,1.07488,1.07366,1.07378,3551,1759.5,-670157,-666322,19.555008602385318,48.587866682702334,53.16421939140098,NaN,NaN,50
1673425800,1.07378,1.07454,1.0729,1.07298,3347,1700.25,-673504,-668081.4,18.172818690242543,43.90094660957323,53.0061961626262,NaN,NaN,50
1673427600,1.07298,1.07474,1.07256,1.07464,3438,1848.8,-670066,-668825.4,17.33018741631745,53.84910381443956,53.181432729281276,NaN,NaN,50
1673429400,1.07464,1.07482,1.074,1.07416,2352,1939.1,-672418,-670550.2,16.42337708196803,51.03111050018834,53.69863680360306,NaN,NaN,50
1673431200,1.07416,1.07494,1.074,1.07436,2288,1984.55,-670130,-671255,15.388816985404702,52.15461539821166,54.06549764652517,NaN,NaN,50
1673433000,1.07436,1.07512,1.0742,1.07492,2096,2000,-668034,-670830.4,14.441959558523276,55.25050568411436,54.49258905733524,NaN,NaN,50
1673434800,1.07492,1.07524,1.07436,1.07448,2304,2022.85,-670338,-670197.2,13.757640283312082,52.38249337399126,54.67381334948542,NaN,NaN,50
1673436600,1.07448,1.07552,1.07438,1.07484,2435,2055.05,-667903,-669764.6,13.56713559050651,54.46517521873866,54.74887272942952,NaN,NaN,50
1673438400,1.07484,1.07488,1.07282,1.07322,2674,2119.55,-670577,-669396.4,14.043901723588629,44.93975438507969,53.82871510597443,NaN,NaN,50
1673440200,1.07322,1.07412,1.07307,1.07406,2929,2176.85,-667648,-668900,14.486613132879164,49.8384984468655,53.12171786536927,NaN,NaN,50
1673442000,1.07406,1.07508,1.07392,1.07488,3303,2283.3,-664345,-668162.2,13.458536126873982,54.12896386141408,52.47761303979132,NaN,NaN,50
1673443800,1.07488,1.07528,1.07428,1.07498,3972,2423.45,-660373,-666169.2,12.749577093994407,54.63851986772365,52.3609978902361,NaN,NaN,50
1673445600,1.07498,1.07688,1.07452,1.07678,4176,2585.35,-656197,-663828,13.730480690789296,62.67567766092755,52.32358511373427,NaN,NaN,50
1673447400,1.07678,1.07764,1.0755,1.07698,5378,2806.6,-650819,-659876.4,15.211032915099128,63.45056422182589,52.94955683755681,NaN,NaN,50
1673449200,1.07698,1.07748,1.07602,1.0772,4731,2978.65,-646088,-655564.4,16.585831409101118,64.32787319054935,54.07384301668874,NaN,NaN,50
1673451000,1.0772,1.07742,1.0752,1.07552,4348,3101.25,-650436,-652782.6,16.714446810256682,53.723041740206334,54.77542124030539,NaN,NaN,50
1673452800,1.07552,1.07618,1.07496,1.07506,2638,3148.15,-653074,-651322.8,16.526852529265202,51.23255723198888,54.58852505584463,NaN,NaN,50
1673454600,1.07506,1.0759,1.07376,1.07392,1696,3151,-654770,-651037.4,15.672710375873008,45.591750488713735,54.199999340739296,NaN,NaN,50
1673456400,1.07392,1.0744,1.07364,1.07406,1755,3111.15,-653015,-651476.6,14.997546870696585,46.37263979251477,53.78700108318952,NaN,NaN,50
1673458200,1.07406,1.07486,1.07398,1.07468,1302,3035.65,-651713,-652601.6,13.987890648620668,49.8082611921659,53.39826933376463,NaN,NaN,50
1673460000,1.07468,1.07685,1.0735,1.07427,2998,3008,-654711,-653456.6,14.728764436462027,47.63495226144651,53.05915925429714,NaN,NaN,50
1673461800,1.07427,1.07558,1.07422,1.07532,2091,2945.2,-652620,-653365.8,15.416718668029006,53.259684455941425,52.9730527712402,NaN,NaN,50
1673463600,1.07532,1.07552,1.07477,1.07518,1630,2854.8,-654250,-653261.8,16.05553331162691,52.45070939726082,53.50954955782457,NaN,NaN,50
1673465400,1.07518,1.07638,1.07509,1.07634,1742,2824.3,-652508,-653160.4,17.261528997026502,58.12608659106017,54.101520139552754,NaN,NaN,50
1673467200,1.07634,1.07634,1.07547,1.07578,1685,2794.15,-654193,-653656.4,18.381382133468982,54.72991088640947,54.144444927052426,NaN,NaN,50
1673469000,1.07578,1.07592,1.07526,1.0754,1525,2765.6,-655718,-653857.8,19.125724382271745,52.4887870430304,53.99089258243148,NaN,NaN,50
1673470800,1.0754,1.07566,1.0752,1.07558,681,2684.45,-655037,-654341.2,19.729635188875122,53.46093498446122,53.3326966769696,NaN,NaN,50
1673472600,1.07558,1.07582,1.07555,1.07579,564,2590.9,-654473,-654385.8,20.42757666133774,54.62737293554301,52.702468727949395,NaN,NaN,50
1673474400,1.07579,1.07579,1.07536,1.07554,84,2461.4,-654557,-654795.6,20.772274587843825,52.926687097468914,51.88809829272936,NaN,NaN,50
1673476200,1.07554,1.07622,1.07523,1.0758,4863,2558.1,-649694,-653895.8,21.487555630271522,54.51275380029324,51.944506297021285,NaN,NaN,50
1673478000,1.0758,1.0766,1.07564,1.07647,1891,2487.5,-647803,-652312.8,22.477100267283916,58.40232625875601,52.456632656076074,NaN,NaN,50
1673479800,1.07647,1.07677,1.07624,1.07656,1567,2367.25,-646236,-650552.6,23.537897246441677,58.91059622800904,53.40797878031146,NaN,NaN,50
1673481600,1.07656,1.07716,1.07614,1.077,2373,2277.1,-643863,-648430.6,24.838822511968036,61.39414896873546,54.48094372147007,NaN,NaN,50
1673483400,1.077,1.07748,1.07604,1.07614,2525,2134.45,-646388,-646796.8,26.291036493954422,54.464835590412704,54.81355617848771,NaN,NaN,50
1673485200,1.07614,1.07672,1.07614,1.07654,2253,2010.55,-644135,-645685,27.639520905798925,56.90137190504627,55.47544329588769,NaN,NaN,50
1673487000,1.07654,1.07676,1.07606,1.07667,2577,1922,-641558,-644436,28.718171094740125,57.6936892780493,55.79215792603826,NaN,NaN,50
1673488800,1.07667,1.07672,1.07614,1.07638,1690,1874.6,-643248,-643838.4,29.719774841614093,55.2534389750841,55.992352895882775,NaN,NaN,50
1673490600,1.07638,1.0769,1.07626,1.07671,1542,1866.9,-641706,-643407,30.820953249823198,57.4584945712965,55.94466775161394,NaN,NaN,50
1673492400,1.07671,1.07714,1.07668,1.07668,1300,1844.15,-643006,-642730.6,32.06556161864507,57.18261730859528,56.11986106748435,NaN,NaN,50
1673494200,1.07668,1.07692,1.07648,1.07687,896,1823.85,-642110,-642325.6,32.70879106701449,58.54031988333019,56.552113413220056,NaN,NaN,50
1673496000,1.07687,1.07702,1.07661,1.07694,844,1716.15,-641266,-642267.2,33.41298268582557,59.05544157605624,56.95172102690541,NaN,NaN,50
1673497800,1.07694,1.07736,1.07684,1.07716,1166,1669.9,-640100,-641637.6,34.415917638967954,60.70778285251142,57.386036020974586,NaN,NaN,50
1673499600,1.07716,1.07753,1.07688,1.07733,1222,1649.5,-638878,-641072,35.51163631768258,61.98444453774452,58.033018695279985,NaN,NaN,50
1673501400,1.07733,1.07736,1.07624,1.07628,1573,1641.05,-640451,-640561,34.915772935357836,50.96903264077887,57.77989575531468,NaN,NaN,50
1673503200,1.07628,1.0769,1.07595,1.07624,1445,1629.05,-641896,-640518.2,33.73977027791856,50.60011880806229,57.22259522312227,NaN,NaN,50
1673505000,1.07624,1.0763,1.07568,1.07574,1717,1638.65,-643613,-640987.6,32.10361805649789,46.10763904261418,56.30809828130835,NaN,NaN,50
1673506800,1.07574,1.07629,1.07556,1.0759,2406,1724.9,-641207,-641209,30.347914167899848,47.707594439079976,55.330487243475815,NaN,NaN,50
1673508600,1.0759,1.07654,1.07558,1.07626,2278,1810.6,-638929,-641219.2,29.13240042733314,51.21687043033631,55.09848973204179,NaN,NaN,50
1673510400,1.07626,1.07646,1.07468,1.07484,3163,1964.55,-642092,-641547.4,27.684205506140124,39.85535804126144,53.880917313200015,NaN,NaN,50
1673512200,1.07484,1.07568,1.07454,1.0748,2817,1862.25,-644909,-642150,26.546193346454167,39.58894628742438,52.587721385298224,NaN,NaN,50
1673514000,1.0748,1.07676,1.07428,1.07666,3414,1938.4,-641495,-641726.4,25.476910173273172,54.73937310245786,52.55100239439635,NaN,NaN,50
1673515800,1.07666,1.07736,1.07632,1.07654,3572,2038.65,-645067,-642498.4,25.185247833735907,53.801899492756924,52.28981703164352,NaN,NaN,50
1673517600,1.07654,1.07684,1.07516,1.0757,2855,2062.75,-647922,-644297,23.486248368137627,47.650054843479836,51.60891971270671,NaN,NaN,50
1673519400,1.0757,1.07677,1.07518,1.07626,2360,2054.5,-645562,-644991,21.908606007224936,51.62154229209446,51.11472131333273,NaN,NaN,50
1673521200,1.07626,1.07666,1.0759,1.07633,2133,2048.5,-643429,-644695,20.44365238637744,52.110612203435,50.61866207243121,NaN,NaN,50
1673523000,1.07633,1.0766,1.0759,1.07618,2222,2030.75,-645651,-645526.2,19.08333830987619,50.92263609710145,49.919723018473356,NaN,NaN,50
1673524800,1.07618,1.07667,1.07592,1.07654,2454,2068.95,-643197,-645152.2,17.729018639744915,53.65346639769429,49.32465315132691,NaN,NaN,50
1673526600,1.07654,1.07661,1.0755,1.07626,2886,2136.15,-646083,-644784.4,17.086223457896722,51.264182607659194,49.345735291818364,NaN,NaN,50
1673528400,1.07626,1.08122,1.07621,1.0776,4786,2310.45,-641297,-643931.4,19.21116556393832,60.36158971789157,50.04298321394903,NaN,NaN,50
1673530200,1.0776,1.08388,1.07305,1.08292,18760,3203.65,-622537,-639753,18.311452182624556,77.95547234747892,52.31782845001079,NaN,NaN,50
1673532000,1.08292,1.0834,1.07888,1.08146,10352,3679.05,-632889,-637200.6,17.476004042833207,68.91511028344806,53.832651010322806,NaN,NaN,50
1673533800,1.08146,1.08252,1.07518,1.07676,11264,4183.95,-644153,-637391.8,17.8198576307663,49.15346691499218,53.68526504494108,NaN,NaN,50
1673535600,1.07676,1.08032,1.07638,1.07964,10006,4623.15,-634147,-635004.6,18.139150248132747,57.24412289798766,54.92731967756437,NaN,NaN,50
1673537400,1.07964,1.08098,1.07849,1.08069,9319,5010.45,-624828,-631710.8,17.97172994556621,59.75821465266547,56.36798170365302,NaN,NaN,50
1673539200,1.08069,1.08179,1.08024,1.08142,7125,5294.45,-617703,-630744,17.273775420684654,61.45516726023703,56.847681286351545,NaN,NaN,50
1673541000,1.08142,1.0826,1.08068,1.08224,6004,5508.8,-611699,-626506,16.115786038299944,63.32596503104629,57.52797168194365,NaN,NaN,50
1673542800,1.08224,1.08357,1.08214,1.08316,4258,5601.4,-607441,-619163.6,15.454840641501303,65.35751882356834,58.79279053766425,NaN,NaN,50
1673544600,1.08316,1.08491,1.08269,1.08488,4065,5690.75,-603376,-613009.4,15.536095112896856,68.83353998002406,60.02221894394494,NaN,NaN,50
1673546400,1.08488,1.0867,1.08467,1.08497,5159,5790.55,-598217,-607687.2,16.389917438146934,69.00877099099769,61.229230285913715,NaN,NaN,50
1673548200,1.08497,1.08602,1.08463,1.08557,4531,5876.25,-593686,-602883.8,17.15421044506382,70.21122788432936,62.60698684214427,NaN,NaN,50
1673550000,1.08557,1.0856,1.08401,1.08406,3739,5892.5,-597425,-600029,17.41258500656187,63.530505733629745,63.312489651853944,NaN,NaN,50
1673551800,1.08406,1.08504,1.08394,1.08494,3125,5870.15,-594300,-597400.8,17.600669982157818,65.58567012795586,64.33545304616085,NaN,NaN,50
1673553600,1.08494,1.08496,1.08414,1.08468,2743,5864.55,-597043,-596134.2,17.775320316639775,64.43040138704686,64.62608245110052,NaN,NaN,50
1673555400,1.08468,1.08524,1.08458,1.08523,2535,5873.3,-594508,-595392.4,18.09237130297854,65.80267351223358,63.758025391440135,NaN,NaN,50
1673557200,1.08523,1.08553,1.08506,1.08538,990,5816.15,-593518,-595358.8,18.549902838309965,66.18582745123142,63.563076617710365,NaN,NaN,50
1673559000,1.08538,1.08548,1.08492,1.08514,845,5747.3,-594363,-594746.4,18.841056384938536,64.93226391409826,64.69013354621795,NaN,NaN,50
1673560800,1.08514,1.08525,1.08478,1.08498,118,5630.5,-594481,-594782.6,18.971855945856973,64.06116077957768,65.17706482347437,NaN,NaN,50
1673562600,1.08498,1.08508,1.08487,1.0849,605,5516.45,-595086,-594391.2,19.093312680995524,63.60171680765184,65.45160069168769,NaN,NaN,50
1673564400,1.0849,1.08602,1.0847,1.08584,1516,5352.95,-593570,-594203.6,19.83151248219368,66.63012801431105,65.82124074555016,NaN,NaN,50
1673566200,1.08584,1.08603,1.08545,1.08599,1033,4466.6,-592537,-594007.4,20.52335000075796,67.10053191055977,66.0908526655154,NaN,NaN,50
1673568000,1.08599,1.0868,1.08578,1.08644,1949,4046.45,-590588,-593252.4,21.64303284908147,68.53360802038918,66.31771617957403,NaN,NaN,50
1673569800,1.08644,1.08653,1.08512,1.08523,2570,3611.75,-593158,-592987.8,21.89993281643107,60.857328139760135,65.74798676241231,NaN,NaN,50
1673571600,1.08523,1.08549,1.08454,1.0851,2796,3251.25,-595954,-593161.4,21.505462733916698,60.07873486386896,65.11012703904598,NaN,NaN,50
1673573400,1.0851,1.08564,1.0846,1.0856,2661,2918.35,-593293,-593106,21.25461313393826,62.08777395829035,64.5298803300432,NaN,NaN,50
1673575200,1.0856,1.08564,1.08318,1.0838,2727,2698.45,-596020,-593802.6,19.838497745052933,51.951675222912776,63.702821007849124,NaN,NaN,50
1673577000,1.0838,1.08483,1.08373,1.08449,2589,2527.7,-593431,-594371.2,18.523533455373702,54.98542113077403,62.94566036519327,NaN,NaN,50
1673578800,1.08449,1.08478,1.08428,1.08454,1727,2401.15,-591704,-594080.4,17.30249518638584,55.20613270537041,62.286784030787814,NaN,NaN,50
1673580600,1.08454,1.08464,1.08416,1.08458,1114,2253.6,-590590,-593007.6,16.28891029212709,55.39455594011045,61.54334706135045,NaN,NaN,50
1673582400,1.08458,1.08466,1.08398,1.0844,1184,2054.85,-591774,-592703.8,15.53351030887937,54.28789121914853,60.69349447334453,NaN,NaN,50
1673584200,1.0844,1.08464,1.0838,1.08402,1030,1879.8,-592804,-592060.6,15.021302602573064,51.9292763834951,59.76470964973002,NaN,NaN,50
1673586000,1.08402,1.08434,1.08348,1.0835,1285,1757.1,-594089,-592192.2,14.879822473871105,48.80450400044172,58.67494845122031,NaN,NaN,50
1673587800,1.0835,1.08384,1.08318,1.08372,1748,1688.25,-592341,-592319.6,15.052889928708604,50.17064462551073,57.71558615249594,NaN,NaN,50
1673589600,1.08372,1.08433,1.08341,1.08394,2110,1656.6,-590231,-592247.8,14.548566850532248,51.56261198143205,56.6393350072903,NaN,NaN,50
1673591400,1.08394,1.0851,1.08385,1.08451,2293,1644.5,-587938,-591480.6,13.851916963851844,55.065008433464754,55.77965475892637,NaN,NaN,50
1673593200,1.08451,1.08486,1.08332,1.08358,3088,1749.4,-591026,-591125,13.123977578157822,48.85761049559431,54.37422636429816,NaN,NaN,50
1673595000,1.08358,1.0849,1.08342,1.08488,3670,1890.65,-587356,-589778.4,12.399789046507887,56.277303011160015,54.0470817122553,NaN,NaN,50
1673596800,1.08488,1.08586,1.08373,1.08498,4912,2130.35,-582444,-587799,12.361113912518784,56.7965389719636,53.812639148547774,NaN,NaN,50
1673598600,1.08498,1.08646,1.08463,1.08552,4288,2314.5,-578156,-585384,12.881966517231872,59.58748922986232,53.634047382231486,NaN,NaN,50
1673600400,1.08552,1.08603,1.08372,1.08383,3698,2423.6,-581854,-584167.2,12.286927858074193,48.933395009831095,53.41845593843994,NaN,NaN,50
1673602200,1.08383,1.08444,1.08334,1.08425,3097,2526.8,-578757,-581713.4,11.485288835543336,51.265485304377826,53.15274623655449,NaN,NaN,50
1673604000,1.08425,1.08518,1.0842,1.0844,2641,2561.4,-576116,-579465.4,11.319712552548024,52.106705594256056,52.93135858576061,NaN,NaN,50
1673605800,1.0844,1.0847,1.08372,1.08451,2346,2550.2,-573770,-577730.6,10.650955174463196,52.75080605079324,52.74251930795224,NaN,NaN,50
1673607600,1.08451,1.08458,1.08126,1.08149,3376,2579.2,-577146,-577528.6,11.695900528542078,37.74307306226587,51.560746582460624,NaN,NaN,50
1673609400,1.08149,1.08152,1.08082,1.08122,3209,2606.6,-580355,-577228.8,12.927401880028158,36.73677073598972,50.47556760763881,NaN,NaN,50
1673611200,1.08122,1.0816,1.08069,1.08106,2927,2616.6,-583282,-578133.8,14.148767208400034,36.122152081529734,49.56968532771653,NaN,NaN,50
1673613000,1.08106,1.08126,1.08034,1.0812,4006,2687.45,-579276,-578765.8,15.495630869676958,37.113564770360604,48.637036766634374,NaN,NaN,50
1673614800,1.0812,1.08203,1.08084,1.08203,4299,2816.05,-574977,-579007.2,15.87600343172045,42.78328770355264,48.009942175357274,NaN,NaN,50
1673616600,1.08203,1.08204,1.07926,1.07938,5439,3032.3,-580416,-579661.2,17.181338248424733,32.659076005412516,46.409518430496405,NaN,NaN,50
1673618400,1.07938,1.08061,1.07804,1.08016,5509,3248.55,-574907,-578571.6,18.971029593491554,37.35787589975711,45.58810881650803,NaN,NaN,50
1673620200,1.08016,1.08202,1.07962,1.08187,6523,3523.2,-568384,-575592,19.285913621598876,46.21784610389742,44.86957618027499,NaN,NaN,50
1673622000,1.08187,1.08326,1.08134,1.0826,7351,3826.5,-561033,-571943.4,18.59518675301442,49.501488085048734,44.348501116923934,NaN,NaN,50
1673623800,1.0826,1.08388,1.08177,1.08296,5789,4028.55,-555244,-567996.8,17.510130448953678,51.08748354365257,43.741357853623235,NaN,NaN,50
1673625600,1.08296,1.08336,1.0809,1.08187,4548,4150.45,-559792,-563872,17.046795230418063,46.34173890868672,43.55623956068435,NaN,NaN,50
1673627400,1.08187,1.08193,1.0801,1.08102,4441,4257.85,-564233,-561737.2,17.077006339667026,42.98810776072378,42.9649983075662,NaN,NaN,50
1673629200,1.08102,1.08254,1.08066,1.0824,3201,4263.5,-561032,-560266.8,16.633908040053218,49.391515348103155,42.771056147126714,NaN,NaN,50
1673631000,1.0824,1.08318,1.08214,1.0828,2543,4207.15,-558489,-559758,15.74998056121752,51.10574541609362,42.65355181607674,NaN,NaN,50
1673632800,1.0828,1.08305,1.0818,1.08192,1958,4059.45,-560447,-560798.6,15.154905599479765,47.30911791148044,43.336840733877786,NaN,NaN,50
1673634600,1.08192,1.08342,1.08188,1.08312,2018,3945.95,-558429,-560526,14.316598025858527,52.49207466366432,44.46221958585454,NaN,NaN,50
1673636400,1.08312,1.08353,1.08269,1.08328,1844,3853.25,-556585,-558996.4,13.451130565025505,53.15374312054461,45.678761802927035,NaN,NaN,50
1673638200,1.08328,1.08354,1.08267,1.08292,1740,3785.4,-558325,-558455,12.663561801280398,51.41849752855622,46.70054271422673,NaN,NaN,50
1673640000,1.08292,1.08308,1.08271,1.08296,1446,3725.65,-556879,-558133,11.93224794923137,51.60753461654571,47.330846065154795,NaN,NaN,50
1673641800,1.08296,1.08358,1.08294,1.08326,1455,3681.1,-555424,-557128.4,11.364432758553793,53.0820886574197,48.78963268315531,NaN,NaN,50
1673643600,1.08326,1.08346,1.08304,1.08338,659,3545.25,-554765,-556395.6,10.837175795781757,53.689947713842706,49.95620924130428,NaN,NaN,50
1673645400,1.08338,1.08343,1.08289,1.08324,818,3425.7,-555583,-556195.2,10.189350262926936,52.829991702285795,50.428505355474876,NaN,NaN,50
1673820000,1.08324,1.08362,1.08294,1.08294,63,3282.5,-555646,-555659.4,9.785944938627779,50.9468688404489,50.53174683800346,NaN,NaN,50
1673821800,1.08294,1.08354,1.08294,1.08334,1119,3138.15,-554527,-555189,9.41135428034999,53.335285786346645,50.692304141053036,NaN,NaN,50
1673823600,1.08334,1.08358,1.08204,1.08222,2266,3036.5,-556793,-555462.8,9.417583525770707,46.50709925515915,50.70411559437249,NaN,NaN,50
1673825400,1.08222,1.0831,1.08218,1.08228,1598,2844.45,-555195,-555548.8,9.423367825089946,46.899300442174635,50.9834865001904,NaN,NaN,50
1673827200,1.08228,1.08361,1.08214,1.08318,1627,2650.35,-553568,-555145.8,8.794389846612072,52.52241946754692,51.207122508722094,NaN,NaN,50
1673829000,1.08318,1.08444,1.08318,1.08418,2162,2432.3,-551406,-554297.8,9.016566659145589,57.861847074600746,51.68970119861546,NaN,NaN,50
1673830800,1.08418,1.08512,1.08407,1.08466,2422,2185.85,-548984,-553189.2,9.845474624018156,60.176931156473636,52.60883071611497,NaN,NaN,50
1673832600,1.08466,1.08724,1.08466,1.0868,2918,2042.3,-546066,-551043.8,12.029029220849033,68.48902343492914,53.75146991406246,NaN,NaN,50
1673834400,1.0868,1.08743,1.08656,1.08732,2741,1951.95,-543325,-548669.8,14.156640873896686,70.12100721645761,54.96341734948482,NaN,NaN,50
1673836200,1.08732,1.08738,1.08668,1.08668,1870,1823.4,-545195,-546995.2,16.132280266012362,65.61668378651922,55.9775735107679,NaN,NaN,50
1673838000,1.08668,1.08674,1.08616,1.08627,1519,1739.3,-546714,-546056.8,17.263613890663663,62.83215358224017,56.779332008317496,NaN,NaN,50
1673839800,1.08627,1.08652,1.08594,1.08602,1020,1663.15,-547734,-545806.8,18.02513196062075,61.12872538863432,57.35409177483283,NaN,NaN,50
1673841600,1.08602,1.08641,1.08591,1.08628,1017,1616.1,-546717,-545937,18.69130004634738,62.27423301826061,57.96725501086268,NaN,NaN,50
1673843400,1.08628,1.0863,1.08509,1.0853,1318,1581.1,-548035,-546879,18.249606286543454,55.6208265784241,58.16660035915827,NaN,NaN,50
1673845200,1.0853,1.08594,1.08524,1.08545,1258,1551.8,-546777,-547195.4,17.83946208101124,56.388864959481005,58.55531436766056,NaN,NaN,50
1673847000,1.08545,1.08612,1.08532,1.08608,1417,1535.65,-545360,-546924.6,17.63871429484847,59.554818090623286,58.99956667510888,NaN,NaN,50
1673848800,1.08608,1.08608,1.08484,1.08486,1709,1548.8,-547069,-546791.6,16.824287155050712,51.7240622726262,59.37220689064224,NaN,NaN,50
1673850600,1.08486,1.085,1.08361,1.08396,1946,1573.35,-549015,-547251.2,16.498880485056276,46.831950331257715,59.36739616843389,NaN,NaN,50
1673852400,1.08396,1.08426,1.08318,1.08337,2676,1674.2,-551691,-547982.4,16.582382994493862,43.90059571855726,58.75155161493462,NaN,NaN,50
1673854200,1.08337,1.08405,1.08266,1.08313,2688,1767.7,-554379,-549502.8,17.096296869772264,42.72896066306119,57.67063115696751,NaN,NaN,50
1673856000,1.08313,1.08322,1.08072,1.08102,4601,1994.6,-558980,-552226.8,18.82388306839409,34.109926147390766,55.808702227747304,NaN,NaN,50
1673857800,1.08102,1.08139,1.08025,1.08036,3343,2105.8,-562323,-555277.6,20.665170895680333,31.93966118449589,53.198033495573505,NaN,NaN,50
1673859600,1.08036,1.082,1.08015,1.08166,2827,2133.85,-559496,-557373.8,21.618578444770865,40.033011182191835,51.04889092169737,NaN,NaN,50
1673861400,1.08166,1.08242,1.0816,1.08212,2352,2171.55,-557144,-558464.4,22.010891605127885,42.63256498396614,49.407168150086434,NaN,NaN,50
1673863200,1.08212,1.08316,1.08208,1.0831,2332,2206.8,-554812,-558551,21.56691898021385,47.82207440873661,48.33501963769333,NaN,NaN,50
1673865000,1.0831,1.08336,1.08236,1.08302,2086,2203,-556898,-558134.6,20.945760769502257,47.44476488612576,47.35759388751414,NaN,NaN,50
1673866800,1.08302,1.08352,1.08284,1.0832,2139,2188.85,-554759,-556621.8,20.19727880765084,48.430654243520706,46.368766832175574,NaN,NaN,50
1673868600,1.0832,1.08368,1.0824,1.08271,2059,2145.9,-556818,-556086.2,19.881669504576845,45.90606613927184,45.67485537223613,NaN,NaN,50
1673870400,1.08271,1.08285,1.08222,1.08279,2141,2115.9,-554677,-555592.8,19.741834539137354,46.397352857833276,44.96117593640415,NaN,NaN,50
1673872200,1.08279,1.08283,1.08145,1.08152,2251,2134.95,-556928,-556016,20.227670974054735,40.16151315875484,43.57593986984212,NaN,NaN,50
1673874000,1.08152,1.08188,1.08063,1.08063,2236,2170.8,-559164,-556469.2,21.242818338132146,36.46301594551292,42.48586513219117,NaN,NaN,50
1673875800,1.08063,1.08203,1.08059,1.08158,3190,2279.3,-555974,-556712.2,21.986319729777207,42.54520341223422,42.17966892368948,NaN,NaN,50
1673877600,1.08158,1.08257,1.0814,1.08224,2747,2365.8,-553227,-555994,21.976949320129194,46.385134581168934,42.357135985304616,NaN,NaN,50
1673879400,1.08224,1.08245,1.08154,1.0822,2299,2414.85,-555526,-556163.8,21.968248225456037,46.18367571634348,42.603901346253345,NaN,NaN,50
1673881200,1.0822,1.08276,1.08164,1.08172,2034,2453.65,-557560,-556290.2,21.549297596272705,43.72927340006434,43.290997578587174,NaN,NaN,50
1673883000,1.08172,1.08292,1.08163,1.08254,2147,2490.15,-555413,-555540,20.948240824440877,48.740971759471364,44.491091191085424,NaN,NaN,50
1673884800,1.08254,1.08264,1.08204,1.08218,1871,2498.25,-557284,-555802,20.39011667916846,46.771468348874976,44.972409560134224,NaN,NaN,50
1673886600,1.08218,1.08258,1.08174,1.08246,1496,2475.75,-555788,-556314.2,20.198654090840293,48.514043640733995,45.39251517847479,NaN,NaN,50
1673888400,1.08246,1.08268,1.08179,1.08184,923,2388.1,-556711,-556551.2,19.864851171818714,45.00096978262324,45.19100770518097,NaN,NaN,50
1673890200,1.08184,1.08186,1.08118,1.08138,858,2296.6,-557569,-556553,20.210499798323937,42.53966874297533,44.840643694955936,NaN,NaN,50
1673892000,1.08138,1.0815,1.08109,1.08128,416,2087.35,-557985,-557067.4,20.62273478015979,42.00184730988919,44.38144319969655,NaN,NaN,50
1673893800,1.08128,1.0814,1.08116,1.0813,241,1932.25,-557744,-557159.4,21.00552440615022,42.15935139965884,44.11382071829561,NaN,NaN,50
1673895600,1.0813,1.08175,1.08126,1.0817,284,1805.1,-557460,-557493.8,20.721158341688447,45.355582368369106,44.03940854047674,NaN,NaN,50
1673897400,1.0817,1.08195,1.08162,1.08194,409,1707.95,-557051,-557561.8,20.106698996224342,47.23944943275501,44.54497541719104,NaN,NaN,50
1673899200,1.08194,1.08204,1.08176,1.08186,275,1605.1,-557326,-557513.2,19.376675725582373,46.66197731696388,45.27347265800897,NaN,NaN,50
1673901000,1.08186,1.08208,1.08184,1.08206,245,1513.05,-557081,-557332.4,18.624702852075497,48.36149066535966,45.68892174751793,NaN,NaN,50
1673902800,1.08206,1.08245,1.0819,1.08234,415,1426.85,-556666,-557116.8,17.33057293026391,50.728480241722735,45.99916072327177,NaN,NaN,50
1673904600,1.08234,1.08248,1.08202,1.08237,556,1351.7,-556110,-556846.8,16.181820942934237,50.987704475094354,46.34230563461112,NaN,NaN,50
1673906400,1.08237,1.08237,1.0817,1.08212,918,1290.55,-557028,-556842.2,15.506906696006975,48.68884436405895,46.696560703467874,NaN,NaN,50
1673908200,1.08212,1.08242,1.08203,1.0823,2573,1306.65,-554455,-556268,14.780401401771618,50.422060554136586,46.81663847451539,NaN,NaN,50
1673910000,1.0823,1.08314,1.08226,1.08293,1268,1258.25,-553187,-555489.2,14.613179574961762,56.02138024444202,47.477346467055895,NaN,NaN,50
1673911800,1.08293,1.08326,1.08276,1.08298,1069,1152.2,-552118,-554579.6,14.641764440345897,56.44184577440744,48.04361804803256,NaN,NaN,50
1673913600,1.08298,1.08338,1.08262,1.08302,1242,1076.95,-550876,-553532.8,14.375682496975003,56.79769854870057,48.88624153132381,NaN,NaN,50
1673915400,1.08302,1.08325,1.08257,1.08288,1338,1028.9,-552214,-552570,14.021534135925013,55.10096813334482,49.78347720206448,NaN,NaN,50
1673917200,1.08288,1.08317,1.08178,1.08238,2222,1038.3,-554436,-552566.2,13.808540546850082,49.42247331008169,50.313521916363946,NaN,NaN,50
1673919000,1.08238,1.08248,1.0814,1.08174,2194,1040.65,-556630,-553254.8,14.171837219364985,43.274887429080295,50.393203061322616,NaN,NaN,50
1673920800,1.08174,1.0833,1.08122,1.08124,2361,1065.15,-558991,-554629.4,13.255865358926155,39.17506909026678,49.95173782717245,NaN,NaN,50
1673922600,1.08124,1.0815,1.08062,1.08142,2007,1090.7,-556984,-555851,13.069054217029896,41.3299932452786,49.529633813781274,NaN,NaN,50
1673924400,1.08142,1.0823,1.08136,1.08228,1448,1116.95,-555536,-556515.4,12.522966005924541,50.37592697424732,49.794915932158666,NaN,NaN,50
1673926200,1.08228,1.08287,1.08222,1.08252,1272,1137.65,-554264,-556481,12.693054585891256,52.573560437937786,50.09577805877139,NaN,NaN,50
1673928000,1.08252,1.08288,1.08222,1.08274,1182,1175.95,-553082,-555771.4,12.862483780997364,54.56009615746239,50.36946490989565,NaN,NaN,50
1673929800,1.08274,1.08281,1.08243,1.08262,926,1210.2,-554008,-554774.8,13.01981089073875,53.24989534783127,50.531049972233994,NaN,NaN,50
1673931600,1.08262,1.08324,1.08242,1.08281,885,1240.25,-553123,-554002.6,13.68854238178174,55.088861921220676,50.98819408345984,NaN,NaN,50
1673933400,1.08281,1.08318,1.08219,1.0831,1451,1292.35,-551672,-553229.8,13.896225720638045,57.81635956819474,51.51635829874971,NaN,NaN,50
1673935200,1.0831,1.08358,1.08278,1.08296,1691,1363.15,-553363,-553049.6,14.573675610483876,56.04675781506992,51.51817098236598,NaN,NaN,50
1673937000,1.08296,1.08335,1.08136,1.08151,1858,1443.8,-555221,-553477.4,13.95320893643705,41.78263003634635,50.47108414393305,NaN,NaN,50
1673938800,1.08151,1.08208,1.0812,1.08172,3816,1613.85,-551405,-552956.8,13.56514638966961,44.00531301204656,49.55734231988633,NaN,NaN,50
1673940600,1.08172,1.08298,1.08154,1.08281,3097,1740.9,-548308,-551993.8,13.110994744235255,53.853487091902984,49.468236531211915,NaN,NaN,50
1673942400,1.08281,1.08388,1.08281,1.08306,3777,1883.85,-544531,-550565.6,13.584092661822329,55.77471009571832,49.921967730185955,NaN,NaN,50
1673944200,1.08306,1.08374,1.08231,1.08275,3659,1938.15,-548190,-549531,13.384232744380073,52.837163573435376,50.60498745478275,NaN,NaN,50
1673946000,1.08275,1.0831,1.08158,1.08181,3426,2046.05,-551616,-548810,12.48986746310027,45.083363718064085,51.02700849962542,NaN,NaN,50
1673947800,1.08181,1.0822,1.0811,1.08175,3136,2149.4,-554752,-549479.4,12.150101965184858,44.63312743544036,51.262946656065544,NaN,NaN,50
1673949600,1.08175,1.08276,1.08093,1.08105,3861,2280.35,-558613,-551540.4,11.346208949968439,39.65716273589447,50.49732063904033,NaN,NaN,50
1673951400,1.08105,1.08276,1.08092,1.08216,3077,2367.3,-555536,-553741.4,10.588653516356214,49.30807519000856,50.26407169275968,NaN,NaN,50
1673953200,1.08216,1.08264,1.08148,1.08178,2638,2388.1,-558174,-555738.2,9.885209185144864,46.562554330694645,49.69281870513341,NaN,NaN,50
1673955000,1.08178,1.08338,1.08135,1.08323,3389,2447.85,-554785,-556372,10.058678928095611,56.51286394001781,49.92588789028959,NaN,NaN,50
1673956800,1.08323,1.08442,1.08223,1.08442,3460,2502.8,-551325,-555686.6,11.15925456659307,62.6582505150722,50.46655850413613,NaN,NaN,50
1673958600,1.08442,1.08576,1.08346,1.08528,4331,2619,-546994,-553362.8,13.098396835190188,66.35826142794639,51.07669435126125,NaN,NaN,50
1673960400,1.08528,1.08548,1.08364,1.08416,4604,2776.8,-551598,-552575.2,14.899028941744655,58.26177961271149,51.234910193949936,NaN,NaN,50
1673962200,1.08416,1.0858,1.08394,1.08426,5902,3008.3,-545696,-550079.6,16.77172718712154,58.74576973110877,52.44656302929011,NaN,NaN,50
1673964000,1.08426,1.08695,1.08422,1.08626,5927,3245.55,-539769,-547076.4,19.140891179921944,66.99019225053453,54.08834011775357,NaN,NaN,50
1673965800,1.08626,1.08694,1.08608,1.08632,5679,3483.2,-534090,-543629.4,21.340829173236607,67.20195310132657,55.041801975569534,NaN,NaN,50
1673967600,1.08632,1.08639,1.08112,1.08267,9682,3923.05,-543772,-542985,20.8376954638769,47.31630344024939,54.43763007160747,NaN,NaN,50
1673969400,1.08267,1.08274,1.0795,1.08019,7731,4237.05,-551503,-542966,21.172169233961704,38.894747387341276,53.44174320117217,NaN,NaN,50
1673971200,1.08019,1.08092,1.07927,1.08052,5400,4422.5,-546103,-543047.4,21.5871818156714,40.41448692090967,53.108252001375426,NaN,NaN,50
1673973000,1.08052,1.08061,1.07862,1.07928,4427,4550.95,-550530,-545199.6,22.266575681725076,36.71898282517646,52.542955957785146,NaN,NaN,50
1673974800,1.07928,1.07988,1.07816,1.07824,3204,4520.35,-553734,-549128.4,23.100183240299398,33.917685749411376,52.13299331589349,NaN,NaN,50
1673976600,1.07824,1.07868,1.07744,1.07822,2103,4470.65,-555837,-551541.4,24.18063911032797,33.86418123273049,51.02985803323078,NaN,NaN,50
1673978400,1.07822,1.07888,1.07798,1.07881,1866,4375.1,-553971,-552035,24.995798130117446,37.020425832812634,50.348277426239214,NaN,NaN,50
1673980200,1.07881,1.07966,1.07858,1.07952,1689,4276.6,-552282,-553270.8,25.035103802985432,40.68870472547897,49.21798033948644,NaN,NaN,50
1673982000,1.07952,1.08026,1.07914,1.07999,2299,4220.25,-549983,-553161.4,24.552998172844017,43.05329249588606,47.81762619525886,NaN,NaN,50
1673983800,1.07999,1.08039,1.07918,1.07935,2580,4192.45,-552563,-552927.2,23.992837050942665,40.675273539727534,45.98312706038608,NaN,NaN,50
1673985600,1.07935,1.07972,1.0788,1.07902,2205,4109.65,-554768,-552713.4,23.71200299127885,39.46484814162095,44.64048909816533,NaN,NaN,50
1673987400,1.07902,1.07938,1.07867,1.07938,1817,4046.65,-552951,-552509.4,23.534614884499263,41.509712684730765,43.40934216628119,NaN,NaN,50
1673989200,1.07938,1.07939,1.07888,1.0791,737,3951.6,-553688,-552790.6,23.35943430213689,40.367546043943946,41.507724580096145,NaN,NaN,50
1673991000,1.0791,1.07924,1.0788,1.0788,686,3816.45,-554374,-553668.8,23.254843873857993,39.12536179645997,39.50225377260568,NaN,NaN,50
1673992800,1.0788,1.07946,1.0788,1.07926,771,3682,-553603,-553876.8,22.899925236306952,42.06900982468185,39.12744708577942,NaN,NaN,50
1673994600,1.07926,1.07943,1.07905,1.07918,838,3507.35,-554441,-553811.4,22.570357930009564,41.691426263330115,39.32720986263577,NaN,NaN,50
1673996400,1.07918,1.07934,1.07898,1.07921,906,3322.45,-553535,-553928.2,22.327414751944225,41.902011458646506,39.43346161533126,NaN,NaN,50
1673998200,1.07921,1.07934,1.07855,1.07894,888,3071.75,-554423,-554075.2,22.48709022892936,40.48486320342835,39.70245307092068,NaN,NaN,50
1674000000,1.07894,1.07902,1.07824,1.07882,1412,2846,-555835,-554367.4,22.90076589992412,39.83994985871979,40.12547193587128,NaN,NaN,50
1674001800,1.07882,1.07916,1.07832,1.07844,1459,2635,-557294,-555105.6,23.070530755252282,37.78718026226116,40.405686152266334,NaN,NaN,50
1674003600,1.07844,1.07902,1.07834,1.07872,1842,2243,-555452,-555307.8,23.22816954948557,40.2309316859106,40.63500799891619,NaN,NaN,50
1674005400,1.07872,1.07964,1.07863,1.07964,1880,1950.45,-553572,-555315.2,22.414658897339066,47.52462019404985,41.123287675242686,NaN,NaN,50
1674007200,1.07964,1.07994,1.0793,1.07931,1580,1759.45,-555152,-555461,21.236359536139453,45.385201483885176,41.2898526029569,NaN,NaN,50
1674009000,1.07931,1.07934,1.07662,1.07874,7956,1935.9,-563108,-556915.6,22.409843480559164,41.878387832379175,41.375789338146305,NaN,NaN,50
1674010800,1.07874,1.07893,1.0774,1.07764,4852,2018.3,-567960,-559048.8,23.499507143234606,36.083907484891114,41.134293576951315,NaN,NaN,50
1674012600,1.07764,1.07767,1.07683,1.07732,3559,2091.1,-571519,-562262.2,24.8534618147518,34.584737098374816,40.639652463640175,NaN,NaN,50
1674014400,1.07732,1.07748,1.07674,1.07722,2494,2122.5,-574013,-566350.4,26.16371765387357,34.10783818464226,40.192530473690056,NaN,NaN,50
1674016200,1.07722,1.07778,1.07709,1.07748,1727,2124.4,-572286,-569777.2,26.9277889138741,36.557359027841585,40.00910170450303,NaN,NaN,50
1674018000,1.07748,1.07764,1.0768,1.07706,1924,2105.65,-574210,-571997.6,27.8358832051648,34.33677356053478,39.45679911420681,NaN,NaN,50
1674019800,1.07706,1.07802,1.07696,1.07798,2681,2110.7,-571529,-572711.4,28.095560926075507,42.56643011075433,39.51929938902283,NaN,NaN,50
1674021600,1.07798,1.0789,1.07796,1.07852,2535,2127.2,-568994,-572206.4,27.1409631864563,46.782470997543186,39.867903641801156,NaN,NaN,50
1674023400,1.07852,1.07909,1.07817,1.07898,3321,2202.4,-565673,-570538.4,26.018901360044328,50.14014674435365,40.55756675186725,NaN,NaN,50
1674025200,1.07898,1.08206,1.07898,1.08114,4932,2412.15,-560741,-568229.4,25.939987970624724,62.20030373435738,42.15473488584137,NaN,NaN,50
1674027000,1.08114,1.08366,1.0808,1.08255,6208,2688.25,-554533,-564294,26.72012641244225,67.69368166253449,44.290913557289464,NaN,NaN,50
1674028800,1.08255,1.08515,1.08253,1.08431,5536,2926.5,-548997,-559787.6,28.065185691202565,72.97350237675182,46.62966860663527,NaN,NaN,50
1674030600,1.08431,1.08463,1.08352,1.08432,4457,3107.45,-544540,-554896.8,29.314169307194287,73.00050210609508,48.449374457495644,NaN,NaN,50
1674032400,1.08432,1.08566,1.0837,1.08529,3650,3244.65,-540890,-549940.2,30.860404463642837,75.5518626560428,50.604135969792615,NaN,NaN,50
1674034200,1.08529,1.08718,1.08508,1.087,4637,3432.1,-536253,-545042.6,32.77390975345632,79.2707193214417,53.27501679043994,NaN,NaN,50
1674036000,1.087,1.08702,1.08552,1.08557,3779,3550.45,-540032,-542142.4,34.55073609399741,69.71981489920256,55.677581605747896,NaN,NaN,50
1674037800,1.08557,1.08619,1.08498,1.08526,3142,3634.6,-543174,-540977.8,35.60154428231795,67.81237443689429,58.050984272785,NaN,NaN,50
1674039600,1.08526,1.08542,1.08298,1.08304,2972,3691.1,-546146,-541299,34.71090560227662,55.9972695641029,59.61451508560362,NaN,NaN,50
1674041400,1.08304,1.08365,1.08116,1.08152,3652,3779.7,-549798,-543080.6,32.59596443191964,49.622264869989344,60.54772264575703,NaN,NaN,50
1674043200,1.08152,1.08339,1.08144,1.08328,3734,3887.4,-546064,-545042.8,30.632090488016733,55.884869429516556,62.086872350684295,NaN,NaN,50
1674045000,1.08328,1.08336,1.08208,1.0824,3491,3664.15,-549555,-546947.4,28.80849325439261,52.378754060687456,62.78775263282238,NaN,NaN,50
1674046800,1.0824,1.08444,1.08224,1.08411,4089,3626,-545466,-547405.8,27.778793503376892,57.90534182004465,63.5822434058582,NaN,NaN,50
1674048600,1.08411,1.0868,1.08392,1.08584,9364,3916.25,-536102,-545397,27.96766439877517,62.630422039668744,64.47440592695213,NaN,NaN,50
1674050400,1.08584,1.08876,1.08524,1.0879,7036,4143.35,-529066,-541250.6,28.855976536644924,67.33263320448229,64.84100088910391,NaN,NaN,50
1674052200,1.0879,1.08852,1.08479,1.0864,9151,4514.55,-538217,-539681.2,29.337306866770064,61.28548915497525,64.38327285284969,NaN,NaN,50
1674054000,1.0864,1.08688,1.08428,1.08505,7075,4772.1,-545292,-538828.6,29.395584295889034,56.37797687373737,63.19787817406293,NaN,NaN,50
1674055800,1.08505,1.08539,1.08268,1.08334,6631,4969.6,-551923,-540120,28.3397279633287,50.82612622864217,61.61399418281629,NaN,NaN,50
1674057600,1.08334,1.0836,1.08154,1.08236,5565,5121.1,-557488,-544397.2,26.67223089533624,47.91403054122526,59.639863317472184,NaN,NaN,50
1674059400,1.08236,1.08292,1.08136,1.08268,4913,5200.7,-552575,-549099,25.01832334609005,48.94272139691138,57.4735777514343,NaN,NaN,50
1674061200,1.08268,1.0828,1.07873,1.07922,4722,5190.2,-557297,-552915,24.320295729607857,39.79173676292729,55.33585788455749,NaN,NaN,50
1674063000,1.07922,1.07967,1.07882,1.0796,3754,5067.5,-553543,-554565.2,23.672127228588682,41.09438920151015,53.42743036774434,NaN,NaN,50
1674064800,1.0796,1.07994,1.07894,1.07926,3208,4951.1,-556751,-555530.8,22.89635585072322,40.25517243458705,52.30299485849321,NaN,NaN,50
1674066600,1.07926,1.07968,1.0787,1.07967,3177,4887.1,-553574,-554748,22.299441523937872,41.79869841036547,51.7441686828058,NaN,NaN,50
1674068400,1.07967,1.07967,1.07888,1.07932,2864,4847.8,-556438,-555520.6,21.74516393478005,40.828968241707486,50.66874716939086,NaN,NaN,50
1674070200,1.07932,1.07968,1.07872,1.07952,1886,4710.25,-554552,-554971.6,21.322618124331346,41.66185772536898,49.90325457401097,NaN,NaN,50
1674072000,1.07952,1.07952,1.07882,1.07938,2480,4645.3,-557032,-555669.4,20.93025415748612,41.22442071819963,48.71176020959347,NaN,NaN,50
1674073800,1.07938,1.07942,1.07876,1.07894,2164,4596.4,-559196,-556158.4,20.605126857545315,39.809686141794735,47.081707645459616,NaN,NaN,50
1674075600,1.07894,1.07942,1.07894,1.07918,867,4491.15,-558329,-557109.4,20.30322293617171,40.99907126685507,45.2007389356291,NaN,NaN,50
1674077400,1.07918,1.07972,1.07918,1.07946,818,4349.45,-557511,-557324,19.719958799754828,42.42841137776092,43.85380480868522,NaN,NaN,50
1674079200,1.07946,1.07946,1.0789,1.07926,695,4197.5,-558206,-558054.8,19.40010666088022,41.65221522666936,42.801964691037504,NaN,NaN,50
1674081000,1.07926,1.07944,1.07905,1.07926,938,4069.85,-558206,-558289.6,19.103101103353797,41.652215226669355,42.14668533375374,NaN,NaN,50
1674082800,1.07926,1.07952,1.07907,1.07942,1426,3936.7,-556780,-557806.4,18.73204867054579,42.62605780556862,41.76897299549255,NaN,NaN,50
1674084600,1.07942,1.07982,1.07936,1.07977,966,3516.8,-555814,-557303.4,18.024220195419545,44.796574638722234,41.47281965562189,NaN,NaN,50
1674086400,1.07977,1.07984,1.079,1.07942,1857,3257.85,-557671,-557335.4,17.722235794683243,43.042955664624124,41.70504957717167,NaN,NaN,50
1674088200,1.07942,1.07972,1.07864,1.07873,2774,2939,-560445,-557783.2,17.783490764736413,39.7401314643081,41.60831688165724,NaN,NaN,50
1674090000,1.07873,1.07958,1.07864,1.0791,2341,2702.3,-558104,-557762.8,17.84037037978579,42.297060227575145,41.75416600972782,NaN,NaN,50
1674091800,1.0791,1.07934,1.07826,1.07878,2076,2474.55,-560180,-558442.8,18.263117905799756,40.689006795184746,41.674902322929185,NaN,NaN,50
1674093600,1.07878,1.07888,1.07824,1.07886,1670,2279.8,-558510,-558982,18.675232651373207,41.28994178906351,41.70782900488319,NaN,NaN,50
1674095400,1.07886,1.07948,1.07881,1.07937,1306,2099.45,-557204,-558888.6,18.13659112257278,45.10819464477428,41.953995927697854,NaN,NaN,50
1674097200,1.07937,1.07972,1.07928,1.07948,1357,1931.2,-555847,-557969,17.296066927536234,45.9250691454826,42.28975652964664,NaN,NaN,50
1674099000,1.07948,1.08056,1.07943,1.08007,1549,1820.95,-554298,-557207.8,16.662736700393296,50.20537044006509,43.03230540809453,NaN,NaN,50
1674100800,1.08007,1.08023,1.07936,1.07962,1677,1744.4,-555975,-556366.8,15.979136048688538,47.14046277766849,43.47097623029549,NaN,NaN,50
1674102600,1.07962,1.0797,1.07931,1.0796,1263,1648.7,-557238,-556112.4,15.272483923067636,47.00312307606834,43.79774135160316,NaN,NaN,50
1674104400,1.0796,1.0798,1.07912,1.07964,1582,1584.6,-555656,-555802.8,14.335705961635028,47.3336071314782,44.2035550590895,NaN,NaN,50
1674106200,1.07964,1.07968,1.07914,1.07917,1623,1571.45,-557279,-556089.2,13.465840711733321,43.871760335466924,44.36209399543219,NaN,NaN,50
1674108000,1.07917,1.08,1.07914,1.07982,1512,1523.05,-555767,-556383,13.129514667105333,49.385123565177985,44.844884406832854,NaN,NaN,50
1674109800,1.07982,1.08034,1.07908,1.07911,1746,1502.15,-557513,-556690.6,13.28418428377754,44.269807292891436,44.80725816784494,NaN,NaN,50
1674111600,1.07911,1.08016,1.07822,1.07934,3611,1639.35,-553902,-556023.4,12.587677170128591,46.21339718373762,45.03371827635304,NaN,NaN,50
1674113400,1.07934,1.08142,1.07922,1.08078,3288,1762.85,-550614,-555015,12.951280937423562,56.453163334049336,46.22750626704885,NaN,NaN,50
1674115200,1.08078,1.08243,1.08036,1.08202,3859,1921.05,-546755,-552910.2,14.17257351690556,62.98758585786914,47.705400954926986,NaN,NaN,50
1674117000,1.08202,1.08249,1.0814,1.0817,3503,2049.3,-550258,-551808.4,15.354210526636555,60.46599410973875,49.11804290596656,NaN,NaN,50
1674118800,1.0817,1.08247,1.0816,1.08186,3143,2135.15,-547115,-549728.8,16.45144489281534,61.300218742097314,50.54734840261183,NaN,NaN,50
1674120600,1.08186,1.08295,1.08176,1.08248,2965,2235.1,-544150,-547778.4,17.872054943908086,64.43224258897189,51.92763754148308,NaN,NaN,50
1674122400,1.08248,1.08282,1.08159,1.08252,2850,2284.75,-541300,-545915.6,18.898715718986058,64.63112245211306,53.2637842062424,NaN,NaN,50
1674124200,1.08252,1.08385,1.08159,1.08292,3825,2337.3,-537475,-544059.6,20.645026841591484,66.63996330662708,54.43768369671112,NaN,NaN,50
1674126000,1.08292,1.08348,1.08232,1.08248,2849,2362.7,-540324,-542072.8,22.266601455439382,62.43892138412294,55.530430740029296,NaN,NaN,50
1674127800,1.08248,1.08249,1.0816,1.08219,3034,2410.6,-543358,-541321.4,22.571714658794605,59.76470201874876,56.441972093077894,NaN,NaN,50
1674129600,1.08219,1.08258,1.0814,1.08186,2866,2470.4,-546224,-541736.2,22.548729936922758,56.78432810144363,57.11702359093257,NaN,NaN,50
1674131400,1.08186,1.08272,1.08052,1.08092,3836,2596.9,-550060,-543488.2,21.319179793975167,49.25020615510503,57.50119829233529,NaN,NaN,50
1674133200,1.08092,1.08228,1.08088,1.08192,4681,2763.1,-545379,-545069,20.17745466123812,55.946592340022924,57.96987463339564,NaN,NaN,50
1674135000,1.08192,1.08201,1.07956,1.08098,8216,3096.45,-553595,-547723.2,19.81481702819101,49.354202451895176,58.33304571618162,NaN,NaN,50
1674136800,1.08098,1.08218,1.0802,1.08212,5658,3295.5,-547937,-548639,19.262659481799208,56.10892000537406,59.03986877486994,NaN,NaN,50
1674138600,1.08212,1.08251,1.07954,1.08104,6291,3546.9,-554228,-550239.8,19.369968975118173,49.388543763673134,58.535253091271635,NaN,NaN,50
1674140400,1.08104,1.08192,1.08036,1.08036,4958,3715.7,-559186,-552065,19.46961350462864,45.678781893345445,57.29890995094852,NaN,NaN,50
1674142200,1.08036,1.08038,1.07835,1.07892,5902,3929.65,-565088,-556006.8,21.025523072383105,38.9983530631556,55.76550701904972,NaN,NaN,50
1674144000,1.07892,1.07989,1.07876,1.07946,4035,4055.8,-561053,-557498.4,22.470296242440828,42.40028864478034,54.41551201209852,NaN,NaN,50
1674145800,1.07946,1.08095,1.07924,1.08092,3339,4135.45,-557714,-559453.8,22.434174398265856,50.44667856268555,53.41654315307806,NaN,NaN,50
1674147600,1.08092,1.08247,1.08088,1.08174,3268,4118.3,-554446,-559497.4,20.883520247062485,54.30743156591847,52.67913666120702,NaN,NaN,50
1674149400,1.08174,1.08234,1.08098,1.08164,2270,4067.4,-556716,-559003.4,19.443627106659353,53.75737402202408,51.758951712306796,NaN,NaN,50
1674151200,1.08164,1.08232,1.0813,1.08222,3763,4062.6,-552953,-556576.4,18.106583476285017,56.50883036432943,51.33537378232155,NaN,NaN,50
1674153000,1.08222,1.08353,1.08222,1.0829,2829,4028.9,-550124,-554390.6,17.823325632607332,59.54780992766669,51.3198814901014,NaN,NaN,50
1674154800,1.0829,1.08296,1.08211,1.08271,2532,3998.35,-552656,-553379,17.44417390743611,58.3215428519663,51.429682543710165,NaN,NaN,50
1674156600,1.08271,1.08358,1.08271,1.08308,2391,3969.65,-550265,-552542.8,17.589376087569097,60.04698971036355,52.20088136908577,NaN,NaN,50
1674158400,1.08308,1.084,1.08295,1.08355,2086,3931.45,-548179,-550835.4,18.039791070330676,62.18838105990351,52.646723420505815,NaN,NaN,50
1674160200,1.08355,1.08358,1.08279,1.08292,2493,3864.85,-550672,-550379.2,18.263211664389114,57.72238649569553,53.24445085220584,NaN,NaN,50
1674162000,1.08292,1.08348,1.08282,1.08316,1376,3791.2,-549296,-550213.6,18.470673644586235,58.93232806760625,53.446122856651,NaN,NaN,50
1674163800,1.08316,1.08324,1.08298,1.08312,654,3672.2,-549950,-549672.4,18.663316911912133,58.63115521755473,54.10630938907111,NaN,NaN,50
1674165600,1.08312,1.08354,1.0831,1.08319,108,3534.3,-549842,-549587.8,19.11826482721613,59.025790163218865,55.05966712263349,NaN,NaN,50
1674167400,1.08319,1.08354,1.08296,1.08313,403,3362.65,-550245,-550001,19.325957857585685,58.51056821418252,56.453396776278275,NaN,NaN,50
1674169200,1.08313,1.08373,1.08304,1.08361,784,3167.8,-549461,-549758.8,19.70791341229497,61.41241709832322,57.81140595153134,NaN,NaN,50
1674171000,1.08361,1.08373,1.08337,1.08337,491,2781.55,-549952,-549890,20.062586427382165,59.18350631928764,58.43546507700292,NaN,NaN,50
1674172800,1.08337,1.08405,1.08322,1.08382,1046,2550.95,-548906,-549681.2,20.7265551097169,61.97054233552905,58.9828301319751,NaN,NaN,50
1674174600,1.08382,1.0839,1.08288,1.08316,1617,2317.25,-550523,-549817.4,20.729240633349246,55.937629506107626,59.1385626665525,NaN,NaN,50
1674176400,1.08316,1.08442,1.08281,1.08441,1626,2150.65,-548897,-549547.8,21.289956106385286,63.23725312985367,59.619164292661374,NaN,NaN,50
1674178200,1.08441,1.08441,1.08336,1.08364,1852,1948.15,-550749,-549805.4,21.810620474204462,56.975627185701825,59.43543695394959,NaN,NaN,50
1674180000,1.08364,1.0844,1.08314,1.08438,1485,1820.65,-549264,-549667.8,21.870139610834624,60.97492334433279,59.62496413197577,NaN,NaN,50
1674181800,1.08438,1.08442,1.08364,1.08364,1326,1720,-550590,-550004.6,21.95026600659624,55.42648181227667,59.29492785354099,NaN,NaN,50
1674183600,1.08364,1.08386,1.08332,1.08335,1116,1612.4,-551706,-550241.2,21.392638269087662,53.37663274160382,58.66551725937673,NaN,NaN,50
1674185400,1.08335,1.08358,1.08322,1.08343,760,1536.9,-550946,-550651,20.682107319201762,53.8833191877772,58.391298165953984,NaN,NaN,50
1674187200,1.08343,1.08351,1.08279,1.08314,1149,1406.2,-552095,-550920.2,19.23690057533149,51.69032438314655,57.874012188492586,NaN,NaN,50
1674189000,1.08314,1.08338,1.08294,1.08296,1142,1321.85,-553237,-551714.8,17.894922884594806,50.32135179418704,57.28045480110917,NaN,NaN,50
1674190800,1.08296,1.08307,1.08251,1.08267,1270,1258.75,-554507,-552498.2,17.321356611833714,48.1106172388012,56.5007995922222,NaN,NaN,50
1674192600,1.08267,1.08357,1.08266,1.08352,1374,1207.9,-553133,-552783.6,16.273550041282732,54.42992689450281,56.209325212245076,NaN,NaN,50
1674194400,1.08352,1.08368,1.08312,1.0832,1169,1162.05,-554302,-553454.8,15.483346984360194,51.86890130972275,55.52764551305933,NaN,NaN,50
1674196200,1.0832,1.08338,1.0824,1.08247,1462,1110.5,-555764,-554188.6,15.179885827841039,46.494442088447514,54.62128378228505,NaN,NaN,50
1674198000,1.08247,1.08467,1.08209,1.08395,2575,1170.45,-553189,-554179,15.134172150628492,56.36582560011342,54.2209468726125,NaN,NaN,50
1674199800,1.08395,1.08455,1.08352,1.08402,2483,1261.9,-550706,-553418.8,15.091723736073984,56.77204886091008,54.28054825509839,NaN,NaN,50
1674201600,1.08402,1.0859,1.08386,1.08444,3567,1434.85,-547139,-552220,16.39221375743181,59.22488828650416,53.99395076628771,NaN,NaN,50
1674203400,1.08444,1.08502,1.08386,1.08408,2655,1547.45,-549794,-551318.4,17.59981163440694,56.27724330222462,53.9440662031822,NaN,NaN,50
1674205200,1.08408,1.0852,1.08388,1.08428,3285,1672.5,-546509,-549467.4,18.877560064563003,57.5415353018687,53.698824200149055,NaN,NaN,50
1674207000,1.08428,1.08434,1.08285,1.0831,2926,1794.25,-549435,-548716.6,18.435643898754225,48.6104160766737,53.2119623618917,NaN,NaN,50
1674208800,1.0831,1.08408,1.0826,1.08356,2770,1880.45,-546665,-547908.4,17.68618270412978,51.754144088303676,53.09607031522741,NaN,NaN,50
1674210600,1.08356,1.08474,1.08327,1.08388,3311,1965.15,-543354,-547151.4,17.693596204241256,53.868342547233524,53.09500055518857,NaN,NaN,50
1674212400,1.08388,1.08417,1.08314,1.08362,2153,1991.5,-545507,-546294,17.513816783936555,51.87910669109061,53.108485005756,NaN,NaN,50
1674214200,1.08362,1.08374,1.08247,1.0825,2499,2023.85,-548006,-546593.4,16.44489630332971,44.291535775370505,52.67778386155482,NaN,NaN,50
1674216000,1.0825,1.08278,1.08144,1.082,2885,2093.85,-550891,-546884.6,16.21350682784325,41.38178270734197,52.19715282359345,NaN,NaN,50
1674217800,1.082,1.08242,1.0814,1.08185,3009,2178,-553900,-548331.6,16.038223775630893,40.52172176874432,51.203709600324984,NaN,NaN,50
1674219600,1.08185,1.08276,1.08145,1.08244,3109,2277.65,-550791,-549819,15.426825300740607,45.33432622741135,50.73695423730273,NaN,NaN,50
1674221400,1.08244,1.08269,1.08024,1.08066,4262,2452.75,-555053,-551728.2,16.013290349839483,35.897281460784555,49.98001419246966,NaN,NaN,50
1674223200,1.08066,1.08182,1.0806,1.08145,4034,2597,-551019,-552330.8,16.55786503828844,41.698027720846376,48.93231434395059,NaN,NaN,50
1674225000,1.08145,1.0826,1.08046,1.0822,5028,2791.3,-545991,-551350.8,16.04361942912838,46.63522997284195,48.208255851945715,NaN,NaN,50
1674226800,1.0822,1.08454,1.08184,1.08439,4428,2949.2,-541563,-548883.4,16.074664956595814,57.857597699748936,48.11059223860606,NaN,NaN,50
1674228600,1.08439,1.08478,1.08225,1.08311,4911,3126.05,-546474,-548020,16.28554312808538,51.094377829818846,47.74038756200565,NaN,NaN,50
1674230400,1.08311,1.08451,1.08292,1.0839,3679,3251.55,-542795,-545568.4,16.481358573039977,54.62017805807832,47.5317191874492,NaN,NaN,50
1674232200,1.0839,1.08436,1.08273,1.08306,2654,3311.15,-545449,-544454.4,16.431475443004246,50.45494303417178,47.66347111298477,NaN,NaN,50
1674234000,1.08306,1.08474,1.08295,1.08433,2563,3310.55,-542886,-543833.4,16.71869229102188,55.927196392415205,47.96154627756416,NaN,NaN,50
1674235800,1.08433,1.0846,1.08414,1.08439,1860,3279.4,-541026,-543726,16.9853936498954,56.17347975070298,48.126198934954836,NaN,NaN,50
1674237600,1.08439,1.08504,1.08337,1.08416,3369,3269.5,-544395,-543310.2,16.241203510586747,54.906842866856245,48.342465804652385,NaN,NaN,50
1674239400,1.08416,1.08502,1.08414,1.08477,2024,3237.95,-542371,-543225.4,15.550169809800144,57.63526745063873,49.29558949574298,NaN,NaN,50
1674241200,1.08477,1.08551,1.08458,1.08536,1899,3168.65,-540472,-542230,15.431783625486844,60.14697713155993,50.63596052604426,NaN,NaN,50
1674243000,1.08536,1.08585,1.08532,1.0854,1855,3115.1,-538617,-541376.2,15.662275872026802,60.31874543569704,52.05003364511231,NaN,NaN,50
1674244800,1.0854,1.08584,1.08521,1.08557,1607,3056.95,-537010,-540573,15.715949975744872,61.0863843074434,53.175180650828885,NaN,NaN,50
1674246600,1.08557,1.08582,1.08524,1.08566,1680,2975.4,-535330,-538760,15.765790214911652,61.51089404694226,55.00472440698301,NaN,NaN,50
1674248400,1.08566,1.08582,1.08548,1.08577,571,2896.3,-534759,-537237.6,15.812070436995088,62.055731701548495,56.4588461198903,NaN,NaN,50
1674250200,1.08577,1.08582,1.08553,1.08555,576,2800.15,-535335,-536210.2,15.85504492892971,60.21969022517972,57.429164709343,NaN,NaN,50
1674424800,1.08555,1.08672,1.08555,1.08654,179,2664.85,-535156,-535518,16.92382619127718,65.20823872469303,57.954210496838996,NaN,NaN,50
1674426600,1.08654,1.08684,1.08617,1.08683,813,2555.05,-534343,-534984.6,18.0355903151181,66.53221585707973,59.05691321307192,NaN,NaN,50
1674428400,1.08683,1.0869,1.08622,1.08672,1638,2481.5,-535981,-535114.8,19.129838040320827,65.51382060218742,59.83503053765115,NaN,NaN,50
1674430200,1.08672,1.08699,1.08641,1.08644,1171,2326.95,-537152,-535593.4,20.242621717198922,62.87556826244679,60.7222180539565,NaN,NaN,50
1674432000,1.08644,1.08723,1.08644,1.08678,1397,2195.1,-535755,-535677.4,21.53297738311993,64.73277504852473,61.35118795796432,NaN,NaN,50
1674433800,1.08678,1.08874,1.08678,1.08851,2071,2047.25,-533684,-535383,23.929388235343065,72.32048598297129,62.50454554598349,NaN,NaN,50
1674435600,1.08851,1.08992,1.0881,1.0894,2792,1965.45,-530892,-534692.8,26.75209592875901,75.26843322346674,63.95894485716995,NaN,NaN,50
1674437400,1.0894,1.08998,1.08875,1.08948,1545,1797.15,-529347,-533366,29.399537024851156,75.5208062980023,65.23648334626736,NaN,NaN,50
1674439200,1.08948,1.08986,1.08934,1.08986,1366,1681.5,-527981,-531531.8,31.85787518550815,76.73522524231946,66.42135821132162,NaN,NaN,50
1674441000,1.08986,1.0899,1.08901,1.08924,1004,1599,-528985,-530177.8,33.43277204548071,70.58258188766396,67.15448938646212,NaN,NaN,50
1674442800,1.08924,1.09033,1.08924,1.09026,1043,1523,-527942,-529029.4,35.15279415416639,74.24170666583267,68.0941552692042,NaN,NaN,50
1674444600,1.09026,1.09026,1.08964,1.08986,1183,1489.15,-529125,-528676,36.7499575408031,70.53634891564226,68.73883061696849,NaN,NaN,50
1674446400,1.08986,1.08987,1.08902,1.08918,1112,1376.3,-530237,-528854,36.931244887543436,64.63086150461453,68.92276846004464,NaN,NaN,50
1674448200,1.08918,1.08952,1.08892,1.0895,1150,1332.6,-529087,-529075.2,36.903567756705954,66.0704762448667,69.34068174716512,NaN,NaN,50
1674450000,1.0895,1.08972,1.08902,1.08966,1267,1301,-527820,-528842.2,37.062376204047624,66.79815338158073,69.45424707979997,NaN,NaN,50
1674451800,1.08966,1.08984,1.08916,1.08923,1471,1281.8,-529291,-529112,37.321277888614496,62.894199181627855,69.19438874583912,NaN,NaN,50
1674453600,1.08923,1.08938,1.08874,1.08883,1684,1285.65,-530975,-529482,36.676447450761934,59.415504860814536,68.75879476431248,NaN,NaN,50
1674455400,1.08883,1.09122,1.08872,1.09008,2596,1331.45,-528379,-529110.4,37.581418166167154,65.78440547889753,68.96656885120181,NaN,NaN,50
1674457200,1.09008,1.0927,1.08922,1.08943,3906,1498.2,-532285,-529750,39.15533405471906,60.47025158876796,68.66210288979063,NaN,NaN,50
1674459000,1.08943,1.09143,1.0894,1.09142,2783,1608.55,-529502,-530086.4,40.61682737980297,68.78424111860159,68.40951397090706,NaN,NaN,50
1674460800,1.09142,1.09157,1.08938,1.09008,3702,1784.7,-533204,-530869,42.03669450310144,59.68169337769708,67.29617541049494,NaN,NaN,50
1674462600,1.09008,1.09052,1.08933,1.08999,3094,1898.75,-536298,-531933.6,43.259997205335814,59.115844694990805,66.12439243885127,NaN,NaN,50
1674464400,1.08999,1.0903,1.08933,1.09,2634,1948.55,-533664,-532990.6,44.39592114312488,59.162174871112484,64.86917455519362,NaN,NaN,50
1674466200,1.09,1.09205,1.08987,1.09118,2569,2018.45,-531095,-532752.6,46.1857655212896,64.30273616185123,64.42061414620701,NaN,NaN,50
1674468000,1.09118,1.09155,1.09041,1.09052,2551,2076.15,-533646,-533581.4,47.84776387244257,59.770801618715765,63.38697807141295,NaN,NaN,50
1674469800,1.09052,1.09064,1.08956,1.08994,2505,2097.85,-536151,-534170.8,47.886451467357034,56.03339900856262,62.35105307805011,NaN,NaN,50
1674471600,1.08994,1.09025,1.08878,1.08905,2900,2103.25,-539051,-534721.4,46.762764656426015,50.78569971362247,61.3621129501221,NaN,NaN,50
1674473400,1.08905,1.08908,1.0879,1.08813,2884,2170.2,-541935,-536375.6,44.61179025085756,45.99084086065609,59.92785327982135,NaN,NaN,50
1674475200,1.08813,1.08822,1.08686,1.08706,3330,2268.4,-545265,-539209.6,41.531894002636484,41.12737359828559,58.09422615244313,NaN,NaN,50
1674477000,1.08706,1.08834,1.08669,1.0871,3686,2402.5,-541579,-540796.2,38.62077175088858,41.37695024881953,56.55727980009967,NaN,NaN,50
1674478800,1.0871,1.08778,1.08677,1.08744,3556,2528.15,-538023,-541170.6,35.91758680283695,43.56687042826156,55.425234483488744,NaN,NaN,50
1674480600,1.08744,1.0875,1.08532,1.0859,4984,2718.2,-543007,-541961.8,34.69121016334774,36.85187195660706,53.358624946182296,NaN,NaN,50
1674482400,1.0859,1.08606,1.08462,1.0852,4415,2883.35,-547422,-543059.2,34.05191304672379,34.26650957327624,51.486929087932886,NaN,NaN,50
1674484200,1.0852,1.08684,1.08472,1.08617,5937,3122.7,-541485,-542303.2,32.61754093636386,40.49618033151302,49.46635331742656,NaN,NaN,50
1674486000,1.08617,1.08626,1.0847,1.08582,5132,3315.95,-546617,-543310.8,31.30146668648412,39.057820968928525,47.99321957394309,NaN,NaN,50
1674487800,1.08582,1.08692,1.08573,1.08648,5949,3539.85,-540668,-543839.8,29.394783093931583,43.15782782701921,46.85336122623084,NaN,NaN,50
1674489600,1.08648,1.0876,1.08627,1.08664,5101,3710.7,-535567,-542351.8,27.60259764594575,44.13897961464027,45.78027585076853,NaN,NaN,50
1674491400,1.08664,1.0869,1.08598,1.08642,3348,3748.3,-538915,-540650.4,25.657886500162196,43.03892479427756,44.261432181656126,NaN,NaN,50
1674493200,1.08642,1.0865,1.0857,1.08594,2393,3672.65,-541308,-540615,24.06841762097703,40.658022719667535,42.896233688866964,NaN,NaN,50
1674495000,1.08594,1.08642,1.08582,1.08626,2072,3637.1,-539236,-539138.8,22.592482233162233,42.92486092175797,41.95990953980949,NaN,NaN,50
1674496800,1.08626,1.08692,1.08623,1.08687,2199,3561.95,-537037,-538412.6,21.270121782638917,47.07518844529145,41.694873020642994,NaN,NaN,50
1674498600,1.08687,1.08732,1.08648,1.08664,2067,3510.6,-539104,-539120,20.44439644128378,45.725068234192605,41.67588926160989,NaN,NaN,50
1674500400,1.08664,1.08673,1.08616,1.08616,2164,3487.1,-541268,-539590.6,19.30042304071358,42.956187883132515,41.80651885338467,NaN,NaN,50
1674502200,1.08616,1.08642,1.08475,1.08592,3072,3512.25,-544340,-540197,18.992505838555587,41.599764139947716,41.82243413132239,NaN,NaN,50
1674504000,1.08592,1.0865,1.08572,1.08616,2839,3526.65,-541501,-540650,18.614310356542973,43.520403901948875,41.81911509372863,NaN,NaN,50
1674505800,1.08616,1.08684,1.08586,1.08682,2171,3509.95,-539330,-541108.6,17.865970827048866,48.53315602050386,42.65349252686411,NaN,NaN,50
1674507600,1.08682,1.08716,1.0865,1.08716,680,3398.95,-538650,-541017.8,16.80630212560942,50.94838135168567,43.8450547967505,NaN,NaN,50
1674509400,1.08716,1.08718,1.08689,1.08718,542,3281.85,-538108,-540385.8,15.799005068054136,51.093769855311145,44.6020254770218,NaN,NaN,50
1674511200,1.08718,1.08735,1.08706,1.08706,115,3121.1,-538223,-539162.4,14.684135773122788,50.13361414003443,45.39315356067222,NaN,NaN,50
1674513000,1.08706,1.08713,1.08696,1.08708,295,2951.55,-537928,-538447.8,13.747184930771153,50.30124449733377,45.903397608551835,NaN,NaN,50
1674514800,1.08708,1.08748,1.0868,1.08722,1216,2834.55,-536712,-537924.2,13.103288735675195,51.52954491122583,46.43129512973652,NaN,NaN,50
1674516600,1.08722,1.08761,1.08713,1.08714,695,2620.1,-537407,-537675.6,12.670119681201466,50.75756412550708,46.98262651053863,NaN,NaN,50
1674518400,1.08714,1.08747,1.08678,1.08721,1086,2453.65,-536321,-537318.2,11.766437847359079,51.44304347902625,47.7529851362071,NaN,NaN,50
1674520200,1.08721,1.0875,1.08716,1.08737,1344,2224,-534977,-536669,10.97028059116075,53.051764550631034,48.47633539541233,NaN,NaN,50
1674522000,1.08737,1.08776,1.08718,1.08746,923,2013.55,-534054,-535894.2,10.608484040329065,53.975454068264874,48.969211511339,NaN,NaN,50
1674523800,1.08746,1.08827,1.08746,1.0881,1223,1777.25,-532831,-535118,10.95129842116401,60.00198425306901,49.98899122697303,NaN,NaN,50
1674525600,1.0881,1.0883,1.08794,1.08801,988,1571.6,-533819,-534400.4,11.308036709893063,58.835274505022795,51.12321169996519,NaN,NaN,50
1674527400,1.08801,1.08806,1.08778,1.0879,787,1443.55,-534606,-534057.4,11.347560844731234,57.36704300424539,52.24944590455789,NaN,NaN,50
1674529200,1.0879,1.08805,1.08764,1.08792,855,1366.65,-533751,-533812.2,11.127563997974903,57.57434681465078,53.25329896975088,NaN,NaN,50
1674531000,1.08792,1.088,1.08732,1.08746,855,1305.8,-534606,-533922.6,10.356529526166845,51.38543384258157,53.457033099899284,NaN,NaN,50
1674532800,1.08746,1.0875,1.08694,1.08736,1018,1246.75,-535624,-534481.2,10.20710112693414,50.12401855538537,53.39815004302069,NaN,NaN,50
1674534600,1.08736,1.08766,1.08728,1.08766,624,1174.6,-535000,-534717.4,9.779106576435424,53.788981132754664,53.590665134266665,NaN,NaN,50
1674536400,1.08766,1.0881,1.08756,1.08798,678,1100.3,-534322,-534660.6,9.521843622092062,57.38600826761181,54.10869328623647,NaN,NaN,50
1674538200,1.08798,1.08828,1.08772,1.08782,961,994.75,-535283,-534967,9.56499240200607,55.07752223004956,54.44985598143046,NaN,NaN,50
1674540000,1.08782,1.08856,1.08774,1.08851,941,899.85,-534342,-534914.2,10.027839162818255,62.14903024287544,55.208390647976856,NaN,NaN,50
1674541800,1.08851,1.08919,1.08799,1.0888,1632,872.9,-532710,-534331.4,11.28289214870271,64.66652339257347,56.2018877384816,NaN,NaN,50
1674543600,1.0888,1.08924,1.08834,1.08914,2257,951.75,-530453,-533422,12.5084199817814,67.40383010240402,57.34194392586573,NaN,NaN,50
1674545400,1.08914,1.08981,1.08856,1.08889,2310,1040.15,-532763,-533110.2,14.284819194284967,63.50790455442741,58.08881106899405,NaN,NaN,50
1674547200,1.08889,1.0896,1.08813,1.08886,3080,1188.4,-535843,-533222.2,15.030364146205374,63.037048807285004,58.73606783606691,NaN,NaN,50
1674549000,1.08886,1.08886,1.08665,1.08753,3600,1353.65,-539443,-534242.4,14.45855034640268,46.55695358423004,57.77570850257842,NaN,NaN,50
1674550800,1.08753,1.08832,1.08684,1.08692,3091,1447.4,-542534,-536207.2,13.927580389443031,41.232593988581804,56.51837417997549,NaN,NaN,50
1674552600,1.08692,1.08721,1.0852,1.0861,4100,1617.65,-546634,-539443.4,15.071509314718753,35.37582491286088,54.947572887733735,NaN,NaN,50
1674554400,1.0861,1.08655,1.08521,1.08598,3110,1718.85,-549744,-542839.6,16.13372903104621,34.60125369536691,53.30663766492775,NaN,NaN,50
1674556200,1.08598,1.08666,1.08582,1.0864,2533,1778.3,-547211,-545113.2,16.945454995530387,39.58708201200792,52.463898248458214,NaN,NaN,50
1674558000,1.0864,1.08691,1.08538,1.08674,2274,1845.85,-544937,-546212,18.087437554938575,43.35209159565694,51.980189179906176,NaN,NaN,50
1674559800,1.08674,1.0876,1.08642,1.08668,2041,1886.75,-546978,-547100.8,18.080790233582928,42.84464558291777,51.19845092634639,NaN,NaN,50
1674561600,1.08668,1.08744,1.08636,1.08742,1684,1921.55,-545294,-546832.8,18.135619034539936,50.534947891711,50.7090894709249,NaN,NaN,50
1674563400,1.08742,1.08766,1.08591,1.08598,2717,2018.05,-548011,-546486.2,18.636273614359148,39.41977769988731,49.590679147341895,NaN,NaN,50
1674565200,1.08598,1.0881,1.08542,1.0878,3572,2153.9,-544439,-545931.8,19.547068285091214,53.377472250413966,48.96413929073749,NaN,NaN,50
1674567000,1.0878,1.08788,1.08578,1.0866,4315,2326.9,-548754,-546695.2,20.392806193628136,45.872786809751325,47.621729534821625,NaN,NaN,50
1674568800,1.0866,1.08701,1.08556,1.08634,3708,2461.4,-552462,-547792,21.3820989871515,44.41569233472487,45.97971969427312,NaN,NaN,50
1674570600,1.08634,1.08692,1.08405,1.08422,7170,2788.7,-559632,-550659.6,23.40569769639116,34.72906007554994,43.92408794578187,NaN,NaN,50
1674572400,1.08422,1.08622,1.08352,1.08619,7120,3110.8,-552512,-551559.8,25.57808193768711,46.42231393521294,42.737321169205295,NaN,NaN,50
1674574200,1.08619,1.08807,1.0851,1.08753,5819,3353.7,-546693,-552010.6,25.014715602704623,52.637743542412224,43.17166330907545,NaN,NaN,50
1674576000,1.08753,1.0883,1.08702,1.08824,4045,3508.9,-542648,-550789.4,24.23529230606716,55.57824338862808,44.1963525519359,NaN,NaN,50
1674577800,1.08824,1.08835,1.08672,1.08718,3229,3588.75,-545877,-549472.4,23.763510726845404,50.53390898320852,45.27907284267502,NaN,NaN,50
1674579600,1.08718,1.08838,1.08703,1.08804,2752,3613.5,-543125,-546171,23.28843181304935,54.16838249064824,46.67672489948084,NaN,NaN,50
1674581400,1.08804,1.0887,1.08796,1.08835,2272,3611.6,-540853,-543839.2,22.44454886670729,55.43934689834897,47.809029534219476,NaN,NaN,50
1674583200,1.08835,1.0889,1.08804,1.08868,1726,3543.9,-539127,-542326,21.41101901892331,56.81232912805192,48.77047507224769,NaN,NaN,50
1674585000,1.08868,1.08878,1.08767,1.08792,1348,3431.3,-540475,-541891.4,20.83817214214709,52.77904141964429,49.480074774871014,NaN,NaN,50
1674586800,1.08792,1.0881,1.0874,1.08763,1166,3335.05,-541641,-541044.2,20.579719978677698,51.28294810925382,49.53350336183836,NaN,NaN,50
1674588600,1.08763,1.08847,1.08758,1.08839,1347,3197.4,-540294,-540478,19.82694368500184,54.89167612000532,50.63863896327536,NaN,NaN,50
1674590400,1.08839,1.08848,1.08795,1.08833,878,3085.8,-541172,-540541.8,19.11395099483177,54.54813761575355,50.72225791794248,NaN,NaN,50
1674592200,1.08833,1.08838,1.08792,1.08815,1284,3023.35,-542456,-541207.6,18.488694986199686,53.467049519626315,51.26470525436212,NaN,NaN,50
1674594000,1.08815,1.08857,1.08808,1.08844,1377,2978.5,-541079,-541328.4,17.61231202908302,55.01397348916179,52.021725336821895,NaN,NaN,50
1674595800,1.08844,1.08891,1.0883,1.08882,826,2917.75,-540253,-541050.8,16.4216866666296,57.02976844696773,53.61463307763746,NaN,NaN,50
1674597600,1.08882,1.08893,1.08862,1.08864,117,2839.4,-540370,-541066,15.346203020099376,55.75530177665371,54.28127506631181,NaN,NaN,50
1674599400,1.08864,1.08885,1.08825,1.08865,516,2729.35,-539854,-540802.4,14.718213262943907,55.8143789918951,54.50817759841772,NaN,NaN,50
1674601200,1.08865,1.08876,1.08838,1.08864,1051,2603.3,-540905,-540492.2,14.135079917013831,55.73423600693337,54.51931992829667,NaN,NaN,50
1674603000,1.08864,1.08905,1.0883,1.08899,1055,2440.3,-539850,-540246.4,13.16193601241355,58.0069737190255,55.053110266569306,NaN,NaN,50
1674604800,1.08899,1.08905,1.08814,1.08826,1112,2310.5,-540962,-540388.2,12.457423414186527,52.00906441157827,54.89887326092145,NaN,NaN,50
1674606600,1.08826,1.089,1.08808,1.08872,2465,2075.25,-538497,-540013.6,11.90737215859745,55.15570094865075,54.878612835943,NaN,NaN,50
1674608400,1.08872,1.08938,1.0884,1.08912,1777,1808.1,-536720,-539386.8,11.414784674235868,57.749892416846755,54.94558164228549,NaN,NaN,50
1674610200,1.08912,1.08942,1.08878,1.08932,1119,1573.1,-535601,-538326,11.028349025239867,59.02620104873409,55.39180733007762,NaN,NaN,50
1674612000,1.08932,1.09,1.0893,1.08996,974,1419.55,-534627,-537281.4,11.612143298134782,62.88950836757479,56.22084734852911,NaN,NaN,50
1674613800,1.08996,1.09016,1.08956,1.08967,1099,1313.05,-535726,-536234.2,12.385320563414124,60.12321687375459,56.59452883093978,NaN,NaN,50
1674615600,1.08967,1.08988,1.08926,1.08979,1180,1234.45,-534546,-535444,12.449093088124236,60.889831948894596,57.0475069975927,NaN,NaN,50
1674617400,1.08979,1.08996,1.08948,1.08972,1158,1178.75,-535704,-535240.8,12.638577889428227,60.16324107223471,57.525806394207585,NaN,NaN,50
1674619200,1.08972,1.09028,1.0897,1.08996,851,1135,-534853,-535091.2,13.318247353616709,61.844372437683354,58.0136920333877,NaN,NaN,50
1674621000,1.08996,1.09012,1.08972,1.08989,952,1115.2,-535805,-535326.8,13.949368998934583,61.03533160057077,58.29980368721648,NaN,NaN,50
1674622800,1.08989,1.08995,1.08956,1.08984,861,1099.95,-536666,-535514.8,14.13444546225475,60.42725294984385,58.6335144853015,NaN,NaN,50
1674624600,1.08984,1.08986,1.0892,1.08976,1113,1088.25,-537779,-536161.4,13.472253087157998,59.407432083652246,58.89016113471273,NaN,NaN,50
1674626400,1.08976,1.09112,1.0896,1.09066,1493,1119,-536286,-536277.8,14.720189647448962,66.29838076451102,59.64474290311113,NaN,NaN,50
1674628200,1.09066,1.09084,1.0899,1.09064,1627,1136.15,-537913,-536889.8,15.878987882004855,66.030126405442,60.21782523785516,NaN,NaN,50
1674630000,1.09064,1.09114,1.09012,1.09044,2422,1188.4,-540335,-537795.8,17.30212140437038,63.27305901770938,61.022396281150236,NaN,NaN,50
1674631800,1.09044,1.09054,1.08786,1.08811,2875,1290.85,-543210,-539104.6,17.034164650076143,41.521549114045776,60.04852829296417,NaN,NaN,50
1674633600,1.08811,1.08914,1.08786,1.08864,3376,1453.8,-539834,-539515.6,16.785347663945785,46.0636498739887,59.21379668276002,NaN,NaN,50
1674635400,1.08864,1.08904,1.0868,1.08774,2894,1572.7,-542728,-540804,17.573520672608275,40.33451476167126,57.87867623368411,NaN,NaN,50
1674637200,1.08774,1.08829,1.087,1.08818,2819,1661.1,-539909,-541203.2,18.305395609223446,44.001442948617374,56.52952870375857,NaN,NaN,50
1674639000,1.08818,1.0892,1.08795,1.08814,2702,1743.45,-542611,-541658.4,17.696360729916087,43.738275071218986,55.359175717863174,NaN,NaN,50
1674640800,1.08814,1.08814,1.08632,1.0871,3008,1838.25,-545619,-542140.2,18.509919525197354,37.46431455121361,53.68592447517168,NaN,NaN,50
1674642600,1.0871,1.08724,1.08639,1.08659,2658,1847.9,-548277,-543828.8,19.265366977958532,34.826120433584805,51.87613014383954,NaN,NaN,50
1674644400,1.08659,1.08698,1.08574,1.0864,2544,1886.25,-550821,-545447.4,20.423021707150266,33.869229624475594,49.87790565718184,NaN,NaN,50
1674646200,1.0864,1.08652,1.08574,1.08646,2228,1941.7,-548593,-547184.2,21.497986812828305,34.48144457618335,47.98119944115417,NaN,NaN,50
1674648000,1.08646,1.08692,1.08585,1.08634,2346,2010.3,-550939,-548849.8,21.911772436779543,33.80734189482662,46.07977722293865,NaN,NaN,50
1674649800,1.08634,1.08772,1.08594,1.08748,2845,2097.6,-548094,-549344.8,21.249450323576085,44.83985157942085,45.03923575835069,NaN,NaN,50
1674651600,1.08748,1.0885,1.08724,1.08734,3518,2214.5,-551612,-550011.8,19.766894000104514,43.87276061409341,43.437405747606576,NaN,NaN,50
1674653400,1.08734,1.0877,1.08644,1.08722,3527,2332.95,-555139,-550875.4,19.146655173510155,43.01636436679943,41.79356560198925,NaN,NaN,50
1674655200,1.08722,1.08864,1.08687,1.08839,3827,2481.75,-551312,-551419.2,17.92906275534216,52.709105626156976,41.03899750259264,NaN,NaN,50
1674657000,1.08839,1.09004,1.08799,1.08939,5579,2713.1,-545733,-550378,17.916728894647104,59.1109142495709,42.295380726558726,NaN,NaN,50
1674658800,1.08939,1.09237,1.08921,1.09096,7544,3047.25,-538189,-548397,19.213961940419587,66.72656662448802,43.77130335159439,NaN,NaN,50
1674660600,1.09096,1.09124,1.0891,1.09024,5622,3272.7,-543811,-546836.8,20.30967973823057,61.1057511714281,45.254963095148454,NaN,NaN,50
1674662400,1.09024,1.09034,1.08742,1.08884,5346,3465.35,-549157,-545640.4,19.832150390222615,51.9433244971345,45.82224034861397,NaN,NaN,50
1674664200,1.08884,1.09014,1.08856,1.09002,3430,3555.5,-545727,-544523.4,19.38873028135809,57.700416512690005,46.8195361658619,NaN,NaN,50
1674666000,1.09002,1.09013,1.08941,1.08952,2050,3536.9,-547777,-544932.2,18.976983037412456,54.709626788521575,48.051344182812464,NaN,NaN,50
1674667800,1.08952,1.09038,1.0895,1.08992,1738,3480.05,-546039,-546502.2,18.768002044745316,56.645665880896765,49.60988314333475,NaN,NaN,50
1674669600,1.08992,1.09182,1.08992,1.09126,2258,3424.15,-543781,-546496.2,19.46395060962516,62.43837921627269,51.65053668560597,NaN,NaN,50
1674671400,1.09126,1.09157,1.09084,1.09092,1694,3364.15,-545475,-545759.8,20.110188562727878,60.23906861695517,53.490366974232536,NaN,NaN,50
1674673200,1.09092,1.09138,1.09068,1.09094,1899,3318.15,-543576,-545329.6,20.537993747949926,60.32759225770984,55.38467057158133,NaN,NaN,50
1674675000,1.09094,1.09152,1.09076,1.09146,1477,3256.9,-542099,-544194,21.026969617726856,62.655609159495555,56.65722468444381,NaN,NaN,50
1674676800,1.09146,1.09176,1.09065,1.09098,1352,3174.1,-543451,-543676.4,21.642247817867634,59.20212519139061,57.7521792971079,NaN,NaN,50
1674678600,1.09098,1.09148,1.09093,1.09146,1372,3109.8,-542079,-543336,22.21357757514122,61.48812820257163,59.07159099966306,NaN,NaN,50
1674680400,1.09146,1.09176,1.09114,1.0916,913,3028.25,-541166,-542474.2,22.946938167975617,62.15421112821278,59.746241392667045,NaN,NaN,50
1674682200,1.0916,1.09179,1.09148,1.09152,1111,2972.4,-542277,-542214.4,23.650271743665158,61.499645910751745,59.916865082751386,NaN,NaN,50
1674684000,1.09152,1.09172,1.09138,1.09154,120,2861.1,-542157,-542226,24.1481153549752,61.60849934754973,59.55128884868437,NaN,NaN,50
1674685800,1.09154,1.09185,1.09134,1.09148,644,2751.05,-542801,-542096,24.721413789263718,61.05083234333728,59.547366075249315,NaN,NaN,50
1674687600,1.09148,1.09228,1.09137,1.09212,1018,2626.05,-541783,-542036.8,25.611784765773315,64.71930171810627,60.45993587674726,NaN,NaN,50
1674689400,1.09212,1.09232,1.09206,1.09207,787,2489.05,-542570,-542317.6,26.471529493244123,64.21047801614631,60.92494026985128,NaN,NaN,50
1674691200,1.09207,1.09248,1.09197,1.09218,1395,2367.45,-541175,-542097.2,27.406525739302406,64.86493578333625,61.650319483766616,NaN,NaN,50
1674693000,1.09218,1.09224,1.09158,1.09158,1473,2162.15,-542648,-542195.4,27.531633351934925,58.57323333451893,61.78800287331105,NaN,NaN,50
1674694800,1.09158,1.0916,1.0907,1.0908,1537,1861.8,-544185,-542472.2,26.2329678644372,51.57021645718825,61.01170553337645,NaN,NaN,50
1674696600,1.0908,1.09213,1.09071,1.09192,1522,1656.8,-542663,-542648.2,25.612859444129203,59.12690617399039,60.93226535887896,NaN,NaN,50
1674698400,1.09192,1.09218,1.09127,1.09132,1120,1445.5,-543783,-542890.8,25.090681893510702,54.24389374380727,60.497715465028776,NaN,NaN,50
1674700200,1.09132,1.09181,1.09108,1.09154,1321,1340.05,-542462,-543148.2,24.302166274259637,55.68890513129199,60.00009374872853,NaN,NaN,50
1674702000,1.09154,1.09179,1.09124,1.09156,1229,1299,-541233,-542865.2,23.569973199240792,55.825484782749044,59.758905148111275,NaN,NaN,50
1674703800,1.09156,1.0916,1.09113,1.09132,789,1251.55,-542022,-542432.6,22.69816145049614,53.68698853647838,59.201680886247466,NaN,NaN,50
1674705600,1.09132,1.09184,1.09128,1.09158,1100,1193.65,-540922,-542084.4,22.220690430000154,55.66823192931883,58.73839665775505,NaN,NaN,50
1674707400,1.09158,1.0917,1.09132,1.09144,950,1156.45,-541872,-541702.2,21.777324482396736,54.32069856435419,58.225614704440936,NaN,NaN,50
1674709200,1.09144,1.09144,1.09092,1.09128,833,1103.15,-542705,-541750.8,20.6028307446388,52.74916268842392,57.592804943074796,NaN,NaN,50
1674711000,1.09128,1.09189,1.09098,1.09188,1153,1086.95,-541552,-541814.6,20.19066852529498,57.69221486428542,57.35290369457109,NaN,NaN,50
1674712800,1.09188,1.0921,1.09172,1.0919,1130,1075.85,-540422,-541494.6,20.099970848623798,57.850500511487475,56.86227503695547,NaN,NaN,50
1674714600,1.0919,1.09296,1.09188,1.09204,1482,1081.35,-538940,-541098.2,21.027611227175157,59.00665877400338,56.49057366251669,NaN,NaN,50
1674716400,1.09204,1.09204,1.09066,1.09152,3204,1195.9,-542144,-541152.6,19.886167766632905,53.17257635429635,55.655405131870985,NaN,NaN,50
1674718200,1.09152,1.09226,1.0915,1.092,2490,1264.85,-539654,-540542.4,19.092847557190566,57.36320049989232,55.56897421511194,NaN,NaN,50
1674720000,1.092,1.09282,1.09118,1.09181,3392,1428.45,-543046,-540841.2,18.989974312676654,55.25530314231665,55.83219469262111,NaN,NaN,50
1674721800,1.09181,1.09214,1.09058,1.09091,2916,1542.05,-545962,-541949.2,18.046438658827245,46.532669281250044,54.93260634313965,NaN,NaN,50
1674723600,1.09091,1.09101,1.0897,1.08974,2781,1630.2,-548743,-543909.8,17.38322565419519,38.110144328054716,53.780195670585904,NaN,NaN,50
1674725400,1.08974,1.09012,1.08926,1.08958,3102,1745.95,-551845,-545850,17.21655184574743,37.12063799855431,52.45389087539036,NaN,NaN,50
1674727200,1.08958,1.09022,1.08939,1.08988,1980,1775.2,-549865,-547892.2,16.925456214564026,40.2530554779061,51.341574496473,NaN,NaN,50
1674729000,1.08988,1.09078,1.08982,1.0907,2131,1808.1,-547734,-548829.8,15.920166774799952,47.89383861344723,50.927778073399345,NaN,NaN,50
1674730800,1.0907,1.09078,1.08999,1.09004,1676,1815.05,-549410,-549519.4,14.986683723590458,43.114574372628425,50.03108824792146,NaN,NaN,50
1674732600,1.09004,1.09044,1.08991,1.09031,1734,1825.65,-547676,-549306,14.222886074840895,45.51010580158104,49.40176019343767,NaN,NaN,50
1674734400,1.09031,1.09044,1.08868,1.08936,2314,1885.35,-549990,-548935,14.862394838344011,39.24747130004377,48.43735366569623,NaN,NaN,50
1674736200,1.08936,1.08998,1.08879,1.0893,2579,1948.25,-552569,-549475.8,15.45622440445405,38.883533410204095,47.09387641897614,NaN,NaN,50
1674738000,1.0893,1.08984,1.08912,1.08972,3171,2045.35,-549398,-549808.6,16.0076375729848,42.8766499435925,46.0243156641265,NaN,NaN,50
1674739800,1.08972,1.09084,1.08731,1.09026,8604,2436.1,-540794,-548085.4,17.979961148832103,47.61562743666613,45.210670568602396,NaN,NaN,50
1674741600,1.09026,1.09176,1.08932,1.08986,5704,2666.3,-546498,-547849.8,18.507052936255334,44.660057950999885,44.60263353979551,NaN,NaN,50
1674743400,1.08986,1.09062,1.08816,1.08874,6715,2954.55,-553213,-548494.4,19.781445930955925,37.61894939664768,43.192329889563744,NaN,NaN,50
1674745200,1.08874,1.0895,1.08784,1.08877,5487,3187.25,-547726,-547525.8,21.15533905187758,37.901366967583144,41.95276301993993,NaN,NaN,50
1674747000,1.08877,1.08903,1.0851,1.08552,6694,3464.3,-554420,-548530.2,23.645202374126654,24.801561567545576,40.400541040389605,NaN,NaN,50
1674748800,1.08552,1.0872,1.08506,1.08633,4978,3656.7,-549442,-550259.8,25.970925729603234,31.185332938596076,39.90591165542828,NaN,NaN,50
1674750600,1.08633,1.08678,1.08578,1.08647,3697,3767.45,-545745,-550109.2,28.130525988260057,32.25578789869195,39.55842236258097,NaN,NaN,50
1674752400,1.08647,1.08701,1.0858,1.08608,2771,3745.8,-548516,-549169.8,29.82043148484691,30.81762586683476,38.8844631046473,NaN,NaN,50
1674754200,1.08608,1.08668,1.08582,1.08648,1943,3718.45,-546573,-548939.2,31.389629445963273,34.064742858048135,37.89667055069022,NaN,NaN,50
1674756000,1.08648,1.08779,1.08636,1.08759,2189,3658.3,-544384,-546932,31.365502354700514,42.17551038314854,37.829594551441666,NaN,NaN,50
1674757800,1.08759,1.08882,1.08758,1.08861,1853,3605.15,-542531,-545549.8,30.218629358537,48.4507263368233,38.03963887538753,NaN,NaN,50
1674759600,1.08861,1.08904,1.08836,1.08841,1359,3534.05,-543890,-545178.8,28.932212709910754,47.36532122606893,38.619485298675045,NaN,NaN,50
1674761400,1.08841,1.08894,1.08822,1.08892,1236,3440.75,-542654,-544006.4,27.851144417736673,50.41574532610185,39.443214721239165,NaN,NaN,50
1674763200,1.08892,1.08922,1.0887,1.0889,1259,3404.7,-543913,-543474.4,26.54240721372868,50.29265121402446,39.972929097698604,NaN,NaN,50
1674765000,1.0889,1.08925,1.08864,1.08922,1320,3364.15,-542593,-543116.2,25.3826079016014,52.29942920755547,40.30748636704784,NaN,NaN,50
1674766800,1.08922,1.08934,1.08903,1.08932,683,3314.5,-541910,-542992,24.19792147435191,52.93883433556102,40.898827537373634,NaN,NaN,50
1674768600,1.08932,1.08948,1.08907,1.08912,598,3257.7,-542508,-542715.6,22.923838403888915,51.45330745466394,41.88699597008908,NaN,NaN,50
1674770400,1.08912,1.08916,1.08886,1.08886,101,3147.05,-542609,-542706.6,21.974255829802374,49.508339127792944,42.71606541010407,NaN,NaN,50
1674772200,1.08886,1.08912,1.08878,1.08908,215,3028.85,-542394,-542402.8,21.183643776325596,51.189639346515555,44.60092810860193,NaN,NaN,50
1674774000,1.08908,1.08959,1.08898,1.08932,1043,2922.45,-541351,-542154.4,19.799847849623713,53.02721475200043,46.1610625238451,NaN,NaN,50
1674775800,1.08932,1.08966,1.08931,1.08932,1195,2552,-541351,-542042.6,18.420481462761856,53.02721475200043,47.64473587050999,NaN,NaN,50
1674777600,1.08932,1.08988,1.08932,1.08983,1103,2321.95,-540248,-541590.6,17.37195146585494,57.01539177308478,49.51600486381356,NaN,NaN,50
1674779400,1.08983,1.09004,1.08936,1.08967,1625,2067.45,-541873,-541443.4,16.617753004959752,55.42548340915942,51.041772046035796,NaN,NaN,50
1674781200,1.08967,1.08994,1.08862,1.08896,1616,1873.9,-543489,-541662.4,15.990569203674928,48.90796027521368,51.52266132404044,NaN,NaN,50
1674783000,1.08896,1.0894,1.08867,1.08896,1472,1612.8,-543489,-542090,15.408184245339024,48.90796027521368,51.55532089106833,NaN,NaN,50
1674784800,1.08896,1.089,1.0881,1.08815,1201,1423.95,-544690,-542757.8,15.585963544823885,42.32309953897599,51.195162199133115,NaN,NaN,50
1674786600,1.08815,1.08858,1.08786,1.08794,898,1284,-545588,-543825.8,16.027617340415908,40.78976402100348,50.507592105911804,NaN,NaN,50
1674788400,1.08794,1.08802,1.08752,1.08756,1012,1196.05,-546600,-544771.2,16.812790081879484,38.09988712780072,49.63668038546725,NaN,NaN,50
1674790200,1.08756,1.08759,1.08708,1.08737,1152,1156.5,-547752,-545623.8,17.987796964576777,36.79339800751758,48.529106728321686,NaN,NaN,50
1674792000,1.08737,1.08737,1.08696,1.08698,1375,1115.8,-549127,-546751.4,19.19570507194862,34.20091719400524,47.19068407535342,NaN,NaN,50
1674793800,1.08698,1.08702,1.0866,1.08664,948,1070.55,-550075,-547828.4,20.658519496965106,32.078830268630625,45.806792847779604,NaN,NaN,50
1674795600,1.08664,1.08688,1.08659,1.08682,981,1051.65,-549094,-548529.6,22.02628400806659,34.39948709634177,44.72758913124738,NaN,NaN,50
1674797400,1.08682,1.0874,1.08677,1.08738,996,1039.65,-548098,-548829.2,22.20540003968917,41.13767870461176,44.00959194253996,NaN,NaN,50
1674799200,1.08738,1.08738,1.08694,1.08737,1141,1033.75,-549239,-549126.6,22.371722069052996,41.056579696115186,43.154546581405306,NaN,NaN,50
1674801000,1.08737,1.08738,1.08663,1.087,1920,1063.75,-551159,-549533,22.904721450984386,38.06635730064284,42.085913906308335,NaN,NaN,50
1674802800,1.087,1.08772,1.08681,1.08751,1755,1117.35,-549404,-549398.8,22.689317304395303,44.10885966522972,41.16401875574726,NaN,NaN,50
1674804600,1.08751,1.08796,1.08736,1.08739,1942,1184.55,-551346,-549849.2,22.018113553862605,43.04470275098692,40.27967728016351,NaN,NaN,50
1674806400,1.08739,1.08784,1.08658,1.08739,2985,1328.75,-551346,-550498.8,22.394968631230093,43.04470275098692,39.860873171290166,NaN,NaN,50
1674808200,1.08739,1.08916,1.08739,1.08904,2510,1443.5,-548836,-550418.2,20.91318514898317,58.868914272208954,40.572369885361255,NaN,NaN,50
1674810000,1.08904,1.08922,1.08838,1.0889,2735,1528.1,-551571,-550500.6,19.614574184089488,57.411393281105916,41.650105152656245,NaN,NaN,50
1674811800,1.0889,1.08908,1.08775,1.08838,2130,1574.85,-553701,-551360,18.8306352751001,52.23800184591575,42.46783642586427,NaN,NaN,50
1674813600,1.08838,1.08902,1.08828,1.08874,1779,1608.65,-551922,-551475.2,18.102692002467098,55.24480208189918,43.69247320829987,NaN,NaN,50
1674815400,1.08874,1.08954,1.08842,1.08895,2045,1629.65,-549877,-551181.4,16.936040417226998,56.947440924637135,45.13204770237984,NaN,NaN,50
1674817200,1.08895,1.08939,1.08856,1.08862,1863,1642,-551740,-551762.2,15.852721088075475,53.502867533660776,46.510758440926665,NaN,NaN,50
1674819000,1.08862,1.08864,1.08755,1.0879,2275,1682.15,-554015,-552251,15.884392290696367,46.84509982668833,47.56549198078793,NaN,NaN,50
1674820800,1.0879,1.08808,1.08748,1.08764,1672,1705.7,-555687,-552648.2,15.991981882248748,44.6827924937157,48.30001379488606,NaN,NaN,50
1674822600,1.08764,1.08783,1.08664,1.0867,2474,1784.5,-558161,-553896,16.94486839417475,37.875813494548154,48.067023422738664,NaN,NaN,50
1674824400,1.0867,1.08698,1.08594,1.08689,3183,1893.05,-554978,-554916.2,18.409333201836674,39.86977763825104,47.98225184717694,NaN,NaN,50
1674826200,1.08689,1.08778,1.08622,1.08622,5023,2086.6,-560001,-556568.4,18.553455774635793,35.53809474927169,47.80166166493615,NaN,NaN,50
1674828000,1.08622,1.08686,1.08453,1.08511,4902,2262.95,-564903,-558746,19.936559215120578,29.76786184541014,46.77730467780618,NaN,NaN,50
1674829800,1.08511,1.08769,1.0846,1.08651,5820,2506.55,-559083,-559425.2,20.194923792988682,42.458180626080086,46.73541024031283,NaN,NaN,50
1674831600,1.08651,1.08792,1.08612,1.08674,5450,2730,-553633,-558519.6,20.16881948268985,44.240716622115166,46.820839802536284,NaN,NaN,50
1674833400,1.08674,1.08692,1.08379,1.08386,6499,3005.15,-560132,-559550.4,21.561687363422937,31.20514120762857,44.844856012209114,NaN,NaN,50
1674835200,1.08386,1.08589,1.08382,1.0857,4614,3178.8,-555518,-558653.8,22.85506468124652,42.80107969756445,43.8012621848133,NaN,NaN,50
1674837000,1.0857,1.08674,1.08542,1.08566,2821,3223.85,-558339,-557341,23.11052680826758,42.63284287217866,43.115179400974924,NaN,NaN,50
1674838800,1.08566,1.08637,1.08526,1.0862,2810,3276.6,-555529,-556630.2,23.446799393978914,45.73392455778023,42.435831006395006,NaN,NaN,50
1674840600,1.0862,1.08719,1.08616,1.08666,1814,3270.2,-553715,-556646.6,22.898686152358604,48.29786037266547,41.818003824111315,NaN,NaN,50
1674842400,1.08666,1.08666,1.08564,1.08578,1858,3213.85,-555573,-555734.8,22.75349439374559,44.01360634808111,41.140199453712775,NaN,NaN,50
1674844200,1.08578,1.08677,1.08572,1.08658,1594,3168.05,-553979,-555427,22.501369140003995,48.48718050684158,41.257490930866574,NaN,NaN,50
1674846000,1.08658,1.08724,1.08642,1.08707,1441,3103.35,-552538,-554266.8,21.76615228888821,51.06629726533159,41.71345555741056,NaN,NaN,50
1674847800,1.08707,1.08722,1.08664,1.08686,1372,3065.45,-553910,-553943,21.08345092713784,49.91290657615934,42.57324792038279,NaN,NaN,50
1674849600,1.08686,1.0873,1.08676,1.087,934,3023.2,-552976,-553795.2,20.357483168122226,50.712143297688286,43.34770261034259,NaN,NaN,50
1674851400,1.087,1.08702,1.08642,1.08654,1047,2973.3,-554023,-553485.2,20.00107061262148,48.00181595524989,44.237968410769604,NaN,NaN,50
1674853200,1.08654,1.08693,1.08651,1.08686,702,2915.25,-553321,-553353.6,19.670116096799358,50.003635991538104,45.68338084977875,NaN,NaN,50
1674855000,1.08686,1.08695,1.08662,1.08679,682,2835.6,-554003,-553646.6,19.33482652373315,49.55421823324995,46.19024067886231,NaN,NaN,50
1675029600,1.08679,1.08679,1.086,1.08658,252,2764.6,-554255,-553715.6,19.641706541534496,48.15590605280479,46.4698970667687,NaN,NaN,50
1675031400,1.08658,1.0867,1.08647,1.0867,163,2649.05,-554092,-553938.8,19.926666558064326,49.040803050821864,47.74387291271108,NaN,NaN,50
1675033200,1.0867,1.08708,1.0866,1.08706,1348,2557.3,-552744,-553683,19.59540283650962,51.704042130522055,48.37979880077949,NaN,NaN,50
1675035000,1.08706,1.08726,1.0869,1.0872,862,2349.25,-551882,-553395.2,19.01377768311408,52.738482497922085,49.1016302026183,NaN,NaN,50
1675036800,1.0872,1.08748,1.08692,1.08723,1316,2169.95,-550566,-552707.8,18.139649931679493,52.970937501970084,49.61855969863186,NaN,NaN,50
1675038600,1.08723,1.08758,1.08694,1.08748,1423,1950.1,-549143,-551685.4,17.17445473293769,54.959055530545484,50.094359352766155,NaN,NaN,50
1675040400,1.08748,1.08753,1.08648,1.08685,1787,1766.95,-550930,-551053,16.895850275572673,49.30275759358406,50.472155870302075,NaN,NaN,50
1675042200,1.08685,1.0875,1.08612,1.08736,2080,1546,-548850,-550274.2,17.07690516001607,53.47697682726818,50.828569893189695,NaN,NaN,50
1675044000,1.08736,1.08736,1.08656,1.08694,1696,1400.1,-550546,-550007,17.24502755271351,49.83771862812284,50.74081427624621,NaN,NaN,50
1675045800,1.08694,1.08711,1.08658,1.08691,1671,1342.6,-552217,-550337.2,17.401141203075415,49.57818520514208,50.716905606887835,NaN,NaN,50
1675047600,1.08691,1.08694,1.08644,1.08679,1256,1264.9,-553473,-551203.2,17.737923366591808,48.49041853361194,50.558210980882386,NaN,NaN,50
1675049400,1.08679,1.08694,1.08662,1.08686,1012,1224.8,-552461,-551509.4,18.050649661285597,49.19072732467025,50.64313322155527,NaN,NaN,50
1675051200,1.08686,1.08796,1.08683,1.08747,2891,1276.45,-549570,-551653.4,17.09837334956291,54.93995674940466,50.99572756140287,NaN,NaN,50
1675053000,1.08747,1.08778,1.08737,1.08765,1806,1287.05,-547764,-551097,16.214116774391844,56.5039811462579,51.492139198046296,NaN,NaN,50
1675054800,1.08765,1.08768,1.08704,1.08714,1568,1293.4,-549332,-550520,15.288676415822009,51.092778545632385,51.701915804676844,NaN,NaN,50
1675056600,1.08714,1.0872,1.08644,1.08692,1629,1306.25,-550961,-550017.6,15.32621637135168,48.91653440247346,51.693039472651954,NaN,NaN,50
1675058400,1.08692,1.08696,1.0863,1.08681,1511,1335.1,-552472,-550019.8,15.550998894852727,47.819777607430574,51.41559200671685,NaN,NaN,50
1675060200,1.08681,1.08694,1.08582,1.0862,1477,1356.6,-553949,-550895.6,16.36790929173936,42.17288191172829,50.66090625056015,NaN,NaN,50
1675062000,1.0862,1.087,1.0853,1.08567,2463,1444.65,-556412,-552625.2,17.69289578718281,37.976736122071735,49.58989186628169,NaN,NaN,50
1675063800,1.08567,1.08615,1.08543,1.08596,2213,1521.2,-554199,-553598.6,18.923240390094588,41.411795804780404,48.62223045729847,NaN,NaN,50
1675065600,1.08596,1.08898,1.08596,1.0879,5065,1761.85,-549134,-553233.2,18.996971092669952,58.121237133940646,49.252121853038226,NaN,NaN,50
1675067400,1.0879,1.08896,1.0879,1.08813,3200,1913.7,-545934,-551925.6,19.065435316489936,59.592611925943785,49.688952931515054,NaN,NaN,50
1675069200,1.08813,1.08958,1.08764,1.08924,3280,2010.3,-542654,-549666.6,19.664510308101278,65.8318402951999,50.831390193449124,NaN,NaN,50
1675071000,1.08924,1.09042,1.08904,1.0902,2900,2112.2,-539754,-546335,20.84380337188564,70.12788691609317,52.299226029945636,NaN,NaN,50
1675072800,1.0902,1.09139,1.09017,1.09123,3494,2221.1,-536260,-542747.2,22.53182590113253,73.91713748557238,54.11542024079995,NaN,NaN,50
1675074600,1.09123,1.09136,1.09061,1.09108,2514,2275.65,-538774,-540675.2,24.09927539257607,72.47530062826203,55.77860404819936,NaN,NaN,50
1675076400,1.09108,1.09114,1.08976,1.09004,2443,2308.45,-541217,-539731.8,24.349920097021524,63.261529233773075,56.3730020827971,NaN,NaN,50
1675078200,1.09004,1.09006,1.08906,1.08962,2441,2326.5,-543658,-539932.6,23.7274221984611,59.947045982313334,56.6189352853725,NaN,NaN,50
1675080000,1.08962,1.09004,1.08948,1.08974,2090,2346.2,-541568,-540295.4,23.14938843551213,60.582496728734625,57.29677229845123,NaN,NaN,50
1675081800,1.08974,1.09095,1.0893,1.0904,2401,2382.7,-539167,-540876.8,23.359472192188207,63.96842647987713,58.371907446837206,NaN,NaN,50
1675083600,1.0904,1.09112,1.08947,1.08964,3111,2475.45,-542278,-541577.6,23.682976677997676,57.81030269349225,59.0855163815559,NaN,NaN,50
1675085400,1.08964,1.08965,1.08861,1.08862,3525,2601.1,-545803,-542494.8,22.914389817605766,50.74904753150693,59.69809964011152,NaN,NaN,50
1675087200,1.08862,1.08926,1.08798,1.08848,3491,2631.1,-549294,-543622,21.518994554727662,49.84904027592286,60.546121365386604,NaN,NaN,50
1675089000,1.08848,1.08998,1.08842,1.08913,4927,2787.15,-544367,-544181.8,20.873531840355835,53.93383449457979,61.44055270037227,NaN,NaN,50
1675090800,1.08913,1.08993,1.08822,1.08868,4606,2939.05,-548973,-546143,20.053925814081584,50.84615045365162,60.9209036517802,NaN,NaN,50
1675092600,1.08868,1.08888,1.08677,1.08708,5388,3127,-554361,-548559.6,19.32777295244033,41.70411991119594,59.64315422215536,NaN,NaN,50
1675094400,1.08708,1.08748,1.08607,1.08658,4113,3257.1,-558474,-551093.8,19.193908663557924,39.32462962772573,57.749782031621486,NaN,NaN,50
1675096200,1.08658,1.08699,1.08628,1.08658,2582,3312.35,-558474,-552929.8,19.06960610959569,39.32462962772573,55.549549368166666,NaN,NaN,50
1675098000,1.08658,1.08668,1.08586,1.08618,2559,3317.15,-561033,-556263,19.27964900132991,37.34754012025821,52.93743527064423,NaN,NaN,50
1675099800,1.08618,1.08642,1.08576,1.08578,2187,3315.85,-563220,-559112.4,19.552434846152522,35.42927496275783,50.291290580251065,NaN,NaN,50
1675101600,1.08578,1.08607,1.08503,1.08558,2098,3167.5,-565318,-561303.8,20.34882302943457,34.47578636347029,48.235166089515154,NaN,NaN,50
1675103400,1.08558,1.08558,1.0852,1.08546,1805,3097.75,-567123,-563033.6,21.088326342482187,33.886514007805204,46.373699519907426,NaN,NaN,50
1675105200,1.08546,1.08557,1.08394,1.08423,2035,3035.5,-569158,-565170.4,22.592809187512035,28.507844949076016,44.08265296421753,NaN,NaN,50
1675107000,1.08423,1.08468,1.08408,1.08462,1682,2974.6,-567476,-566459,23.98982897218261,32.18344165964214,41.81229690562932,NaN,NaN,50
1675108800,1.08462,1.08497,1.0844,1.08486,1527,2876.25,-565949,-567004.8,24.8581867571735,34.417968865666595,40.14141591792749,NaN,NaN,50
1675110600,1.08486,1.08546,1.08451,1.08458,1659,2833.5,-567608,-567462.8,24.970434795738743,33.04976821696535,38.87718168117452,NaN,NaN,50
1675112400,1.08458,1.08521,1.08457,1.08514,728,2747.75,-566880,-567414.2,25.07466511726361,38.33000218571542,38.0543932461597,NaN,NaN,50
1675114200,1.08514,1.08524,1.08502,1.08517,445,2647.95,-566435,-566869.6,25.125914643827947,38.6093345990341,36.959786110763574,NaN,NaN,50
1675116000,1.08517,1.08524,1.0848,1.08488,93,2548.1,-566528,-566680,25.376496387090004,36.87076922688314,35.96154459456583,NaN,NaN,50
1675117800,1.08488,1.08526,1.08484,1.08512,3027,2579.4,-563501,-566190.4,25.57485892256604,39.30655141440994,35.79028970193825,NaN,NaN,50
1675119600,1.08512,1.08513,1.08468,1.08483,649,2456.3,-564150,-565498.8,25.919053354433387,37.427370023336174,35.654771158767566,NaN,NaN,50
1675121400,1.08483,1.08504,1.08474,1.08501,429,2301.5,-563721,-564867,26.238662469738777,39.365066964028124,35.65765953993203,NaN,NaN,50
1675123200,1.08501,1.08533,1.0849,1.08524,1104,2182.15,-562617,-564103.4,25.962578682879528,41.84329492105075,35.97878488284578,NaN,NaN,50
1675125000,1.08524,1.08576,1.08506,1.08539,1569,2014.25,-561048,-563007.4,24.924497096589707,43.46613285230543,36.552846160670605,NaN,NaN,50
1675126800,1.08539,1.08556,1.0852,1.0853,1570,1862.45,-562618,-562830.8,23.960564195034873,42.6962911346188,37.140025072895504,NaN,NaN,50
1675128600,1.0853,1.08602,1.0851,1.08578,1712,1678.65,-560906,-562182,22.270561224062895,47.98735263210523,38.14722783177407,NaN,NaN,50
1675130400,1.08578,1.08592,1.08538,1.08541,1220,1534,-562126,-561863,20.701272751017488,44.57103701378886,39.29459869353928,NaN,NaN,50
1675132200,1.08541,1.08543,1.085,1.08518,1217,1465.75,-563343,-562008.2,19.865985179342207,42.54347141335894,40.034600818804755,NaN,NaN,50
1675134000,1.08518,1.08527,1.08476,1.08476,1140,1394.8,-564483,-562695.2,19.454773885388608,39.050057902266126,40.36546432141902,NaN,NaN,50
1675135800,1.08476,1.085,1.0844,1.08446,1225,1346.7,-565708,-563313.2,19.58244902233711,36.7300209845963,40.62833951910694,NaN,NaN,50
1675137600,1.08446,1.08457,1.08396,1.08406,1021,1292.85,-566729,-564477.8,20.255353127813933,33.842904772714675,40.30783256103546,NaN,NaN,50
1675139400,1.08406,1.08464,1.08396,1.08462,1028,1254,-565701,-565192.8,20.72720767241672,40.85248933319334,40.468057899189695,NaN,NaN,50
1675141200,1.08462,1.08469,1.0842,1.08442,864,1195.45,-566565,-565837.2,21.051090714555095,39.25287964557886,40.63820864338224,NaN,NaN,50
1675143000,1.08442,1.08452,1.08331,1.08348,1227,1172.7,-567792,-566499,22.391079982002214,32.76019237381716,40.17061156905419,NaN,NaN,50
1675144800,1.08348,1.08404,1.08316,1.08394,1963,1194.5,-565829,-566523.2,23.782077796197296,38.15153062255868,40.222337326141506,NaN,NaN,50
1675146600,1.08394,1.08425,1.08377,1.08394,1378,1180.45,-565829,-566343.2,24.577839578938935,38.15153062255868,40.135656158893696,NaN,NaN,50
1675148400,1.08394,1.08467,1.08342,1.08439,2299,1259,-563530,-565909,24.397835341438896,43.30869115495888,40.24032731845856,NaN,NaN,50
1675150200,1.08439,1.08498,1.08384,1.0844,2691,1371.3,-560839,-564763.8,23.616460312926492,43.42159391845152,40.23714596604042,NaN,NaN,50
1675152000,1.0844,1.0845,1.08121,1.08226,4786,1605.95,-565625,-564330.4,25.31164449981309,29.761765685604757,39.31325129111084,NaN,NaN,50
1675153800,1.08226,1.08226,1.08026,1.08034,3504,1629.8,-569129,-564990.4,27.382913769480975,22.824199121998973,37.51588318324611,NaN,NaN,50
1675155600,1.08034,1.0821,1.08022,1.0821,3055,1750.1,-566074,-565039.4,29.32568214142219,37.2613031563189,36.99375933628397,NaN,NaN,50
1675157400,1.0821,1.08342,1.08208,1.08299,3256,1891.45,-562818,-564897,29.200101821737253,43.0617939637221,37.03078237559562,NaN,NaN,50
1675159200,1.08299,1.08313,1.08202,1.0825,2607,1966.6,-565425,-565814.2,29.127374942577433,40.82392446173553,37.15748712984344,NaN,NaN,50
1675161000,1.0825,1.08278,1.08208,1.08228,2397,2008,-567822,-566253.6,29.059842840500455,39.82325492888069,37.37843241157804,NaN,NaN,50
1675162800,1.08228,1.08308,1.08214,1.0823,2198,2039.4,-565624,-565552.6,28.567913118428223,39.9673189931103,37.81589057017772,NaN,NaN,50
1675164600,1.0823,1.08382,1.08222,1.08359,2374,2072.5,-563250,-564987.8,27.144730337271845,48.52688623806677,38.364061777668674,NaN,NaN,50
1675166400,1.08359,1.08378,1.08328,1.08376,2698,2146.4,-560552,-564534.6,25.823203469055212,49.5477977284189,39.099413069300105,NaN,NaN,50
1675168200,1.08376,1.08388,1.08256,1.08262,2408,2205.95,-562960,-564041.6,25.320925844872566,43.340004830365835,39.85511395905358,NaN,NaN,50
1675170000,1.08262,1.08402,1.08259,1.08345,3431,2320.5,-559529,-562383,24.661644221913527,48.40818021277888,40.587731786926454,NaN,NaN,50
1675171800,1.08345,1.08634,1.08338,1.0851,9257,2722.1,-550272,-559312.6,24.143854939450485,56.70005894991723,41.912626667452066,NaN,NaN,50
1675173600,1.0851,1.08646,1.08474,1.08588,4574,2899.75,-545698,-555802.2,23.75638255771391,59.97496717452061,43.103074954563624,NaN,NaN,50
1675175400,1.08588,1.08606,1.0843,1.0848,6408,3168.75,-552106,-554113,22.897960268669728,53.89659870136559,43.85128958191462,NaN,NaN,50
1675177200,1.0848,1.0854,1.08336,1.08394,6246,3437.85,-558352,-553191.4,21.37500024723034,49.586932562114754,45.26737293023677,NaN,NaN,50
1675179000,1.08394,1.08626,1.08391,1.08602,6093,3681.15,-552259,-551737.4,20.497943624764655,58.27673863244379,47.799697180982825,NaN,NaN,50
1675180800,1.08602,1.08678,1.08534,1.08639,5095,3837.75,-547164,-551115.8,20.09933377916216,59.6104416620895,49.3960642171093,NaN,NaN,50
1675182600,1.08639,1.08675,1.08548,1.0857,2830,3910.35,-549994,-551975,19.729196065388408,56.0144940433385,50.32125707993904,NaN,NaN,50
1675184400,1.0857,1.08609,1.08506,1.08574,2236,3907.2,-547758,-551105.4,18.92097764688751,56.179524343127135,51.41808564289558,NaN,NaN,50
1675186200,1.08574,1.08664,1.08538,1.08654,1793,3862.3,-545965,-548628,18.65399074257509,59.45591919213153,52.82041880455636,NaN,NaN,50
1675188000,1.08654,1.08694,1.08647,1.08692,1468,3696.4,-544497,-547075.6,18.658153941583592,60.94948448022436,54.319144910778796,NaN,NaN,50
1675189800,1.08692,1.08749,1.08692,1.08724,1209,3581.65,-543288,-546300.4,19.10279693453268,62.21190154397543,55.29664600405799,NaN,NaN,50
1675191600,1.08724,1.08736,1.08682,1.08695,1261,3491.95,-544549,-545211.4,19.385028933017498,60.30910790042336,56.06531101634402,NaN,NaN,50
1675193400,1.08695,1.08741,1.0863,1.08642,1426,3400.45,-545975,-544854.8,18.980822019988718,56.88476877399572,57.03279415517473,NaN,NaN,50
1675195200,1.08642,1.0866,1.08599,1.08644,1434,3341.8,-544541,-544570,18.228500020513376,56.98402606853598,57.6453545734431,NaN,NaN,50
1675197000,1.08644,1.08732,1.08611,1.0872,1850,3314.45,-542691,-544208.8,18.210047652475904,60.68766650613876,57.93018368460178,NaN,NaN,50
1675198800,1.0872,1.08726,1.08652,1.08668,1133,3261.2,-543824,-544316,18.192913310726823,57.0672351030558,57.72248853664001,NaN,NaN,50
1675200600,1.08668,1.0867,1.08618,1.08632,831,3184.05,-544655,-544337.2,17.72289766394086,54.6370949311822,57.77538112448405,NaN,NaN,50
1675202400,1.08632,1.08646,1.08622,1.08622,201,3059.2,-544856,-544113.4,17.286454563353892,53.94984160621024,58.08701748477659,NaN,NaN,50
1675204200,1.08622,1.08628,1.08609,1.08618,346,2956.1,-545202,-544245.6,16.69511641095792,53.65909325924957,57.75718567240557,NaN,NaN,50
1675206000,1.08618,1.08657,1.08604,1.08634,855,2827.3,-544347,-544576.8,16.491091289279762,54.7104965077935,57.407189589955856,NaN,NaN,50
1675207800,1.08634,1.08634,1.08606,1.08608,479,2388.4,-544826,-544777.2,16.301639390578618,52.62118378054119,57.16481028547033,NaN,NaN,50
1675209600,1.08608,1.08626,1.08584,1.08611,1099,2214.65,-543727,-544591.6,15.762837820867666,52.84494952258773,56.92662636971752,NaN,NaN,50
1675211400,1.08611,1.08642,1.08605,1.08626,1012,1944.85,-542715,-544163.4,15.48262678599927,54.01441077175103,56.5379471968332,NaN,NaN,50
1675213200,1.08626,1.08638,1.08592,1.08606,1337,1699.4,-544052,-543933.4,14.993136447986993,52.157059115899266,55.90991681366712,NaN,NaN,50
1675215000,1.08606,1.0863,1.08571,1.08572,1297,1459.6,-545349,-544133.8,14.169594147607045,49.06806533403706,54.97107137010009,NaN,NaN,50
1675216800,1.08572,1.08574,1.08528,1.08551,1055,1257.6,-546404,-544449.4,13.611548039713512,47.20834444249329,54.035302551676516,NaN,NaN,50
1675218600,1.08551,1.08566,1.08522,1.08537,1130,1172.6,-547534,-545210.8,13.187423524654035,45.95779338554288,53.25480430964417,NaN,NaN,50
1675220400,1.08537,1.08599,1.08524,1.08597,1021,1111.85,-546513,-545970.4,12.288687861086059,51.845273773633984,52.88775057429403,NaN,NaN,50
1675222200,1.08597,1.0863,1.08582,1.0863,569,1050.65,-545944,-546348.8,11.966537211376723,54.764218495270185,52.464647144946284,NaN,NaN,50
1675224000,1.0863,1.08678,1.08627,1.08674,560,1005.25,-545384,-546355.8,12.374985420798192,58.38621165884377,52.55885975607399,NaN,NaN,50
1675225800,1.08674,1.0869,1.08647,1.08658,998,994.7,-546382,-546351.4,12.919520252963723,56.61112601609896,52.69986197642519,NaN,NaN,50
1675227600,1.08658,1.08704,1.08654,1.08669,624,962.85,-545758,-545996.2,13.620076515729899,57.566288850599925,52.958179636738734,NaN,NaN,50
1675229400,1.08669,1.0875,1.08666,1.08717,986,940.85,-544772,-545648,14.865026961255385,61.54452410642875,53.521424697251526,NaN,NaN,50
1675231200,1.08717,1.08755,1.08708,1.08729,1117,925,-543655,-545190.2,16.082368082328973,62.49127652301593,54.07719469833885,NaN,NaN,50
1675233000,1.08729,1.08769,1.0866,1.08697,1360,900.5,-545015,-545116.4,16.138329013099646,58.36477097403536,54.48745092644557,NaN,NaN,50
1675234800,1.08697,1.08804,1.0868,1.08778,2532,970.45,-542483,-544336.6,16.678328974360326,64.7160347124084,55.33538558286133,NaN,NaN,50
1675236600,1.08778,1.08839,1.08667,1.08801,2669,1062.35,-539814,-543147.8,17.622916286910005,66.28858198834784,56.21211209833253,NaN,NaN,50
1675238400,1.08801,1.08838,1.08698,1.0879,3304,1217.5,-543118,-542817,18.500033077134706,64.80107817143715,57.115256316585246,NaN,NaN,50
1675240200,1.0879,1.08885,1.08788,1.08875,2745,1337.45,-540373,-542160.6,19.877285068949266,70.33974417044472,58.634661947757216,NaN,NaN,50
1675242000,1.08875,1.08886,1.08796,1.08828,2584,1423.9,-542957,-541749,21.16757834660013,64.31356531665693,59.856463438768905,NaN,NaN,50
1675243800,1.08828,1.08881,1.08787,1.08836,2259,1512.9,-540698,-541392,22.126347454505414,64.86533003090366,61.20700177058039,NaN,NaN,50
1675245600,1.08836,1.08898,1.08797,1.08855,2795,1597.7,-537903,-541009.8,23.236643079754117,66.20189895627954,62.23247499791221,NaN,NaN,50
1675247400,1.08855,1.08938,1.08852,1.08923,1858,1640,-536045,-539595.2,24.742239439749543,70.52373188946592,63.358154526069065,NaN,NaN,50
1675249200,1.08923,1.0897,1.08887,1.08936,2178,1682.05,-533867,-538294,26.47486850881848,71.27983619333878,64.27912770710442,NaN,NaN,50
1675251000,1.08936,1.08969,1.08902,1.08926,1558,1695.1,-535425,-536787.6,28.08373835866821,69.79668528822437,65.2209533693991,NaN,NaN,50
1675252800,1.08926,1.0896,1.08896,1.0896,1582,1721.45,-533843,-535416.6,29.38651110744197,71.93488869656655,66.24728192982528,NaN,NaN,50
1675254600,1.0896,1.0898,1.0888,1.08915,2010,1765.45,-535853,-535006.6,30.828486580470944,65.34159500787086,66.51850127992829,NaN,NaN,50
1675256400,1.08915,1.09076,1.08883,1.09008,4690,1948.9,-531163,-534030.2,33.026374636643844,71.21381228502953,67.14153954864354,NaN,NaN,50
1675258200,1.09008,1.09102,1.08998,1.0904,4227,2131.8,-526936,-532644,35.24564131234646,72.91434355730226,68.18079473316261,NaN,NaN,50
1675260000,1.0904,1.09109,1.09026,1.09032,3234,2265.5,-530170,-531593,37.35384793919823,71.77281923991787,68.68485077084186,NaN,NaN,50
1675261800,1.09032,1.09092,1.09014,1.09042,3985,2414.85,-526185,-530061.4,38.92268420797086,72.3554276764845,69.11819689142304,NaN,NaN,50
1675263600,1.09042,1.09073,1.08886,1.09046,7109,2739.1,-519076,-526706,37.24895262902182,72.59905137828727,69.67519497762662,NaN,NaN,50
1675265400,1.09046,1.09246,1.09003,1.09196,5965,2988.05,-513111,-523095.6,37.42070670479524,79.79129143284909,70.35030549636978,NaN,NaN,50
1675267200,1.09196,1.09222,1.09142,1.09188,3963,3130.35,-517074,-521123.2,37.58019263229913,78.60623513285461,71.37121048324106,NaN,NaN,50
1675269000,1.09188,1.0924,1.09157,1.09166,2565,3190.6,-519639,-519017,37.8720456041474,75.29443773260053,72.11614674764797,NaN,NaN,50
1675270800,1.09166,1.0919,1.09112,1.09129,2337,3180.85,-521976,-518175.2,37.3093131327719,69.9562138028613,72.38431209383239,NaN,NaN,50
1675272600,1.09129,1.09138,1.09048,1.09079,1919,3143.35,-523895,-519139,35.74631699745973,63.41335445823142,71.87642799160135,NaN,NaN,50
1675274400,1.09079,1.09199,1.09062,1.09172,1964,3076.35,-521931,-520903,34.9181024079768,69.18613548370266,71.72687794091304,NaN,NaN,50
1675276200,1.09172,1.09209,1.09088,1.09174,2190,3048.6,-519741,-521436.4,34.2459451866711,69.29832603369499,71.6912808513038,NaN,NaN,50
1675278000,1.09174,1.09258,1.08913,1.0911,9793,3409.05,-529534,-523415.4,32.23782671593162,61.572711281204896,70.95112532163512,NaN,NaN,50
1675279800,1.0911,1.0986,1.08889,1.0978,17743,4183.25,-511791,-521378.4,33.158034121647844,82.97318164294207,72.21052436699735,NaN,NaN,50
1675281600,1.0978,1.10013,1.09695,1.09927,8939,4490.45,-502852,-517169.8,34.470146133133625,84.9531424772302,73.19190509501168,NaN,NaN,50
1675283400,1.09927,1.10004,1.0984,1.09882,5077,4651.4,-507929,-514369.4,35.688535858084705,81.81664720409248,73.82778392692526,NaN,NaN,50
1675285200,1.09882,1.09892,1.09834,1.0984,1464,4615.7,-509393,-512299.8,36.762732672562436,78.88910166353403,74.33608981432643,NaN,NaN,50
1675287000,1.0984,1.09908,1.09837,1.09896,1121,4593.85,-508272,-508047.4,37.81278604439123,79.92075272481446,74.87647017492142,NaN,NaN,50
1675288800,1.09896,1.099,1.09856,1.09885,129,4521.2,-508401,-507369.4,38.78783560394655,79.10302532494052,75.34103974253951,NaN,NaN,50
1675290600,1.09885,1.09905,1.09866,1.09884,1488,4495.1,-509889,-508776.8,39.71191104287038,79.02386651474185,75.28622367696042,NaN,NaN,50
1675292400,1.09884,1.1033,1.09881,1.10175,3348,4428,-506541,-508499.2,41.70863379209612,84.03163539463782,75.67375226708779,NaN,NaN,50
1675294200,1.10175,1.10198,1.10076,1.10129,1696,4301.45,-508237,-508268,43.56273348780574,80.7498506436925,76.06342461788007,NaN,NaN,50
1675296000,1.10129,1.1022,1.10108,1.1019,2259,4252.7,-505978,-507809.2,45.3292931960808,81.76677235123093,76.90703594276363,NaN,NaN,50
1675297800,1.1019,1.10269,1.10155,1.1019,1899,4148.4,-505978,-507324.6,47.07055953165705,81.76677235123093,78.21799436369216,NaN,NaN,50
1675299600,1.1019,1.10214,1.10107,1.10118,1940,3889.95,-507918,-506930.4,48.14332758525714,76.25260280681552,78.72274202962879,NaN,NaN,50
1675301400,1.10118,1.10142,1.10062,1.10134,2149,3699.15,-505769,-506776,48.63752213324397,76.62977385178148,79.24641687377782,NaN,NaN,50
1675303200,1.10134,1.10184,1.1012,1.10183,1771,3589.55,-503998,-505928.2,49.23045078401627,77.79302251414268,80.4050105332734,NaN,NaN,50
1675305000,1.10183,1.10212,1.10151,1.10188,1750,3548.8,-502248,-505182.2,49.870554511588516,77.91382856662763,80.0436281706795,NaN,NaN,50
1675306800,1.10188,1.10206,1.1016,1.10165,1465,3505.2,-503713,-504729.2,50.46493654433418,75.86923283972718,79.39477748228641,NaN,NaN,50
1675308600,1.10165,1.1018,1.10146,1.10177,1183,3468.4,-502530,-503651.6,50.82931133118554,76.21985988025449,78.99500695915513,NaN,NaN,50
1675310400,1.10177,1.10195,1.10162,1.10168,953,3417.85,-503483,-503194.4,51.227302230993644,75.33571962463849,78.74119395637688,NaN,NaN,50
1675312200,1.10168,1.10256,1.1016,1.10198,1108,3363.75,-502375,-502869.8,51.833672778586894,76.32169715597935,78.48411855860294,NaN,NaN,50
1675314000,1.10198,1.10249,1.10192,1.10241,1237,2935.95,-501138,-502647.8,52.396731144209205,77.69788138076649,78.38375113401909,NaN,NaN,50
1675315800,1.10241,1.10244,1.1019,1.10201,1472,2122.4,-502610,-502427.2,52.88667936188782,73.4229043731802,77.98368240962182,NaN,NaN,50
1675317600,1.10201,1.10218,1.1014,1.1014,1616,1756.25,-504226,-502766.4,52.52224210246703,67.33818517345286,76.7912931081086,NaN,NaN,50
1675319400,1.1014,1.10146,1.10046,1.10052,1585,1581.65,-505811,-503232,50.84031804454964,59.6573184406755,75.28468366503596,NaN,NaN,50
1675321200,1.10052,1.10149,1.09992,1.10037,2755,1646.2,-508566,-504470.2,48.606089180372365,58.43381185726826,73.61804362975292,NaN,NaN,50
1675323000,1.10037,1.10092,1.09914,1.09936,2671,1723.7,-511237,-506490,45.66065145602228,50.86881122025146,71.41104640611152,NaN,NaN,50
1675324800,1.09936,1.10106,1.09934,1.10052,3014,1867.95,-508223,-507612.6,43.05348735593768,57.65018344706759,70.08230216612954,NaN,NaN,50
1675326600,1.10052,1.10088,1.09918,1.1005,3720,1979.55,-511943,-509156,40.45137367902513,57.50281445870341,68.71609078090967,NaN,NaN,50
1675328400,1.1005,1.10064,1.09908,1.09936,3075,1965.9,-515018,-510997.4,37.917847865093265,49.70357002969407,66.70970131773475,NaN,NaN,50
1675330200,1.09936,1.10058,1.0989,1.09986,3024,2032.3,-511994,-511683,35.347939068933705,52.73175725688706,64.91098193846757,NaN,NaN,50
1675332000,1.09986,1.10004,1.09813,1.09844,2876,2063.15,-514870,-512409.6,33.542314761643674,44.531684429773385,62.672585623470866,NaN,NaN,50
1675333800,1.09844,1.09901,1.09804,1.0983,2564,2096.4,-517434,-514251.8,31.959520474562275,43.80837031904308,60.35747922624148,NaN,NaN,50
1675335600,1.0983,1.09959,1.09822,1.09959,2230,2110.9,-515204,-514904,29.7572946679968,51.60805816927098,58.662646265143806,NaN,NaN,50
1675337400,1.09959,1.10022,1.09932,1.09992,2445,2125.7,-512759,-514452.2,28.253488321088376,53.39039558612076,57.02469615301105,NaN,NaN,50
1675339200,1.09992,1.10044,1.0987,1.09989,6045,2339.4,-518804,-515814.2,26.339014119030423,53.19856898875026,55.27474526786703,NaN,NaN,50
1675341000,1.09989,1.10024,1.09826,1.09841,5742,2539,-524546,-517749.4,25.03036999144614,44.671473824065636,53.22107165721599,NaN,NaN,50
1675342800,1.09841,1.10043,1.09627,1.09728,7089,2820.2,-531635,-520589.6,25.425136794126217,39.469541979090714,51.230454286190124,NaN,NaN,50
1675344600,1.09728,1.09884,1.09439,1.09454,7932,3157.65,-539567,-525462.2,26.781525826766376,30.266142847493,49.13108460096281,NaN,NaN,50
1675346400,1.09454,1.09666,1.09302,1.09496,8750,3547.5,-530817,-529073.8,28.578620691006197,32.850842871075386,47.303729673377596,NaN,NaN,50
1675348200,1.09496,1.09546,1.09049,1.09056,9014,3942.8,-539831,-533279.2,30.97562476617509,23.164222866653674,45.32483050526347,NaN,NaN,50
1675350000,1.09056,1.09155,1.08854,1.09044,8373,4299.6,-548204,-538010.8,33.606357007890644,22.965333413311072,42.84734121713801,NaN,NaN,50
1675351800,1.09044,1.09396,1.09025,1.09368,6135,4532.75,-542069,-540097.6,34.057463227759925,38.35531512486619,41.47966269329249,NaN,NaN,50
1675353600,1.09368,1.09491,1.09253,1.09278,4943,4699.1,-547012,-541586.6,33.81778967510101,36.19234367812269,40.51457509675168,NaN,NaN,50
1675355400,1.09278,1.09282,1.09072,1.09171,4153,4827.5,-551165,-545656.2,34.18475257764887,33.75514381311464,39.15910270791079,NaN,NaN,50
1675357200,1.09171,1.09246,1.09136,1.09228,3021,4840.8,-548144,-547318.8,34.52550384430045,36.219142943786146,38.56534974462598,NaN,NaN,50
1675359000,1.09228,1.09268,1.09058,1.09086,2821,4848.3,-550965,-547871,35.0868777319633,32.932783930486934,37.7885221454434,NaN,NaN,50
1675360800,1.09086,1.09228,1.09078,1.0921,2485,4821.85,-548480,-549153.2,35.608153484793085,38.205615190143426,36.83120478979144,NaN,NaN,50
1675362600,1.0921,1.09223,1.09133,1.09194,1846,4728.15,-550326,-549816,36.092195255277886,37.792734199668786,35.71708611933058,NaN,NaN,50
1675364400,1.09194,1.09226,1.0913,1.09148,2376,4693.2,-552702,-550123.4,36.54166261358521,36.5691466500097,34.52927023799197,NaN,NaN,50
1675366200,1.09148,1.0916,1.09052,1.0908,3455,4714.75,-556157,-551726,37.24815331750765,34.77668182241483,33.8224993807312,NaN,NaN,50
1675368000,1.0908,1.09107,1.09055,1.09084,3149,4728.4,-553008,-552134.6,37.904180399721355,34.97857797446203,33.50171623754344,NaN,NaN,50
1675369800,1.09084,1.0915,1.09084,1.09138,2473,4723.85,-550535,-552545.6,38.06372255409386,37.778735336229445,34.0383299867389,NaN,NaN,50
1675371600,1.09138,1.09164,1.09099,1.09128,1953,4710,-552488,-552978,38.063235549301275,37.4570358956553,34.36734377420889,NaN,NaN,50
1675373400,1.09128,1.09129,1.09083,1.09098,1563,4665.9,-554051,-553247.8,38.14219150227521,36.454140379044496,35.31662359652252,NaN,NaN,50
1675375200,1.09098,1.09104,1.09091,1.09092,104,4368.85,-554155,-552847.4,38.215507744322444,36.245121017986285,36.26517985399932,NaN,NaN,50
1675377000,1.09092,1.09096,1.09068,1.09088,466,4105.05,-554621,-553170,38.40982020786594,36.096527964004295,36.10383791393775,NaN,NaN,50
1675378800,1.09088,1.09116,1.09073,1.09088,900,3795.6,-554621,-553987.2,38.323630864844375,36.096527964004295,36.09699393435786,NaN,NaN,50
1675380600,1.09088,1.09094,1.09046,1.09046,868,3442.4,-555489,-554587.4,38.409909445359666,34.380140749847584,36.14163657269593,NaN,NaN,50
1675382400,1.09046,1.09052,1.08924,1.08988,2196,3114.7,-557685,-555314.2,39.15019633851819,32.109508094478116,35.84809122631679,NaN,NaN,50
1675384200,1.08988,1.08988,1.08934,1.08975,1534,2740.7,-559219,-556327,39.83760559645111,31.605654844504258,35.75329629160374,NaN,NaN,50
1675386000,1.08975,1.08996,1.08934,1.08935,1730,2408.55,-560949,-557592.6,40.353808828863194,30.043506223486645,35.17028850827112,NaN,NaN,50
1675387800,1.08935,1.08953,1.0891,1.0894,1694,2186.5,-559255,-558519.4,40.968481924115245,30.505887528050238,34.64979946029836,NaN,NaN,50
1675389600,1.0894,1.08961,1.089,1.08907,1616,2020.15,-560871,-559595.8,41.59688055140647,29.137066478125263,34.11893659087804,NaN,NaN,50
1675391400,1.08907,1.08933,1.08878,1.08897,1317,1878.35,-562188,-560496.4,42.30992457426411,28.716566224554697,33.68607119103089,NaN,NaN,50
1675393200,1.08897,1.08959,1.08894,1.0891,1007,1777.65,-561181,-560888.8,42.4964351475548,30.12829036962765,33.33962207639986,NaN,NaN,50
1675395000,1.0891,1.08958,1.08908,1.08941,798,1676.5,-560383,-560775.6,42.669623537039,33.50988347807022,33.03470408653134,NaN,NaN,50
1675396800,1.08941,1.08948,1.08872,1.08904,968,1600.65,-561351,-561194.8,43.08967084594176,31.547390399135736,32.61258655106566,NaN,NaN,50
1675398600,1.08904,1.08938,1.08899,1.08932,826,1549.65,-560525,-561125.6,43.479714775637184,34.66568778293154,32.48483993705759,NaN,NaN,50
1675400400,1.08932,1.08955,1.08906,1.08944,1005,1481.1,-559520,-560592,43.47233216736115,36.011053568418006,32.468120833517006,NaN,NaN,50
1675402200,1.08944,1.08984,1.08898,1.08938,1415,1379.1,-560935,-560542.8,42.849599197419586,35.616141315544155,32.43380750148414,NaN,NaN,50
1675404000,1.08938,1.0897,1.08916,1.08937,1286,1285.95,-562221,-560910.4,42.27134715390241,35.54617466485959,32.39449655154523,NaN,NaN,50
1675405800,1.08937,1.09001,1.08937,1.08984,1356,1230.1,-560865,-560813.2,41.06657309838427,41.3753488333492,32.89415427179535,NaN,NaN,50
1675407600,1.08984,1.09062,1.08927,1.08928,2700,1267.45,-563565,-561421.2,38.79966647079676,37.07313050354751,33.24869872958602,NaN,NaN,50
1675409400,1.08928,1.09008,1.0882,1.08996,3251,1351.85,-560314,-561580,37.95718375486899,44.60536835829524,34.177249694856805,NaN,NaN,50
1675411200,1.08996,1.08998,1.08846,1.08955,3490,1521.15,-563804,-562153.8,37.1748783757932,41.388541756931154,34.98760937581713,NaN,NaN,50
1675413000,1.08955,1.09075,1.0891,1.09034,2875,1641.6,-560929,-561895.4,35.179049948597125,49.0178717567238,36.309893963579526,NaN,NaN,50
1675414800,1.09034,1.09153,1.08936,1.0913,2962,1744.7,-557967,-561315.8,33.04003714215189,56.438424807358835,38.25999098709621,NaN,NaN,50
1675416600,1.0913,1.09312,1.09123,1.09301,2860,1844.3,-555107,-559624.2,32.57849745164925,65.94644902253948,40.91926832980941,NaN,NaN,50
1675418400,1.09301,1.09335,1.0925,1.09295,2515,1860.25,-557622,-559085.8,32.32770535215391,65.40699957322545,43.43917613006639,NaN,NaN,50
1675420200,1.09295,1.09368,1.0929,1.09352,2478,1907.45,-555144,-557353.8,32.34700370872003,68.07847542340895,45.90836126901916,NaN,NaN,50
1675422000,1.09352,1.09372,1.09248,1.09304,2385,1940.2,-557529,-556673.8,31.7600628813297,63.622672315628414,48.199452834482926,NaN,NaN,50
1675423800,1.09304,1.09342,1.09248,1.0929,1733,1942.15,-559262,-556932.8,31.21504639875296,62.34104507177952,50.17626406940064,NaN,NaN,50
1675425600,1.0929,1.09342,1.0926,1.09338,2158,1969.25,-557104,-557332.2,30.708959664931708,64.94815079958572,52.24319958591264,NaN,NaN,50
1675427400,1.09338,1.09372,1.09321,1.09328,2340,2020.4,-559444,-557696.6,30.531135574837492,63.954790257758155,54.26738879607079,NaN,NaN,50
1675429200,1.09328,1.09404,1.09211,1.09259,3555,2147.8,-562999,-559267.6,28.758757047453383,57.42802801740478,55.83037832125258,NaN,NaN,50
1675431000,1.09259,1.09283,1.08266,1.08398,14357,2825.75,-577356,-563233,30.96922313914107,24.21695226760744,54.60477856655674,NaN,NaN,50
1675432800,1.08398,1.08528,1.08326,1.08488,7772,3165.95,-569584,-565297.4,33.02179879570822,28.848910509676983,54.01733428128028,NaN,NaN,50
1675434600,1.08488,1.08714,1.08474,1.08642,8141,3531.7,-561443,-566165.2,33.515749992363475,36.05145769953239,53.40634066279721,NaN,NaN,50
1675436400,1.08642,1.08642,1.08092,1.0852,11100,4036.45,-572543,-568785,34.89650221019387,33.18545783999676,52.8204060973019,NaN,NaN,50
1675438200,1.0852,1.08764,1.08452,1.08584,8163,4373.85,-564380,-569061.2,35.42713222767651,36.05722763852413,51.89464580314478,NaN,NaN,50
1675440000,1.08584,1.08617,1.08412,1.08424,5156,4567.35,-569536,-567497.2,36.017609336941305,32.31749149045109,50.171721994794225,NaN,NaN,50
1675441800,1.08424,1.08452,1.08235,1.08252,4794,4739.25,-574330,-568446.4,36.974472585508394,28.853048038746493,47.52219335309473,NaN,NaN,50
1675443600,1.08252,1.08363,1.0824,1.08281,3186,4763.55,-571144,-570386.6,37.862988459177835,30.211468234960776,45.00822682893296,NaN,NaN,50
1675445400,1.08281,1.08369,1.08224,1.08246,2506,4726.3,-573650,-570608,38.726114909530196,29.479893874434907,42.25118528972053,NaN,NaN,50
1675447200,1.08246,1.08248,1.08086,1.08138,3460,4724.8,-577110,-573154,39.84633182439431,27.284356874549673,39.65559132964348,NaN,NaN,50
1675449000,1.08138,1.08138,1.08054,1.08118,3089,4735.5,-580199,-575286.6,40.95745476169062,26.885041094553145,37.12301961698445,NaN,NaN,50
1675450800,1.08118,1.08147,1.0806,1.08076,2552,4715,-582751,-576970.8,41.91647082933539,26.02369883775205,34.34270161971062,NaN,NaN,50
1675452600,1.08076,1.08104,1.08018,1.08048,2890,4716.5,-585641,-579870.2,42.910872800733884,25.438570440853198,31.591543061360266,NaN,NaN,50
1675454400,1.08048,1.08048,1.07973,1.07988,2537,4717.6,-588178,-582775.8,43.94617605712763,24.183744194859344,29.216951359749878,NaN,NaN,50
1675456200,1.07988,1.08013,1.07932,1.07934,2433,4715.35,-590611,-585476,45.0098934708874,23.080277787889557,29.135760325484316,NaN,NaN,50
1675458000,1.07934,1.08008,1.07933,1.07988,992,4645.7,-589619,-587360,45.997631069378606,26.68295388895139,28.98104913828963,NaN,NaN,50
1675459800,1.07988,1.07988,1.07928,1.0794,750,4596.55,-590369,-588883.6,46.928740476758065,25.537953171935314,28.23008452917555,NaN,NaN,50
1675634400,1.0794,1.07948,1.07843,1.07904,105,4493.9,-590474,-589850.2,48.02681656314021,24.682479620991984,27.622728942103784,NaN,NaN,50
1675636200,1.07904,1.0795,1.07865,1.0792,286,4391.2,-590188,-590252.2,49.02306763436083,25.87101124412048,26.895142056789236,NaN,NaN,50
1675638000,1.0792,1.07986,1.07855,1.0794,2716,4349.25,-587472,-589624.4,49.5126795347969,27.412955028874066,26.544818023819452,NaN,NaN,50
1675639800,1.0794,1.07954,1.07856,1.07894,2233,3743.05,-589705,-589641.6,49.9673191566304,26.06978664267706,26.346013638385923,NaN,NaN,50
1675641600,1.07894,1.07951,1.07858,1.07864,2667,3487.8,-592372,-590042.2,50.38948451976151,25.202492895823582,25.988229685590408,NaN,NaN,50
1675643400,1.07864,1.079,1.07812,1.07888,2110,3186.25,-590262,-589999.8,50.96008393181931,27.286589862286007,25.831565113294058,NaN,NaN,50
1675645200,1.07888,1.07942,1.0786,1.07896,1980,2730.25,-588282,-589618.6,50.89286654866479,28.00667928621209,25.88315957126995,NaN,NaN,50
1675647000,1.07896,1.07918,1.07844,1.07851,2161,2430.15,-590443,-590212.8,50.90611279286953,26.421643891688348,25.85005977106532,NaN,NaN,50
1675648800,1.07851,1.07928,1.07822,1.0789,1931,2268.9,-588512,-589974.2,51.024740077567486,30.11319842332651,26.142166884320638,NaN,NaN,50
1675650600,1.0789,1.07981,1.07866,1.07908,2412,2149.8,-586100,-588719.8,50.337555016527425,31.8135925582897,26.597525606994676,NaN,NaN,50
1675652400,1.07908,1.07984,1.079,1.07944,1891,2085.05,-584209,-587509.2,49.65460669038663,35.208939819650425,27.38503958019404,NaN,NaN,50
1675654200,1.07944,1.07975,1.07892,1.07902,1238,2021.65,-585447,-586942.2,49.0737034692062,33.13585961804985,28.103295425205488,NaN,NaN,50
1675656000,1.07902,1.07988,1.07888,1.07966,1668,1932.05,-583779,-585609.4,48.31635829242341,39.02720676000827,28.98502777313812,NaN,NaN,50
1675657800,1.07966,1.07991,1.07943,1.07964,1233,1839.25,-585012,-584909.4,47.56039792151291,38.911824869116316,29.940304322936765,NaN,NaN,50
1675659600,1.07964,1.07981,1.07924,1.07931,1346,1778.95,-586358,-584961,47.014431181902125,36.96966776388472,30.81796061885768,NaN,NaN,50
1675661400,1.07931,1.07982,1.07902,1.07967,1264,1697.65,-585094,-585138,46.6872961228751,40.46089643242161,31.8600952751649,NaN,NaN,50
1675663200,1.07967,1.07981,1.07902,1.07915,1303,1635.95,-586397,-585328,46.383527853778574,37.25126441502493,32.562831659889966,NaN,NaN,50
1675665000,1.07915,1.07916,1.07864,1.07873,1353,1581.95,-587750,-586122.2,46.41988124036806,34.84682630008132,33.18976306399027,NaN,NaN,50
1675666800,1.07873,1.07964,1.07829,1.07904,2508,1657.75,-585242,-586168.2,45.453666233471765,38.02645223502537,34.10576015964754,NaN,NaN,50
1675668600,1.07904,1.0793,1.07798,1.078,2353,1737.9,-587595,-586415.6,44.854447389889174,32.326675686437184,34.46576628994405,NaN,NaN,50
1675670400,1.078,1.07886,1.07749,1.07756,3359,1900.6,-590954,-587587.6,44.72820902413691,30.26012189159185,34.626726476042606,NaN,NaN,50
1675672200,1.07756,1.07952,1.07749,1.07852,3368,2054.7,-587586,-587825.4,43.36522061106048,39.3675185357804,35.55143180776347,NaN,NaN,50
1675674000,1.07852,1.07884,1.0769,1.07723,3317,2084.75,-590903,-588456,42.65734516280152,33.11032398606224,35.765512205101736,NaN,NaN,50
1675675800,1.07723,1.07851,1.07651,1.07665,3043,2125.25,-593946,-590196.8,42.33066367310077,30.744249157112918,35.68913053358911,NaN,NaN,50
1675677600,1.07665,1.07778,1.07632,1.07699,3014,2142.6,-590932,-590864.2,42.18303475261634,33.733712894161414,35.58375718176846,NaN,NaN,50
1675679400,1.07699,1.07719,1.07599,1.07658,2576,2165.9,-593508,-591375,42.30959476686152,31.943090535399918,35.49855939015061,NaN,NaN,50
1675681200,1.07658,1.0767,1.07601,1.07612,2235,2178.65,-595743,-593006.4,42.427114780089184,30.017878731362046,34.855035959533026,NaN,NaN,50
1675683000,1.07612,1.07674,1.07566,1.07662,2225,2181.85,-593518,-593529.4,42.819007341725445,34.62976397644394,34.549174467199286,NaN,NaN,50
1675684800,1.07662,1.0773,1.07657,1.07722,2009,2185.75,-591509,-593042,42.036541940011105,39.760053739697405,34.748487751185905,NaN,NaN,50
1675686600,1.07722,1.07834,1.07713,1.07732,2459,2188.1,-589050,-592665.6,39.63046723142707,40.59682153729267,34.75819668724812,NaN,NaN,50
1675688400,1.07732,1.07778,1.07674,1.0771,3427,2264.9,-592477,-592459.4,37.83599335019615,39.30334873409693,34.904774138610414,NaN,NaN,50
1675690200,1.0771,1.07749,1.07572,1.07581,3673,2386.65,-596150,-592540.8,37.14123744237274,32.720209284849375,34.7528729232367,NaN,NaN,50
1675692000,1.07581,1.07623,1.07492,1.07534,3721,2489.3,-599871,-593811.4,37.10441361985319,30.7024499594678,34.229729903554016,NaN,NaN,50
1675693800,1.07534,1.07662,1.07392,1.07447,5545,2704.9,-605416,-596592.8,37.69280649500839,27.341364513694558,33.87363624835812,NaN,NaN,50
1675695600,1.07447,1.07477,1.07263,1.07314,4641,2869.65,-610057,-600794.2,38.86546581113893,23.16616088809944,33.36692474810866,NaN,NaN,50
1675697400,1.07314,1.07348,1.07222,1.07302,4452,3029.05,-614509,-605200.6,40.12497448893256,22.827449994518133,32.18549128087564,NaN,NaN,50
1675699200,1.07302,1.07394,1.07288,1.07346,3874,3157.6,-610635,-608097.6,40.63310973381086,27.03973376076351,31.7518776933543,NaN,NaN,50
1675701000,1.07346,1.07356,1.07174,1.07212,2674,3223.65,-613309,-610785.2,41.618909319820716,22.934155560299843,31.19401386501051,NaN,NaN,50
1675702800,1.07212,1.0722,1.07157,1.0718,2355,3216,-615664,-612834.8,42.60404923246111,22.072271573503826,30.361053770677824,NaN,NaN,50
1675704600,1.0718,1.07202,1.07094,1.07132,2027,3199.7,-617691,-614361.6,43.76977744644504,20.809009633887555,29.565762277712654,NaN,NaN,50
1675706400,1.07132,1.07179,1.07102,1.0717,1740,3118.75,-615951,-614650,44.852239359430115,24.493340951259725,29.171152436276774,NaN,NaN,50
1675708200,1.0717,1.07266,1.0717,1.07264,1422,3021.45,-614529,-615428.8,44.58536810044072,32.81967693826556,29.04186050497832,NaN,NaN,50
1675710000,1.07264,1.07374,1.07242,1.07352,1983,2954.75,-612546,-615276.2,43.02431874484853,39.541200126793214,29.026228104056592,NaN,NaN,50
1675711800,1.07352,1.07352,1.07236,1.07247,1666,2885.9,-614212,-614985.8,41.61746181554285,35.03675960303842,28.629080823038432,NaN,NaN,50
1675713600,1.07247,1.0731,1.07233,1.07277,1772,2823.8,-612440,-613935.6,40.33380861061483,37.23671225846142,28.48146393192161,NaN,NaN,50
1675715400,1.07277,1.07306,1.07187,1.07296,2076,2798.8,-610364,-612818.2,39.491419356361995,38.65365205486843,28.905281272637257,NaN,NaN,50
1675717200,1.07296,1.07303,1.07234,1.07264,600,2717.05,-610964,-612105.2,38.70920076312722,37.13314477279752,29.364616616446522,NaN,NaN,50
1675719000,1.07264,1.07266,1.07241,1.0725,413,2626.45,-611377,-611871.4,37.98285492655208,36.45745543524936,30.01576596798615,NaN,NaN,50
1675720800,1.0725,1.0729,1.07242,1.07275,374,2544.7,-611003,-611229.6,36.94027419245715,38.6058258024511,31.11859917615413,NaN,NaN,50
1675722600,1.07275,1.07288,1.0724,1.07276,2243,2533.9,-608760,-610493.6,35.99178327046463,38.69511200027487,32.25200360513676,NaN,NaN,50
1675724400,1.07276,1.07288,1.0724,1.07254,625,2393.8,-609385,-610297.8,35.111041700043,37.406243447603416,32.992468582768176,NaN,NaN,50
1675726200,1.07254,1.07292,1.0725,1.07292,552,2237.75,-608833,-609871.6,34.22036075450094,41.05816762151308,34.28704087285483,NaN,NaN,50
1675728000,1.07292,1.07342,1.07282,1.07316,1118,2107.6,-607715,-609139.2,32.517910532583656,43.30787383865824,35.80386960608015,NaN,NaN,50
1675729800,1.07316,1.07363,1.07302,1.07363,1131,1886.9,-606584,-608255.4,30.596096296062473,47.531379862984885,37.71261033672996,NaN,NaN,50
1675731600,1.07363,1.07387,1.07338,1.07373,1558,1732.75,-605026,-607508.6,28.430339185894276,48.411994572207256,39.421085595369064,NaN,NaN,50
1675733400,1.07373,1.07428,1.07338,1.07412,1494,1584.85,-603532,-606338,26.989177286193637,51.809038583098804,40.77746857000001,NaN,NaN,50
1675735200,1.07412,1.07412,1.07362,1.07403,1417,1462,-604949,-605561.2,25.650955522185903,50.974837267542156,41.59415693719637,NaN,NaN,50
1675737000,1.07403,1.07418,1.07367,1.0741,1248,1390.7,-603701,-604758.4,24.501582620939484,51.627226137559376,42.779190261090726,NaN,NaN,50
1675738800,1.0741,1.07419,1.07384,1.07404,1200,1332.95,-604901,-604421.8,23.450766781589234,51.00075367313472,43.76233607642454,NaN,NaN,50
1675740600,1.07404,1.07428,1.0736,1.07382,2261,1344.65,-607162,-604849,21.990497583582,48.66874861062871,44.477700116121696,NaN,NaN,50
1675742400,1.07382,1.07382,1.0733,1.07344,1497,1332.5,-608659,-605874.4,20.769906749710714,44.853726781032655,45.02917025956707,NaN,NaN,50
1675744200,1.07344,1.07346,1.07286,1.07331,1362,1329.5,-610021,-606888.8,20.37120450919459,43.59472814242157,45.538975452936505,NaN,NaN,50
1675746000,1.07331,1.07378,1.07308,1.07374,1338,1297.25,-608683,-607885.2,19.358417128613333,48.72179872800024,46.26154494761859,NaN,NaN,50
1675747800,1.07374,1.07418,1.07368,1.07404,1460,1286.95,-607223,-608349.6,18.25495057414753,51.999948456906445,47.21189040880655,NaN,NaN,50
1675749600,1.07404,1.07438,1.07354,1.07394,1722,1284.45,-608945,-608706.2,17.564750467132193,50.83338475180139,48.17097193053498,NaN,NaN,50
1675751400,1.07394,1.07426,1.07372,1.07393,1872,1274.25,-610817,-609137.8,16.92385036776081,50.710869181816314,48.86045061341378,NaN,NaN,50
1675753200,1.07393,1.07398,1.07286,1.07359,2885,1388.5,-613702,-609874,16.617674672131553,46.598624441224956,49.095504227882834,NaN,NaN,50
1675755000,1.07359,1.07386,1.07232,1.07243,3051,1520.4,-616753,-611488,17.06198288464656,35.90174287885998,48.264815871873914,NaN,NaN,50
1675756800,1.07243,1.0726,1.0697,1.0711,4983,1750.85,-621736,-614390.6,19.562976752808144,27.97304073184219,46.80489059756212,NaN,NaN,50
1675758600,1.0711,1.07242,1.07106,1.0719,4597,1868.55,-617139,-616029.4,21.885328201815327,36.98743880753465,45.74620489930754,NaN,NaN,50
1675760400,1.0719,1.07348,1.0713,1.07238,3781,2026.35,-613358,-616537.6,22.402039368206395,41.70189920972104,45.083852180891746,NaN,NaN,50
1675762200,1.07238,1.07258,1.07108,1.0711,3095,2153.5,-616453,-617087.8,23.04709109417725,34.32646830266974,43.848083764113916,NaN,NaN,50
1675764000,1.0711,1.07189,1.07068,1.07181,2927,2243.95,-613526,-616442.4,23.940268425694704,40.601816009073154,43.105302502395226,NaN,NaN,50
1675765800,1.07181,1.07228,1.0712,1.07136,2650,2319.9,-616176,-615330.4,24.195189990945497,38.115867765440164,42.35152529916748,NaN,NaN,50
1675767600,1.07136,1.07181,1.07011,1.07076,2974,2390.7,-619150,-615732.6,25.21646001747587,35.035657813176556,41.65023465860633,NaN,NaN,50
1675769400,1.07076,1.07082,1.06981,1.07051,2920,2462,-622070,-617475,26.353610259704695,33.80966256704092,40.95130140322199,NaN,NaN,50
1675771200,1.07051,1.07123,1.07044,1.07114,2648,2523.55,-619422,-618068.8,26.80975839001942,39.55027302700174,40.296192424579246,NaN,NaN,50
1675773000,1.07114,1.07115,1.07018,1.07054,2806,2601.45,-622228,-619809.2,27.42090464845555,36.31955273913338,39.176164159024026,NaN,NaN,50
1675774800,1.07054,1.07066,1.0688,1.06888,4118,2747.35,-626346,-621843.2,28.83074638597627,29.210254481669082,37.63165485401458,NaN,NaN,50
1675776600,1.06888,1.06991,1.06858,1.06954,3874,2828,-622472,-622507.6,30.254525118769628,34.684485556310676,36.48691316647846,NaN,NaN,50
1675778400,1.06954,1.06996,1.06902,1.06919,3846,2945.45,-626318,-623357.2,31.49819477934836,33.21749135443879,35.53111794599373,NaN,NaN,50
1675780200,1.06919,1.06971,1.06798,1.06823,4855,3120.1,-631173,-625707.4,33.183274713329915,29.528388542314815,35.07587835052622,NaN,NaN,50
1675782000,1.06823,1.0684,1.06692,1.06706,4256,3266,-635429,-628347.6,35.18016151075783,25.771767061227635,34.918644516910895,NaN,NaN,50
1675783800,1.06706,1.06966,1.06692,1.06926,5159,3450.95,-630270,-629132.4,35.34140392084406,40.97720588331302,35.20362787946649,NaN,NaN,50
1675785600,1.06926,1.07014,1.06886,1.06952,3856,3557.65,-626414,-629920.8,34.93243944919743,42.47691609281981,35.25898622825925,NaN,NaN,50
1675787400,1.06952,1.07121,1.06916,1.07049,3715,3649.8,-622699,-629197,33.43984187967078,47.80531726047972,36.22176115381712,NaN,NaN,50
1675789200,1.07049,1.07051,1.06957,1.06972,2996,3655.35,-625695,-628101.4,32.05385842225317,44.29749488134873,36.485738216122506,NaN,NaN,50
1675791000,1.06972,1.07667,1.069,1.076,10736,4039.6,-614959,-624007.4,32.38830831353211,66.12775692720372,38.486587441962754,NaN,NaN,50
1675792800,1.076,1.07626,1.071,1.07114,12260,4403.45,-627219,-623397.2,32.69886892686254,49.84671843065582,39.544520343211275,NaN,NaN,50
1675794600,1.07114,1.07124,1.06874,1.07022,8208,4584,-635427,-625199.8,31.43166654000307,47.464385699826686,40.51985770983884,NaN,NaN,50
1675796400,1.07022,1.07223,1.07015,1.07197,5759,4682.9,-629668,-626593.6,30.679490929569358,52.14917614381173,41.419779361039545,NaN,NaN,50
1675798200,1.07197,1.07286,1.0718,1.07194,4436,4749.95,-634104,-628275.4,30.239268063872277,52.06346499577148,42.54434452222797,NaN,NaN,50
1675800000,1.07194,1.0722,1.07083,1.07178,2567,4731.95,-636671,-632617.8,29.203951606927024,51.576580642411706,44.14193924799531,NaN,NaN,50
1675801800,1.07178,1.07293,1.07174,1.07252,2010,4699.95,-634661,-634106.2,28.5676287455476,53.7317065678381,45.50245503453298,NaN,NaN,50
1675803600,1.07252,1.07264,1.07218,1.07256,878,4595.15,-633783,-633777.4,27.976757517123847,53.851267675187096,46.976296200300716,NaN,NaN,50
1675805400,1.07256,1.07299,1.07254,1.07274,700,4484.15,-633083,-634460.4,27.59408466065067,54.42203431530639,48.7544137555144,NaN,NaN,50
1675807200,1.07274,1.07274,1.07232,1.0725,77,4355.6,-633160,-634271.6,27.069226909703342,53.47240966076673,50.733031084052904,NaN,NaN,50
1675809000,1.0725,1.073,1.07238,1.07298,399,4235.25,-632761,-633489.6,26.718813883829657,55.15771883912223,51.74592486661071,NaN,NaN,50
1675810800,1.07298,1.0731,1.07252,1.07254,592,4058.95,-633353,-633228,26.448247600721714,53.253515043555204,52.51568193452037,NaN,NaN,50
1675812600,1.07254,1.0731,1.07254,1.07306,425,3886.5,-632928,-633057,26.197007480692907,55.221023653750194,53.045375248325406,NaN,NaN,50
1675814400,1.07306,1.07342,1.0727,1.07273,1332,3760.8,-634260,-633292.4,26.158036710012926,53.67700951411998,53.71534057923764,NaN,NaN,50
1675816200,1.07273,1.07334,1.0727,1.07322,1104,3573.25,-633156,-633291.6,26.121849565810084,55.659513623708555,52.96760891470227,NaN,NaN,50
1675818000,1.07322,1.07352,1.0723,1.07268,1330,3426.95,-634486,-633636.6,25.651311811084852,52.96907988862178,53.19063473312841,NaN,NaN,50
1675819800,1.07268,1.07316,1.07253,1.07266,1857,3261.85,-636343,-634234.6,25.214383895982856,52.867152773188536,53.576546666939976,NaN,NaN,50
1675821600,1.07266,1.073,1.0724,1.07285,1396,3138.85,-634947,-634638.4,24.65481486055963,53.777134062788036,53.69282937543828,NaN,NaN,50
1675823400,1.07285,1.07334,1.07274,1.0733,1156,3010.9,-633791,-634544.6,24.42025686799574,55.946499928163966,53.97018901346631,NaN,NaN,50
1675825200,1.0733,1.0733,1.07304,1.07321,997,2910.95,-634788,-634871,24.20245301775785,55.386619264004636,54.242334629294376,NaN,NaN,50
1675827000,1.07321,1.07349,1.07306,1.07324,1043,2426.3,-633745,-634722.8,24.170683566001443,55.546315155148406,54.37194952838797,NaN,NaN,50
1675828800,1.07324,1.07348,1.07308,1.07342,921,1859.35,-632824,-634019,24.141183360799065,56.551258871763615,54.564806042429154,NaN,NaN,50
1675830600,1.07342,1.07345,1.07308,1.07338,643,1481.1,-633467,-633723,24.113790313111146,56.24695661631917,54.69515763535863,NaN,NaN,50
1675832400,1.07338,1.07338,1.07284,1.07287,666,1226.45,-634133,-633791.4,23.684381064152422,52.37706401197929,54.61691866044526,NaN,NaN,50
1675834200,1.07287,1.0735,1.07273,1.07338,742,1041.75,-633391,-633512,23.4261354721488,55.662237716622634,54.65295572312385,NaN,NaN,50
1675836000,1.07338,1.07364,1.0732,1.07354,1349,980.85,-632042,-633171.4,23.353565773039193,56.67205943834389,54.897137465608765,NaN,NaN,50
1675837800,1.07354,1.07398,1.07272,1.07273,1510,955.85,-633552,-633317,22.432853372987978,50.4123060809104,54.553657638977356,NaN,NaN,50
1675839600,1.07273,1.07389,1.07241,1.07368,2364,1030.15,-631188,-632861.2,21.076372362915443,56.48339388146091,54.75411366521599,NaN,NaN,50
1675841400,1.07368,1.07598,1.07344,1.07588,2956,1142.95,-628232,-631681,21.994678742377126,66.66249546627564,55.54004093968506,NaN,NaN,50
1675843200,1.07588,1.0759,1.0741,1.0748,4179,1348.05,-632411,-631485,22.847391809020117,59.3260510646275,55.99411030939975,NaN,NaN,50
1675845000,1.0748,1.0756,1.0741,1.07522,3259,1491.05,-629152,-630907,23.63919679947432,61.118146924878786,56.583467034520496,NaN,NaN,50
1675846800,1.07522,1.07609,1.07505,1.07537,2747,1598.8,-626405,-629477.6,24.77386647508649,61.76606566214444,57.15410500590309,NaN,NaN,50
1675848600,1.07537,1.07583,1.07502,1.07552,2844,1719.75,-623561,-627952.2,25.77218017966653,62.440101027181775,57.617933655832935,NaN,NaN,50
1675850400,1.07552,1.0756,1.0743,1.07476,2497,1778,-626058,-627517.4,25.455943751605293,56.96089633761051,57.73038201823336,NaN,NaN,50
1675852200,1.07476,1.07502,1.07442,1.07466,1914,1818.5,-627972,-626629.6,25.16229563983414,56.26132027884877,57.78145381278339,NaN,NaN,50
1675854000,1.07466,1.07476,1.0733,1.07407,1781,1841.05,-629753,-626749.8,23.439904875368583,52.188722806699474,57.46984409385023,NaN,NaN,50
1675855800,1.07407,1.07464,1.07348,1.07349,1955,1845.95,-631708,-627810.4,21.84054202265057,48.473962822870064,56.914630251461006,NaN,NaN,50
1675857600,1.07349,1.0749,1.07348,1.07462,2266,1889.45,-629442,-628986.6,20.547230687372338,55.16919658873481,57.11406829265783,NaN,NaN,50
1675859400,1.07462,1.07492,1.07336,1.07338,2619,1962.6,-632061,-630187.2,19.175982088532418,47.82532817778584,56.55428903988377,NaN,NaN,50
1675861200,1.07338,1.07378,1.07258,1.07308,3622,2093.85,-635683,-631729.4,18.71322667199694,46.22221839225867,55.807871822306254,NaN,NaN,50
1675863000,1.07308,1.07336,1.07264,1.07316,2987,2191.05,-632696,-632318,18.28352521378542,46.734962828229335,55.545204447114756,NaN,NaN,50
1675864800,1.07316,1.07434,1.07264,1.07308,4265,2358.25,-636961,-633368.6,17.42317930624619,46.25996886222803,54.814959802883834,NaN,NaN,50
1675866600,1.07308,1.07339,1.07178,1.0725,5781,2615.15,-642742,-636028.6,16.77292317768451,42.85894007798928,53.11470584657767,NaN,NaN,50
1675868400,1.0725,1.07276,1.07162,1.0719,5681,2865.9,-648423,-639301,16.344106179637734,39.614311259328645,51.706724431913464,NaN,NaN,50
1675870200,1.0719,1.0728,1.07136,1.07253,4852,3071.4,-643571,-640878.6,16.230656773238454,44.37598778206262,50.51085592171231,NaN,NaN,50
1675872000,1.07253,1.07358,1.07201,1.07222,3896,3198.75,-647467,-643832.8,15.09145515760564,42.59606495340989,49.14157015680269,NaN,NaN,50
1675873800,1.07222,1.07362,1.07186,1.07337,3525,3299.5,-643942,-645229,14.21494360612146,50.524133222458616,48.29042959932247,NaN,NaN,50
1675875600,1.07337,1.07401,1.07301,1.07362,2719,3317.25,-641223,-644925.2,13.4867963255634,52.073755902162546,47.94134813964762,NaN,NaN,50
1675877400,1.07362,1.07372,1.07259,1.07284,2115,3275.2,-643338,-643908.2,12.768517216164785,47.11543082472267,47.28807032149575,NaN,NaN,50
1675879200,1.07284,1.07394,1.07275,1.07291,3171,3224.8,-640167,-643227.4,11.898372184867888,47.59766155450235,46.96013737491024,NaN,NaN,50
1675881000,1.07291,1.07348,1.07244,1.0734,2705,3197.1,-637462,-641226.4,11.406500597067678,50.96810695129989,47.13829052694094,NaN,NaN,50
1675882800,1.0734,1.07342,1.07258,1.07266,1997,3159.6,-639459,-640329.8,10.949762694110344,46.14143233003195,46.493450222747875,NaN,NaN,50
1675884600,1.07266,1.07288,1.0721,1.07231,1788,3106.8,-641247,-640334.6,11.142185950040124,44.01817533535956,46.22151073400314,NaN,NaN,50
1675886400,1.07231,1.07246,1.07095,1.07104,1834,3073.65,-643081,-640283.2,12.492388471436122,37.30931007424059,45.584874425573275,NaN,NaN,50
1675888200,1.07104,1.07142,1.07095,1.07138,1824,3069.15,-641257,-640501.2,13.74614795558955,39.94809329816739,45.10009803056885,NaN,NaN,50
1675890000,1.07138,1.07149,1.07114,1.0712,587,3009.45,-641844,-641377.6,14.787457652467822,39.01187787278452,44.5823772456086,NaN,NaN,50
1675891800,1.0712,1.07156,1.07118,1.07143,595,2941.45,-641249,-641735.6,15.625624690305678,40.91725274000857,44.44368529289569,NaN,NaN,50
1675893600,1.07143,1.0716,1.07096,1.07156,1394,2897.85,-639855,-641457.2,16.64214218288358,42.01984450992147,44.61550909650946,NaN,NaN,50
1675895400,1.07156,1.07176,1.0711,1.07127,4212,2977.5,-644067,-641654.4,17.267635167062032,40.216822021965044,44.31842582793106,NaN,NaN,50
1675897200,1.07127,1.07161,1.071,1.07141,806,2836.7,-643261,-642055.2,17.968792466710585,41.521365760848816,44.24166159989098,NaN,NaN,50
1675899000,1.07141,1.07172,1.07134,1.07154,672,2720.95,-642589,-642204.2,18.38334281287105,42.7701917771249,43.68780863951001,NaN,NaN,50
1675900800,1.07154,1.07193,1.07152,1.07162,1136,2564.5,-641453,-642245,18.318753829307084,43.568839061826125,43.08031457948597,NaN,NaN,50
1675902600,1.07162,1.0719,1.07148,1.07162,1157,2333.3,-641453,-642564.6,18.319622134887492,43.568839061826125,42.82698659642193,NaN,NaN,50
1675904400,1.07162,1.07178,1.07094,1.07164,1811,2139.8,-639642,-641679.6,19.08163676894572,43.7962479388164,42.55545705244436,NaN,NaN,50
1675906200,1.07164,1.07261,1.0716,1.07248,1679,1981.15,-637963,-640620,18.152661807694994,52.461275145987344,42.66211192349347,NaN,NaN,50
1675908000,1.07248,1.07302,1.07238,1.07286,1026,1837.65,-636937,-639489.6,17.076194344393002,55.782425459403456,43.35075428987715,NaN,NaN,50
1675909800,1.07286,1.0733,1.07272,1.07308,1347,1728.75,-635590,-638317,16.489938286628497,57.62804945487865,44.32288815555709,NaN,NaN,50
1675911600,1.07308,1.07317,1.07255,1.07302,1081,1646.85,-636671,-637360.6,15.653391269019265,56.93013248437388,45.724375470566606,NaN,NaN,50
1675913400,1.07302,1.07327,1.07285,1.07298,998,1591,-637669,-636966,15.034716553830707,56.439399054907156,46.902325881762295,NaN,NaN,50
1675915200,1.07298,1.07317,1.07294,1.07312,759,1470.4,-636910,-636755.4,14.460232889727045,57.81016713223442,48.24506082886586,NaN,NaN,50
1675917000,1.07312,1.07328,1.07284,1.07322,712,1370.75,-636198,-636607.6,14.11813780196512,58.807286537039104,49.52292038579662,NaN,NaN,50
1675918800,1.07322,1.07344,1.07318,1.07328,825,1312.15,-635373,-636564.2,14.079020318894262,59.42688966124376,50.76628075374821,NaN,NaN,50
1675920600,1.07328,1.0738,1.0727,1.07356,2436,1344.55,-632937,-635817.4,13.097010879164378,62.278398884604464,52.34210767250817,NaN,NaN,50
1675922400,1.07356,1.07449,1.07335,1.07438,1989,1352.3,-630948,-634473.2,13.279520062405181,69.12253478073751,54.31361974535736,NaN,NaN,50
1675924200,1.07438,1.07438,1.07355,1.07398,1508,1336.5,-632456,-633582.4,13.448992875414497,63.10747267082737,55.76628266633611,NaN,NaN,50
1675926000,1.07398,1.07403,1.07243,1.0737,3550,1484.65,-636006,-633544,13.276159166403717,59.2224836105326,56.88440013410086,NaN,NaN,50
1675927800,1.0737,1.07392,1.07246,1.07331,2376,1573.7,-638382,-634145.8,13.115670722322278,54.21605334432837,57.64491543999388,NaN,NaN,50
1675929600,1.07331,1.07568,1.07326,1.07538,4053,1706.65,-634329,-634424.2,13.738508901302735,69.13176026251594,59.454594891686725,NaN,NaN,50
1675931400,1.07538,1.07596,1.07508,1.0753,3256,1658.85,-637585,-635751.6,14.586334688549583,68.20692703927223,60.57928431263565,NaN,NaN,50
1675933200,1.0753,1.0769,1.0751,1.07546,3202,1778.65,-634383,-636137,16.163075466374657,69.0973497197549,61.53035033123218,NaN,NaN,50
1675935000,1.07546,1.0765,1.07531,1.07637,2446,1867.35,-631937,-635323.2,17.627191902926516,73.62223697256093,62.67279229678091,NaN,NaN,50
1675936800,1.07637,1.07694,1.07592,1.07682,2447,1932.9,-629490,-633544.8,19.324398313706407,75.53031535988913,64.00137678788914,NaN,NaN,50
1675938600,1.07682,1.07787,1.0766,1.07776,2944,2022.25,-626546,-631988.2,21.508336553910073,78.95490924011867,65.60962751540426,NaN,NaN,50
1675940400,1.07776,1.07776,1.07632,1.07637,2312,2047.3,-628858,-630242.8,23.054810546134867,64.56523207997863,66.09213215452884,NaN,NaN,50
1675942200,1.07637,1.07686,1.07588,1.07632,2309,2078.8,-631167,-629599.6,23.76769659498974,64.11258979800488,66.47108238745497,NaN,NaN,50
1675944000,1.07632,1.07723,1.07592,1.07697,2008,2127.9,-629159,-629044,24.717545883186467,67.32008057265875,67.03488173827033,NaN,NaN,50
1675945800,1.07697,1.07718,1.07632,1.07694,2429,2182,-631588,-629463.6,25.599548793654858,67.02234174330817,67.3737347996063,NaN,NaN,50
1675947600,1.07694,1.07732,1.07628,1.07686,3240,2289.95,-634828,-631120,26.534224731313177,66.18175498469904,67.16367909988926,NaN,NaN,50
1675949400,1.07686,1.07902,1.07684,1.07898,4953,2487.7,-629875,-631323.4,28.50481849464879,75.09566814190023,68.01997877639448,NaN,NaN,50
1675951200,1.07898,1.07911,1.0779,1.07866,3808,2640.15,-633683,-631826.6,30.381029168690326,72.0102743680561,68.93339240193187,NaN,NaN,50
1675953000,1.07866,1.07894,1.0778,1.07801,4779,2843.5,-638462,-633687.2,31.939142107732128,66.07198785094602,69.78024486669027,NaN,NaN,50
1675954800,1.07801,1.07894,1.07706,1.07706,4494,3026.95,-642956,-635960.8,32.11239192439553,58.48133867328339,69.01950046745938,NaN,NaN,50
1675956600,1.07706,1.0772,1.07618,1.07628,4715,3140.9,-647671,-638529.4,31.021182306631935,53.08849714350118,67.93961261776144,NaN,NaN,50
1675958400,1.07628,1.07634,1.07488,1.07514,4154,3249.15,-651825,-642919.4,29.03722903971226,46.359720746449085,66.31549626252531,NaN,NaN,50
1675960200,1.07514,1.0761,1.07444,1.07608,3305,3339,-648520,-645886.8,27.6024261056734,51.78616143297174,64.75577658112607,NaN,NaN,50
1675962000,1.07608,1.07616,1.07522,1.07597,2383,3280.65,-650903,-648375,26.20331163324027,51.13425468673804,63.01320081875814,NaN,NaN,50
1675963800,1.07597,1.07598,1.0739,1.07488,2368,3280.25,-653271,-650438,26.014489206103775,45.07860530868606,60.593464823655815,NaN,NaN,50
1675965600,1.07488,1.07488,1.07394,1.07414,2978,3226.5,-656249,-652153.6,25.839154095191326,41.486527148501594,58.94498589997888,NaN,NaN,50
1675967400,1.07414,1.07458,1.07376,1.07414,2607,3194.05,-656249,-653038.4,25.818470766005667,41.486527148501594,57.328838567871514,NaN,NaN,50
1675969200,1.07414,1.07458,1.0734,1.07358,3122,3190.05,-659371,-655208.6,26.08158897753452,38.774773397913336,55.2898880553897,NaN,NaN,50
1675971000,1.07358,1.07418,1.07333,1.07374,2490,3192.25,-656881,-656404.2,26.38127808805789,39.98187065275869,53.35842583463616,NaN,NaN,50
1675972800,1.07374,1.07396,1.07326,1.07344,2275,3183.65,-659156,-657581.2,26.717839139348243,38.451112008273206,51.37766562203432,NaN,NaN,50
1675974600,1.07344,1.0736,1.07316,1.07336,2011,3137,-661167,-658564.8,27.117402820603363,38.03293812732998,48.730327763850724,NaN,NaN,50
1675976400,1.07336,1.0735,1.0733,1.07334,538,3048.3,-661705,-659656,27.48842623891169,37.92190238324867,46.2954440506502,NaN,NaN,50
1675978200,1.07334,1.0739,1.07333,1.0739,595,2962.6,-661110,-660003.8,27.116385373213582,42.944657043538506,44.64349185012109,NaN,NaN,50
1675980000,1.0739,1.07435,1.07368,1.07379,637,2894.05,-661747,-660977,26.036098107228213,42.22200086914091,43.48211057839662,NaN,NaN,50
1675981800,1.07379,1.07426,1.07376,1.07413,1155,2830.35,-660592,-661264.2,25.032974217384652,45.28669036866008,42.92483866590798,NaN,NaN,50
1675983600,1.07413,1.07426,1.07382,1.07394,600,2698.35,-661192,-661269.2,24.101502033958493,43.88578993551294,42.748129322269676,NaN,NaN,50
1675985400,1.07394,1.07396,1.07381,1.07392,717,2486.55,-661909,-661310,23.251208109161585,43.732433709855705,42.17286305633282,NaN,NaN,50
1675987200,1.07392,1.07394,1.0727,1.07276,1168,2354.55,-663077,-661703.4,23.827732120658844,35.89721795108022,41.08450328950012,NaN,NaN,50
1675989000,1.07276,1.07348,1.07256,1.07348,1739,2202.55,-661338,-661621.6,24.50404068996782,42.75303149872527,40.91839087450292,NaN,NaN,50
1675990800,1.07348,1.07388,1.07312,1.07358,1460,2050.85,-659878,-661478.8,24.358586988031668,43.65438352924616,41.07323775884182,NaN,NaN,50
1675992600,1.07358,1.07362,1.0728,1.07337,1692,1899.7,-661570,-661554.4,24.58576267130013,42.15339129344081,41.120870912051764,NaN,NaN,50
1675994400,1.07337,1.07342,1.0729,1.07312,1241,1754.05,-662811,-661734.8,24.79671152004942,40.37366130318419,41.23507719099968,NaN,NaN,50
1675996200,1.07312,1.07326,1.07244,1.07252,1023,1639.95,-663834,-661886.2,25.501506476047293,36.4014181305867,40.979330582273114,NaN,NaN,50
1675998000,1.07252,1.07262,1.07176,1.07186,1771,1609.35,-665605,-662739.6,26.787602156676034,32.60166923601609,40.561513241397606,NaN,NaN,50
1675999800,1.07186,1.07218,1.07173,1.07208,1033,1542.6,-664572,-663678.4,28.00761649548505,35.03596322257657,40.34744360534379,NaN,NaN,50
1676001600,1.07208,1.07244,1.07198,1.07223,1039,1445.65,-663533,-664071,28.562156774698323,36.71431364335262,40.26118726677979,NaN,NaN,50
1676003400,1.07223,1.07234,1.07174,1.07186,1247,1377.65,-664780,-664464.8,29.32015256703056,34.35647853639411,39.6477459448409,NaN,NaN,50
1676005200,1.07186,1.07236,1.07182,1.07194,1300,1286.55,-663480,-664394,29.976962778176443,35.3236346207387,39.155005498526464,NaN,NaN,50
1676007000,1.07194,1.07268,1.07194,1.0726,1484,1236.25,-661996,-663672.2,29.840929216485414,42.80988425490359,38.97809077611528,NaN,NaN,50
1676008800,1.0726,1.07292,1.07252,1.07257,1497,1197.35,-663493,-663456.4,29.189528204435756,42.56868777551103,38.88401205040086,NaN,NaN,50
1676010600,1.07257,1.07268,1.0722,1.07232,1261,1159.85,-664754,-663700.6,29.015834934470657,40.519892192091206,38.654544799131976,NaN,NaN,50
1676012400,1.07232,1.07428,1.07192,1.07336,5140,1389.95,-659614,-662667.4,27.664764077007405,51.070093896786446,39.73832165239669,NaN,NaN,50
1676014200,1.07336,1.07448,1.07256,1.07412,4649,1592.65,-654965,-660964.4,26.652084761145904,57.06358339057594,40.76050393038604,NaN,NaN,50
1676016000,1.07412,1.07528,1.07332,1.07383,5830,1852.3,-660795,-660724.2,26.574469988508987,54.32891010736932,41.52297011453769,NaN,NaN,50
1676017800,1.07383,1.07435,1.07268,1.0742,4300,2009.55,-656495,-659324.6,25.539428941411007,57.1504188363651,42.59418636760371,NaN,NaN,50
1676019600,1.0742,1.07448,1.07129,1.07198,5393,2249.2,-661888,-658751.4,24.459006814394687,40.84545890113438,42.627886196028726,NaN,NaN,50
1676021400,1.07198,1.07297,1.07041,1.07066,4065,2416.6,-665953,-660019.2,24.22604646873728,34.536173465646,42.49465443424725,NaN,NaN,50
1676023200,1.07066,1.07092,1.06918,1.07073,3746,2545.5,-662207,-661467.6,24.87317429416369,35.1086164299664,42.67372209095799,NaN,NaN,50
1676025000,1.07073,1.07115,1.07024,1.07088,2607,2588.9,-659600,-661228.6,25.1887961158044,36.392185405895354,42.770595104052184,NaN,NaN,50
1676026800,1.07088,1.07112,1.06936,1.06948,2889,2660.35,-662489,-662427.4,26.036932183926524,30.35674645989205,42.31648316237643,NaN,NaN,50
1676028600,1.06948,1.07006,1.06944,1.06986,2267,2689.1,-660222,-662094.2,26.824487104325645,33.57678352594223,42.26079066162987,NaN,NaN,50
1676030400,1.06986,1.07008,1.06956,1.0697,2317,2742.9,-662539,-661411.4,27.527510059782102,32.88728878145267,42.08676595882372,NaN,NaN,50
1676032200,1.0697,1.07001,1.06814,1.06832,3050,2844.25,-665589,-662087.8,28.99867159268607,27.619264523433955,41.001721692290175,NaN,NaN,50
1676034000,1.06832,1.0696,1.06821,1.06947,3584,2934.9,-662005,-662568.8,30.364750158954042,36.71657666105922,40.58371375554362,NaN,NaN,50
1676035800,1.06947,1.06995,1.06816,1.06958,5208,3143.65,-656797,-661430.4,31.113031373462807,37.525435746719204,40.36982400944562,NaN,NaN,50
1676037600,1.06958,1.06996,1.06908,1.06988,3801,3281.75,-652996,-659985.2,31.792667177852792,39.78588350846656,39.56380898170848,NaN,NaN,50
1676039400,1.06988,1.0707,1.06864,1.06978,5267,3482.75,-658263,-659130,31.3444532407972,39.275755445748366,38.29324984279224,NaN,NaN,50
1676041200,1.06978,1.07068,1.06844,1.06978,7429,3789.2,-658263,-657664.8,31.08959176504351,39.275755445748366,37.218024509819315,NaN,NaN,50
1676043000,1.06978,1.07006,1.06746,1.0677,4891,3959.55,-663154,-657894.6,31.564596243109204,29.997473125211087,35.27852838759402,NaN,NaN,50
1676044800,1.0677,1.0687,1.06748,1.06756,3966,4083,-667120,-659959.2,32.00567182988449,29.492459138444744,34.46759983311619,NaN,NaN,50
1676046600,1.06756,1.06795,1.06683,1.06688,3030,4171.45,-670150,-663390,32.84188245017708,27.105516506496613,33.93683862174838,NaN,NaN,50
1676048400,1.06688,1.06732,1.06662,1.06717,2376,4033.25,-667774,-665292.2,33.74822889575865,29.717972856383255,33.55179265220672,NaN,NaN,50
1676050200,1.06717,1.06742,1.06666,1.06684,2321,3916.85,-670095,-667658.6,34.42045447667767,28.46769287702513,32.98575747157314,NaN,NaN,50
1676052000,1.06684,1.06763,1.06677,1.0674,1496,3700.15,-668599,-668747.6,34.68123479947675,33.57485207779693,33.21562215856634,NaN,NaN,50
1676053800,1.0674,1.06768,1.06712,1.06714,1233,3546.8,-669832,-669290,34.83432457921844,32.417599851445516,33.13282332467372,NaN,NaN,50
1676055600,1.06714,1.06754,1.06683,1.06745,1497,3352,-668335,-668927,35.217428568012295,35.28186323901808,33.303864357356964,NaN,NaN,50
1676057400,1.06745,1.06752,1.06712,1.06734,1566,3227.05,-669901,-669352.4,35.573167986178014,34.719561729603925,33.811028443511965,NaN,NaN,50
1676059200,1.06734,1.06789,1.06732,1.06786,1297,3104.6,-668604,-669054.2,35.1702242655758,39.61865660615717,34.01831986816182,NaN,NaN,50
1676061000,1.06786,1.06809,1.06768,1.0679,1178,3033.15,-667426,-668819.6,34.4166377065004,39.9917222724369,34.194483191427366,NaN,NaN,50
1676062800,1.0679,1.06802,1.06766,1.06769,548,2916.1,-667974,-668448,33.74048040477695,38.64187483252733,34.11276828600314,NaN,NaN,50
1676064600,1.06769,1.06792,1.06754,1.06774,578,2831.65,-667396,-668260.2,33.26027244608058,39.16835201606382,34.10509661245424,NaN,NaN,50
1676239200,1.06774,1.06837,1.06772,1.06772,81,2719.85,-667477,-667775.4,31.90619607247974,39.02411219342069,34.08712209443083,NaN,NaN,50
1676241000,1.06772,1.06802,1.06765,1.06782,1753,2655,-665724,-667199.4,30.749791566146538,40.20970422030881,34.8165671726521,NaN,NaN,50
1676242800,1.06782,1.06793,1.06716,1.0676,1400,2545.8,-667124,-667139,30.34169538592117,38.4389588390273,35.45560286555085,NaN,NaN,50
1676244600,1.0676,1.06796,1.06743,1.06773,1297,2350.25,-665827,-666709.6,29.898104226753553,40.117118524662345,36.38500300970555,NaN,NaN,50
1676246400,1.06773,1.06789,1.0668,1.06718,1559,2238.15,-667386,-666707.6,30.248494973904005,35.68494840736537,36.81121554906141,NaN,NaN,50
1676248200,1.06718,1.06766,1.06693,1.06726,1410,2045.3,-665976,-666407.4,30.573857810543714,36.779055046733305,37.40488427546914,NaN,NaN,50
1676250000,1.06726,1.0675,1.06594,1.06596,2123,1780,-668099,-666882.4,31.82622423889871,28.34163035949007,37.031082724161514,NaN,NaN,50
1676251800,1.06596,1.06688,1.06556,1.0667,2503,1660.6,-665596,-666576.8,33.277462534191834,37.176578035949824,37.37100973734039,NaN,NaN,50
1676253600,1.0667,1.06712,1.06636,1.06676,1857,1555.15,-663739,-666159.2,34.0789668445439,37.845710924211524,37.554141714854204,NaN,NaN,50
1676255400,1.06676,1.06696,1.06605,1.06675,1550,1481.15,-665289,-665739.8,35.082218329999144,37.77349858197804,37.772280061452356,NaN,NaN,50
1676257200,1.06675,1.06685,1.06642,1.06666,1396,1432.15,-666685,-665881.6,36.01380899506473,37.0876142937385,37.59149132485102,NaN,NaN,50
1676259000,1.06666,1.06672,1.06608,1.06608,1219,1377.05,-667904,-665842.6,37.163153687514985,32.93695354432832,37.087579272843264,NaN,NaN,50
1676260800,1.06608,1.06664,1.06608,1.06661,1004,1352.45,-666900,-666103.4,38.23040233050452,39.59012667480911,37.155311547291966,NaN,NaN,50
1676262600,1.06661,1.06694,1.06656,1.06672,741,1327.85,-666159,-666587.4,38.430490925578766,40.90060570397208,37.27904395357113,NaN,NaN,50
1676264400,1.06672,1.06698,1.06648,1.0669,1273,1316.65,-664886,-666506.8,38.70254184487441,43.07669523488938,37.568514170818894,NaN,NaN,50
1676266200,1.0669,1.06706,1.06632,1.06696,1511,1313.9,-663375,-665844.8,39.129447565772665,43.819277340607115,37.826340822268776,NaN,NaN,50
1676268000,1.06696,1.0675,1.06673,1.0674,1783,1338.2,-661592,-664582.4,38.37674884862719,49.06665894812048,38.585462258632575,NaN,NaN,50
1676269800,1.0674,1.06794,1.06734,1.0674,1639,1361.25,-661592,-663520.8,36.69553940385719,49.066658948120484,39.22471514602244,NaN,NaN,50
1676271600,1.0674,1.0689,1.06724,1.0689,2608,1464.25,-658984,-662085.8,34.66170481038072,62.80300291820033,41.16171903965351,NaN,NaN,50
1676273400,1.0689,1.069,1.0682,1.06831,2395,1555.1,-661379,-661384.4,32.91757099193167,56.36403177072827,42.56064594851029,NaN,NaN,50
1676275200,1.06831,1.06856,1.06736,1.06761,3397,1720.9,-664776,-661664.6,31.143193636883648,49.835631864606825,44.09593177030435,NaN,NaN,50
1676277000,1.06761,1.06828,1.06741,1.06744,2639,1765.2,-667415,-662829.2,29.495557521481913,48.37035550495552,44.89548730380476,NaN,NaN,50
1676278800,1.06744,1.06841,1.06695,1.0673,2695,1829.95,-670110,-664532.8,28.592434989733967,47.14109745697085,45.559443484716134,NaN,NaN,50
1676280600,1.0673,1.06813,1.06633,1.0677,2965,1913.35,-667145,-666165,28.476642344104842,50.974647566493125,46.50238269789578,NaN,NaN,50
1676282400,1.0677,1.06813,1.06753,1.06786,2164,1943.6,-664981,-666885.4,28.369120601734938,52.459858531314715,47.60040014343694,NaN,NaN,50
1676284200,1.06786,1.06851,1.06766,1.06804,1872,1966.7,-663109,-666552,27.54715568803358,54.14296129920673,49.115114983071116,NaN,NaN,50
1676286000,1.06804,1.06844,1.06752,1.0676,1722,1946.65,-664831,-666035.2,26.965759065065864,49.52704975501685,49.82489520308595,NaN,NaN,50
1676287800,1.0676,1.06816,1.06732,1.06759,1863,1914.65,-666694,-665352,26.68489948102905,49.423919838598216,50.433703355559246,NaN,NaN,50
1676289600,1.06759,1.06948,1.06736,1.06938,2198,1931.7,-664496,-664822.2,25.263008774871697,63.910378914892945,51.921823618416646,NaN,NaN,50
1676291400,1.06938,1.06968,1.06872,1.06908,2780,1993.2,-667276,-665281.2,24.195936749179165,60.76878162739288,53.132502496044204,NaN,NaN,50
1676293200,1.06908,1.06956,1.06818,1.0682,3136,2080.2,-670412,-666741.8,22.514931502523343,52.60075411099054,53.384937864820635,NaN,NaN,50
1676295000,1.0682,1.06846,1.06762,1.06808,2589,2148.7,-673001,-668375.8,21.66412347676408,51.58257786051103,53.56464635856282,NaN,NaN,50
1676296800,1.06808,1.06914,1.06765,1.06882,2855,2241.25,-670146,-669066.2,20.273565981387733,57.097605364473125,53.15711796186802,NaN,NaN,50
1676298600,1.06882,1.07072,1.0686,1.0705,5336,2471,-664810,-669129,20.55106914843427,66.44289476652466,53.87703674728201,NaN,NaN,50
1676300400,1.0705,1.07174,1.07022,1.07134,4309,2622.8,-660501,-667774,21.540271459303312,69.96566218211981,55.31489605567579,NaN,NaN,50
1676302200,1.07134,1.07274,1.07087,1.07196,3864,2740.45,-656637,-665019,23.043506890761307,72.27883482867664,57.02264457879873,NaN,NaN,50
1676304000,1.07196,1.07202,1.07102,1.07152,3502,2826.4,-660139,-662446.6,24.439368362829445,68.26085824373138,58.5311989207102,NaN,NaN,50
1676305800,1.07152,1.07234,1.07108,1.07169,2354,2862.15,-657785,-659974.4,25.917035963584485,68.97839063601799,59.817180568533395,NaN,NaN,50
1676307600,1.07169,1.07218,1.0716,1.07208,1863,2824.9,-655922,-658196.8,27.289155878571307,70.61938676947518,61.114289728402,NaN,NaN,50
1676309400,1.07208,1.07212,1.07165,1.07183,1626,2786.45,-657548,-657606.2,28.563267228201926,68.1313858253119,62.11346290883808,NaN,NaN,50
1676311200,1.07183,1.07212,1.07118,1.07211,1526,2692.9,-656022,-657483.2,28.967926606788957,69.43041483616086,63.53513184320551,NaN,NaN,50
1676313000,1.07211,1.073,1.07211,1.0728,1464,2634.15,-654558,-656367,29.961490777417488,72.41450658037971,65.17731661047561,NaN,NaN,50
1676314800,1.0728,1.07282,1.07196,1.07202,1698,2584.3,-656256,-656061.2,30.643530597514047,64.72299929622878,65.23536092342817,NaN,NaN,50
1676316600,1.07202,1.07214,1.07162,1.07174,1766,2524.35,-658022,-656481.2,30.734687023230084,62.170202343716475,65.33546240316556,NaN,NaN,50
1676318400,1.07174,1.07204,1.07141,1.07192,1308,2481.55,-656714,-656314.4,30.490236214012,63.17572306184822,66.09081732822683,NaN,NaN,50
1676320200,1.07192,1.07237,1.07192,1.07228,1164,2446.15,-655550,-656220,30.55298985219665,65.1697380777195,67.06132877231315,NaN,NaN,50
1676322000,1.07228,1.07248,1.0721,1.07211,672,2393.65,-656222,-656552.8,30.707538495861638,63.42321803321535,67.51315824865188,NaN,NaN,50
1676323800,1.07211,1.0725,1.07206,1.07242,357,2318.35,-655865,-656474.6,30.778695573277652,65.25197174494332,67.42809231853893,NaN,NaN,50
1676325600,1.07242,1.07248,1.07205,1.07246,74,2212.15,-655791,-656028.4,30.825478829797603,65.49172031043736,67.10852504199018,NaN,NaN,50
1676327400,1.07246,1.07268,1.0723,1.0725,541,2100.2,-655250,-655735.6,31.076085229880956,65.74623848770123,66.6419110176348,NaN,NaN,50
1676329200,1.0725,1.07257,1.07214,1.07252,899,1988.35,-654351,-655495.8,30.97141039757091,65.88173779818027,66.47197384295258,NaN,NaN,50
1676331000,1.07252,1.07325,1.0724,1.07312,538,1885.8,-653813,-655014,31.571174530349406,69.74798059531108,66.52694455433065,NaN,NaN,50
1676332800,1.07312,1.0737,1.07298,1.0732,1329,1809.5,-652484,-654337.8,32.51748083826817,70.23234285473548,66.49929856042068,NaN,NaN,50
1676334600,1.0732,1.07346,1.07302,1.07336,1322,1608.8,-651162,-653412,33.39619383847845,71.22466126734378,66.7202468062801,NaN,NaN,50
1676336400,1.07336,1.07343,1.07266,1.07284,1567,1471.7,-652729,-652907.8,33.41567919540821,63.7828544741299,66.31684963756359,NaN,NaN,50
1676338200,1.07284,1.07314,1.07258,1.07288,1837,1370.35,-650892,-652216,33.26102531703613,64.09363994723606,65.72250202091048,NaN,NaN,50
1676340000,1.07288,1.07332,1.07255,1.07272,1897,1290.1,-652789,-652011.2,33.323663099732734,61.80887257063361,65.51435011193941,NaN,NaN,50
1676341800,1.07272,1.07341,1.07262,1.0732,1356,1240.2,-651433,-651801,33.48586468243583,65.7530373521943,65.77026689825925,NaN,NaN,50
1676343600,1.0732,1.07347,1.07296,1.07331,925,1193.3,-650508,-651670.2,33.708380899508974,66.60421528438215,66.01515919986882,NaN,NaN,50
1676345400,1.07331,1.0736,1.0732,1.07346,715,1147.75,-649793,-651083,34.07433812043813,67.780207094708,66.20162127251085,NaN,NaN,50
1676347200,1.07346,1.074,1.0732,1.07363,900,1116.45,-648893,-650683.2,34.870363789618125,69.10791403360471,66.60767098682437,NaN,NaN,50
1676349000,1.07363,1.07385,1.07348,1.07381,762,1081.35,-648131,-649751.6,35.60953048242813,70.49432901535104,66.98212507756777,NaN,NaN,50
1676350800,1.07381,1.07399,1.07366,1.07376,1187,1055.8,-649318,-649328.6,36.45500289607948,69.56045009169475,67.27274863337188,NaN,NaN,50
1676352600,1.07376,1.07387,1.07354,1.07384,922,1013.6,-648396,-648906.2,36.85909198393415,70.23977458780014,67.59371549766466,NaN,NaN,50
1676354400,1.07384,1.07396,1.0734,1.07362,1481,1022.25,-649877,-648923,36.79300907129666,65.88521353558963,67.59396376462247,NaN,NaN,50
1676356200,1.07362,1.07431,1.0735,1.07391,1466,1037.35,-648411,-648826.6,37.211149838047,68.64472316941615,67.51515966277283,NaN,NaN,50
1676358000,1.07391,1.07467,1.07334,1.0736,2416,1124.55,-650827,-649365.8,38.02546169166421,62.797126523006355,66.98407278193504,NaN,NaN,50
1676359800,1.0736,1.0741,1.07288,1.07321,2691,1241.25,-653518,-650205.8,37.45269100554356,56.29939752264879,65.91798251445684,NaN,NaN,50
1676361600,1.07321,1.07414,1.07289,1.07354,3295,1402.3,-650223,-650571.2,36.97876566068772,60.064802366073884,65.6524073638814,NaN,NaN,50
1676363400,1.07354,1.07503,1.07296,1.07486,2604,1505.45,-647619,-650119.6,37.61259420810647,70.87502228082293,66.13679181628046,NaN,NaN,50
1676365200,1.07486,1.0761,1.07446,1.07585,3244,1622.7,-644375,-649312.4,39.05043459754459,76.10037611631057,67.15761349811454,NaN,NaN,50
1676367000,1.07585,1.0767,1.07564,1.07614,2621,1726.85,-641754,-647497.8,40.73896164956985,77.38057975809815,67.98815224139338,NaN,NaN,50
1676368800,1.07614,1.07664,1.0751,1.07542,2640,1792.4,-644394,-645673,41.12259747392662,67.6864483946641,68.06545460641352,NaN,NaN,50
1676370600,1.07542,1.07578,1.07486,1.07557,2507,1851.65,-641887,-644005.8,40.99343841318009,68.5698670879824,68.1218588916474,NaN,NaN,50
1676372400,1.07557,1.07652,1.07512,1.07612,2255,1886.05,-639632,-642408.4,41.45338054864522,71.63227165469691,68.30217015029685,NaN,NaN,50
1676374200,1.07612,1.07636,1.07546,1.07552,2202,1904.3,-641834,-641900.2,41.880469674434266,64.2747737514121,67.85791620287263,NaN,NaN,50
1676376000,1.07552,1.07604,1.07488,1.07596,2782,1948.55,-639052,-641359.8,41.13530720832721,66.95523880859812,67.67182968265145,NaN,NaN,50
1676377800,1.07596,1.07681,1.0755,1.0758,3004,2030.95,-642056,-640892.2,41.10050975593612,65.04408790610779,67.30070920538772,NaN,NaN,50
1676379600,1.0758,1.07664,1.07509,1.07572,4066,2188,-646122,-641739.2,40.35031733180569,64.05951305763969,67.17030202839129,NaN,NaN,50
1676381400,1.07572,1.08047,1.07188,1.07611,16593,2981.9,-629529,-639718.6,41.72695101136695,66.70541541475401,67.03178004591543,NaN,NaN,50
1676383200,1.07611,1.07694,1.07178,1.07254,12207,3547.25,-641736,-639699,42.872733778036384,38.65333334323609,65.30722339021754,NaN,NaN,50
1676385000,1.07254,1.07564,1.07084,1.07524,12113,4114.8,-629623,-637813.2,42.75034070835238,54.30479412844683,65.16475171920311,NaN,NaN,50
1676386800,1.07524,1.07718,1.07504,1.07542,8154,4463.15,-621469,-633695.8,43.29503963867668,55.12674322510054,64.81203320913359,NaN,NaN,50
1676388600,1.07542,1.0758,1.07068,1.07158,8344,4834.25,-629813,-630434,40.3290437427771,39.006944384220844,62.53574193080487,NaN,NaN,50
1676390400,1.07158,1.0734,1.07146,1.07166,7108,5115.6,-622705,-629069.2,37.57490469658464,39.40448472964843,59.914606831757574,NaN,NaN,50
1676392200,1.07166,1.07242,1.07124,1.07214,6780,5381.3,-615925,-623907,34.899423951783334,41.85333138725302,57.37694623384006,NaN,NaN,50
1676394000,1.07214,1.07305,1.07208,1.07228,4408,5480.9,-611517,-620285.8,32.78540656480935,42.58218324490275,55.58378443742853,NaN,NaN,50
1676395800,1.07228,1.07294,1.07192,1.07278,3302,5511.45,-608215,-617635,30.71261940398231,45.22300612469056,53.91615151147912,NaN,NaN,50
1676397600,1.07278,1.07456,1.07273,1.07354,4594,5576.4,-603621,-612396.6,29.731558796397277,49.05826433540067,52.30372241724367,NaN,NaN,50
1676399400,1.07354,1.07406,1.073,1.07316,3424,5617.4,-607045,-609264.6,28.820573946496893,47.27592205593523,51.089518724709606,NaN,NaN,50
1676401200,1.07316,1.07325,1.07232,1.07294,3725,5641.45,-610770,-608233.6,27.451222880259767,46.22875753560315,49.609055776638534,NaN,NaN,50
1676403000,1.07294,1.0741,1.07294,1.07394,2425,5631.65,-608345,-607599.2,26.681590038451148,51.48868724911144,48.64081287256737,NaN,NaN,50
1676404800,1.07394,1.07394,1.07322,1.07358,2085,5603.9,-610430,-608042.2,25.96693097105743,49.607364912547126,47.60851657648933,NaN,NaN,50
1676406600,1.07358,1.07425,1.07338,1.0738,2197,5588.4,-608233,-608964.6,25.492866400526776,50.790688561913264,46.47175037271499,NaN,NaN,50
1676408400,1.0738,1.0739,1.07367,1.07381,958,5523.55,-607275,-609010.6,25.05266358503403,50.847188353200586,47.342740016283884,NaN,NaN,50
1676410200,1.07381,1.07382,1.07351,1.07357,480,5437.45,-607755,-608407.6,24.484453374536656,49.381768340698514,46.991095317159,NaN,NaN,50
1676412000,1.07357,1.07376,1.07352,1.07362,131,5304.9,-607624,-608263.4,23.95682960764624,49.706965290153654,46.60396832180565,NaN,NaN,50
1676413800,1.07362,1.07364,1.07335,1.07351,312,5170.3,-607936,-607764.6,23.278430644004505,48.96171275882573,47.315023205706,NaN,NaN,50
1676415600,1.07351,1.07365,1.07338,1.07364,1117,5022.85,-606819,-607481.8,22.657197706065666,49.91738410685485,48.065944589792174,NaN,NaN,50
1676417400,1.07364,1.07396,1.07344,1.07354,717,4229.05,-607536,-607534,22.35748154153838,49.15491758908247,48.58748646135142,NaN,NaN,50
1676419200,1.07354,1.07392,1.07328,1.07386,1404,3688.9,-606132,-607209.4,21.870801134833176,51.69748994163803,49.238579796832504,NaN,NaN,50
1676421000,1.07386,1.07402,1.07348,1.0738,1451,3155.8,-607583,-607201.2,21.517244043160094,51.1806970675524,49.664129149894066,NaN,NaN,50
1676422800,1.0738,1.07435,1.07358,1.07427,1393,2817.75,-606190,-606852,21.513965785748557,54.97741857436496,50.08692588124866,NaN,NaN,50
1676424600,1.07427,1.07446,1.07374,1.07398,1580,2479.55,-607770,-607042.2,21.61908020998133,52.275926307114794,50.444069042047204,NaN,NaN,50
1676426400,1.07398,1.074,1.07268,1.07282,1635,2205.9,-609405,-607416,20.251930502847674,43.14361701811802,50.22370186222684,NaN,NaN,50
1676428200,1.07282,1.07292,1.07233,1.07248,1839,1958.85,-611244,-608438.4,19.038004773359855,40.888910479759204,49.466574950130244,NaN,NaN,50
1676430000,1.07248,1.07278,1.07233,1.07252,1469,1811.9,-609775,-608876.8,17.910788024549735,41.27772466832518,48.87160064697154,NaN,NaN,50
1676431800,1.07252,1.07254,1.07172,1.07181,1405,1717.05,-611180,-609874.8,17.566423429385395,36.66735485657071,47.86279109658993,NaN,NaN,50
1676433600,1.07181,1.07205,1.07144,1.07194,1624,1568.55,-609556,-610232,17.54363172555543,38.03211513156688,46.94742872361609,NaN,NaN,50
1676435400,1.07194,1.07209,1.07159,1.07182,958,1445.25,-610514,-610453.8,17.46128169723147,37.234493770297796,46.07976625430175,NaN,NaN,50
1676437200,1.07182,1.07212,1.07146,1.07146,1261,1322.05,-611775,-610560,17.533718362910097,34.87170235369031,45.02010461598294,NaN,NaN,50
1676439000,1.07146,1.07174,1.07136,1.0715,969,1249.25,-610806,-610766.2,17.718824215567746,35.362504692978064,44.04873261127954,NaN,NaN,50
1676440800,1.0715,1.072,1.0714,1.07146,1307,1210.35,-612113,-610952.8,17.430587835740454,35.0778264635252,42.988764208184556,NaN,NaN,50
1676442600,1.07146,1.07148,1.07038,1.07075,1888,1194.9,-614001,-611841.8,18.301759488473245,30.399778241199556,41.649111397621496,NaN,NaN,50
1676444400,1.07075,1.07148,1.06998,1.07106,4239,1358.95,-609762,-611691.4,19.47444392306135,34.50670437894907,40.42119814314371,NaN,NaN,50
1676446200,1.07106,1.07188,1.07044,1.07082,3296,1499.75,-613058,-611948,19.867686364856002,32.88867331538647,39.114625017989,NaN,NaN,50
1676448000,1.07082,1.07198,1.07048,1.07192,4660,1726.2,-608398,-611466.4,20.06240003355648,45.502009885850754,38.43781011166656,NaN,NaN,50
1676449800,1.07192,1.07288,1.07157,1.07243,3352,1878.2,-605046,-610053,18.87582132308627,50.17744790932952,38.28791879753904,NaN,NaN,50
1676451600,1.07243,1.07288,1.07166,1.07234,2708,1957.75,-607754,-608803.6,17.773998234792508,49.37247049678452,38.73283690315808,NaN,NaN,50
1676453400,1.07234,1.073,1.07225,1.07258,2766,2060.2,-604988,-607848.8,16.57665593202707,51.602209724843924,39.49807256352127,NaN,NaN,50
1676455200,1.07258,1.07332,1.0722,1.07222,2536,2116.8,-607524,-606742,15.777929768892953,48.174820797527396,39.99072228703572,NaN,NaN,50
1676457000,1.07222,1.07289,1.07155,1.07156,2411,2164.8,-609935,-607049.4,15.182714804916886,42.58977710320148,40.413752447509346,NaN,NaN,50
1676458800,1.07156,1.07212,1.07156,1.07202,1959,2193.1,-607976,-607635.4,14.630015195510534,47.18554268631808,41.06756870142014,NaN,NaN,50
1676460600,1.07202,1.07244,1.07103,1.0711,2137,2220.95,-610113,-608107.2,14.799726698138665,40.24633818311765,41.28270044519298,NaN,NaN,50
1676462400,1.0711,1.07182,1.07106,1.07128,2517,2265.05,-607596,-608628.8,14.957315950579073,42.04223637337381,41.79488144659894,NaN,NaN,50
1676464200,1.07128,1.07132,1.06969,1.06976,3069,2326.55,-610665,-609257,16.5054025442082,33.017783690030896,41.62740137495986,NaN,NaN,50
1676466000,1.06976,1.07052,1.06952,1.06978,3599,2433.05,-607066,-608683.2,18.08155752033411,33.22090089397264,41.494763834277535,NaN,NaN,50
1676467800,1.06978,1.0706,1.06742,1.0683,10318,2878.7,-617384,-610564.8,20.815435855817096,26.755245672030867,41.23444007933692,NaN,NaN,50
1676469600,1.0683,1.06892,1.06658,1.06766,6525,3123.75,-623909,-613324,23.699712087295058,24.531767272847404,40.52194457175823,NaN,NaN,50
1676471400,1.06766,1.06854,1.06686,1.06695,6765,3414.1,-630674,-617939.6,26.377968587953166,22.31609635375743,39.766760503070444,NaN,NaN,50
1676473200,1.06695,1.06848,1.06684,1.0673,5788,3640.45,-624886,-620783.8,28.873381990868946,25.870461932498714,38.36450707783102,NaN,NaN,50
1676475000,1.0673,1.06793,1.06652,1.0676,5506,3867.3,-619380,-623246.6,31.32863229299036,28.87442598730115,36.84286265482899,NaN,NaN,50
1676476800,1.0676,1.06878,1.06689,1.06714,4551,4029.5,-623931,-624556,32.15019365730923,27.063468896333745,35.24936254051107,NaN,NaN,50
1676478600,1.06714,1.06858,1.06673,1.06824,3209,4095.55,-620722,-623918.6,33.014039924614345,37.20572129030123,34.22104193804374,NaN,NaN,50
1676480400,1.06824,1.06824,1.06662,1.06662,2636,4015.4,-623358,-622455.4,33.887778903797866,30.482886846794585,32.95733237013425,NaN,NaN,50
1676482200,1.06662,1.06697,1.06618,1.0667,2775,3989.35,-620583,-621594.8,34.98020843865815,31.144555605369078,32.13981654886051,NaN,NaN,50
1676484000,1.0667,1.06746,1.06605,1.06732,2560,3884.35,-618023,-621323.4,35.14897201160777,36.21184088875106,31.355980706177153,NaN,NaN,50
1676485800,1.06732,1.06782,1.06674,1.06757,2113,3822.4,-615910,-619719.2,34.72609573725808,38.18721070673212,31.208900172149615,NaN,NaN,50
1676487600,1.06757,1.06854,1.06754,1.06849,1966,3785.3,-613944,-618363.6,33.29143137435192,44.944071038910174,31.41617407683078,NaN,NaN,50
1676489400,1.06849,1.06864,1.06788,1.0681,1757,3734.85,-615701,-616832.2,31.823278448092964,42.80782520812969,32.11546275669498,NaN,NaN,50
1676491200,1.0681,1.06838,1.06798,1.0682,1103,3663.2,-614598,-615635.2,30.45999358799536,43.54874719169081,32.85316606367485,NaN,NaN,50
1676493000,1.0682,1.06904,1.06814,1.06902,1755,3630.4,-612843,-614599.2,28.28604187874045,49.343915130226975,34.466642453546,NaN,NaN,50
1676494800,1.06902,1.06915,1.06879,1.069,886,3576.75,-613729,-614163,26.40558344450405,49.21121926415066,36.22946045292481,NaN,NaN,50
1676496600,1.069,1.06908,1.06874,1.0688,537,3496.75,-614266,-614227.4,24.589400603717813,47.82614255738431,38.05160661032672,NaN,NaN,50
1676498400,1.0688,1.06912,1.0688,1.06901,1657,3453.75,-612609,-613609,22.961068892105118,49.4354169951631,39.73481768623133,NaN,NaN,50
1676500200,1.06901,1.06902,1.06831,1.06888,5438,3572.2,-618047,-614298.8,21.904091885831715,48.43935974552684,41.13231295467602,NaN,NaN,50
1676502000,1.06888,1.06912,1.06868,1.06884,785,3431.5,-618832,-615496.6,20.760028968667417,48.11810030813453,42.63621519837608,NaN,NaN,50
1676503800,1.06884,1.06926,1.06884,1.06917,939,2962.55,-617893,-616329.4,19.465095733687363,51.005101696828945,43.62188522741377,NaN,NaN,50
1676505600,1.06917,1.06956,1.06902,1.06906,1492,2710.9,-619385,-617353.2,18.37257094716367,50.006209799357,45.016408295453935,NaN,NaN,50
1676507400,1.06906,1.06916,1.06847,1.06894,2457,2495.5,-621842,-619199.8,17.623238408320944,48.88154515558966,46.2833361204697,NaN,NaN,50
1676509200,1.06894,1.06982,1.06868,1.06982,1887,2300.45,-619955,-619581.4,16.80369859579746,56.59162297883869,47.73903484119025,NaN,NaN,50
1676511000,1.06982,1.07081,1.06975,1.07048,2523,2151.3,-617432,-619301.4,17.20660731546615,61.305480470786996,49.390339824337026,NaN,NaN,50
1676512800,1.07048,1.07066,1.07026,1.07044,1596,2003.55,-619028,-619528.4,17.580736840872795,60.874025317867876,50.52819370140543,NaN,NaN,50
1676514600,1.07044,1.0715,1.07034,1.07126,1956,1940.9,-617072,-619065.8,18.736507640591622,66.1356267427891,52.194465239595395,NaN,NaN,50
1676516400,1.07126,1.07128,1.07078,1.07086,1119,1865.05,-618191,-618335.6,19.809723383187677,61.77174034410536,53.49610760762501,NaN,NaN,50
1676518200,1.07086,1.07102,1.07076,1.07094,1227,1787.65,-616964,-617737.4,20.76793669976199,62.30742407927454,54.422072532556975,NaN,NaN,50
1676520000,1.07094,1.07106,1.07079,1.07093,954,1707.35,-617918,-617834.6,21.698581472926485,62.19011274522777,55.34913635263392,NaN,NaN,50
1676521800,1.07093,1.07106,1.07068,1.07071,1059,1654.65,-618977,-617824.4,22.326201253875613,59.53443264099511,56.18544278717754,NaN,NaN,50
1676523600,1.07071,1.07088,1.07018,1.07036,886,1600.65,-619863,-618382.6,21.90175248893979,55.475727784688424,56.61689355785792,NaN,NaN,50
1676525400,1.07036,1.07072,1.0701,1.07054,1036,1564.6,-618827,-618509.8,21.355652180225043,57.09570593397542,57.23520399988996,NaN,NaN,50
1676527200,1.07054,1.07088,1.07004,1.07023,1320,1575.45,-620147,-619146.4,21.080569663625326,53.48635428510049,57.61865071253039,NaN,NaN,50
1676529000,1.07023,1.07039,1.06961,1.06996,1680,1571.7,-621827,-619928.2,19.995835959896954,50.49244326336501,57.582032252997244,NaN,NaN,50
1676530800,1.06996,1.0709,1.0697,1.07078,2498,1652.3,-619329,-619998.6,19.741839227750457,58.15351677711906,58.16398275140882,NaN,NaN,50
1676532600,1.07078,1.07104,1.07059,1.07089,2334,1742.15,-616995,-619425,19.697372830307618,59.068553955274275,58.89162623710058,NaN,NaN,50
1676534400,1.07089,1.07226,1.07026,1.07191,3951,1856.85,-613044,-618268.4,20.992443570274183,66.40445736329261,59.59254297884729,NaN,NaN,50
1676536200,1.07191,1.07194,1.07007,1.0707,2929,1731.4,-615973,-617433.6,21.82733284183281,54.03289299039507,59.07307244453358,NaN,NaN,50
1676538000,1.0707,1.07128,1.06981,1.07014,2946,1839.45,-618919,-616852,22.108194468917322,49.4418685688717,58.256489819605285,NaN,NaN,50
1676539800,1.07014,1.07016,1.06889,1.07004,2932,1939.1,-621851,-617356.4,20.879425083858642,48.64698419344391,57.00730106608063,NaN,NaN,50
1676541600,1.07004,1.07095,1.06998,1.07074,2310,1980,-619541,-617865.6,20.641534468378705,54.198043165478914,56.466322696178736,NaN,NaN,50
1676543400,1.07074,1.0713,1.07042,1.07064,1859,1950.1,-621400,-619536.8,20.771949634449108,53.31146476556568,55.82375417377096,NaN,NaN,50
1676545200,1.07064,1.07068,1.06947,1.06947,2454,1978.45,-623854,-621113,19.5942110899321,44.20107571263604,54.538822957157265,NaN,NaN,50
1676547000,1.06947,1.07065,1.06936,1.07051,1842,1944.4,-622012,-621731.6,18.365190913392457,52.0457601851004,54.00391778173621,NaN,NaN,50
1676548800,1.07051,1.07082,1.06966,1.06972,2017,1965.45,-624029,-622167.2,17.428706603300164,46.67747649936688,53.375471261356104,NaN,NaN,50
1676550600,1.06972,1.07027,1.06919,1.06938,2665,2000.9,-626694,-623597.8,16.412973427969256,44.54780358736992,52.47919252231286,NaN,NaN,50
1676552400,1.06938,1.07088,1.06938,1.07032,3741,2132,-622953,-623908.4,15.756221572535448,51.1797251094919,52.314433295483674,NaN,NaN,50
1676554200,1.07032,1.07032,1.06699,1.06794,10299,2585.6,-633252,-625788,16.404089398549974,38.59408822109081,51.46455079246409,NaN,NaN,50
1676556000,1.06794,1.06892,1.06628,1.0665,6225,2849.15,-639477,-629281,17.474291756421426,33.26413178159511,49.68673757849809,NaN,NaN,50
1676557800,1.0665,1.06754,1.06596,1.06626,6686,3130.5,-646163,-633707.8,18.667215828949455,32.45953443889421,47.78609332732809,NaN,NaN,50
1676559600,1.06626,1.06739,1.06544,1.06726,6706,3421.5,-639457,-636260.4,20.087104635853173,39.07240302991311,45.8338037320867,NaN,NaN,50
1676561400,1.06726,1.06828,1.06637,1.06732,5601,3649.75,-633856,-638441,20.326547522646063,39.45543667872342,44.79255685268158,NaN,NaN,50
1676563200,1.06732,1.06799,1.06683,1.06783,4507,3809.1,-629349,-637660.4,20.548887346096606,42.75002954722368,44.314568351135286,NaN,NaN,50
1676565000,1.06783,1.06912,1.0677,1.06834,4627,3956.45,-624722,-634709.4,19.53555833918236,45.919260629881066,44.11973095373794,NaN,NaN,50
1676566800,1.06834,1.069,1.0678,1.06838,3306,3996.85,-621416,-629760,18.594609975619132,46.170952872545605,43.54636736138557,NaN,NaN,50
1676568600,1.06838,1.06962,1.06838,1.06928,2918,4026.05,-618498,-625568.2,17.42666921681234,51.62608922907634,43.42598339449347,NaN,NaN,50
1676570400,1.06928,1.06962,1.06832,1.06841,2807,3968.85,-621305,-623058,16.281086087179023,46.699333529060944,43.604430381380965,NaN,NaN,50
1676572200,1.06841,1.06937,1.06841,1.0692,2693,3957.05,-618612,-620910.6,15.217330323948088,51.24888780107684,43.547510925379285,NaN,NaN,50
1676574000,1.0692,1.06976,1.06916,1.06937,2323,3925.9,-616289,-619224,14.647225778694503,52.194516062131015,43.941585179862436,NaN,NaN,50
1676575800,1.06937,1.0697,1.06896,1.06902,1815,3870.05,-618104,-618561.6,13.874958262995554,50.042342213908434,44.33405222461518,NaN,NaN,50
1676577600,1.06902,1.06911,1.06708,1.0673,4980,4003.55,-623084,-619478.8,14.412183756722479,41.07819614232342,43.612514441246006,NaN,NaN,50
1676579400,1.0673,1.06762,1.06692,1.06738,3104,4065.8,-619980,-619213.8,15.033355462213633,41.60217551218349,43.8273778191812,NaN,NaN,50
1676581200,1.06738,1.06757,1.067,1.06732,1271,4006.65,-621251,-619741.6,15.610157760169702,41.30549302494656,44.401760765134874,NaN,NaN,50
1676583000,1.06732,1.06738,1.06714,1.0673,702,3949.65,-621953,-620874.4,16.145759893986053,41.200021132900126,45.026081243278156,NaN,NaN,50
1676584800,1.0673,1.06752,1.06726,1.06736,92,3853.4,-621861,-621625.8,16.438609566753097,41.681130663375335,45.2124189313826,NaN,NaN,50
1676586600,1.06736,1.06746,1.06685,1.06692,876,3763.95,-622737,-621556.4,17.099811205735868,39.15125822675335,45.190691899099015,NaN,NaN,50
1676588400,1.06692,1.067,1.06631,1.0665,1104,3632.1,-623841,-622328.6,18.182738982980865,36.85193151463642,44.769399182485635,NaN,NaN,50
1676590200,1.0665,1.06662,1.06624,1.06654,770,3155.65,-623071,-622692.6,19.247269736927365,37.23002768827697,44.148739686656775,NaN,NaN,50
1676592000,1.06654,1.06656,1.06566,1.0657,1360,2912.4,-624431,-623188.2,20.704454657935823,32.78998264544282,43.19295609900657,NaN,NaN,50
1676593800,1.0657,1.06603,1.06552,1.06603,1384,2647.3,-623047,-623425.4,22.164711149854945,36.01824981632374,42.0781104266671,NaN,NaN,50
1676595600,1.06603,1.06644,1.06588,1.06632,1468,2385.4,-621579,-623193.8,22.787734768809663,38.80022976334822,41.513888729116196,NaN,NaN,50
1676597400,1.06632,1.06658,1.06523,1.06536,1964,2203.55,-623543,-623134.2,23.91132299061982,33.59302235008687,40.25275548261691,NaN,NaN,50
1676599200,1.06536,1.0654,1.06485,1.06538,1858,2071.1,-621685,-622857,25.240089405630396,33.79237500991384,38.938316836029976,NaN,NaN,50
1676601000,1.06538,1.06554,1.06501,1.06512,1316,1905.55,-623001,-622571,26.218033783254185,32.42943802091516,37.68025225081617,NaN,NaN,50
1676602800,1.06512,1.06538,1.06488,1.06538,1111,1795.8,-621890,-622339.6,27.23309583518833,35.242205267016004,37.263395759722776,NaN,NaN,50
1676604600,1.06538,1.06559,1.06516,1.06528,1030,1701.4,-622920,-622607.8,27.7652408979495,34.644858669008414,36.76644455663884,NaN,NaN,50
1676606400,1.06528,1.06532,1.06466,1.06476,988,1610.45,-623908,-622680.8,28.702368737903576,31.641492364617193,36.07615879518674,NaN,NaN,50
1676608200,1.06476,1.06477,1.06329,1.06384,1681,1559.85,-625589,-623461.6,30.49669038627781,27.156050034705117,35.07301800245853,NaN,NaN,50
1676610000,1.06384,1.06407,1.06366,1.06379,1226,1505,-626815,-624224.4,32.1628462026253,26.932593349186092,34.01955105144502,NaN,NaN,50
1676611800,1.06379,1.06392,1.06354,1.06384,1255,1477,-625560,-624958.4,33.78172793028646,27.574399010354398,33.192632535987954,NaN,NaN,50
1676613600,1.06384,1.06389,1.06322,1.06328,1538,1304.9,-627098,-625794,35.47466099795681,24.932873056862363,32.34127121757552,NaN,NaN,50
1676615400,1.06328,1.06382,1.06314,1.06348,1523,1225.85,-625575,-626127.4,37.093988354354494,27.600416767883317,31.653441866118833,NaN,NaN,50
1676617200,1.06348,1.06393,1.06294,1.06391,2620,1293.3,-622955,-625600.6,38.718010437248566,33.104462586996306,31.675904719086937,NaN,NaN,50
1676619000,1.06391,1.06464,1.06352,1.0644,3220,1419.2,-619735,-624184.6,38.7032443442076,38.812910921362366,31.875523369446842,NaN,NaN,50
1676620800,1.0644,1.06472,1.06312,1.06394,3899,1609.55,-623634,-623799.4,39.018358291885185,35.730395969392674,31.656249527021448,NaN,NaN,50
1676622600,1.06394,1.06455,1.06306,1.06438,3113,1721.4,-620521,-622484,39.35951797232554,40.59069485723581,32.15608327753208,NaN,NaN,50
1676624400,1.06438,1.06512,1.06371,1.06454,3104,1821.4,-617417,-620852.4,38.557425860119466,42.299486154139636,32.763734073548214,NaN,NaN,50
1676626200,1.06454,1.06616,1.06357,1.0637,3034,1934.6,-620451,-620351.6,36.199008055034035,36.382845426650825,33.04612031681505,NaN,NaN,50
1676628000,1.0637,1.06413,1.06326,1.06382,2470,1990.1,-617981,-620000.8,34.37046089938991,37.722998614119014,33.22331984160812,NaN,NaN,50
1676629800,1.06382,1.06448,1.06376,1.06416,2480,2044.9,-615501,-618374.2,32.1894715716102,41.48427419017178,33.711849521691214,NaN,NaN,50
1676631600,1.06416,1.06422,1.06286,1.06321,2585,2100.75,-618086,-617887.2,31.15892672222646,35.10457064903106,33.959212256292204,NaN,NaN,50
1676633400,1.06321,1.06344,1.06238,1.06256,2694,2137.25,-620780,-618559.8,30.653041622551854,31.531540907119364,34.2717473186075,NaN,NaN,50
1676635200,1.06256,1.06266,1.06128,1.06188,2760,2182.35,-623540,-619177.6,31.047258944369872,28.287758321577797,34.368544816635485,NaN,NaN,50
1676637000,1.06188,1.06232,1.06128,1.062,3491,2291.1,-620049,-619591.2,31.413317886058024,29.662901780374284,34.51772358592262,NaN,NaN,50
1676638800,1.062,1.06308,1.062,1.06308,3225,2396.8,-616824,-619855.8,30.652138271874446,40.68675851779389,35.6430011188463,NaN,NaN,50
1676640600,1.06308,1.0644,1.0627,1.06412,4083,2549.45,-612741,-618786.8,28.487308032076864,48.97933515803613,37.170066718142934,NaN,NaN,50
1676642400,1.06412,1.06558,1.06375,1.06482,4275,2713.8,-608466,-616324,27.502140433023893,53.674072918035144,38.63932459893142,NaN,NaN,50
1676644200,1.06482,1.0649,1.06366,1.06404,4582,2858.85,-613048,-614225.6,26.491574253590905,48.33674515041124,39.31959847243491,NaN,NaN,50
1676646000,1.06404,1.06791,1.06404,1.06641,7204,3157.75,-605844,-611384.6,27.386890374785168,61.02019532664954,41.12601271223897,NaN,NaN,50
1676647800,1.06641,1.06822,1.06592,1.06622,6992,3444.6,-612836,-610587,28.356823375316402,59.753680602616875,42.49479740833762,NaN,NaN,50
1676649600,1.06622,1.06706,1.06569,1.06612,4584,3596.9,-617420,-611522.8,29.007854462032824,59.058891460267475,43.691897787346754,NaN,NaN,50
1676651400,1.06612,1.06796,1.06604,1.0677,3794,3710.45,-613626,-612554.8,30.0348492978935,65.82109549687743,45.79462993522007,NaN,NaN,50
1676653200,1.0677,1.06938,1.06768,1.06911,2998,3729.35,-610628,-612070.8,31.548426096460098,70.50328543815104,48.136078994079504,NaN,NaN,50
1676655000,1.06911,1.06916,1.06779,1.06784,2619,3699.3,-613247,-613551.4,32.95389026655765,62.2336653062275,49.61817835951205,NaN,NaN,50
1676656800,1.06784,1.06898,1.06776,1.06878,1906,3599.65,-611341,-613252.4,34.222440863370174,65.46270471074766,51.78661650677753,NaN,NaN,50
1676658600,1.06878,1.06909,1.0683,1.06856,1871,3537.55,-613212,-612410.8,35.44676483644593,64.08174083233155,54.11163078714982,NaN,NaN,50
1676660400,1.06856,1.06952,1.06854,1.06918,2049,3484.8,-611163,-611918.2,36.76620537610405,66.24299560943537,56.822719164853936,NaN,NaN,50
1676662200,1.06918,1.0697,1.06894,1.06964,1973,3431.75,-609190,-611630.6,38.067573135593385,67.7914985386671,59.54619036187485,NaN,NaN,50
1676664000,1.06964,1.06984,1.06937,1.06942,2156,3416.05,-611346,-611250.4,39.337127338584274,66.22679733369687,61.37047884872506,NaN,NaN,50
1676665800,1.06942,1.06982,1.06936,1.06946,1750,3379.55,-609596,-610901.4,40.499740420955156,66.37874432534156,62.61329378924688,NaN,NaN,50
1676667600,1.06946,1.06978,1.0693,1.06964,616,3281.1,-608980,-610055,41.47538787005497,67.09614832855614,63.57201346142695,NaN,NaN,50
1676669400,1.06964,1.06966,1.06928,1.06937,661,3179.45,-609641,-609750.6,42.34451334295862,64.86048700259065,64.75228073658262,NaN,NaN,50
1676844000,1.06937,1.06937,1.06878,1.06888,111,3047,-609752,-609863,42.24487490687628,60.89490975213403,64.74333176697438,NaN,NaN,50
1676845800,1.06888,1.06944,1.06884,1.06911,1480,2946.45,-608272,-609248.2,42.204245699522644,62.06725864695797,64.90858734157017,NaN,NaN,50
1676847600,1.06911,1.0694,1.06826,1.06867,1245,2847.45,-609517,-609232.4,41.16547399688971,58.45675480264713,64.86557758031157,NaN,NaN,50
1676849400,1.06867,1.06882,1.06836,1.06842,783,2682.45,-610300,-609496.4,40.20090027301627,56.4475582533236,64.19603920577201,NaN,NaN,50
1676851200,1.06842,1.06856,1.06766,1.06776,1508,2544.1,-611808,-609929.8,38.196207410207634,51.42262208033854,62.83313468021397,NaN,NaN,50
1676853000,1.06776,1.06792,1.06732,1.06792,1419,2385.95,-610389,-610057.2,35.8556347991361,52.525944524157836,62.13972605292329,NaN,NaN,50
1676854800,1.06792,1.06812,1.06766,1.06804,1219,2086.7,-609170,-610236.8,33.92885278322052,53.381160468303854,61.27675860703444,NaN,NaN,50
1676856600,1.06804,1.06806,1.06736,1.0676,1548,1814.5,-610718,-610477,31.706600584300787,49.83613070293814,60.25921502636349,NaN,NaN,50
1676858400,1.0676,1.06828,1.06754,1.06822,1287,1649.65,-609431,-610303.2,29.935507944453132,54.42861614705647,59.415330779050706,NaN,NaN,50
1676860200,1.06822,1.06868,1.06782,1.06838,1370,1528.45,-608061,-609553.8,28.79759256118476,55.559323963119624,58.541604023654465,NaN,NaN,50
1676862000,1.06838,1.06843,1.0679,1.06808,1169,1437,-609230,-609322,27.740956848149846,52.908565715626345,57.59030176522085,NaN,NaN,50
1676863800,1.06808,1.06834,1.06801,1.06818,973,1354.7,-608257,-609139.4,26.759795114617425,53.70151134857898,56.68478512402353,NaN,NaN,50
1676865600,1.06818,1.06913,1.06815,1.06882,1257,1322.25,-607000,-608395.8,26.82061481723404,58.51596631836726,56.07191498043861,NaN,NaN,50
1676867400,1.06882,1.06914,1.06863,1.06868,1105,1283.95,-608105,-608130.6,26.88821881501279,57.11677614538104,55.51879277635221,NaN,NaN,50
1676869200,1.06868,1.06878,1.06838,1.06859,966,1229.8,-609071,-608332.6,26.451134071253495,56.18666515030655,55.18248959050739,NaN,NaN,50
1676871000,1.06859,1.06934,1.06856,1.0691,1178,1190.05,-607893,-608065.2,26.705753259263332,60.14710412998094,55.0453356964376,NaN,NaN,50
1676872800,1.0691,1.06938,1.0689,1.06921,1896,1177.05,-605997,-607613.2,26.986663055973796,60.96666250864463,55.22461481829456,NaN,NaN,50
1676874600,1.06921,1.06934,1.06876,1.06907,1826,1180.85,-607823,-607777.8,26.944718818842322,59.29533870645221,55.42802770780376,NaN,NaN,50
1676876400,1.06907,1.06982,1.06876,1.06974,1853,1242.7,-605970,-607350.8,27.468245891881356,64.33439513036032,56.350297211376734,NaN,NaN,50
1676878200,1.06974,1.07039,1.06974,1.07018,2015,1310.4,-603955,-606327.6,28.519423395864013,67.20561909298752,57.398845394864566,NaN,NaN,50
1676880000,1.07018,1.07048,1.06927,1.06948,2698,1439.75,-606653,-606079.6,28.514880153455856,59.05972196759555,57.80445693052826,NaN,NaN,50
1676881800,1.06948,1.06964,1.06854,1.0693,2230,1477.25,-608883,-606656.8,27.234820365113848,57.141733913451,58.32628573127918,NaN,NaN,50
1676883600,1.0693,1.06994,1.06866,1.06876,2242,1527.1,-611125,-607317.2,26.416410263098598,51.71569613831139,58.13250573065453,NaN,NaN,50
1676885400,1.06876,1.06888,1.06792,1.06794,2381,1607,-613506,-608824.4,24.552880900385748,44.76438404691903,57.361438593783056,NaN,NaN,50
1676887200,1.06794,1.06889,1.06782,1.06849,2219,1642.55,-611287,-610290.8,22.91226699595816,49.65264716014927,57.12887298267755,NaN,NaN,50
1676889000,1.06849,1.0689,1.0681,1.06882,1961,1669.65,-609326,-610825.4,21.373983835581363,52.37596004168966,57.03419074647117,NaN,NaN,50
1676890800,1.06882,1.06898,1.0683,1.06868,1823,1699.85,-611149,-611278.6,19.87447720350061,51.11282562471196,56.50539498263864,NaN,NaN,50
1676892600,1.06868,1.06922,1.06831,1.06854,2107,1727.8,-613256,-611704.8,18.859424210852573,49.81893753050389,55.984120795861706,NaN,NaN,50
1676894400,1.06854,1.06864,1.06792,1.06831,1552,1741.05,-614808,-611965.2,17.74871258066611,47.68334673878465,55.37674090932443,NaN,NaN,50
1676896200,1.06831,1.06852,1.06706,1.06713,2225,1783.8,-617033,-613114.4,17.87641036278433,38.55243327002597,53.83426441932765,NaN,NaN,50
1676898000,1.06713,1.0679,1.06702,1.06784,2781,1864.4,-614252,-614099.6,18.04289801256456,45.33533066853984,52.71774071646302,NaN,NaN,50
1676899800,1.06784,1.06864,1.06767,1.06806,2767,1954.1,-611485,-614166.8,16.97458087426948,47.277364041458526,51.85931395467775,NaN,NaN,50
1676901600,1.06806,1.06892,1.06782,1.0689,2285,2005.5,-609200,-613355.6,15.945552162470152,53.99742744970512,51.12095912034523,NaN,NaN,50
1676903400,1.0689,1.06914,1.06846,1.06888,1662,2033.35,-610862,-612566.4,15.298714771888939,53.8215267117887,50.16495252168817,NaN,NaN,50
1676905200,1.06888,1.06939,1.06838,1.0686,1573,2063.7,-612435,-611646.8,15.040503361980612,51.3018748009952,49.61082058121672,NaN,NaN,50
1676907000,1.0686,1.06924,1.0684,1.06862,1746,2092.1,-610689,-610934.2,14.800735624208597,51.476614777818355,49.20616921438581,NaN,NaN,50
1676908800,1.06862,1.0688,1.06834,1.06848,1265,2060.55,-611954,-611028,14.46538553249983,50.120859617306564,49.09225232002832,NaN,NaN,50
1676910600,1.06848,1.06891,1.06834,1.06884,960,2017.25,-610994,-611386.8,14.328240362973382,53.51145807995232,49.717043322387845,NaN,NaN,50
1676912400,1.06884,1.06905,1.0684,1.06868,856,1967.4,-611850,-611584.4,14.42491130592234,51.82528833373576,49.87223197764403,NaN,NaN,50
1676914200,1.06868,1.06882,1.06855,1.06855,586,1895.95,-612436,-611584.6,14.514677181517799,50.434720499264095,49.73357201032791,NaN,NaN,50
1676916000,1.06855,1.06869,1.06855,1.06859,265,1774.3,-612171,-611881,14.598031208856439,50.87152295990016,49.716336105698495,NaN,NaN,50
1676917800,1.06859,1.06862,1.06836,1.06836,311,1678.35,-612482,-611986.6,14.201931635369977,48.23907947337022,49.60348910161752,NaN,NaN,50
1676919600,1.06836,1.06858,1.06836,1.06858,359,1584.2,-612123,-612212.4,13.834124888561123,50.858540241457845,49.83028863752275,NaN,NaN,50
1676921400,1.06858,1.06875,1.06851,1.06874,336,1481.95,-611787,-612199.8,13.857196435255783,52.73206120426932,50.84311920425442,NaN,NaN,50
1676923200,1.06874,1.06874,1.06862,1.06866,662,1404.1,-612449,-612202.4,13.878620014329398,51.671307295531705,51.29568896332527,NaN,NaN,50
1676925000,1.06866,1.0687,1.06844,1.06844,685,1340.3,-613134,-612395,13.372757266658523,48.76611155794223,51.402028071645525,NaN,NaN,50
1676926800,1.06844,1.06859,1.06824,1.06846,358,1267.05,-612776,-612453.8,12.478483806656127,49.046584678450266,51.04839644512732,NaN,NaN,50
1676928600,1.06846,1.06864,1.06841,1.06844,305,1176.95,-613081,-612645.4,11.662530084065649,48.75912659273052,50.68679643662316,NaN,NaN,50
1676930400,1.06844,1.06854,1.06834,1.06844,64,1102.55,-613081,-612904.2,10.954310929264253,48.75912659273052,50.50517156460426,NaN,NaN,50
1676932200,1.06844,1.06889,1.06838,1.06856,2946,1138.6,-610135,-612441.4,10.991332830704286,50.767028197070275,50.45448680883654,NaN,NaN,50
1676934000,1.06856,1.06887,1.0685,1.06882,551,1027.1,-609584,-611731.4,11.025710310612887,54.89143678584062,50.795242320874685,NaN,NaN,50
1676935800,1.06882,1.06884,1.06822,1.06822,525,915,-610109,-611198,10.27528769374584,45.43263467675515,50.2181835063606,NaN,NaN,50
1676937600,1.06822,1.06836,1.06774,1.06813,1117,856.6,-611226,-610827,10.755899421747369,44.202219828405184,49.6736786131227,NaN,NaN,50
1676939400,1.06813,1.06852,1.0677,1.06772,1546,850.8,-612772,-610765.2,10.73296971669562,39.01809201911028,48.85820515025457,NaN,NaN,50
1676941200,1.06772,1.06773,1.06674,1.06694,1811,862.7,-614583,-611654.8,12.414702040567386,31.458967294156864,47.47159403127291,NaN,NaN,50
1676943000,1.06694,1.0678,1.06682,1.06736,1813,866.05,-612770,-612292,13.779924403474569,38.38137045002491,46.76747195817682,NaN,NaN,50
1676944800,1.06736,1.06752,1.0667,1.06692,1328,869.2,-614098,-613089.8,15.22577710395895,34.455362798301806,45.59581642652282,NaN,NaN,50
1676946600,1.06692,1.06714,1.06635,1.06636,1786,910.5,-615884,-614021.4,17.052180576598417,30.218677961823744,43.987717623490994,NaN,NaN,50
1676948400,1.06636,1.06668,1.06624,1.06642,1336,934.5,-614548,-614376.6,18.890136754356764,31.194876197887154,42.52511540223067,NaN,NaN,50
1676950200,1.06642,1.06668,1.06634,1.06668,1118,961.1,-613430,-614146,20.596810347989518,35.41146307995665,41.57121193951741,NaN,NaN,50
1676952000,1.06668,1.06678,1.0663,1.06649,839,989.8,-614269,-614445.8,21.83283329913452,33.782193122993746,40.4808982569848,NaN,NaN,50
1676953800,1.06649,1.06699,1.0664,1.06684,844,1016.45,-613425,-614311.2,22.273515399276082,39.3206552216503,39.80672173047907,NaN,NaN,50
1676955600,1.06684,1.0671,1.06661,1.06669,1105,1053.75,-614530,-614040.4,22.3269072361473,37.85917339048063,39.028153644604075,NaN,NaN,50
1676957400,1.06669,1.06741,1.06664,1.06738,1217,1097.8,-613313,-613793.4,21.4482624939371,47.52177975307403,38.796350184318634,NaN,NaN,50
1676959200,1.06738,1.06738,1.06688,1.06732,1407,1135.05,-614720,-614051.4,20.632378090456204,46.83972623624081,38.22122800220436,NaN,NaN,50
1676961000,1.06732,1.06738,1.06672,1.06712,1312,1166.4,-616032,-614404,20.25697117671088,44.5447122231562,38.15780496980444,NaN,NaN,50
1676962800,1.06712,1.06724,1.06601,1.06617,2331,1265.05,-618363,-615391.6,21.246063018539722,35.61755160430269,37.54461438236854,NaN,NaN,50
1676964600,1.06617,1.06703,1.06607,1.06698,2227,1361.15,-616136,-615712.8,22.164505443095077,45.62381678934881,38.016451865957016,NaN,NaN,50
1676966400,1.06698,1.06884,1.06674,1.06777,4600,1587.95,-611536,-615357.4,21.933916422305145,53.254615717899405,39.57328389622433,NaN,NaN,50
1676968200,1.06777,1.06777,1.06594,1.06606,4210,1651.15,-615746,-615562.6,20.373827600063283,40.127778267954156,39.69802731179071,NaN,NaN,50
1676970000,1.06606,1.0668,1.06426,1.06551,3853,1816.25,-619599,-616276,20.7978844297925,36.97119263735895,39.87772944315193,NaN,NaN,50
1676971800,1.06551,1.06752,1.0655,1.06632,5571,2068.55,-614028,-615409,20.212431909025458,43.96249755379358,40.85943084257834,NaN,NaN,50
1676973600,1.06632,1.06684,1.06517,1.06598,3230,2174.2,-617258,-615633.4,19.98622600693802,41.86340179217493,41.62146838502747,NaN,NaN,50
1676975400,1.06598,1.06612,1.06457,1.06488,3160,2254.9,-620418,-617409.8,20.312695763897047,35.8923570501604,41.655817954327745,NaN,NaN,50
1676977200,1.06488,1.06579,1.06464,1.06559,2738,2301.25,-617680,-617796.6,20.615846252501854,41.674933692768384,42.21958513788307,NaN,NaN,50
1676979000,1.06559,1.0661,1.06532,1.06574,2773,2349.25,-614907,-616858.2,20.43946952086016,42.847836054027134,42.47152662590999,NaN,NaN,50
1676980800,1.06574,1.06578,1.06473,1.06521,2627,2414.2,-617534,-617559.4,20.833567658404565,39.80216751942486,42.610311920834576,NaN,NaN,50
1676982600,1.06521,1.06648,1.06517,1.066,3096,2479.7,-614438,-616995.4,20.221843341536996,45.96734974712598,42.499281206124,NaN,NaN,50
1676984400,1.066,1.06654,1.06564,1.06631,4149,2620.35,-610289,-614969.6,19.57417266851226,48.208855500711756,42.59707615358621,NaN,NaN,50
1676986200,1.06631,1.06698,1.06516,1.0653,4608,2794.85,-614897,-614413,19.472949441203582,42.08339529278013,42.42126780141649,NaN,NaN,50
1676988000,1.0653,1.0669,1.06529,1.06608,4595,2982.65,-610302,-613492,19.378956444416954,47.6187524915553,43.278496436220244,NaN,NaN,50
1676989800,1.06608,1.06733,1.06439,1.06488,7202,3300.55,-617504,-613486,20.14702831056974,41.10917701835093,42.95602216686326,NaN,NaN,50
1676991600,1.06488,1.06744,1.06458,1.06742,7069,3598.75,-610435,-612685.4,20.68460836694284,55.100365633771965,43.087861446568446,NaN,NaN,50
1676993400,1.06742,1.06984,1.06732,1.06854,5957,3835.75,-604478,-611523.2,20.0343724241622,59.65228840491749,44.4824693134944,NaN,NaN,50
1676995200,1.06854,1.06857,1.06658,1.0673,3611,3945.95,-608089,-610161.6,18.69227007990433,53.21934207815468,45.643051416408376,NaN,NaN,50
1676997000,1.0673,1.06766,1.06562,1.06564,3412,4050.95,-611501,-610401.4,18.096870671930493,46.058505719488245,45.79276628538657,NaN,NaN,50
1676998800,1.06564,1.06588,1.06526,1.06576,2521,4060.45,-608980,-608696.6,17.827207188401918,46.61768298931185,46.132357799467776,NaN,NaN,50
1677000600,1.06576,1.06629,1.06551,1.06608,1986,4048.4,-606994,-608008.4,17.15662257057879,48.16093589778832,47.00868486001263,NaN,NaN,50
1677002400,1.06608,1.06616,1.06444,1.06462,1825,3909.65,-608819,-608876.6,17.36024962928295,42.17077089966896,47.044101803362665,NaN,NaN,50
1677004200,1.06462,1.06476,1.06375,1.06428,1922,3795.25,-610741,-609407,18.010232827395516,40.89513635246269,46.90462325325092,NaN,NaN,50
1677006000,1.06428,1.06458,1.06398,1.06456,1895,3697.35,-608846,-608876,18.61378865421432,42.439339033804295,47.092992647135155,NaN,NaN,50
1677007800,1.06456,1.06524,1.06439,1.06486,1702,3503.9,-607144,-608508.8,18.43231864477458,44.12378080101814,46.9613091509846,NaN,NaN,50
1677009600,1.06486,1.06526,1.06453,1.06484,1509,3417.85,-608653,-608840.6,18.241647145361163,44.031271610329384,46.66291030167157,NaN,NaN,50
1677011400,1.06484,1.06524,1.06456,1.06456,1729,3346.3,-610382,-609153.2,18.064595038762995,42.68208955909899,46.7056741778372,NaN,NaN,50
1677013200,1.06456,1.06486,1.06436,1.06452,534,3236.1,-610916,-609188.2,18.081124119582466,42.48182727776852,46.33875094828101,NaN,NaN,50
1677015000,1.06452,1.06469,1.06432,1.06464,420,3118.45,-610496,-609518.2,18.13402796482142,43.34070354454474,46.498145700151994,NaN,NaN,50
1677016800,1.06464,1.06514,1.06464,1.06482,683,3021.25,-609813,-610052,17.569308696760707,44.67521167745981,45.75349184612969,NaN,NaN,50
1677018600,1.06482,1.06498,1.06458,1.06492,7014,3217.15,-602799,-608881.2,17.11083475972159,45.443996453429165,44.73861384959481,NaN,NaN,50
1677020400,1.06492,1.06506,1.06476,1.06504,605,3039.95,-602194,-607243.6,16.5696383879303,46.40641449575638,44.25197616513778,NaN,NaN,50
1677022200,1.06504,1.06536,1.06488,1.06512,1054,2862.25,-601140,-605288.4,15.633051814623183,47.076702622399765,44.32470451534575,NaN,NaN,50
1677024000,1.06512,1.0655,1.06488,1.06539,1808,2722.9,-599332,-603055.6,14.562918053976198,49.3778668579828,44.5218605059651,NaN,NaN,50
1677025800,1.06539,1.06586,1.06498,1.0658,2069,2466.25,-597263,-600545.6,13.97849261737481,52.73844142367973,44.848825186385916,NaN,NaN,50
1677027600,1.0658,1.0663,1.06568,1.0663,2239,2224.75,-595024,-598990.6,13.998972878385944,56.528521104657635,45.874378772456545,NaN,NaN,50
1677029400,1.0663,1.06642,1.0654,1.06577,2272,2040.5,-597296,-598011,13.57263769993377,51.78766094131992,46.6524162430892,NaN,NaN,50
1677031200,1.06577,1.06601,1.06537,1.06574,1822,1951.05,-599118,-597606.6,13.128476111907334,51.524251533413924,47.30133856448988,NaN,NaN,50
1677033000,1.06574,1.06608,1.06548,1.0656,1640,1862.45,-600758,-597891.8,12.818469528566023,50.24001156737632,47.738212190658324,NaN,NaN,50
1677034800,1.0656,1.06628,1.0656,1.06586,1218,1797.3,-599540,-598347.2,12.82678872261149,52.60276028142791,48.350461381451076,NaN,NaN,50
1677036600,1.06586,1.06598,1.0655,1.06598,651,1730.55,-598889,-599120.2,12.641766008619006,53.6955892731251,49.13713993245294,NaN,NaN,50
1677038400,1.06598,1.06602,1.06568,1.06582,664,1672.5,-599553,-599571.6,12.535281007735191,51.97484711867782,49.81521277823218,NaN,NaN,50
1677040200,1.06582,1.06601,1.06566,1.06587,839,1618.35,-598714,-599490.8,12.393085885543664,52.48726225046022,50.46853840008328,NaN,NaN,50
1677042000,1.06587,1.0659,1.06513,1.06514,1215,1584.35,-599929,-599325,11.818480552826081,44.94692583503612,50.48794655419588,NaN,NaN,50
1677043800,1.06514,1.06586,1.06514,1.06578,973,1547.9,-598956,-599208.2,11.284918458159755,51.52230180179182,50.92211122193606,NaN,NaN,50
1677045600,1.06578,1.06586,1.06552,1.06554,989,1521.9,-599945,-599419.4,10.789467941683876,49.15151826075092,51.11819006229281,NaN,NaN,50
1677047400,1.06554,1.06602,1.06554,1.06566,1221,1496.5,-598724,-599253.6,10.068495476644939,50.38093717768422,51.35420681624171,NaN,NaN,50
1677049200,1.06566,1.06616,1.06524,1.06582,2095,1574.55,-596629,-598836.6,9.939271769438347,52.04577597838904,51.54477175341358,NaN,NaN,50
1677051000,1.06582,1.06636,1.06534,1.06537,2307,1668.9,-598936,-598638,9.355174483886548,47.24454582929941,51.15235063952928,NaN,NaN,50
1677052800,1.06537,1.06578,1.06468,1.0653,3498,1809.65,-602434,-599333.6,10.046364973992583,46.52554610215562,50.43785242506484,NaN,NaN,50
1677054600,1.0653,1.06562,1.06429,1.06455,3143,1616.1,-605577,-600460,11.270084278507404,39.57599440589708,49.5655905296775,NaN,NaN,50
1677056400,1.06455,1.06507,1.06356,1.06444,3288,1750.25,-608865,-602488.2,13.283470782259071,38.66380298227624,48.6469870617391,NaN,NaN,50
1677058200,1.06444,1.0649,1.06366,1.06374,3800,1887.55,-612665,-605695.4,15.15304396431419,33.389615067383204,47.443387311739585,NaN,NaN,50
1677060000,1.06374,1.06423,1.0631,1.0637,3459,1970.1,-616124,-609133,17.453191463772086,33.11165744679555,46.05116568069441,NaN,NaN,50
1677061800,1.0637,1.06389,1.06249,1.06252,2717,2002.5,-618841,-612414.4,20.088101279879076,26.186226637686445,44.08621120673451,NaN,NaN,50
1677063600,1.06252,1.06362,1.06246,1.06344,2571,2019.1,-616270,-614553,22.557567165576458,37.21251756879741,43.03175909602877,NaN,NaN,50
1677065400,1.06344,1.06348,1.06246,1.06306,2786,2044.8,-619056,-616591.2,24.850642630866883,34.89393563032138,41.77509290887599,NaN,NaN,50
1677067200,1.06306,1.06414,1.06254,1.06392,3453,2126.35,-615603,-617178.8,25.309908790999575,43.47727055557758,41.670117531771815,NaN,NaN,50
1677069000,1.06392,1.06478,1.06374,1.06478,3723,2230.5,-611880,-616330,24.457862260898718,50.504512487735006,41.597418295053465,NaN,NaN,50
1677070800,1.06478,1.06504,1.0641,1.06427,3837,2361.45,-615717,-615705.2,23.210785665032045,46.78944995656258,41.428699130468594,NaN,NaN,50
1677072600,1.06427,1.06488,1.06362,1.06463,3623,2510.05,-612094,-614870,22.7214188321553,49.607316611157806,41.373440518573844,NaN,NaN,50
1677074400,1.06463,1.06496,1.06411,1.06471,3726,2663.15,-608368,-612732.4,22.119517970492836,50.23797317491078,41.24431174689683,NaN,NaN,50
1677076200,1.06471,1.06604,1.06462,1.06498,5656,2904,-602712,-610154.2,21.192760363240517,52.403000926760654,41.61277282528692,NaN,NaN,50
1677078000,1.06498,1.06574,1.06394,1.06468,5046,3095.55,-607758,-609329.8,19.977539267813242,49.8098782633463,41.84736797965768,NaN,NaN,50
1677079800,1.06468,1.0648,1.0625,1.0627,5690,3331.4,-613448,-608876,20.339671034628655,36.84929150050814,41.652603486415614,NaN,NaN,50
1677081600,1.0627,1.06342,1.06172,1.06269,4880,3525.95,-618328,-610122.8,21.27940423761099,36.797214780336134,41.51927575770561,NaN,NaN,50
1677083400,1.06269,1.06298,1.06186,1.06229,3389,3634.35,-621717,-612792.6,22.152013640380304,34.685628987983094,41.611848180605605,NaN,NaN,50
1677085200,1.06229,1.0631,1.0618,1.06282,2498,3654.5,-619219,-616094,22.77429991789457,39.62899482663095,42.07737227916528,NaN,NaN,50
1677087000,1.06282,1.06346,1.06266,1.06282,1973,3637.8,-619219,-618386.2,22.79239955543528,39.62899482663095,43.03757000694703,NaN,NaN,50
1677088800,1.06282,1.06362,1.0626,1.06264,2263,3576.05,-621482,-619993,22.564358155980937,38.48180460761962,43.1282333668629,NaN,NaN,50
1677090600,1.06264,1.06289,1.06222,1.06248,1998,3518.8,-623480,-621023.4,22.734640148900105,37.44418325159737,43.31039391123976,NaN,NaN,50
1677092400,1.06248,1.06345,1.06059,1.06098,8873,3798.05,-632353,-623150.6,24.152901899007585,29.431879169917636,42.3071516694069,NaN,NaN,50
1677094200,1.06098,1.06103,1.05994,1.06012,4444,3830.25,-636797,-626666.2,25.84585947611299,25.997162725654505,40.55662668640115,NaN,NaN,50
1677096000,1.06012,1.06072,1.05992,1.06044,2962,3805.4,-633835,-629589.4,27.429174006061952,29.303208134986363,39.30760941343142,NaN,NaN,50
1677097800,1.06044,1.06047,1.05992,1.06029,2250,3782.05,-636085,-632510,28.899394641014553,28.65693493719961,37.811153579577265,NaN,NaN,50
1677099600,1.06029,1.06041,1.06014,1.06019,543,3680.65,-636628,-635139.6,30.264599516327685,28.21024997274199,36.237744779422364,NaN,NaN,50
1677101400,1.06019,1.06054,1.06018,1.06044,517,3567.2,-636111,-635891.2,31.278542647754193,31.1016303793523,34.71621831175033,NaN,NaN,50
1677103200,1.06044,1.06064,1.06034,1.0604,108,3399.95,-636219,-635775.6,32.01890129064298,30.88727859458973,33.3646040496963,NaN,NaN,50
1677105000,1.0604,1.06063,1.06037,1.06062,168,3222.2,-636051,-636218.8,32.706377173325436,33.59792561668277,33.132363629423054,NaN,NaN,50
1677106800,1.06062,1.06102,1.06033,1.06066,1083,3084.5,-634968,-635995.4,32.52491399082906,34.103978798918874,32.9399896307504,NaN,NaN,50
1677108600,1.06066,1.06072,1.06047,1.06056,532,2929.95,-635500,-635769.8,32.356412464225286,33.41829561015922,32.84946581804869,NaN,NaN,50
1677110400,1.06056,1.06102,1.06054,1.061,860,2786.65,-634640,-635475.6,31.573131539918954,39.209775580101066,32.81952158615369,NaN,NaN,50
1677112200,1.061,1.06124,1.06076,1.0612,925,2550.1,-633715,-634974.8,30.407485807229932,41.692459194142494,32.96691189811881,NaN,NaN,50
1677114000,1.0612,1.06165,1.0611,1.06162,1114,2353.5,-632601,-634284.8,28.56681007672085,46.62249298088923,33.548389639066635,NaN,NaN,50
1677115800,1.06162,1.06218,1.06149,1.06198,1479,2142.95,-631122,-633515.6,27.04450688754226,50.48690264476664,34.48001245286444,NaN,NaN,50
1677117600,1.06198,1.06201,1.06155,1.06156,1193,1958.6,-632315,-632878.6,25.63093964044785,46.27744877178785,35.6832674244266,NaN,NaN,50
1677119400,1.06156,1.06248,1.06145,1.0623,1314,1854.85,-631001,-632150.8,25.01165921150067,53.61559161816156,37.65601234531997,NaN,NaN,50
1677121200,1.0623,1.06248,1.06212,1.06221,1215,1790.7,-632216,-631851,24.43661309890686,52.673235611742506,39.325300022231126,NaN,NaN,50
1677123000,1.06221,1.06242,1.06215,1.06224,855,1734.8,-631361,-631603,23.902641708641184,52.96996640534383,41.06194512709857,NaN,NaN,50
1677124800,1.06224,1.06226,1.06196,1.06199,550,1649.15,-631911,-631760.8,22.987508524296743,50.148239785019925,42.62894439940413,NaN,NaN,50
1677126600,1.06199,1.06247,1.06194,1.06246,578,1578.15,-631333,-631564.4,22.495743066042547,55.00142162603511,44.33607234559577,NaN,NaN,50
1677128400,1.06246,1.06247,1.06167,1.0617,1072,1188.1,-632405,-631845.2,21.438664777315182,47.02865514673867,45.489027813606405,NaN,NaN,50
1677130200,1.0617,1.06224,1.06154,1.06224,1220,1026.9,-631185,-631639,20.178744846452233,52.31747994000875,46.82613883670111,NaN,NaN,50
1677132000,1.06224,1.06273,1.06206,1.06272,1382,947.9,-629803,-631327.4,19.888817425943422,56.47722679505075,48.424227979281966,NaN,NaN,50
1677133800,1.06272,1.06278,1.06197,1.06225,1352,903,-631155,-631176.2,19.41468181568494,51.71946163899573,49.73145412419886,NaN,NaN,50
1677135600,1.06225,1.06242,1.06118,1.06123,2433,997.5,-633588,-631627.2,18.612965621020955,43.211656238431154,50.017302742651005,NaN,NaN,50
1677137400,1.06123,1.0618,1.06104,1.06166,2587,1101,-631001,-631346.4,18.09720320979365,47.1580072090529,50.407699029430326,NaN,NaN,50
1677139200,1.06166,1.06178,1.06061,1.06116,3826,1286.9,-634827,-632074.8,18.27283172562337,43.38280382756986,50.176292661336085,NaN,NaN,50
1677141000,1.06116,1.0616,1.0603,1.0606,3087,1432.85,-637914,-633697,18.857679113331287,39.562713068382216,49.395993405880056,NaN,NaN,50
1677142800,1.0606,1.06064,1.05902,1.05944,3268,1542.1,-641182,-635702.4,20.705558894535724,33.0672666167426,48.45240896623396,NaN,NaN,50
1677144600,1.05944,1.05964,1.05873,1.05911,3100,1670.5,-644282,-637841.2,22.647052920299345,31.483654859916243,46.87155634064501,NaN,NaN,50
1677146400,1.05911,1.05954,1.05874,1.05948,3031,1779.05,-641251,-639891.2,24.449868801365565,35.22909493880856,45.6255462925783,NaN,NaN,50
1677148200,1.05948,1.06016,1.05922,1.0598,2089,1837.25,-639162,-640758.2,24.812954934493117,38.367103891120706,44.582484684419505,NaN,NaN,50
1677150000,1.0598,1.06027,1.05857,1.05928,2346,1898.85,-641508,-641477,25.76869486750558,35.36843760669977,43.5267845288252,NaN,NaN,50
1677151800,1.05928,1.06044,1.05922,1.06042,2346,1942.2,-639162,-641073,26.325915987342096,45.436727654405715,42.84359210228025,NaN,NaN,50
1677153600,1.06042,1.06138,1.0601,1.06132,2689,2017,-636473,-639511.2,25.258339423152115,51.81814205363995,43.185698309916056,NaN,NaN,50
1677155400,1.06132,1.06192,1.06086,1.06138,3011,2101.85,-633462,-637953.4,23.525555776747108,52.219343121013786,43.1786885371307,NaN,NaN,50
1677157200,1.06138,1.0621,1.06097,1.06142,3422,2212.2,-630040,-636129,22.007321628410406,52.5032889534337,42.89483583415805,NaN,NaN,50
1677159000,1.06142,1.06208,1.05942,1.06075,7969,2567.9,-638009,-635429.2,21.959891192044843,47.42000391410447,42.58773171095153,NaN,NaN,50
1677160800,1.06075,1.06167,1.06009,1.0607,4896,2785.2,-642905,-636177.8,21.9158486439911,47.05387566491028,42.86217595570004,NaN,NaN,50
1677162600,1.0607,1.06154,1.05952,1.0607,6525,3082.55,-642905,-637464.2,22.378617765296802,47.05387566491027,42.85473798826128,NaN,NaN,50
1677164400,1.0607,1.06088,1.05954,1.06022,5251,3291.5,-648156,-640403,22.808331949366377,43.32916475934747,42.85090662624539,NaN,NaN,50
1677166200,1.06022,1.06026,1.05876,1.05968,5174,3489.2,-653330,-645061,23.844399156746306,39.537391265794604,42.849097926060566,NaN,NaN,50
1677168000,1.05968,1.05982,1.0588,1.0593,4062,3623.2,-657392,-648937.6,24.806461563599093,37.07839687658373,43.135607230334934,NaN,NaN,50
1677169800,1.0593,1.0595,1.05792,1.05824,3700,3740.6,-661092,-652575,26.327270582317613,31.241428245913838,43.11830532933476,NaN,NaN,50
1677171600,1.05824,1.05858,1.0577,1.05822,2446,3741.25,-663538,-656701.6,27.879429031699825,31.14181453062706,42.82635672875036,NaN,NaN,50
1677173400,1.05822,1.05858,1.05806,1.05854,2054,3714.6,-661484,-659367.2,29.32071902041188,34.727899010349034,42.566413522980966,NaN,NaN,50
1677175200,1.05854,1.0589,1.05809,1.05849,2459,3646.25,-663943,-661489.8,30.047932821586613,34.42621043052114,42.499111581825346,NaN,NaN,50
1677177000,1.05849,1.05934,1.05822,1.05882,2293,3606.55,-661650,-662341.4,29.937767307666245,38.2396653785109,41.985035704975715,NaN,NaN,50
1677178800,1.05882,1.0599,1.0587,1.05976,2276,3556.95,-659374,-661997.8,28.940480694190608,47.589523899574004,41.682991551113865,NaN,NaN,50
1677180600,1.05976,1.0603,1.05952,1.05956,2018,3502.85,-661392,-661568.6,27.436452398139792,45.99407068734904,41.238329234423524,NaN,NaN,50
1677182400,1.05956,1.05996,1.05953,1.05974,1380,3420.3,-660012,-661274.2,26.03985469466404,47.693698837657564,40.89478708329666,NaN,NaN,50
1677184200,1.05974,1.06033,1.05968,1.06031,1688,3400.25,-658324,-660150.4,24.20639721771455,52.76335547044071,41.27645505160639,NaN,NaN,50
1677186000,1.06031,1.06034,1.05948,1.05966,613,3313.6,-658937,-659607.8,22.781134822053136,47.15107555270915,41.28339790073489,NaN,NaN,50
1677187800,1.05966,1.05975,1.05949,1.0595,456,3219.1,-659393,-659611.6,21.457676883224682,45.85803059156522,41.197980395495954,NaN,NaN,50
1677189600,1.0595,1.05972,1.0592,1.05946,116,3090.45,-659509,-659235,20.649253052292327,45.52193145636803,41.35460658814028,NaN,NaN,50
1677191400,1.05946,1.05968,1.05942,1.05958,594,2969.6,-658915,-659015.6,19.898573780712283,46.782063242362284,41.87208315789512,NaN,NaN,50
1677193200,1.05958,1.06018,1.05958,1.05989,858,2841.4,-658057,-658962.2,18.614306608326235,49.99966513567721,42.79503089068751,NaN,NaN,50
1677195000,1.05989,1.06002,1.0597,1.05975,505,2468.2,-658562,-658887.2,17.421772805396323,48.5714093049867,44.03288668062129,NaN,NaN,50
1677196800,1.05975,1.0601,1.05964,1.05986,982,2272.5,-657580,-658524.6,16.453916762512737,49.785134989237996,45.364552427664925,NaN,NaN,50
1677198600,1.05986,1.06074,1.0595,1.06072,2993,2095.9,-654587,-657540.2,16.56060661403022,58.109033058152306,47.03463343107944,NaN,NaN,50
1677200400,1.06072,1.06143,1.06001,1.06006,3017,1984.2,-657604,-657278,17.511302433568687,51.107271498401836,48.22613779307091,NaN,NaN,50
1677202200,1.06006,1.0605,1.05934,1.06014,2943,1872.65,-654661,-656598.8,17.170475292173368,51.8643848918729,49.19933204402535,NaN,NaN,50
1677204000,1.06014,1.06064,1.06006,1.06038,1962,1767.65,-652699,-655426.2,17.033667403011,54.15782703392743,49.66849655362203,NaN,NaN,50
1677205800,1.06038,1.06062,1.05946,1.05972,1499,1657.6,-654198,-654749.8,15.939935223226403,47.4609129447101,49.77327100057638,NaN,NaN,50
1677207600,1.05972,1.06052,1.0597,1.06043,1290,1599.8,-652908,-654414,14.92432677056928,54.04433433917291,50.22688782211319,NaN,NaN,50
1677209400,1.06043,1.06054,1.05994,1.06001,1050,1549.6,-653958,-653684.8,14.012984442175538,50.049110461766695,50.03301317863647,NaN,NaN,50
1677211200,1.06001,1.0601,1.0596,1.06002,988,1476.05,-652970,-653346.6,13.414982542391057,50.14361379729625,50.246765910392696,NaN,NaN,50
1677213000,1.06002,1.06016,1.05988,1.06,961,1409.45,-653931,-653593,12.751688137360354,49.94011206881796,50.53834315876789,NaN,NaN,50
1677214800,1.06,1.06022,1.05994,1.05994,1144,1352.85,-655075,-653768.4,12.022862093412991,49.293787597006514,50.80776145452778,NaN,NaN,50
1677216600,1.05994,1.06012,1.05972,1.05976,1363,1320.1,-656438,-654474.4,11.739757527038362,47.31540804246748,50.845857511678155,NaN,NaN,50
1677218400,1.05976,1.06015,1.05966,1.06012,1422,1322.2,-655016,-654686,11.58417476937707,51.50728569561197,50.953544694530635,NaN,NaN,50
1677220200,1.06012,1.06024,1.05966,1.05988,1461,1310.85,-656477,-655387.4,11.238465663116697,48.7239784842251,50.96444249304766,NaN,NaN,50
1677222000,1.05988,1.05988,1.05896,1.05904,2435,1401.95,-658912,-656383.6,12.097921033133275,40.47922937703234,50.29973494931868,NaN,NaN,50
1677223800,1.05904,1.05952,1.05884,1.05894,2405,1499.4,-661317,-657632,13.069617472905005,39.619718291934475,48.97906960887455,NaN,NaN,50
1677225600,1.05894,1.05918,1.05798,1.0591,3875,1687.35,-657442,-657832.8,15.014581689965814,41.75086521326788,48.31075487422213,NaN,NaN,50
1677227400,1.0591,1.0596,1.05872,1.05889,3289,1822.1,-660731,-658975.8,15.88207692102252,39.7669437907903,47.44665193843051,NaN,NaN,50
1677229200,1.05889,1.05926,1.05844,1.05891,2803,1919.35,-657928,-659266,17.015404340637858,40.05907490336803,46.43959821481912,NaN,NaN,50
1677231000,1.05891,1.05928,1.05847,1.05858,2137,2000.95,-660065,-659496.6,18.0223925181542,36.88066244889929,45.683866036546924,NaN,NaN,50
1677232800,1.05858,1.05949,1.05824,1.05943,2298,2066.75,-657767,-658786.6,19.234791813791176,48.266626464808915,45.27117261694949,NaN,NaN,50
1677234600,1.05943,1.05961,1.05863,1.05865,2086,2021.4,-659853,-659268.8,20.064590085330753,40.96412835365828,44.62224532351318,NaN,NaN,50
1677236400,1.05865,1.05904,1.05808,1.0584,2311,1986.1,-662164,-659555.4,21.485018272514807,38.931065135601045,43.82134899053494,NaN,NaN,50
1677238200,1.0584,1.05842,1.05734,1.05798,2824,1980.15,-664988,-660967.4,23.49080884864049,35.723366839793115,42.80586718846173,NaN,NaN,50
1677240000,1.05798,1.05798,1.057,1.05711,2590,2011.55,-667578,-662470,25.617797974281093,30.176791297158786,41.44036745275832,NaN,NaN,50
1677241800,1.05711,1.05787,1.05644,1.05664,3416,2107.4,-670994,-665115.4,27.977444046995775,27.676730223140382,40.03760475137783,NaN,NaN,50
1677243600,1.05664,1.05738,1.05622,1.05709,4796,2282.7,-666198,-666384.4,30.305814979000505,33.36861063874879,38.741985104459026,NaN,NaN,50
1677245400,1.05709,1.05764,1.05433,1.0554,10090,2734.7,-676288,-669209.2,33.31469477770801,25.311849779504158,37.06969019697896,NaN,NaN,50
1677247200,1.0554,1.05551,1.05362,1.05392,6822,3026.4,-683110,-672833.6,36.32224074131458,20.6171249178807,35.6509684498967,NaN,NaN,50
1677249000,1.05392,1.05607,1.05382,1.0548,8124,3384.55,-674986,-674315.2,38.057998267464406,29.044250965560934,34.89557792658431,NaN,NaN,50
1677250800,1.0548,1.05584,1.05402,1.05503,8793,3767,-666193,-673355,39.669773113174955,31.102905257098328,34.13500935828649,NaN,NaN,50
1677252600,1.05503,1.05597,1.05402,1.05422,6151,4006.4,-672344,-674584.2,40.91164472597605,28.0197080425703,33.29592109055649,NaN,NaN,50
1677254400,1.05422,1.05562,1.05402,1.05542,4440,4157.3,-667904,-672907.4,42.064811223577074,37.84913960575333,33.13806856929829,NaN,NaN,50
1677256200,1.05542,1.05598,1.05428,1.05438,3275,4248,-671179,-670521.2,42.38878869686232,33.57046785384378,32.9016260982229,NaN,NaN,50
1677258000,1.05438,1.05558,1.05432,1.05532,2597,4256.1,-668582,-669240.4,42.68962492205577,40.15547950342293,32.3222584581239,NaN,NaN,50
1677259800,1.05532,1.05589,1.05437,1.05472,2240,4247.85,-670822,-670166.2,42.316186494150756,37.593828344064235,32.081522743152895,NaN,NaN,50
1677261600,1.05472,1.05552,1.0544,1.05542,2205,4164.35,-668617,-669420.8,41.96942223966752,42.22456287678726,32.31677258180906,NaN,NaN,50
1677263400,1.05542,1.05542,1.05452,1.05453,1909,4095.35,-670526,-669945.2,41.647426860504524,38.330170189721386,32.50297282108965,NaN,NaN,50
1677265200,1.05453,1.05529,1.05441,1.0552,1821,4046.25,-668705,-669450.4,41.468528192977125,42.62059319177803,33.39181581356245,NaN,NaN,50
1677267000,1.0552,1.05544,1.0548,1.05508,2072,4043,-670777,-669889.4,40.924912274288886,42.056242633874184,34.418923842900575,NaN,NaN,50
1677268800,1.05508,1.05556,1.05506,1.05517,1666,4011.4,-669111,-669547.2,40.117165582996705,42.66938596476764,35.08326493761621,NaN,NaN,50
1677270600,1.05517,1.05528,1.05466,1.05472,1834,3998.8,-670945,-670012.8,39.88055617224516,40.369213845919205,36.15879094236014,NaN,NaN,50
1677272400,1.05472,1.05486,1.05462,1.05472,503,3908.4,-670945,-670096.6,39.70995392736386,40.369213845919205,37.56965443722004,NaN,NaN,50
1677274200,1.05472,1.05476,1.05442,1.05457,535,3793.95,-671480,-670651.6,39.79860763248625,39.54510460790745,38.31971541167336,NaN,NaN,50
1677448800,1.05457,1.05484,1.05448,1.05482,82,3668.55,-671398,-670775.8,39.64652353630097,41.68193963742378,39.07536072455374,NaN,NaN,50
1677450600,1.05482,1.05493,1.05472,1.05474,258,3510.65,-671656,-671284.8,39.23553294903249,41.18033213073218,40.015405302279596,NaN,NaN,50
1677452400,1.05474,1.05537,1.0546,1.05532,1000,3320.85,-670656,-671227,37.646876584730165,46.232296557830836,40.61420222742799,NaN,NaN,50
1677454200,1.05532,1.05554,1.05519,1.05534,705,2851.6,-669951,-671028.2,35.75475255346858,46.40324411724531,41.530829103385244,NaN,NaN,50
1677456000,1.05534,1.05548,1.05452,1.05528,2314,2626.2,-672265,-671185.2,35.106769327010966,45.93144463392361,41.94339804127815,NaN,NaN,50
1677457800,1.05528,1.05558,1.05494,1.05548,2023,2321.15,-670242,-670954,34.257840124808645,47.83536474311943,42.67493635549637,NaN,NaN,50
1677459600,1.05548,1.05563,1.05524,1.05544,1795,1971.25,-672037,-671030.2,33.34193919141148,47.4752952657158,43.04998866899127,NaN,NaN,50
1677461400,1.05544,1.05596,1.05535,1.05594,1871,1757.25,-670166,-670932.2,31.68110831753604,52.30787055648318,44.048395838045685,NaN,NaN,50
1677463200,1.05594,1.056,1.05545,1.0556,1297,1600.1,-671463,-671234.6,30.04416584304628,49.00601554595257,44.50449743477244,NaN,NaN,50
1677465000,1.0556,1.05592,1.05523,1.05532,1333,1503,-672796,-671340.8,28.958230791321643,46.40796678504986,44.81533487414213,NaN,NaN,50
1677466800,1.05532,1.0555,1.05452,1.05452,1256,1435.95,-674052,-672102.8,29.09332401444012,39.8994574310543,44.61748283601975,NaN,NaN,50
1677468600,1.05452,1.05464,1.05399,1.05443,1416,1394.75,-675468,-672789,29.86720521574882,39.23284108814878,44.536313353321866,NaN,NaN,50
1677470400,1.05443,1.05482,1.05434,1.05444,1117,1340.35,-674351,-673626,30.127888605677228,39.35408298098417,44.4638040058265,NaN,NaN,50
1677472200,1.05444,1.05494,1.05442,1.0549,815,1285.65,-673536,-674040.6,30.066240865517845,44.80907322191872,44.839801763970165,NaN,NaN,50
1677474000,1.0549,1.05508,1.05402,1.05414,1179,1253.55,-674715,-674424.4,30.527335835354396,38.62712651714874,44.62160082680766,NaN,NaN,50
1677475800,1.05414,1.05432,1.05389,1.05395,1430,1221.45,-676145,-674843,31.112659162342,37.24375924250639,44.340417049077246,NaN,NaN,50
1677477600,1.05395,1.05482,1.05363,1.05363,1693,1222.8,-677838,-675317,30.412176563152123,34.97207700461948,43.5361156524193,NaN,NaN,50
1677479400,1.05363,1.05394,1.05328,1.05378,1980,1230.1,-675858,-675618.4,30.24771820034559,36.914525056063916,42.85835000519205,NaN,NaN,50
1677481200,1.05378,1.05514,1.05354,1.05514,3005,1355.2,-672853,-675481.8,28.293659303885438,51.1595069704103,43.23178302922681,NaN,NaN,50
1677483000,1.05514,1.05529,1.05422,1.0548,2626,1459.75,-675479,-675634.6,26.697999399177974,48.22758293519335,43.25979861437496,NaN,NaN,50
1677484800,1.0548,1.05595,1.0548,1.05534,4337,1672.5,-671142,-674634,26.089901795203247,52.84940350114598,43.643663488334255,NaN,NaN,50
1677486600,1.05534,1.05614,1.05516,1.05525,2879,1803.55,-674021,-673870.6,25.75172035310572,52.01594389516975,43.62281158395473,NaN,NaN,50
1677488400,1.05525,1.05563,1.0549,1.05554,2822,1894.65,-671199,-672938.8,24.96937927574012,54.505617489137954,44.015640294182255,NaN,NaN,50
1677490200,1.05554,1.05588,1.05509,1.05512,2377,1978.25,-673576,-673083.4,24.5653491241854,50.424987369089074,44.30257033589934,NaN,NaN,50
1677492000,1.05512,1.0555,1.05487,1.05542,2275,1976.3,-671301,-672247.8,23.78273349399302,53.12451859491652,45.2472175618895,NaN,NaN,50
1677493800,1.05542,1.0568,1.05524,1.05676,2212,1985.75,-669089,-671837.2,24.495477831037825,62.854286019467445,46.93446362841227,NaN,NaN,50
1677495600,1.05676,1.05694,1.05612,1.05642,2144,2003.2,-671233,-671279.6,25.281940644570028,59.480701448008475,48.37207923319971,NaN,NaN,50
1677497400,1.05642,1.05686,1.05588,1.05622,1929,2006.1,-673162,-671672.2,25.563368751379034,57.52479731894554,49.280345240130195,NaN,NaN,50
1677499200,1.05622,1.05663,1.0557,1.05582,1870,2034.75,-675032,-671963.4,25.49144980412642,53.72007659215229,50.35841310263045,NaN,NaN,50
1677501000,1.05582,1.05608,1.05556,1.05582,2441,2090.15,-675032,-672709.6,25.163514773020516,53.72007659215229,51.535292913319445,NaN,NaN,50
1677502800,1.05582,1.0563,1.05505,1.05537,2997,2177.2,-678029,-674497.6,23.967243756914023,49.45253162770633,52.56961110068279,NaN,NaN,50
1677504600,1.05537,1.05834,1.05502,1.0583,5681,2390.45,-672348,-674720.6,24.870467300246464,67.53604201811524,54.75686231225789,NaN,NaN,50
1677506400,1.0583,1.05883,1.05758,1.05842,4306,2549.9,-668042,-673696.6,26.043158372135935,68.0403360677768,55.96263581921264,NaN,NaN,50
1677508200,1.05842,1.0594,1.05804,1.05898,4480,2733.15,-663562,-671402.6,27.4868376860589,70.3546902998814,57.54314348811892,NaN,NaN,50
1677510000,1.05898,1.062,1.05872,1.0617,5068,2927.6,-658494,-668095,29.954338803142704,78.49896692117719,59.37525516097829,NaN,NaN,50
1677511800,1.0617,1.06172,1.05992,1.0601,5026,3107.4,-663520,-665193.2,32.24558984043481,66.86264245478702,60.435733629522396,NaN,NaN,50
1677513600,1.0601,1.06043,1.05874,1.05898,3170,3181.25,-666690,-664061.6,32.82422049708279,60.141976616904884,60.83833071007717,NaN,NaN,50
1677515400,1.05898,1.05963,1.05796,1.05953,2813,3222.9,-663877,-663228.6,32.489520678224096,62.153758410306864,61.67610007016416,NaN,NaN,50
1677517200,1.05953,1.05969,1.05863,1.05922,2504,3197.85,-666381,-663792.4,32.21545070981228,60.30614803233084,62.18907360140804,NaN,NaN,50
1677519000,1.05922,1.0602,1.05922,1.06014,1663,3149.7,-664718,-665037.2,32.274192805500896,63.75012564815887,62.25306214631456,NaN,NaN,50
1677520800,1.06014,1.06048,1.05988,1.06034,1516,3008.65,-663202,-664973.6,32.496461834695445,64.47179325777721,62.609568704155194,NaN,NaN,50
1677522600,1.06034,1.06076,1.06007,1.06068,1816,2955.5,-661386,-663912.8,32.87080284751314,65.7211613560554,63.195023278234466,NaN,NaN,50
1677524400,1.06068,1.06126,1.06067,1.06104,1677,2898.25,-659709,-663079.2,33.509274755020066,67.04269166253314,64.14663864040452,NaN,NaN,50
1677526200,1.06104,1.0613,1.06062,1.06076,1812,2870,-661521,-662107.2,34.03129616997046,64.94548978533851,64.94845386848927,NaN,NaN,50
1677528000,1.06076,1.06096,1.06045,1.06087,1659,2839.2,-659862,-661136,34.26487359753182,65.40335964877909,66.08779872713731,NaN,NaN,50
1677529800,1.06087,1.06096,1.06045,1.06082,1747,2815.95,-661609,-660817.4,34.4817669231245,64.98783933826506,65.90578425000515,NaN,NaN,50
1677531600,1.06082,1.06088,1.06068,1.06088,435,2730.5,-661174,-660775,34.68316786831772,65.2729581802716,65.70811440089764,NaN,NaN,50
1677533400,1.06088,1.06104,1.0607,1.06098,279,2648,-660895,-661012.2,34.997887785875484,65.7732303581656,65.38086726220367,NaN,NaN,50
1677535200,1.06098,1.0611,1.06035,1.06106,2254,2667.2,-658641,-660436.2,34.664754022600654,66.19281753649186,64.50185659186899,NaN,NaN,50
1677537000,1.06106,1.06107,1.06034,1.06063,1490,2619.65,-660131,-660490,34.33741935665259,61.80693820571513,64.14073485979243,NaN,NaN,50
1677538800,1.06063,1.06106,1.0606,1.06071,744,2507,-659387,-660045.6,34.03346573827225,62.30732857748003,64.29540285697637,NaN,NaN,50
1677540600,1.06071,1.06107,1.0607,1.06096,677,2256.8,-658710,-659552.8,33.762394495719214,63.89908771289376,64.42006923573258,NaN,NaN,50
1677542400,1.06096,1.06149,1.06085,1.06108,888,2085.9,-657822,-658938.2,33.96852372099284,64.67032148460035,64.73179591089469,NaN,NaN,50
1677544200,1.06108,1.06127,1.06059,1.06098,1264,1925.1,-659086,-659027.2,33.5965649336654,63.453774847824114,64.71062799658507,NaN,NaN,50
1677546000,1.06098,1.06103,1.06037,1.06066,1410,1742.2,-660496,-659100.2,32.79161403479795,59.59066851967717,64.36197622957793,NaN,NaN,50
1677547800,1.06066,1.0608,1.05862,1.05866,1883,1585.05,-662379,-659698.6,31.473582031644483,42.269674752644306,62.68687004362,NaN,NaN,50
1677549600,1.05866,1.05956,1.05858,1.05954,1487,1500.9,-660892,-660135,30.294509160021,49.25837309805926,61.41656157472901,NaN,NaN,50
1677551400,1.05954,1.05989,1.05908,1.05952,1163,1418.4,-662055,-660981.6,28.69793478464168,49.112854175107344,60.285659031141066,NaN,NaN,50
1677553200,1.05952,1.05958,1.05922,1.05952,1007,1343.55,-662055,-661575.4,27.215401436075176,49.112854175107344,59.122051497307375,NaN,NaN,50
1677555000,1.05952,1.05966,1.05912,1.05926,871,1303.95,-662926,-662061.4,25.976985903067,47.01863494455078,57.83853689775635,NaN,NaN,50
1677556800,1.05926,1.05928,1.05872,1.05881,877,1272,-663803,-662346.2,25.361532979013614,43.55679684653146,56.28738251677491,NaN,NaN,50
1677558600,1.05881,1.05912,1.05872,1.05901,783,1220.35,-663020,-662771.8,24.79004097810689,45.47815977782163,54.837734618178914,NaN,NaN,50
1677560400,1.05901,1.05906,1.0584,1.05846,1216,1197.3,-664236,-663208,24.681584789055826,41.313259618272774,53.06062333830612,NaN,NaN,50
1677562200,1.05846,1.05868,1.0582,1.05846,1398,1176.6,-664236,-663644.2,24.832612093271784,41.313259618272774,51.596789153488814,NaN,NaN,50
1677564000,1.05846,1.05878,1.05818,1.0586,1393,1163.3,-662843,-663627.6,24.754256816843128,42.858125936077975,50.20756039338867,NaN,NaN,50
1677565800,1.0586,1.05927,1.0584,1.05872,1448,1148.35,-661395,-663146,23.68300220550043,44.21367902574423,48.80145977287798,NaN,NaN,50
1677567600,1.05872,1.05902,1.0582,1.05882,2259,1239.55,-659136,-662369.2,22.993221614829693,45.37658430647819,47.423335688726404,NaN,NaN,50
1677569400,1.05882,1.05969,1.0586,1.05935,2875,1369.35,-656261,-660774.2,21.536443145838575,51.18467464334556,46.546971388406504,NaN,NaN,50
1677571200,1.05935,1.0613,1.05935,1.0607,3920,1452.65,-652341,-658395.2,22.089575432886694,62.207692298059996,46.733901658290996,NaN,NaN,50
1677573000,1.0607,1.062,1.05999,1.06159,3679,1562.1,-648662,-655559,23.177459646654643,67.42938381233056,48.53102373398287,NaN,NaN,50
1677574800,1.06159,1.06262,1.06154,1.0619,3269,1688.35,-645393,-652358.6,24.625629646762867,69.03427440253778,49.943588112874195,NaN,NaN,50
1677576600,1.0619,1.06196,1.06038,1.0606,2946,1801.8,-648339,-650199.2,24.28319001695703,56.46843394959139,50.46898666819448,NaN,NaN,50
1677578400,1.0606,1.06152,1.06056,1.06118,2478,1881.3,-645861,-648119.2,23.965210360708753,59.969402235935064,51.24445438682503,NaN,NaN,50
1677580200,1.06118,1.06172,1.06073,1.06163,2424,1939.3,-643437,-646338.4,23.85247134872755,62.48998154507173,52.349550572576526,NaN,NaN,50
1677582000,1.06163,1.06188,1.06101,1.06141,2443,1990.95,-645880,-645782,23.895958234628473,60.48481925186968,53.558695030100694,NaN,NaN,50
1677583800,1.06141,1.06183,1.06071,1.0609,1985,1996.05,-647865,-646276.4,23.481113621711394,55.99890616168439,54.310176914662314,NaN,NaN,50
1677585600,1.0609,1.06163,1.06058,1.06122,1954,2019.4,-645911,-645790.8,22.89904449893381,58.098791138135255,55.50914345179535,NaN,NaN,50
1677587400,1.06122,1.06194,1.06064,1.06177,2867,2104.6,-643044,-645227.4,22.70051992310829,61.49968955163294,56.951031304178215,NaN,NaN,50
1677589200,1.06177,1.06228,1.06137,1.06165,3351,2221.8,-646395,-645819,22.873391506951187,60.34878611806038,58.200364174319816,NaN,NaN,50
1677591000,1.06165,1.0632,1.06146,1.06313,3419,2349.2,-642976,-645238.2,23.859132352473097,68.24244236642336,59.91670441293975,NaN,NaN,50
1677592800,1.06313,1.06409,1.06218,1.06231,3602,2485.45,-646578,-644980.8,25.400849895313947,60.9969684996355,61.032446141022426,NaN,NaN,50
1677594600,1.06231,1.06394,1.06141,1.06344,5160,2704.3,-641418,-644082.2,25.645216394302206,66.30598707971271,62.112539886477215,NaN,NaN,50
1677596400,1.06344,1.06454,1.06303,1.06322,6256,2956.3,-647674,-645008.2,26.31702719161867,64.46616165924485,62.273859126561845,NaN,NaN,50
1677598200,1.06322,1.06352,1.06016,1.06052,6891,3230.95,-654565,-646642.2,24.93090905987829,47.168083128929595,60.82662336346177,NaN,NaN,50
1677600000,1.06052,1.06172,1.06034,1.06106,5119,3417.25,-649446,-647936.2,23.643799366119364,50.054613358054624,59.47093328885584,NaN,NaN,50
1677601800,1.06106,1.0615,1.06002,1.06008,2880,3488.85,-652326,-649085.8,22.705462852686406,45.225372225942365,58.667857451452335,NaN,NaN,50
1677603600,1.06008,1.06044,1.05981,1.06013,2351,3493.45,-649975,-650797.2,22.004016377967098,45.51420514065343,57.635343373217935,NaN,NaN,50
1677605400,1.06013,1.06098,1.05952,1.06056,2421,3470.75,-647554,-650773.2,20.799989700923156,48.05123517404536,56.60400434671605,NaN,NaN,50
1677607200,1.06056,1.0607,1.05882,1.05906,1916,3370.55,-649470,-649754.2,20.273648809323845,40.89730783485296,55.20489638835772,NaN,NaN,50
1677609000,1.05906,1.05973,1.05883,1.05914,1968,3285,-647502,-649365.4,19.784903695695913,41.39841743711375,54.162004336602664,NaN,NaN,50
1677610800,1.05914,1.05959,1.05856,1.05872,1386,3190.85,-648888,-648677.8,19.563553798730155,39.5046873597106,52.8338540667152,NaN,NaN,50
1677612600,1.05872,1.05898,1.05824,1.0584,1545,3120.8,-650433,-648769.4,19.630514235873893,38.075575621022885,51.16070307167162,NaN,NaN,50
1677614400,1.0584,1.05842,1.05808,1.05828,1283,3061.05,-651716,-649601.8,19.829334355976926,37.527322530730096,49.530598529719455,NaN,NaN,50
1677616200,1.05828,1.05834,1.05766,1.05766,1387,3009.2,-653103,-650328.4,20.366925200829492,34.74372693576552,47.13783314181533,NaN,NaN,50
1677618000,1.05766,1.05788,1.05752,1.05754,723,2923.2,-653826,-651593.2,20.982102491308044,34.21473868266983,45.22481672631778,NaN,NaN,50
1677619800,1.05754,1.05784,1.05742,1.05753,679,2857.9,-654505,-652716.6,21.63908963907933,34.16805197149918,42.929249932873965,NaN,NaN,50
1677621600,1.05753,1.05785,1.05749,1.05776,168,2768.6,-654337,-653497.4,22.23225273324239,36.32030605618489,40.918831675512536,NaN,NaN,50
1677623400,1.05776,1.058,1.0577,1.05794,5349,2892.7,-648988,-652951.8,22.518370235409353,38.02789155834102,40.26596084904192,NaN,NaN,50
1677625200,1.05794,1.05806,1.05774,1.05786,815,2765.9,-649803,-652291.8,22.67463149135305,37.54600217571642,39.372488621732046,NaN,NaN,50
1677627000,1.05786,1.05794,1.0575,1.0577,1037,2646.8,-650840,-651694.6,23.086896862969432,36.548465353436356,38.752709559410185,NaN,NaN,50
1677628800,1.0577,1.05774,1.05674,1.05678,1499,2541.65,-652339,-651261.4,24.210125852362964,31.385014000993607,37.743481620863065,NaN,NaN,50
1677630600,1.05678,1.05702,1.05653,1.05683,2398,2403.55,-649941,-650382.2,25.433744975594752,31.947718636736795,36.59323043962674,NaN,NaN,50
1677632400,1.05683,1.05759,1.05674,1.05747,1971,2189.3,-647970,-650178.6,25.48183108273529,38.85943081141732,36.44766779509562,NaN,NaN,50
1677634200,1.05747,1.05853,1.05746,1.05844,2810,1985.25,-645160,-649250,24.079287747148964,47.55372011790659,36.88733227229511,NaN,NaN,50
1677636000,1.05844,1.05866,1.05816,1.05834,1662,1812.4,-646822,-648446.4,22.600243449896148,46.814627053315036,37.40947082183828,NaN,NaN,50
1677637800,1.05834,1.05847,1.05816,1.05835,1133,1725.05,-645689,-647116.4,21.22684517387567,46.90349910670089,38.040036785101,NaN,NaN,50
1677639600,1.05835,1.0595,1.05822,1.05944,1489,1681.95,-644200,-645968.2,20.77502010012801,55.61043046221825,39.33168735163587,NaN,NaN,50
1677641400,1.05944,1.05957,1.05924,1.05934,1119,1616.85,-645319,-645438,20.433108057724354,54.723818074832344,40.75883671871207,NaN,NaN,50
1677643200,1.05934,1.05943,1.05882,1.05898,980,1570.05,-646299,-645665.8,19.48397707073167,51.5381981915417,41.99622668363149,NaN,NaN,50
1677645000,1.05898,1.0591,1.05883,1.05894,1127,1528,-647426,-645786.6,18.602641154238462,51.18168604967711,43.2114862606442,NaN,NaN,50
1677646800,1.05894,1.05954,1.0589,1.05951,1351,1526.25,-646075,-645863.8,18.3465468721009,55.86670151922282,44.607657365146906,NaN,NaN,50
1677648600,1.05951,1.05952,1.05908,1.0591,1365,1517.25,-647440,-646511.8,18.108745038687456,52.000955963777734,45.605733394106664,NaN,NaN,50
1677650400,1.0591,1.06031,1.05895,1.06022,1717,1538.95,-645723,-646592.6,18.798734210820985,60.11921310009126,47.21810560299058,NaN,NaN,50
1677652200,1.06022,1.06149,1.06006,1.06072,2761,1607.65,-642962,-645925.2,20.44258293848922,63.11822822589973,49.11594580816654,NaN,NaN,50
1677654000,1.06072,1.0619,1.06044,1.06162,2844,1713.7,-640118,-644463.6,22.25088657291099,67.81053015896423,51.71776839087873,NaN,NaN,50
1677655800,1.06162,1.06452,1.0612,1.06414,4767,1918.1,-635351,-642318.8,25.162871403049863,76.73555724473948,54.916899720021775,NaN,NaN,50
1677657600,1.06414,1.06436,1.06258,1.06398,5706,2195,-641057,-641042.2,27.86685731675025,75.30784700057397,57.52035801924725,NaN,NaN,50
1677659400,1.06398,1.0649,1.06334,1.06483,3966,2125.85,-637091,-639315.8,30.564419560187815,77.68335232365186,59.67247460537192,NaN,NaN,50
1677661200,1.06483,1.06578,1.06377,1.06439,3994,2284.8,-641085,-638940.4,33.340215721846846,73.72918609623053,61.594943108437306,NaN,NaN,50
1677663000,1.06439,1.06508,1.06406,1.06424,2762,2371.05,-643847,-639686.2,35.91774072910166,72.37665047988602,63.414453920807674,NaN,NaN,50
1677664800,1.06424,1.06624,1.06398,1.06612,4105,2501.35,-639742,-640564.4,38.62642788833947,77.85890950381136,65.00363099520719,NaN,NaN,50
1677666600,1.06612,1.06694,1.06482,1.06682,3786,2570.75,-635956,-639544.2,41.301908185724216,79.4910290173406,66.77271749110062,NaN,NaN,50
1677668400,1.06682,1.06684,1.06551,1.06652,3390,2641.7,-639346,-639995.2,43.78628274758146,76.87556255723081,68.582529231507,NaN,NaN,50
1677670200,1.06652,1.06742,1.06634,1.06698,3174,2659.9,-636172,-639012.6,46.22328285292556,78.06720581403698,70.50292350038984,NaN,NaN,50
1677672000,1.06698,1.06834,1.06636,1.0679,3094,2731.5,-633078,-636858.8,48.66787020891204,80.2583602348922,72.24518483722338,NaN,NaN,50
1677673800,1.0679,1.06874,1.06766,1.06867,2999,2824.8,-630079,-634926.2,51.00926265463749,81.8891756979452,74.3800576753782,NaN,NaN,50
1677675600,1.06867,1.06915,1.06747,1.06759,4116,2956.15,-634195,-634574,53.25421952605952,72.8047211880043,75.28616539594341,NaN,NaN,50
1677677400,1.06759,1.06784,1.06692,1.06714,4264,3113.4,-638459,-634396.6,54.40501535737855,69.35242954826447,75.73146549039804,NaN,NaN,50
1677679200,1.06714,1.06773,1.0667,1.06718,4127,3270.75,-634332,-634028.6,55.11136321738154,69.49091662695497,75.85149309525453,NaN,NaN,50
1677681000,1.06718,1.06797,1.06653,1.06668,5425,3485.65,-639757,-635364.4,55.85393031944091,65.5062617248749,75.04940055812133,NaN,NaN,50
1677682800,1.06668,1.06776,1.06436,1.06472,9218,3879,-648975,-639143.6,53.60416001726327,52.73976791662041,73.43739490926751,NaN,NaN,50
1677684600,1.06472,1.06788,1.06454,1.06724,6217,4121.6,-642758,-640856.2,51.59392222461599,62.78274212417807,72.3730656093051,NaN,NaN,50
1677686400,1.06724,1.06756,1.06593,1.06728,4674,4269.45,-638084,-640781.2,49.727272845729225,62.917446054776164,71.60079846348694,NaN,NaN,50
1677688200,1.06728,1.06786,1.06648,1.06734,4455,4354.15,-633629,-640640.6,48.21005241864917,63.132996872606725,70.94053749153841,NaN,NaN,50
1677690000,1.06734,1.06783,1.06668,1.06677,3474,4385.65,-637103,-640109.8,46.801204879217686,59.589299654149194,69.63556535941969,NaN,NaN,50
1677691800,1.06677,1.06714,1.06642,1.06654,2518,4273.2,-639621,-638239,45.133259564907185,58.17043752754373,68.11266596729133,NaN,NaN,50
1677693600,1.06654,1.06654,1.06562,1.06574,1728,4074.3,-641349,-637957.2,42.57082404497408,53.40703565901367,66.43634261741869,NaN,NaN,50
1677695400,1.06574,1.06604,1.065,1.0652,1771,3964.55,-643120,-638964.4,39.55187819072266,50.40655804005143,64.46058206213401,NaN,NaN,50
1677697200,1.0652,1.0653,1.0647,1.06494,1878,3858.75,-644998,-641238.2,37.05924166294312,48.97972699549014,62.22639397360529,NaN,NaN,50
1677699000,1.06494,1.0659,1.06464,1.06574,2091,3825.2,-642907,-642399,34.72175075498406,53.354878144677016,60.18822986265756,NaN,NaN,50
1677700800,1.06574,1.0663,1.06564,1.0661,2089,3724.4,-640818,-642638.4,32.948141015752626,55.21598170036667,58.9318913278263,NaN,NaN,50
1677702600,1.0661,1.06661,1.06596,1.0665,2045,3637.35,-638773,-642123.2,31.598821088836683,57.25666174836922,58.06790791354807,NaN,NaN,50
1677704400,1.0665,1.06686,1.06648,1.0668,650,3500.35,-638123,-641123.8,30.582877694161365,58.77395484250021,57.30241064322987,NaN,NaN,50
1677706200,1.0668,1.06712,1.0668,1.06696,970,3390.15,-637153,-639554.8,29.884113299938708,59.59769566796078,56.88037021059315,NaN,NaN,50
1677708000,1.06696,1.06696,1.06672,1.0668,1750,3322.95,-638903,-638754,29.11836086930148,58.34228155046374,57.280549755867675,NaN,NaN,50
1677709800,1.0668,1.06706,1.06664,1.06695,748,3210.4,-638155,-638221.4,28.510723661968175,59.20978164320692,57.025338292941164,NaN,NaN,50
1677711600,1.06695,1.06727,1.0666,1.06688,881,3048.65,-639036,-638274,28.167243229936247,58.5965318281936,56.71670156247098,NaN,NaN,50
1677713400,1.06688,1.06705,1.06678,1.06687,609,2865.9,-639645,-638578.4,27.848297114478026,58.50331140750563,56.38600974353518,NaN,NaN,50
1677715200,1.06687,1.0673,1.06639,1.0669,1073,2713.2,-638572,-638862.2,26.868577288131362,58.71550490061209,56.323595832568245,NaN,NaN,50
1677717000,1.0669,1.06694,1.06584,1.06606,1498,2516.85,-640070,-639095.6,25.10171323678762,50.87153094784955,55.8022453625901,NaN,NaN,50
1677718800,1.06606,1.0662,1.06562,1.06586,1884,2150.15,-641954,-639855.4,23.472500948297345,49.18666214866777,55.50079011185111,NaN,NaN,50
1677720600,1.06586,1.06594,1.06466,1.06514,2842,1981.4,-644796,-641007.4,23.140298284397414,43.58958607810549,55.01386354314069,NaN,NaN,50
1677722400,1.06514,1.0657,1.065,1.06568,1635,1829.45,-643161,-641710.6,22.831824382204623,48.33782426768206,54.96801334829725,NaN,NaN,50
1677724200,1.06568,1.0657,1.06487,1.06559,1855,1699.45,-645016,-642999.4,22.695450769814897,47.61840594222904,54.55826533383668,NaN,NaN,50
1677726000,1.06559,1.0656,1.06466,1.06498,1583,1604.9,-646599,-644305.2,22.812167779387522,42.95231709634888,53.68228929069255,NaN,NaN,50
1677727800,1.06498,1.06502,1.06448,1.06458,1111,1534.55,-647710,-645456.4,23.127279058077026,40.17246630559643,52.46198961620878,NaN,NaN,50
1677729600,1.06458,1.065,1.06456,1.06484,894,1492.85,-646816,-645860.4,23.419882388288705,42.76540096654252,51.31852148221181,NaN,NaN,50
1677731400,1.06484,1.06508,1.06468,1.0648,915,1450.05,-647731,-646774.4,23.515892037347502,42.460508292934996,50.09443666970997,NaN,NaN,50
1677733200,1.0648,1.06488,1.06432,1.06436,1056,1408.95,-648787,-647528.6,24.065421611045625,39.15373089561213,48.72382590864914,NaN,NaN,50
1677735000,1.06436,1.06454,1.06372,1.06414,1609,1384.85,-650396,-648288,25.230539479666113,37.57790921182923,47.178692163550735,NaN,NaN,50
1677736800,1.06414,1.0642,1.06354,1.06393,1720,1366.4,-652116,-649169.2,26.488233943926442,36.084971843259986,45.57072359319834,NaN,NaN,50
1677738600,1.06393,1.06436,1.06372,1.06393,1760,1352.15,-652116,-650229.2,27.268255658775004,36.08497184325999,43.96941362432364,NaN,NaN,50
1677740400,1.06393,1.06448,1.06327,1.06368,2905,1464.9,-655021,-651687.2,28.454165695427776,34.208536717882524,42.21891589698583,NaN,NaN,50
1677742200,1.06368,1.06414,1.06323,1.06366,2355,1534.15,-657376,-653405,29.594605504868188,34.05596464737617,41.01780401838057,NaN,NaN,50
1677744000,1.06366,1.06374,1.06262,1.06292,3885,1640.9,-661261,-655578,31.20332192271022,28.916954235701155,39.569967738882966,NaN,NaN,50
1677745800,1.06292,1.06391,1.06266,1.06386,4225,1814.75,-657036,-656562,32.263584187529936,41.079710424254124,39.39069090646501,NaN,NaN,50
1677747600,1.06386,1.06432,1.06277,1.06305,3330,1937.2,-660366,-658212,32.26852165597136,35.45069347117706,38.47018156385751,NaN,NaN,50
1677749400,1.06305,1.0635,1.06192,1.06244,2915,2052.5,-663281,-659864,33.11081005000187,31.905056989219574,37.3477994957854,NaN,NaN,50
1677751200,1.06244,1.0632,1.06191,1.06266,4314,2214.55,-658967,-660182.2,33.90168971946604,34.45136340459332,36.74058851780286,NaN,NaN,50
1677753000,1.06266,1.06288,1.0613,1.0614,2821,2280.7,-661788,-660287.6,35.13773087173562,27.99474805224341,35.870751499706216,NaN,NaN,50
1677754800,1.0614,1.06272,1.06136,1.06211,3127,2342.85,-658661,-660612.6,36.285483370271656,35.347597226452564,35.34090837541408,NaN,NaN,50
1677756600,1.06211,1.06307,1.06208,1.0625,2193,2310.4,-656468,-659833,36.516814413685296,39.03053842232573,35.09591052751342,NaN,NaN,50
1677758400,1.0625,1.06312,1.06208,1.06242,2463,2351.8,-658931,-658963,36.61455624435453,38.54548045604489,35.05246406754433,NaN,NaN,50
1677760200,1.06242,1.06256,1.06046,1.0606,3823,2450.2,-662754,-659720.4,37.99513345758973,29.548597734850972,34.478941819188734,NaN,NaN,50
1677762000,1.0606,1.06098,1.06013,1.06072,4293,2585.7,-658461,-659055,39.4657605463247,30.697185041811935,34.09409990479959,NaN,NaN,50
1677763800,1.06072,1.06072,1.05818,1.05862,7179,2889.1,-665640,-660450.8,41.64828072977878,23.482194274613377,33.193901507039115,NaN,NaN,50
1677765600,1.05862,1.06044,1.05856,1.05977,4674,3078.1,-660966,-661350.4,43.67490661441472,32.797288511333434,33.09309806371418,NaN,NaN,50
1677767400,1.05977,1.06075,1.05913,1.05994,7001,3382.4,-653965,-660357.2,44.96840208906802,34.074936069911075,33.09445316532382,NaN,NaN,50
1677769200,1.05994,1.06092,1.05937,1.06023,5618,3610.5,-648347,-657475.8,45.84806175325711,36.2997770997174,33.6217976556107,NaN,NaN,50
1677771000,1.06023,1.06148,1.06001,1.06086,5245,3792.3,-643102,-654404,45.65585402335356,40.961147043246946,33.61332884268161,NaN,NaN,50
1677772800,1.06086,1.06129,1.0597,1.0597,4033,3907.95,-647135,-650703,45.68372523263459,35.77072695659152,33.636188377354074,NaN,NaN,50
1677774600,1.0597,1.06011,1.05924,1.0594,2731,3956.5,-649866,-648483,45.99908673065623,34.551335394934,33.82520826347653,NaN,NaN,50
1677776400,1.0594,1.05952,1.0585,1.05892,2515,3937,-652381,-648166.2,46.70235092717009,32.63444902268796,33.695428664769004,NaN,NaN,50
1677778200,1.05892,1.05915,1.05767,1.05799,2404,3939.45,-654785,-649453.8,47.74049011421226,29.248631991220464,33.78499180326737,NaN,NaN,50
1677780000,1.05799,1.05824,1.05766,1.0578,1758,3833.1,-656543,-652142,48.708856208829275,28.595883237427884,33.30272651833703,NaN,NaN,50
1677781800,1.0578,1.05942,1.0577,1.0593,3042,3773.95,-653501,-653415.2,47.67978112346511,39.98351446992406,33.37079623602263,NaN,NaN,50
1677783600,1.0593,1.05994,1.05904,1.05976,3134,3764.15,-650367,-653515.4,46.018325485038964,42.98640713735759,33.688005284687826,NaN,NaN,50
1677785400,1.05976,1.05995,1.0589,1.05904,2118,3724.3,-652485,-653536.2,44.58831800799475,39.6429585050114,34.409031053985,NaN,NaN,50
1677787200,1.05904,1.05999,1.0586,1.05988,2251,3621.15,-650234,-652626,43.50354407282095,45.01612529428698,35.43181250059036,NaN,NaN,50
1677789000,1.05988,1.06068,1.05964,1.06004,1904,3575.3,-648330,-650983.4,41.551047985443695,46.0021866327764,37.04038338331629,NaN,NaN,50
1677790800,1.06004,1.06006,1.05968,1.05974,753,3456.6,-649083,-650099.8,39.73801590430767,44.394563182372394,37.86876014553336,NaN,NaN,50
1677792600,1.05974,1.05986,1.0596,1.05969,437,3368.8,-649520,-649930.4,38.13570799323263,44.11783494200634,38.586110064968736,NaN,NaN,50
1677794400,1.05969,1.05998,1.05963,1.05964,131,3252.2,-649651,-649363.6,36.46819199617272,43.8236523652594,39.12352972679316,NaN,NaN,50
1677796200,1.05964,1.05992,1.0596,1.05986,413,3081.7,-649238,-649164.4,34.954717771059926,45.54426742898723,39.45089546863176,NaN,NaN,50
1677798000,1.05986,1.06012,1.05968,1.06002,763,2905.2,-648475,-649193.4,33.223465408178114,46.82000256907533,40.24012944095203,NaN,NaN,50
1677799800,1.06002,1.06008,1.0598,1.05986,663,2579.4,-649138,-649204.4,31.61587392835929,45.6678443841917,41.03416579732758,NaN,NaN,50
1677801600,1.05986,1.06037,1.05968,1.05992,753,2383.35,-648385,-648977.4,29.629619129899503,46.20248121430986,42.003310953872,NaN,NaN,50
1677803400,1.05992,1.06118,1.05992,1.06108,1382,2102.4,-647003,-648447.8,28.413017505071952,55.35020126013988,43.86770875879482,NaN,NaN,50
1677805200,1.06108,1.06144,1.0609,1.06104,1875,1915.25,-648878,-648375.8,27.606706829055565,55.002886860896226,45.75392330332827,NaN,NaN,50
1677807000,1.06104,1.06118,1.06052,1.06085,2117,1758.85,-650995,-648879.8,26.227313514427614,53.29229538307749,46.70455051141066,NaN,NaN,50
1677808800,1.06085,1.0615,1.06076,1.06091,1974,1655.9,-649021,-648856.4,25.36560977984289,53.7811305823102,47.475602186050125,NaN,NaN,50
1677810600,1.06091,1.061,1.06018,1.06026,1776,1608.15,-650797,-649338.8,23.660008840556664,47.92893882055914,48.067457922874965,NaN,NaN,50
1677812400,1.06026,1.06075,1.06021,1.06066,1294,1547.1,-649503,-649838.8,22.07623653979088,51.431416499940624,48.52569300899308,NaN,NaN,50
1677814200,1.06066,1.06069,1.06023,1.06064,1156,1484.7,-650659,-650195,20.60559083193694,51.24581050398931,48.900237571222576,NaN,NaN,50
1677816000,1.06064,1.06084,1.06063,1.06072,790,1436.3,-649869,-649969.8,19.48362788436617,51.992122963878316,49.44292041275872,NaN,NaN,50
1677817800,1.06072,1.061,1.06054,1.06087,819,1325.15,-649050,-649975.6,18.70164982538774,53.43153982178772,50.10818504702881,NaN,NaN,50
1677819600,1.06087,1.0611,1.06082,1.0611,891,1213,-648159,-649448,18.139510728912985,55.62839043882267,50.9513806237119,NaN,NaN,50
1677821400,1.0611,1.06134,1.06088,1.06092,1140,1164.1,-649299,-649407.2,18.00554733554073,53.50122283827229,51.51973458151797,NaN,NaN,50
1677823200,1.06092,1.06173,1.06091,1.06164,1685,1135.8,-647614,-648798.2,18.45738956202002,60.07733763466238,52.46668708620276,NaN,NaN,50
1677825000,1.06164,1.06232,1.06152,1.06214,1450,1113.1,-646164,-648057.2,19.61021852539326,63.8959531229561,53.768694853257365,NaN,NaN,50
1677826800,1.06214,1.06214,1.06124,1.06162,2533,1202.1,-648697,-647986.6,20.05732042582488,57.71322949555631,54.59089115906068,NaN,NaN,50
1677828600,1.06162,1.0623,1.06093,1.06101,2301,1295.3,-650998,-648554.4,19.827296407938572,51.42675991343613,54.31064534858184,NaN,NaN,50
1677830400,1.06101,1.06232,1.06101,1.06187,3701,1473.8,-647297,-648154,19.64317333907752,58.31985081588553,54.54757134536679,NaN,NaN,50
1677832200,1.06187,1.06292,1.06172,1.06212,3039,1605.1,-644258,-647482.8,20.288729874988302,60.09279273711286,55.03332115636931,NaN,NaN,50
1677834000,1.06212,1.06212,1.06115,1.0617,3459,1739.9,-647717,-647793.4,19.749992903427312,55.79859101306167,55.17742547285156,NaN,NaN,50
1677835800,1.0617,1.06206,1.06073,1.061,3133,1863.4,-650850,-648224,18.52920476313974,49.455407554115496,55.286458953819874,NaN,NaN,50
1677837600,1.061,1.06157,1.06006,1.0613,3335,1992.5,-647515,-647527.4,17.992693301909476,51.97515993957844,55.32529777093686,NaN,NaN,50
1677839400,1.0613,1.06234,1.0613,1.06168,2517,2049.25,-644998,-647067.6,17.042969110717305,55.03306157269847,55.59581570441609,NaN,NaN,50
1677841200,1.06168,1.06181,1.061,1.06107,2312,2071.1,-647310,-647678,15.909395701483128,49.575987157158025,55.42323457536464,NaN,NaN,50
1677843000,1.06107,1.06178,1.06103,1.06147,2000,2065.25,-645310,-647196.6,14.856791821479964,52.87584064471314,55.383541777002165,NaN,NaN,50
1677844800,1.06147,1.06187,1.06055,1.06071,2358,2084.45,-647668,-646560.2,14.544531916511891,46.631647898153275,54.74091730981149,NaN,NaN,50
1677846600,1.06071,1.06143,1.06031,1.06126,2364,2113.85,-645304,-646118,14.563324424462627,51.12944696170159,54.5715047471993,NaN,NaN,50
1677848400,1.06126,1.062,1.06106,1.06166,2821,2190.2,-642483,-645615,13.67930066287108,54.15555847892527,54.148520521789514,NaN,NaN,50
1677850200,1.06166,1.06297,1.06154,1.06224,3754,2320.1,-638729,-643898.8,13.769904845590059,58.19752198028169,53.7414897258842,NaN,NaN,50
1677852000,1.06224,1.06295,1.06116,1.06154,3564,2458.8,-642293,-643295.4,13.31157910894167,52.214117367506745,53.34869600245209,NaN,NaN,50
1677853800,1.06154,1.06228,1.06119,1.06138,4934,2664.55,-647227,-643207.2,12.885990924911022,50.92532106727809,53.312878942012226,NaN,NaN,50
1677855600,1.06138,1.0618,1.05883,1.06142,8053,3022.65,-639174,-641981.2,13.91278803190526,51.24928897114649,52.80783881024515,NaN,NaN,50
1677857400,1.06142,1.06158,1.05934,1.0598,5656,3248.45,-644830,-642450.6,14.86624248839991,39.79203837236627,51.35778492704896,NaN,NaN,50
1677859200,1.0598,1.06034,1.05926,1.0603,3648,3346.6,-641182,-642941.2,15.81662961358113,43.95648773710934,50.51192040733809,NaN,NaN,50
1677861000,1.0603,1.06172,1.06012,1.06159,3093,3428.75,-638089,-642100.4,14.97187561761237,52.99072695930195,50.76444322199426,NaN,NaN,50
1677862800,1.06159,1.06218,1.0612,1.06198,2762,3440.2,-635327,-639720.4,14.088601780053583,55.334922899910445,51.0044262905894,NaN,NaN,50
1677864600,1.06198,1.06254,1.06176,1.06248,2432,3446.75,-632895,-638464.6,13.621449096651887,58.21200335145167,51.23149356050035,NaN,NaN,50
1677866400,1.06248,1.06274,1.06212,1.06233,1813,3352.35,-634708,-636440.2,13.382252697917998,57.02525913528796,51.763584416081066,NaN,NaN,50
1677868200,1.06233,1.06248,1.062,1.06242,1267,3263.75,-633441,-634892,13.012973152622159,57.58399972909593,52.099881493536984,NaN,NaN,50
1677870000,1.06242,1.06314,1.06231,1.06269,1873,3184.45,-631568,-633587.8,13.323343445635055,59.293868301010676,53.00432580802679,NaN,NaN,50
1677871800,1.06269,1.06358,1.06266,1.06347,1903,3122.95,-629665,-632455.4,14.005635331700592,63.83010573180869,53.9115157201773,NaN,NaN,50
1677873600,1.06347,1.06388,1.06332,1.06362,1832,3047.8,-627833,-631443,14.896621668804261,64.64604032525287,54.66083585205784,NaN,NaN,50
1677875400,1.06362,1.06362,1.06306,1.06352,1797,3011.8,-629630,-630427.4,15.34640928917194,63.61573468188301,55.04785104502936,NaN,NaN,50
1677877200,1.06352,1.06352,1.06321,1.06322,555,2923.95,-630185,-629776.2,15.764069222370496,60.50051171595959,55.63973635563314,NaN,NaN,50
1677879000,1.06322,1.06346,1.06303,1.06342,476,2847.75,-629709,-629404.4,15.87085048663118,61.84204993094515,56.419502703037935,NaN,NaN,50
1678053600,1.06342,1.06342,1.06238,1.0625,210,2740.35,-629919,-629455.2,15.03107708499845,52.93564733820224,56.53995687211334,NaN,NaN,50
1678055400,1.0625,1.06288,1.06242,1.0628,1892,2716.75,-628027,-629494,14.251287497768065,55.201342889352794,57.64062148046952,NaN,NaN,50
1678057200,1.0628,1.0629,1.06234,1.06241,1567,2654.05,-629594,-629486.8,13.410072948543334,51.7158728274685,58.19486327263804,NaN,NaN,50
1678059000,1.06241,1.0628,1.06234,1.06258,691,2500.9,-628903,-629230.4,12.628945152834653,53.1058242372517,58.20308450677731,NaN,NaN,50
1678060800,1.06258,1.06368,1.06256,1.06368,1263,2385.85,-627640,-628816.6,13.069089622005547,60.94094075435346,58.60351435352323,NaN,NaN,50
1678062600,1.06368,1.06368,1.06258,1.06269,1316,2204.95,-628956,-628624,13.477795200521378,52.447586256990675,58.191770275347444,NaN,NaN,50
1678064400,1.06269,1.06298,1.06242,1.0628,1701,1887.35,-627255,-628469.6,13.56816144832004,53.22759941955559,57.92050886708085,NaN,NaN,50
1678066200,1.0628,1.06382,1.0628,1.06366,1637,1686.4,-625618,-627674.4,14.635833365045665,58.90338368987203,58.01475057856486,NaN,NaN,50
1678068000,1.06366,1.06372,1.06281,1.06336,1379,1572.95,-626997,-627293.2,15.627243002005173,56.335214346139665,57.80341815321692,NaN,NaN,50
1678069800,1.06336,1.06502,1.06333,1.06452,2097,1523.15,-624900,-626745.2,17.69554600929832,63.04459978525658,57.74731058560605,NaN,NaN,50
1678071600,1.06452,1.06492,1.0644,1.06455,1397,1454.9,-623503,-625654.6,19.616113087499095,63.20207878345626,57.64417047547773,NaN,NaN,50
1678073400,1.06455,1.06478,1.06436,1.06458,1113,1388.95,-622390,-624681.6,21.31731888374531,63.37017743582985,57.62663067218822,NaN,NaN,50
1678075200,1.06458,1.06468,1.06423,1.0645,988,1347.7,-623378,-624233.6,22.619407321239134,62.5496012526895,57.77299421052607,NaN,NaN,50
1678077000,1.0645,1.0645,1.06414,1.06429,851,1326.9,-624229,-623680,23.63111472953607,60.340788227637255,57.66576123171836,NaN,NaN,50
1678078800,1.06429,1.06484,1.06411,1.06458,893,1277.9,-623336,-623367.2,24.907205432969256,62.31963815964632,58.336046290392936,NaN,NaN,50
1678080600,1.06458,1.06491,1.06413,1.06484,1117,1238.6,-622219,-623110.4,26.16010012220983,64.05148609795413,58.96819937672161,NaN,NaN,50
1678082400,1.06484,1.06524,1.06376,1.06386,1536,1223.8,-623755,-623383.4,26.46146751057242,53.98055843640128,59.129962634502526,NaN,NaN,50
1678084200,1.06386,1.0644,1.06373,1.06434,1472,1207.55,-622283,-623164.4,26.672920491305813,57.50490730547958,59.444182853661665,NaN,NaN,50
1678086000,1.06434,1.06528,1.06426,1.06486,2435,1301.55,-619848,-622288.2,27.818531911647455,60.99033853874221,59.44771126683228,NaN,NaN,50
1678087800,1.06486,1.06569,1.06479,1.06485,2545,1405,-622393,-622099.6,29.235547705152282,60.8869141313399,60.05052040071437,NaN,NaN,50
1678089600,1.06485,1.06574,1.06461,1.06498,3277,1558.35,-619116,-621479,30.137778452005676,61.793945330277346,60.66240225148021,NaN,NaN,50
1678091400,1.06498,1.06548,1.06417,1.06417,3254,1626.45,-622370,-621202,30.027415382346696,53.47319272815602,60.27453146850049,NaN,NaN,50
1678093200,1.06417,1.06468,1.06376,1.0639,2966,1696.4,-625336,-621812.6,29.136524629363215,51.007634317569334,59.89399003788832,NaN,NaN,50
1678095000,1.0639,1.06399,1.06281,1.06292,2676,1795.65,-628012,-623445.4,27.28263013938041,43.218398611127355,58.47783281116481,NaN,NaN,50
1678096800,1.06292,1.06369,1.06253,1.06366,2178,1841.4,-625834,-624133.6,25.927839543853743,49.49062835125687,57.498443494579135,NaN,NaN,50
1678098600,1.06366,1.0638,1.06264,1.06283,2237,1887.45,-628071,-625924.6,24.500069633652053,43.664573143101,56.090900330812794,NaN,NaN,50
1678100400,1.06283,1.06328,1.06222,1.06244,2688,1936.8,-630759,-627602.4,23.730260197348482,41.209736146820966,54.566624251822184,NaN,NaN,50
1678102200,1.06244,1.06478,1.06244,1.06395,3452,2027.55,-627307,-627996.6,23.01621715508397,52.37409330067881,53.99757461418229,NaN,NaN,50
1678104000,1.06395,1.06428,1.06336,1.06396,2323,2074.75,-624984,-627391,22.353177187266926,52.438508967843134,53.29177967191064,NaN,NaN,50
1678105800,1.06396,1.0643,1.06322,1.06418,2650,2102.4,-622334,-626691,21.530597766917836,53.91527803939383,52.5677648105849,NaN,NaN,50
1678107600,1.06418,1.0655,1.06402,1.06502,3518,2208.45,-618816,-624840,21.97902787155419,59.13289602456312,52.935788924025026,NaN,NaN,50
1678109400,1.06502,1.06584,1.06476,1.06546,3071,2306.35,-615745,-621837.2,22.678474413395396,61.58624932324444,53.22731335386538,NaN,NaN,50
1678111200,1.06546,1.06675,1.06502,1.06594,3278,2420.85,-612467,-618869.2,23.99369108422103,64.11699378833833,53.4506458716936,NaN,NaN,50
1678113000,1.06594,1.06736,1.06554,1.06692,5631,2659.85,-606836,-615239.6,25.592655669980115,68.65713897491078,54.005661931948666,NaN,NaN,50
1678114800,1.06692,1.0685,1.06614,1.06746,5359,2883.15,-601477,-611068.2,27.663452497411445,70.84606211539037,54.65224170231388,NaN,NaN,50
1678116600,1.06746,1.06899,1.06721,1.06786,4587,3056.65,-596890,-606683,29.800902818584383,72.38455279954013,56.00305313598418,NaN,NaN,50
1678118400,1.06786,1.0689,1.06757,1.06768,3258,3142.75,-600148,-603563.6,31.785678116816396,70.57956682158088,57.401048314842136,NaN,NaN,50
1678120200,1.06768,1.06944,1.06756,1.06937,2417,3190,-597731,-600616.4,33.86482244160177,76.50371617904207,59.77857099826463,NaN,NaN,50
1678122000,1.06937,1.06944,1.06848,1.06861,1805,3158.5,-599536,-599156.4,35.79545645747389,69.70606215736908,61.22253055584406,NaN,NaN,50
1678123800,1.06861,1.06862,1.06802,1.06854,1604,3111.45,-601140,-599089,36.76645766154985,69.09707891229712,63.039138110786645,NaN,NaN,50
1678125600,1.06854,1.0686,1.06758,1.06824,1632,3029.2,-602772,-600265.4,36.93607753287051,66.41893090968776,64.83979487956285,NaN,NaN,50
1678127400,1.06824,1.0683,1.06716,1.06738,1776,2955.3,-604548,-601145.4,36.43887424941454,59.32080349838964,65.33598846511362,NaN,NaN,50
1678129200,1.06738,1.0676,1.06684,1.06712,1542,2884.1,-606090,-602817.2,35.501109788662404,57.32616419131546,65.68510669536164,NaN,NaN,50
1678131000,1.06712,1.06774,1.0671,1.06756,1579,2829.25,-604511,-603812.2,34.759553905090584,59.79023345666818,66.1047463680241,NaN,NaN,50
1678132800,1.06756,1.06778,1.0672,1.06744,1701,2805.4,-606212,-604826.6,34.109510185310654,58.793150673976484,66.08047884298219,NaN,NaN,50
1678134600,1.06744,1.06784,1.06726,1.06771,1689,2778,-604523,-605176.8,33.56700137049725,60.39357028509499,65.99528748311437,NaN,NaN,50
1678136400,1.06771,1.06802,1.06761,1.06798,450,2666.1,-604073,-605081.8,33.25138739526111,61.98365231357435,65.84290594920266,NaN,NaN,50
1678138200,1.06798,1.06838,1.06794,1.06831,512,2519.1,-603561,-604576,33.32102390742918,63.89172716873978,65.50251939161902,NaN,NaN,50
1678140000,1.06831,1.06831,1.0677,1.06822,2754,2540.65,-606315,-604936.8,32.916499102612796,62.96355717079135,64.93948332414766,NaN,NaN,50
1678141800,1.06822,1.06829,1.06797,1.0682,805,2448.4,-607120,-605118.4,32.54086892671187,62.74541628498997,64.25097357310837,NaN,NaN,50
1678143600,1.0682,1.06854,1.06799,1.06824,752,2310.1,-606368,-605487.4,32.48050849858685,63.02135553693387,63.711101338490714,NaN,NaN,50
1678145400,1.06824,1.0687,1.06824,1.06856,511,2182.1,-605857,-605844.2,32.60520954295258,65.23952220712236,62.90651605478216,NaN,NaN,50
1678147200,1.06856,1.06864,1.06803,1.06818,881,2062.25,-606738,-606479.6,32.24392879856578,60.59145030350733,62.25547235093489,NaN,NaN,50
1678149000,1.06818,1.06828,1.06776,1.06791,924,1826.9,-607662,-606749,31.321217760740627,57.45899459165093,61.424180613745875,NaN,NaN,50
1678150800,1.06791,1.06854,1.06764,1.06846,1341,1626,-606321,-606589.2,30.82546561792189,61.7921996023242,61.09369980607705,NaN,NaN,50
1678152600,1.06846,1.06888,1.06804,1.06866,1609,1477.1,-604712,-606258,30.803083970050054,63.25780992764648,61.37491455102396,NaN,NaN,50
1678154400,1.06866,1.06928,1.06843,1.06886,1802,1404.3,-602910,-605668.6,31.244689664365012,64.7154030936328,61.902717329760925,NaN,NaN,50
1678156200,1.06886,1.06918,1.06874,1.06878,1352,1351.05,-604262,-605173.4,31.654752094800326,63.62806482431441,62.176848141735654,NaN,NaN,50
1678158000,1.06878,1.06898,1.06847,1.06894,1082,1314.9,-603180,-604277,31.370442428212396,64.89834433626922,62.612933403327986,NaN,NaN,50
1678159800,1.06894,1.0692,1.06849,1.06911,2512,1360.3,-600668,-603146.4,31.397228012424826,66.24717262416371,63.031047856118604,NaN,NaN,50
1678161600,1.06911,1.06934,1.069,1.0691,1183,1337.85,-601851,-602574.2,31.603179163708038,66.08630217378405,63.32409427470501,NaN,NaN,50
1678163400,1.0691,1.06924,1.06884,1.06907,707,1284.4,-602558,-602503.8,31.375130806678342,65.57186492883365,63.44410411471171,NaN,NaN,50
1678165200,1.06907,1.06907,1.06873,1.06888,1068,1260.7,-603626,-602376.6,30.87581429905452,62.2659722170114,63.39427661801316,NaN,NaN,50
1678167000,1.06888,1.06888,1.06812,1.06852,1360,1249.75,-604986,-602737.8,29.011034390217976,56.45793013247552,62.94517046426212,NaN,NaN,50
1678168800,1.06852,1.0687,1.06809,1.06827,1764,1252.9,-606750,-603954.2,27.217465104274403,52.776300346855905,62.21338080782798,NaN,NaN,50
1678170600,1.06827,1.0685,1.0676,1.06762,1536,1245.25,-608286,-605241.2,25.93851975582669,44.62778438702299,60.74111382067803,NaN,NaN,50
1678172400,1.06762,1.06922,1.06746,1.06908,2831,1364.3,-605455,-605820.6,24.728656513276196,59.68464042518239,60.67634168651197,NaN,NaN,50
1678174200,1.06908,1.06946,1.06846,1.06856,3025,1489.95,-608480,-606791.4,23.973930849708733,54.04756670860019,60.43266826629405,NaN,NaN,50
1678176000,1.06856,1.06864,1.06699,1.0676,3772,1540.85,-612252,-608244.6,23.470284497330944,45.50310450334692,59.26916147350995,NaN,NaN,50
1678177800,1.0676,1.06788,1.06704,1.06738,2994,1650.3,-615246,-609943.8,23.00261288440871,43.79441387925657,57.87891889862495,NaN,NaN,50
1678179600,1.06738,1.06738,1.06584,1.06624,3531,1789.25,-618777,-612042,23.784563898582608,36.20717289593259,55.842616741646374,NaN,NaN,50
1678181400,1.06624,1.06677,1.06556,1.06569,3007,1914.05,-621784,-615307.8,24.741737209706493,33.217178201187494,53.67041055428017,NaN,NaN,50
1678183200,1.06569,1.06664,1.06542,1.06606,2437,1991.85,-619347,-617481.2,25.745831681129914,36.98707252586394,51.676748282108356,NaN,NaN,50
1678185000,1.06606,1.06666,1.06566,1.06609,2377,2064.5,-616970,-618424.8,26.639166855375535,37.296146797470335,49.608817865915974,NaN,NaN,50
1678186800,1.06609,1.06692,1.06585,1.06684,2107,2102.8,-614863,-618348.2,26.952750756777593,44.61063994393903,48.074841992355616,NaN,NaN,50
1678188600,1.06684,1.06688,1.06556,1.06568,2311,2137.9,-617174,-618027.6,27.534851444589968,37.35297920427753,46.059207297744464,NaN,NaN,50
1678190400,1.06568,1.06618,1.06522,1.06527,2197,2157.65,-619371,-617545,28.397012382410324,35.17476793010698,44.12412127725129,NaN,NaN,50
1678192200,1.06527,1.06714,1.06502,1.06698,2609,2220.5,-616762,-617028,27.460272629266917,48.62975610040756,43.56496598924644,NaN,NaN,50
1678194000,1.06698,1.06724,1.06626,1.06664,3232,2328,-619994,-617632.8,26.432591145919364,46.56045382714593,43.120976952124295,NaN,NaN,50
1678195800,1.06664,1.06664,1.06528,1.06564,3166,2360.7,-623160,-619292.2,26.523118737735118,41.03035509214438,42.86401771677582,NaN,NaN,50
1678197600,1.06564,1.06612,1.06482,1.06492,4079,2505.5,-627239,-621305.2,27.0120166960942,37.57034005439328,41.28442483314803,NaN,NaN,50
1678199400,1.06492,1.0652,1.06402,1.0648,5055,2722.9,-632294,-623889.8,28.07531652338299,37.01016067981631,40.06746725966347,NaN,NaN,50
1678201200,1.0648,1.0648,1.05862,1.0603,13090,3324,-645384,-629614.2,31.063175828243715,23.100444346814086,38.46727724848255,NaN,NaN,50
1678203000,1.0603,1.0616,1.0574,1.05856,10520,3782,-655904,-636796.2,34.06326309853853,19.97441662700419,36.765848873321666,NaN,NaN,50
1678204800,1.05856,1.05962,1.05738,1.05753,7445,4066.05,-663349,-644834,36.852617328332066,18.388126458522237,35.493059842078075,NaN,NaN,50
1678206600,1.05753,1.05833,1.05702,1.05727,5705,4274.5,-669054,-653197,39.50920874423054,17.99953730313004,34.40608549221683,NaN,NaN,50
1678208400,1.05727,1.05882,1.05704,1.05816,5609,4413.4,-663445,-659427.2,41.37571166146193,23.92593965806634,33.473147430231286,NaN,NaN,50
1678210200,1.05816,1.05836,1.05658,1.05672,4838,4504.05,-668283,-664007,43.2231348192094,21.249920005104116,32.326988373633704,NaN,NaN,50
1678212000,1.05672,1.05738,1.05581,1.05624,3577,4494.3,-671860,-667198.2,45.119753145850986,20.429672117309636,30.599776386017318,NaN,NaN,50
1678213800,1.05624,1.05642,1.0552,1.0556,2775,4483.35,-674635,-669455.4,47.014651151487016,19.356807383794816,29.31433554169712,NaN,NaN,50
1678215600,1.0556,1.056,1.05509,1.0554,2396,4426.6,-677031,-671050.8,48.79827499781854,19.02064925670595,28.160469922168478,NaN,NaN,50
1678217400,1.0554,1.05541,1.0546,1.05516,2184,4385.45,-679215,-674204.8,50.56246261573912,18.603143796760207,26.015711900479378,NaN,NaN,50
1678219200,1.05516,1.05574,1.05516,1.05532,2118,4369.5,-677097,-675967.6,51.733951840438344,19.86598043721355,24.108963801198502,NaN,NaN,50
1678221000,1.05532,1.05568,1.05498,1.05508,1800,4340.65,-678897,-677375,52.87283370143649,19.380272321212715,22.562529317560525,NaN,NaN,50
1678222800,1.05508,1.05524,1.05474,1.05476,605,4265.55,-679502,-678348.4,53.99994936327678,18.72297240904325,21.216288771464093,NaN,NaN,50
1678224600,1.05476,1.05498,1.05474,1.05492,545,4177.25,-678957,-678733.6,55.04655676355704,20.180666798287845,20.014182065640632,NaN,NaN,50
1678226400,1.05492,1.05498,1.05477,1.05488,76,4071.2,-679033,-678697.2,56.01840649238872,20.083690215721717,19.798699627705464,NaN,NaN,50
1678228200,1.05488,1.05563,1.05478,1.0552,272,3954.35,-678761,-679030,55.806306451799536,23.260737336373182,20.033436821231817,NaN,NaN,50
1678230000,1.0552,1.05525,1.05492,1.05504,705,3828,-679466,-679143.8,55.60935641410959,22.773244947451246,20.346659570441034,NaN,NaN,50
1678231800,1.05504,1.05506,1.05481,1.05484,780,3708.7,-680246,-679292.6,55.48628481567517,22.148387190023357,20.64300599093341,NaN,NaN,50
1678233600,1.05484,1.05498,1.05422,1.05432,1450,3577.25,-681696,-679840.4,55.679631309182575,20.568193142211285,20.403166954086625,NaN,NaN,50
1678235400,1.05432,1.05508,1.05432,1.05504,1645,3406.75,-680051,-680044,55.66976972258829,28.206025901841585,20.900031660996444,NaN,NaN,50
1678237200,1.05504,1.05507,1.05437,1.05466,1656,2835.05,-681707,-680633.2,55.66061253503645,26.74437410376146,21.351081802885858,NaN,NaN,50
1678239000,1.05466,1.055,1.05444,1.05448,1724,2395.25,-683431,-681426.2,55.652109432309736,26.05560017813133,21.829567002481326,NaN,NaN,50
1678240800,1.05448,1.05472,1.05398,1.05398,1281,2087.05,-684712,-682319.4,55.92316180726399,24.191818820945926,22.198936257069896,NaN,NaN,50
1678242600,1.05398,1.05414,1.0532,1.05324,1692,1886.4,-686404,-683261,56.57526403134911,21.71599358488548,22.421282670507416,NaN,NaN,50
1678244400,1.05324,1.05373,1.05316,1.05342,1761,1694,-684643,-684179.4,57.1996997752324,23.75989717366231,22.699419580253757,NaN,NaN,50
1678246200,1.05342,1.0535,1.05276,1.05296,832,1493.7,-685475,-684933,57.96641263323791,22.167080234887266,22.898477288373364,NaN,NaN,50
1678248000,1.05296,1.05346,1.05296,1.05318,1040,1366.85,-684435,-685133.8,58.67836028710015,24.76479781612666,23.330036246022182,NaN,NaN,50
1678249800,1.05318,1.05366,1.05298,1.0535,1451,1300.65,-682984,-684788.2,58.83672640267631,28.502718822735872,23.924468533482752,NaN,NaN,50
1678251600,1.0535,1.05352,1.05244,1.05316,1235,1242.6,-684219,-684351.2,59.28719135966393,26.969528722548105,24.41631414111321,NaN,NaN,50
1678253400,1.05316,1.05356,1.05306,1.0531,1322,1199.5,-685541,-684530.8,59.60414310947828,26.696616517977475,24.661734082656377,NaN,NaN,50
1678255200,1.0531,1.05386,1.05305,1.05323,1494,1168.3,-684047,-684245.2,59.139646632134735,28.387505854260567,25.06275271885704,NaN,NaN,50
1678257000,1.05323,1.05402,1.05322,1.05399,1345,1145.55,-682702,-683898.6,58.31542137804318,37.46871067607825,26.157061539289533,NaN,NaN,50
1678258800,1.05399,1.05423,1.05336,1.0539,2489,1239.75,-685191,-684340,57.04053927946246,36.872403927284594,27.321648023937627,NaN,NaN,50
1678260600,1.0539,1.05471,1.05384,1.05437,2228,1323.9,-682963,-684088.8,54.79000878167223,42.05839241063928,28.31110277456603,NaN,NaN,50
1678262400,1.05437,1.05482,1.05386,1.0545,3068,1473.5,-679895,-682959.6,52.47097557895908,43.44238436784787,29.503817793429352,NaN,NaN,50
1678264200,1.0545,1.05474,1.05351,1.05368,2453,1582.55,-682348,-682619.8,50.76451500359618,37.37766900171437,30.312536995113852,NaN,NaN,50
1678266000,1.05368,1.05453,1.05348,1.05398,2607,1677.65,-679741,-682027.6,49.21759619046653,40.642526727420815,31.48758755986206,NaN,NaN,50
1678267800,1.05398,1.05488,1.05354,1.05356,2661,1771.7,-682402,-681469.8,46.99857462661643,37.68065533170454,32.627920541777705,NaN,NaN,50
1678269600,1.05356,1.05462,1.0534,1.05444,2336,1816,-680066,-680890.4,45.14423619274386,46.48120658127926,34.250871213750344,NaN,NaN,50
1678271400,1.05444,1.05462,1.05392,1.05394,2038,1835.65,-682104,-681332.2,43.42235050414791,42.78426106849609,35.72352698757955,NaN,NaN,50
1678273200,1.05394,1.05448,1.05344,1.0536,2118,1858.75,-684222,-681707,42.517116025001116,40.429444786677884,36.84243034261892,NaN,NaN,50
1678275000,1.0536,1.05399,1.05342,1.05379,1636,1854.35,-682586,-682276,41.70368904766716,42.339350345851,37.83076116569857,NaN,NaN,50
1678276800,1.05379,1.05422,1.05368,1.05398,1606,1870.6,-680980,-681991.6,40.3522449637824,44.263781711761546,39.066064950642385,NaN,NaN,50
1678278600,1.05398,1.05492,1.05388,1.05468,1943,1883.15,-679037,-681785.8,37.583612513633646,50.78129864992089,40.78639938863835,NaN,NaN,50
1678280400,1.05468,1.05492,1.05369,1.05388,4662,2028.2,-683699,-682104.8,35.350339964561705,44.3923495014803,41.929602506296895,NaN,NaN,50
1678282200,1.05388,1.05448,1.05368,1.05412,3989,2186.05,-679710,-681202.4,33.294753641378236,46.56436318007767,42.57929197086828,NaN,NaN,50
1678284000,1.05412,1.05512,1.05412,1.05468,3281,2298.1,-676429,-679971,31.6469916488491,51.34030333300123,43.61271335699091,NaN,NaN,50
1678285800,1.05468,1.05618,1.05468,1.05564,5468,2498.95,-670961,-677967.2,31.524121053725207,58.232181193276155,44.76798398432211,NaN,NaN,50
1678287600,1.05564,1.05702,1.05292,1.0558,10373,2955.85,-660588,-674277.4,29.75013040734595,59.26765942688434,45.898360774253284,NaN,NaN,50
1678289400,1.0558,1.0574,1.0548,1.05528,6805,3230,-667393,-671016.2,27.634211723686242,54.5356287953046,47.12392933093831,NaN,NaN,50
1678291200,1.05528,1.05678,1.055,1.05574,4182,3364.4,-663211,-667716.4,25.669430088859368,57.74930969133514,48.345842399789326,NaN,NaN,50
1678293000,1.05574,1.05574,1.05458,1.05476,3579,3476.1,-666790,-665788.6,24.366248995325513,49.69070826244649,49.203703323413755,NaN,NaN,50
1678294800,1.05476,1.05509,1.05423,1.05458,2540,3478.65,-669330,-665462.4,23.563082798644643,48.35597603809053,49.3376154274717,NaN,NaN,50
1678296600,1.05458,1.05522,1.05422,1.05452,2132,3473.85,-671462,-667637.2,22.62316494727652,47.89416427921672,49.702608513951745,NaN,NaN,50
1678298400,1.05452,1.055,1.05398,1.05432,2956,3468.25,-674418,-669042.2,22.042127707431234,46.306635915483014,50.12240788029497,NaN,NaN,50
1678300200,1.05432,1.05454,1.05398,1.05427,1779,3434.55,-676197,-671639.4,21.502593127574897,45.89704687381384,50.37652906086374,NaN,NaN,50
1678302000,1.05427,1.05496,1.05414,1.05494,1993,3403.85,-674204,-673122.2,20.30904352103249,52.021173983429215,50.93062850884,NaN,NaN,50
1678303800,1.05494,1.05508,1.05439,1.0546,1630,3352.3,-675834,-674423,19.010653872190055,48.99060071905303,50.80272151377801,NaN,NaN,50
1678305600,1.0546,1.0548,1.05412,1.0543,1329,3301.95,-677163,-675563.2,18.210244684698846,46.420885030710835,50.94761690872305,NaN,NaN,50
1678307400,1.0543,1.05502,1.05424,1.05475,1263,3263.2,-675900,-675859.6,17.094270783356365,50.606133775049244,51.23631480836388,NaN,NaN,50
1678309200,1.05475,1.05478,1.05429,1.05452,725,3193.55,-676625,-675945.2,16.05800930353834,48.51997981617655,51.034863128590686,NaN,NaN,50
1678311000,1.05452,1.05452,1.05425,1.05432,497,3136.6,-677122,-676528.8,15.166070272712574,46.71654377330283,50.2123175985926,NaN,NaN,50
1678312800,1.05432,1.05487,1.05432,1.05468,73,3059.95,-677049,-676771.8,14.470839448780934,50.297627245279756,49.57160101419226,NaN,NaN,50
1678314600,1.05468,1.0547,1.05405,1.05437,1349,3030.25,-678398,-677018.8,13.556404427443306,47.34671825730705,49.058107404335296,NaN,NaN,50
1678316400,1.05437,1.05487,1.05437,1.05475,508,2822.55,-677890,-677416.8,12.786079011823986,51.13152484745434,48.585408486915235,NaN,NaN,50
1678318200,1.05475,1.055,1.05458,1.05492,569,2651.55,-677321,-677556,12.311906225408343,52.76725420320623,48.80516176839807,NaN,NaN,50
1678320000,1.05492,1.05535,1.05484,1.0551,946,2534.8,-676375,-677406.6,12.484737598318372,54.50372224021655,49.24428649712136,NaN,NaN,50
1678321800,1.0551,1.05511,1.05444,1.0547,1444,2333.6,-677819,-677560.6,11.81605377446721,50.09614364253594,49.40157073735844,NaN,NaN,50
1678323600,1.0547,1.05488,1.05432,1.05462,1072,1868.55,-678891,-677659.2,10.982126558549886,49.23852615763918,49.610991468941016,NaN,NaN,50
1678325400,1.05462,1.05463,1.05381,1.05406,1419,1599.25,-680310,-678143.2,11.110373457406594,43.61041950289094,49.44766094244653,NaN,NaN,50
1678327200,1.05406,1.05436,1.05394,1.05436,1148,1447.55,-679162,-678511.4,11.22945986348782,47.09892704109855,49.09607187513719,NaN,NaN,50
1678329000,1.05436,1.05488,1.0543,1.05454,858,1311.5,-678304,-678897.2,10.563190106179727,49.13230807387693,49.10619382905319,NaN,NaN,50
1678330800,1.05454,1.05482,1.05435,1.05475,790,1224,-677514,-678836.2,9.944511045822214,51.475700567900454,49.467252081709596,NaN,NaN,50
1678332600,1.05475,1.05511,1.05474,1.05494,667,1150.75,-676847,-678427.4,9.914118517344143,53.56024846854599,49.67826027410222,NaN,NaN,50
1678334400,1.05494,1.05506,1.05461,1.05496,634,1034.65,-676213,-677608,9.603245863520879,53.78530611040324,50.05435500940413,NaN,NaN,50
1678336200,1.05496,1.05535,1.05478,1.05518,639,977.65,-675574,-676890.4,9.853340785109713,56.29440775321457,50.73848815082639,NaN,NaN,50
1678338000,1.05518,1.05556,1.05498,1.05533,1174,936.7,-674400,-676109.6,10.44949674361054,57.969935010071076,51.286510134025775,NaN,NaN,50
1678339800,1.05533,1.05556,1.0551,1.05526,951,902.75,-675351,-675677,11.003070133647022,56.874161100459,51.96704176567948,NaN,NaN,50
1678341600,1.05526,1.05542,1.05486,1.05494,1180,895.3,-676531,-675613.8,10.908283723824164,52.0321423021288,52.03137158387051,NaN,NaN,50
1678343400,1.05494,1.05548,1.05482,1.05511,1058,885.05,-675473,-675465.8,10.943138699149326,54.26001862127086,52.137997613732274,NaN,NaN,50
1678345200,1.05511,1.05598,1.05494,1.05566,1750,936.3,-673723,-675095.6,11.89930151700445,60.630839062587775,52.57564881533022,NaN,NaN,50
1678347000,1.05566,1.0559,1.05524,1.05564,1581,990.5,-675304,-675276.4,12.787166990727064,60.301924920767384,53.30463319234675,NaN,NaN,50
1678348800,1.05564,1.05572,1.05494,1.0551,2363,1105,-677667,-675739.6,12.792759681855367,52.08596796663192,53.508021892989085,NaN,NaN,50
1678350600,1.0551,1.05634,1.05482,1.05574,2672,1171.15,-674995,-675432.4,13.857724492200377,59.183865833770476,54.620410916623335,NaN,NaN,50
1678352400,1.05574,1.05668,1.05504,1.05668,2074,1249.45,-672921,-674922,15.318471658848164,66.93215012994833,56.037069708684044,NaN,NaN,50
1678354200,1.05668,1.05698,1.0557,1.05586,2416,1341.8,-675337,-675244.8,17.04973176206793,56.802156254998124,56.58491600733556,NaN,NaN,50
1678356000,1.05586,1.05604,1.05534,1.05588,2029,1395.95,-673308,-674845.6,17.724518918126336,56.973202778911904,56.97759473669351,NaN,NaN,50
1678357800,1.05588,1.05688,1.05576,1.05664,1979,1422.7,-671329,-673578,19.35063580322344,62.973028735435896,57.6499361843285,NaN,NaN,50
1678359600,1.05664,1.05814,1.05662,1.05802,2565,1497.35,-668764,-672331.8,21.86037272983333,70.90624921888387,58.87286069207712,NaN,NaN,50
1678361400,1.05802,1.05804,1.05706,1.05711,2197,1536.25,-670961,-671939.8,24.190842733113943,61.54243103525588,59.24771949793722,NaN,NaN,50
1678363200,1.05711,1.0572,1.0565,1.05652,1944,1576.05,-672905,-671453.4,25.16170353005117,56.346857866081464,59.13178541622367,NaN,NaN,50
1678365000,1.05652,1.05658,1.05538,1.05592,1837,1625,-674742,-671740.2,24.204176221198185,51.57807177627364,58.753493321639,NaN,NaN,50
1678366800,1.05592,1.05608,1.05527,1.05586,2700,1720.5,-677442,-672962.8,23.15868082098551,51.11222020084209,58.68778460011852,NaN,NaN,50
1678368600,1.05586,1.05779,1.05575,1.05741,6351,2004.7,-671091,-673428.2,23.783012320067236,60.92959751435189,59.164183092481444,NaN,NaN,50
1678370400,1.05741,1.058,1.05667,1.05713,4288,2187.4,-675379,-674311.8,24.516591621394397,58.63877687348597,59.021892936117034,NaN,NaN,50
1678372200,1.05713,1.05866,1.05664,1.05752,4910,2400.95,-670469,-673824.6,25.653247482090425,60.846885102191436,59.06081866336161,NaN,NaN,50
1678374000,1.05752,1.05858,1.05722,1.05756,4308,2557.65,-666161,-672108.4,26.708713638451027,61.07640481816576,59.70299272418545,NaN,NaN,50
1678375800,1.05756,1.0584,1.05668,1.0569,3556,2687.9,-669717,-670563.4,26.84579512623968,55.31455746135354,59.4266135547271,NaN,NaN,50
1678377600,1.0569,1.05783,1.05638,1.05752,3444,2801.1,-666273,-669599.8,26.53323262610271,59.20768861947907,58.87486630397929,NaN,NaN,50
1678379400,1.05752,1.0584,1.05748,1.05757,2657,2881.05,-663616,-667247.2,26.737073344462374,59.5140263973374,59.06857131414638,NaN,NaN,50
1678381200,1.05757,1.05774,1.05695,1.05762,2374,2912.25,-661242,-665401.8,26.16840811201105,59.83882439563874,59.27325857248401,NaN,NaN,50
1678383000,1.05762,1.05796,1.05749,1.05772,2000,2933.2,-659242,-664018,25.845538433499165,60.52098980086427,59.09811293430033,NaN,NaN,50
1678384800,1.05772,1.05854,1.0573,1.0579,3542,2992.15,-655700,-661214.6,26.056386340138154,61.77944413711989,58.446198285602904,NaN,NaN,50
1678386600,1.0579,1.05903,1.05769,1.05898,2715,2994.3,-652985,-658557,26.642019625559684,68.30724793644238,58.929399492830505,NaN,NaN,50
1678388400,1.05898,1.05913,1.05839,1.05854,3177,3049.45,-656162,-657066.2,27.263624080353484,63.545478609329514,59.4435866887768,NaN,NaN,50
1678390200,1.05854,1.05858,1.05754,1.05758,2433,3050.3,-658595,-656536.8,26.567760718298576,54.60187820654734,59.65957286236778,NaN,NaN,50
1678392000,1.05758,1.05828,1.05724,1.05752,3118,3104.75,-661713,-657031,25.52146891802894,54.089482760865536,59.872234473798024,NaN,NaN,50
1678393800,1.05752,1.05816,1.0574,1.05792,3703,3190.95,-658010,-657493,24.549912246349994,56.98740512794628,59.59064930334049,NaN,NaN,50
1678395600,1.05792,1.05808,1.05754,1.05787,1205,3122.95,-659215,-658739,23.647752479790977,56.50725892527128,59.43839802132515,NaN,NaN,50
1678397400,1.05787,1.05824,1.05784,1.05822,547,3040.45,-658668,-659240.2,23.00364963018057,59.10472831045945,59.31395825048715,NaN,NaN,50
1678399200,1.05822,1.05864,1.058,1.05834,574,2971.95,-658094,-659140,22.87213037721815,59.98706025555334,59.23614792458626,NaN,NaN,50
1678401000,1.05834,1.05851,1.05804,1.05824,1000,2930.1,-659094,-658616.2,22.75000535661019,58.84762080484526,59.488509591978534,NaN,NaN,50
1678402800,1.05824,1.05834,1.05788,1.05816,673,2828.75,-659767,-658967.6,22.33993755489636,57.90010235657897,59.39511057319994,NaN,NaN,50
1678404600,1.05816,1.05856,1.05813,1.05856,920,2557.2,-658847,-658894,22.245521942928193,61.258911109562156,59.51974519550172,NaN,NaN,50
1678406400,1.05856,1.05968,1.05856,1.05956,1851,2435.35,-656996,-658559.6,23.33913405300338,68.10901115004377,60.11047282081637,NaN,NaN,50
1678408200,1.05956,1.05994,1.05945,1.05988,1580,2268.85,-655416,-658024,24.576500575268643,69.9406479774812,60.78330554771758,NaN,NaN,50
1678410000,1.05988,1.05993,1.05893,1.05944,1914,2149.15,-657330,-657671.2,24.753189972153596,64.45863723335958,60.974676483163265,NaN,NaN,50
1678411800,1.05944,1.0596,1.05918,1.05946,2027,2072.7,-655303,-656778.4,24.91725869783248,64.59448208536892,60.709478922372305,NaN,NaN,50
1678413600,1.05946,1.0596,1.0582,1.0582,2509,2025.95,-657812,-656571.4,23.485230972732634,51.29318462901085,59.83431506663526,NaN,NaN,50
1678415400,1.0582,1.05948,1.05794,1.05896,4633,2124.75,-653179,-655808,21.815832680490306,57.03957218965674,60.00843606542879,NaN,NaN,50
1678417200,1.05896,1.0596,1.05854,1.0594,1848,2098.45,-651331,-654991,20.41441793120974,59.9831267986897,60.42941063955909,NaN,NaN,50
1678419000,1.0594,1.05984,1.05926,1.05968,1327,2064.8,-650004,-653525.8,19.443809094052842,61.77789410339843,60.771588423519965,NaN,NaN,50
1678420800,1.05968,1.05976,1.05932,1.05976,1764,1975.9,-648240,-652113.2,18.542529459550003,62.29818224435771,61.18522580345471,NaN,NaN,50
1678422600,1.05976,1.05986,1.05944,1.05948,1589,1919.6,-649829,-650516.6,17.85446522941419,59.2578041312021,61.196159790650604,NaN,NaN,50
1678424400,1.05948,1.05952,1.05863,1.0588,1407,1831.1,-651236,-650128,17.212609602820535,52.55027208361657,60.664960635512266,NaN,NaN,50
1678426200,1.0588,1.059,1.05859,1.05866,1789,1798.9,-653025,-650466.8,16.672623728022078,51.26370915128362,60.12325266025787,NaN,NaN,50
1678428000,1.05866,1.05902,1.05858,1.05898,1550,1720.5,-651475,-650761,16.135078633293983,54.03384380442091,59.84709133510371,NaN,NaN,50
1678429800,1.05898,1.05909,1.05812,1.05836,1988,1634.75,-653463,-651805.6,16.301371551330764,48.30500110593967,58.92181204913067,NaN,NaN,50
1678431600,1.05836,1.05964,1.05836,1.05947,4074,1778.2,-649389,-651717.6,15.46886173989627,57.078819913389204,58.1339412465125,NaN,NaN,50
1678433400,1.05947,1.0607,1.05906,1.05948,3230,1912.35,-646159,-650702.2,15.4888793944763,57.14937997411047,57.22027924627173,NaN,NaN,50
1678435200,1.05948,1.0598,1.0574,1.05806,5077,2137.5,-651236,-650344.4,15.302900718987367,45.66846007085046,55.87812373466393,NaN,NaN,50
1678437000,1.05806,1.05992,1.05782,1.05916,4057,2290.35,-647179,-649485.2,14.9778532301337,53.4670298465407,55.08330571760477,NaN,NaN,50
1678438800,1.05916,1.05989,1.05846,1.05886,3321,2422.75,-650500,-648892.6,14.676023419055298,51.30416766504749,55.08409022017882,NaN,NaN,50
1678440600,1.05886,1.05984,1.058,1.05814,3757,2564.6,-654257,-649866.2,14.889753431986467,46.44787792769086,54.3275406300384,NaN,NaN,50
1678442400,1.05814,1.05994,1.05779,1.05992,3208,2632.45,-651049,-650844.2,15.30404372262458,57.227207248639,54.1306892336062,NaN,NaN,50
1678444200,1.05992,1.06039,1.05858,1.05878,2903,2698.6,-653952,-651387.4,15.015641533256533,50.25086004325983,53.307329657882015,NaN,NaN,50
1678446000,1.05878,1.05972,1.05866,1.05968,2417,2723.75,-651535,-652258.6,14.747839500271917,54.92287364163655,52.780521900544784,NaN,NaN,50
1678447800,1.05968,1.06021,1.05868,1.05896,2573,2751.05,-654108,-652980.2,13.785844536530078,50.81177797539751,52.17723431798731,NaN,NaN,50
1678449600,1.05896,1.05896,1.05807,1.05879,2943,2772.75,-657051,-653539,13.64991935769336,49.86274431441597,51.9852680487587,NaN,NaN,50
1678451400,1.05879,1.05986,1.05868,1.05944,3105,2696.35,-653946,-654118.4,12.991148507058098,53.443285457593824,52.14095207063799,NaN,NaN,50
1678453200,1.05944,1.0596,1.05818,1.05912,5236,2865.75,-659182,-655164.4,12.345358801073763,51.49360814259691,51.95950666622199,NaN,NaN,50
1678455000,1.05912,1.06442,1.05906,1.06217,12972,3448,-646210,-654099.4,14.555254653268918,64.7087355194688,53.13120198147412,NaN,NaN,50
1678456800,1.06217,1.06496,1.06122,1.06488,10828,3901.2,-635382,-650354.2,16.81785310642317,72.00641836698358,54.19745901387372,NaN,NaN,50
1678458600,1.06488,1.06748,1.06438,1.0667,12044,4423.95,-623338,-643611.6,19.714241804627417,75.64835839403742,55.518814615297075,NaN,NaN,50
1678460400,1.0667,1.06878,1.0667,1.06872,9525,4829.85,-613813,-635585,22.717965791514267,78.92550691464128,57.89431796128213,NaN,NaN,50
1678462200,1.06872,1.0701,1.06818,1.06874,8207,5150.75,-605606,-624869.8,25.78403750862054,78.955704039257,59.71493754647615,NaN,NaN,50
1678464000,1.06874,1.06875,1.06629,1.06656,6587,5402.6,-612193,-618066.4,27.031414620136847,67.58763089970951,60.87804206323772,NaN,NaN,50
1678465800,1.06656,1.06712,1.06552,1.06588,7520,5679.2,-619713,-614932.6,27.61671868444348,64.46949719131987,62.16530058206837,NaN,NaN,50
1678467600,1.06588,1.06658,1.06557,1.06628,4542,5702.6,-615171,-613299.2,28.160215315585358,65.47841096405907,62.754672276026945,NaN,NaN,50
1678469400,1.06628,1.0674,1.06557,1.06686,4169,5749.55,-611002,-612737,28.964186619046373,66.94414049138811,63.947049450893246,NaN,NaN,50
1678471200,1.06686,1.06727,1.06498,1.06536,3460,5668.7,-614462,-614508.2,29.23540499014758,59.86494952028206,64.3000548707965,NaN,NaN,50
1678473000,1.06536,1.0655,1.06397,1.0643,3600,5645.85,-618062,-615682,28.720281208472358,55.40605140970973,64.62821725896166,NaN,NaN,50
1678474800,1.0643,1.06518,1.06374,1.06402,4073,5683.45,-622135,-616166.4,28.07243540462246,54.25646072080327,64.94205414513218,NaN,NaN,50
1678476600,1.06402,1.06454,1.0636,1.06436,4819,5736.55,-617316,-616595.4,27.363275916860637,55.46481657739906,65.08644922511827,NaN,NaN,50
1678478400,1.06436,1.06482,1.06388,1.06408,4697,5811,-622013,-618797.6,26.85911709571876,54.19515108448772,65.27941657811047,NaN,NaN,50
1678480200,1.06408,1.06447,1.06368,1.06372,3182,5824.95,-625195,-620944.2,26.219945628196196,52.53016854897049,64.40951893736059,NaN,NaN,50
1678482000,1.06372,1.06417,1.06372,1.0638,1087,5758.45,-624108,-622153.4,25.626429265496668,52.8766322506385,63.043105643335934,NaN,NaN,50
1678483800,1.0638,1.06406,1.06368,1.06386,933,5676.45,-623175,-622361.4,25.03660562810954,53.152797898853976,61.43627989367997,NaN,NaN,50
1678654800,1.06386,1.0687,1.06386,1.06856,389,5548.75,-622786,-623455.4,26.641408623339597,68.6511671335162,60.702398480742474,NaN,NaN,50
1678656600,1.06856,1.0698,1.06807,1.06974,326,5409.8,-622460,-623544.8,28.450973876802426,71.22503355279358,60.15020773170937,NaN,NaN,50
1678658400,1.06974,1.07041,1.06833,1.06914,1340,5215,-623800,-623265.8,30.29733235977585,68.16058818515441,60.19113325209829,NaN,NaN,50
1678660200,1.06914,1.06969,1.06787,1.06943,1115,4622.15,-622685,-622981.2,31.594936662893165,68.85801233228045,60.50459861930977,NaN,NaN,50
1678662000,1.06943,1.07028,1.0685,1.0694,5458,4353.65,-628143,-623974.8,32.98262740359452,68.6903884648733,60.73402558365364,NaN,NaN,50
1678663800,1.0694,1.06995,1.06778,1.06812,3664,3934.65,-631807,-625779,33.61042296735165,61.77999692565103,60.36515818610099,NaN,NaN,50
1678665600,1.06812,1.06984,1.06764,1.0698,5207,3718.75,-626600,-626607,34.06512934288759,66.53817126030594,60.84181688181697,NaN,NaN,50
1678667400,1.0698,1.06982,1.06812,1.06817,3510,3483.9,-630110,-627869,34.48735669159952,58.87913603017392,61.08989435470727,NaN,NaN,50
1678669200,1.06817,1.06874,1.06741,1.06778,3130,3311.05,-633240,-629980,34.18630388490486,57.18310942816903,61.29894069094768,NaN,NaN,50
1678671000,1.06778,1.06779,1.0664,1.06686,3516,3110.85,-636756,-631702.6,33.01340578845105,53.28391190116534,61.143161785502414,NaN,NaN,50
1678672800,1.06686,1.06997,1.06682,1.06976,3781,3072.8,-632975,-631936.2,32.99594731842138,62.06490275599375,61.70528690489571,NaN,NaN,50
1678674600,1.06976,1.07316,1.06976,1.07303,5497,3139.2,-627478,-632111.8,34.052101518852844,69.11452411844601,62.88988373128682,NaN,NaN,50
1678676400,1.07303,1.0737,1.07218,1.07228,3624,3147.4,-631102,-632310.2,35.178714722335464,66.08132095800283,63.833075781812845,NaN,NaN,50
1678678200,1.07228,1.07298,1.07166,1.07172,3067,3120.75,-634169,-632496,35.80765961699934,63.82884276380372,64.59565041502354,NaN,NaN,50
1678680000,1.07172,1.07258,1.07172,1.07245,2076,3020.9,-632093,-631563.4,36.39167987633008,65.48066684555252,64.36918610874042,NaN,NaN,50
1678681800,1.07245,1.07246,1.07164,1.07178,1773,2868.6,-633866,-631741.6,36.862942202747035,62.65267823253256,63.75687501443607,NaN,NaN,50
1678683600,1.07178,1.07266,1.07171,1.07222,1785,2723,-632081,-632662.2,37.374892834685866,63.75960785175693,63.44251927633625,NaN,NaN,50
1678685400,1.07222,1.07256,1.07172,1.07202,1953,2661.55,-634034,-633248.6,37.850275564343356,62.847780754181244,63.01321702075773,NaN,NaN,50
1678687200,1.07202,1.07298,1.07174,1.07196,2353,2724.85,-636387,-633692.2,38.46190709474529,62.558738869543866,62.57524204966277,NaN,NaN,50
1678689000,1.07196,1.07286,1.07132,1.07214,2534,2804.9,-633853,-634044.2,38.57137756581487,63.10691701888006,62.670022056321976,NaN,NaN,50
1678690800,1.07214,1.07258,1.07158,1.0724,4707,3020.8,-629146,-633100.2,38.673028717522335,63.92844367309042,62.48361294294944,NaN,NaN,50
1678692600,1.0724,1.07373,1.07213,1.07254,4307,3219.85,-624839,-631651.8,39.29118585544428,64.38828601436123,62.87712365610569,NaN,NaN,50
1678694400,1.07254,1.0729,1.0714,1.07146,5368,3421.25,-630207,-630886.4,39.053862930617825,58.22215489431484,62.951341189401816,NaN,NaN,50
1678696200,1.07146,1.07154,1.07041,1.07076,5230,3627,-635437,-630696.4,37.85059181724716,54.57417813324817,63.04350306312201,NaN,NaN,50
1678698000,1.07076,1.07076,1.06662,1.06706,8069,3757.55,-643506,-632627,36.130581757595195,40.22691939531844,61.483647108788055,NaN,NaN,50
1678699800,1.06706,1.06942,1.06625,1.06706,11264,4137.55,-643506,-635499,34.71834797882323,40.22691939531843,59.42024677142181,NaN,NaN,50
1678701600,1.06706,1.0681,1.06602,1.0665,7572,4255.8,-651078,-640746.8,33.52469723166977,38.45247773472188,57.446757969758885,NaN,NaN,50
1678703400,1.0665,1.06771,1.06602,1.0674,6073,4383.95,-645005,-643706.4,32.41630725217012,42.818067703545815,55.9459883225976,NaN,NaN,50
1678705200,1.0674,1.06768,1.06574,1.06602,5809,4517.9,-650814,-646781.8,31.545596198986104,38.32876902353139,54.00656704959609,NaN,NaN,50
1678707000,1.06602,1.06768,1.0658,1.06642,7553,4719.75,-643261,-646732.8,30.737078792458085,40.283170431841945,52.408745063832484,NaN,NaN,50
1678708800,1.06642,1.06782,1.06504,1.06687,11811,5121.25,-631450,-644321.6,30.43366697397229,42.49118911232715,50.88957229673036,NaN,NaN,50
1678710600,1.06687,1.0698,1.06687,1.06966,11911,5441.95,-619539,-638013.8,28.521031758483634,53.87775602227303,50.2488562444512,NaN,NaN,50
1678712400,1.06966,1.07212,1.06854,1.07037,8735,5697.5,-610804,-631173.6,27.596211081879563,56.25163757111893,49.79834900884942,NaN,NaN,50
1678714200,1.07037,1.07126,1.06931,1.06994,8552,5971.75,-619356,-624882,26.737449025032927,54.42463592432565,49.1781860735241,NaN,NaN,50
1678716000,1.06994,1.07246,1.06968,1.06978,8999,6317.9,-628355,-621900.8,26.543940937695297,53.72540650972305,48.44939770471215,NaN,NaN,50
1678717800,1.06978,1.07282,1.06978,1.07228,8708,6664.65,-619647,-619540.2,26.534323896588642,61.951075855123285,48.27531126476658,NaN,NaN,50
1678719600,1.07228,1.07336,1.07149,1.07323,7400,6945.4,-612247,-618081.8,26.778687346202634,64.5312155511217,48.72595845453849,NaN,NaN,50
1678721400,1.07323,1.07334,1.07117,1.07334,7530,7224.25,-604717,-616864.4,26.728658354622723,64.82861765751878,49.45841842055783,NaN,NaN,50
1678723200,1.07334,1.07384,1.07228,1.07378,6512,7432.2,-598205,-612634.2,26.9346043861371,66.05470660234289,51.30326036391671,NaN,NaN,50
1678725000,1.07378,1.07426,1.07297,1.07396,5644,7587.7,-592561,-605475.4,27.33424002494923,66.5681556899757,53.18477724210652,NaN,NaN,50
1678726800,1.07396,1.07486,1.07332,1.07458,4107,7557.7,-588454,-599236.8,27.99423294130165,68.34428203231771,55.31990612050622,NaN,NaN,50
1678728600,1.07458,1.07468,1.07382,1.07384,3856,7535.15,-592310,-595249.4,28.607083506486042,63.975579616932286,56.8311569714624,NaN,NaN,50
1678730400,1.07384,1.07428,1.07294,1.07344,4530,7493.25,-596840,-593674,28.27347095264741,61.680431920259785,58.49913289265728,NaN,NaN,50
1678732200,1.07344,1.07414,1.07317,1.07339,4258,7444.65,-601098,-594252.6,27.963687866940113,61.38398551515768,60.00633397003698,NaN,NaN,50
1678734000,1.07339,1.0735,1.07212,1.07258,5458,7314.1,-606556,-597051.6,26.67114602815172,56.63517615249947,61.01661875862072,NaN,NaN,50
1678735800,1.07258,1.0735,1.07258,1.07298,5096,7005.7,-601460,-599652.8,25.470928606419648,58.348805038661666,61.335979402648476,NaN,NaN,50
1678737600,1.07298,1.07318,1.07259,1.0729,1666,6710.4,-603126,-601816,24.356441000525578,57.85637438303938,61.450603460642796,NaN,NaN,50
1678739400,1.0729,1.07334,1.07288,1.07316,1041,6458.8,-602085,-602865,23.457703599088493,59.06549791022892,61.78209360249303,NaN,NaN,50
1678741200,1.07316,1.07316,1.07274,1.0729,547,6195.7,-602632,-603171.8,22.467176041603864,57.29521841422357,62.03708016710021,NaN,NaN,50
1678743000,1.0729,1.07347,1.0728,1.07293,344,5835.25,-602288,-602318.2,21.834875612448187,57.453672208007575,61.715837049449085,NaN,NaN,50
1678744800,1.07293,1.07308,1.0727,1.07306,1976,5343.5,-600312,-602088.6,21.1241506824043,58.177840281295246,61.262024530175765,NaN,NaN,50
1678746600,1.07306,1.07306,1.07252,1.07274,1475,4821.7,-601787,-601820.8,20.235033057912126,55.66618485086619,60.6075650439863,NaN,NaN,50
1678748400,1.07274,1.07292,1.07228,1.07286,1050,4437.45,-600737,-601551.2,19.102449788106053,56.42589321610445,59.91979265925498,NaN,NaN,50
1678750200,1.07286,1.07292,1.07227,1.07229,1060,4062.85,-601797,-601384.2,18.037558995737097,51.87835562962869,58.87052122637306,NaN,NaN,50
1678752000,1.07229,1.0724,1.07114,1.07186,2485,3737.15,-604282,-601783,17.76936784117977,48.69035031218575,57.46666896064935,NaN,NaN,50
1678753800,1.07186,1.07226,1.07153,1.07191,2456,3424.55,-601826,-602085.8,17.520333197662254,49.082172417143795,56.402854160664454,NaN,NaN,50
1678755600,1.07191,1.07212,1.07082,1.07114,2630,3186.05,-604456,-602619.6,17.989727226635946,43.564814509328635,55.10888148845508,NaN,NaN,50
1678757400,1.07114,1.07132,1.07052,1.07084,2910,2955.05,-607366,-603945.4,18.693953402346466,41.60261473893922,53.695926433010904,NaN,NaN,50
1678759200,1.07084,1.0713,1.07058,1.07076,2271,2743,-609637,-605513.4,19.347877708363377,41.07136358209063,52.58422553512456,NaN,NaN,50
1678761000,1.07076,1.07092,1.06989,1.0701,2329,2577.25,-611966,-607050.2,20.556148049904284,36.88646506250518,51.051201251113376,NaN,NaN,50
1678762800,1.0701,1.07072,1.06996,1.07012,1769,2460.35,-610197,-608724.4,21.678113367049416,37.09563407298933,49.56829122896694,NaN,NaN,50
1678764600,1.07012,1.07062,1.07012,1.0703,1882,2361.65,-608315,-609496.2,22.719938304398465,39.053359584367286,48.13885277711968,NaN,NaN,50
1678766400,1.0703,1.0707,1.07024,1.0705,1238,2197.05,-607077,-609438.4,23.525698266776455,41.24154225001808,46.99216162253358,NaN,NaN,50
1678768200,1.0705,1.0705,1.06982,1.07026,1302,2049.25,-608379,-609186.8,24.678572342812682,39.41286228124353,45.70353234205043,NaN,NaN,50
1678770000,1.07026,1.0705,1.06984,1.06986,1371,1844.9,-609750,-608743.6,25.749098270560612,36.50738819141184,44.155642907058755,NaN,NaN,50
1678771800,1.06986,1.07083,1.06972,1.07076,1512,1665.7,-608238,-608351.8,26.019428959739287,46.13000455122071,43.47448717136979,NaN,NaN,50
1678773600,1.07076,1.07156,1.06942,1.07011,5152,1840,-613390,-609366.8,24.907033315670365,41.26576043576352,42.391620544202574,NaN,NaN,50
1678775400,1.07011,1.07012,1.06934,1.06974,2935,1934.7,-616325,-611216.4,23.983438579988423,38.760275636036084,41.45461483037453,NaN,NaN,50
1678777200,1.06974,1.0702,1.06822,1.06835,5200,2167.35,-621525,-613845.6,24.414170103601634,31.11674740874946,40.19935748012909,NaN,NaN,50
1678779000,1.06835,1.069,1.0679,1.06898,4604,2380.35,-616921,-615279.8,25.11062795996774,37.16486214965144,39.348121032451054,NaN,NaN,50
1678780800,1.06898,1.07011,1.06878,1.06989,6073,2585.2,-610848,-615801.8,24.019207145860786,44.71567817058524,39.43032557968367,NaN,NaN,50
1678782600,1.06989,1.07074,1.06832,1.07064,5265,2774.7,-605583,-614240.4,22.384263589818545,50.04392327748312,40.03327618957967,NaN,NaN,50
1678784400,1.07064,1.07068,1.06912,1.07,4398,2942.1,-609981,-612971.6,20.86610171635075,45.97217730663313,40.38333431276127,NaN,NaN,50
1678786200,1.07,1.07134,1.06984,1.07112,4389,3108.55,-605592,-609785,20.22007826385795,53.15528903187745,41.54539316771643,NaN,NaN,50
1678788000,1.07112,1.07144,1.07006,1.07136,3544,3161.5,-602048,-606810.4,19.72940949270596,54.54975925786395,42.79211639520748,NaN,NaN,50
1678789800,1.07136,1.0721,1.07099,1.07204,3527,3215.05,-598521,-604345,19.952870076324743,58.33427231251403,44.16932444721796,NaN,NaN,50
1678791600,1.07204,1.07232,1.07126,1.07203,3937,3280.4,-602458,-603720,20.369171349049843,58.257447582360335,45.38474625667097,NaN,NaN,50
1678793400,1.07203,1.07283,1.07165,1.0722,3742,3322,-598716,-601467,21.213914086589753,59.240197319815145,46.80098447371181,NaN,NaN,50
1678795200,1.0722,1.07316,1.07188,1.07268,6486,3532.75,-592230,-598794.6,22.273428776107384,61.96318150394481,48.619255424607026,NaN,NaN,50
1678797000,1.07268,1.0749,1.07,1.07356,15332,4182.9,-576898,-593764.6,20.745865609690508,66.39555086967741,50.06679444735393,NaN,NaN,50
1678798800,1.07356,1.07436,1.07233,1.07296,8108,4499.85,-585006,-591061.6,19.327414098017698,61.162330233176824,51.48797800431202,NaN,NaN,50
1678800600,1.07296,1.07316,1.06979,1.07082,9145,4863,-594151,-589400.2,19.960546841115903,46.94880472784139,52.07287293944098,NaN,NaN,50
1678802400,1.07082,1.07298,1.07053,1.07208,7458,5174,-586693,-586995.6,20.548455816849952,53.7621018558108,53.69039825708821,NaN,NaN,50
1678804200,1.07208,1.07296,1.07152,1.07178,5708,5394.3,-592401,-587029.8,21.094371294317284,52.048133847440354,54.753489092644564,NaN,NaN,50
1678806000,1.07178,1.07298,1.07142,1.07272,4590,5555.25,-587811,-589212.4,21.672972594764534,56.705597794926675,55.609911922954666,NaN,NaN,50
1678807800,1.07272,1.07316,1.07198,1.07212,4480,5703.65,-592291,-590669.4,21.966849325850397,53.15657292865824,55.83224404089575,NaN,NaN,50
1678809600,1.07212,1.07258,1.07148,1.07174,4079,5650,-596370,-591113.2,22.627391917720878,50.98035206785171,56.18997080955422,NaN,NaN,50
1678811400,1.07174,1.072,1.07104,1.07174,4454,5725.95,-596370,-593048.6,23.559196221836217,50.98035206785171,56.034618169266665,NaN,NaN,50
1678813200,1.07174,1.07369,1.07173,1.0728,5705,5751.2,-590665,-592701.4,22.37566160528443,56.713464497448754,56.189168543522726,NaN,NaN,50
1678815000,1.0728,1.0743,1.07275,1.0733,4814,5761.7,-585851,-592309.4,20.858463822008773,59.1409537628944,56.24678864712133,NaN,NaN,50
1678816800,1.0733,1.07454,1.0732,1.07446,4614,5688.75,-581237,-590098.6,19.66977160922498,64.16227079165569,56.668561733499565,NaN,NaN,50
1678818600,1.07446,1.07496,1.07384,1.07416,4028,5626.9,-585265,-587877.6,18.94561914211202,62.03882617534397,56.868463794608765,NaN,NaN,50
1678820400,1.07416,1.07434,1.0734,1.07357,3698,5591.9,-588963,-586396.2,17.812265496007495,57.97515488905072,56.583604750687755,NaN,NaN,50
1678822200,1.07357,1.07423,1.0735,1.07416,2719,5508.4,-586244,-585512,16.75986568176758,60.744280303692854,56.179942567403145,NaN,NaN,50
1678824000,1.07416,1.07424,1.07334,1.07361,846,5373.5,-587090,-585759.8,15.604137036920823,56.97534380856198,55.88087210850208,NaN,NaN,50
1678825800,1.07361,1.07362,1.07322,1.07333,801,5237.2,-587891,-587090.6,14.58612742137902,55.1009846447383,56.46317067399472,NaN,NaN,50
1678827600,1.07333,1.07382,1.0733,1.07332,84,5044.55,-587975,-587632.6,13.688925203844338,55.0313536327935,56.55383151520777,NaN,NaN,50
1678829400,1.07332,1.07332,1.07311,1.07324,131,4864,-588106,-587461.2,12.806732424511388,54.43866650394209,56.72458384781504,NaN,NaN,50
1678831200,1.07324,1.07358,1.07318,1.07346,1042,4591.8,-587064,-587625.2,12.131755071067364,55.84696036078408,56.663252602519144,NaN,NaN,50
1678833000,1.07346,1.07356,1.07313,1.0732,1250,3887.7,-588314,-587870,11.434823242890852,53.73311025269138,56.70443383995007,NaN,NaN,50
1678834800,1.0732,1.07342,1.07304,1.07307,753,3519.95,-589067,-588105.2,10.655385912002197,52.65984053593913,56.824397301956324,NaN,NaN,50
1678836600,1.07307,1.07308,1.07253,1.0727,788,3102.1,-589855,-588481.2,10.570822619204554,49.621873163462084,56.72736309449992,NaN,NaN,50
1678838400,1.0727,1.07336,1.07254,1.07298,2184,2838.4,-587671,-588394.2,10.058167103297714,51.88408517342858,56.38240742849848,NaN,NaN,50
1678840200,1.07298,1.07368,1.07284,1.0734,1927,2649.35,-585744,-588130.2,9.569696629460804,55.138277210788296,56.096501960490905,NaN,NaN,50
1678842000,1.0734,1.07365,1.07314,1.0733,1711,2505.4,-587455,-587958.4,9.116116903755103,54.198389001864335,55.38479611836294,NaN,NaN,50
1678843800,1.0733,1.07395,1.07313,1.07383,1534,2358.1,-585921,-587329.2,9.144426655564732,58.25946888746558,55.114842026371626,NaN,NaN,50
1678845600,1.07383,1.07589,1.07378,1.07536,2573,2282.8,-583348,-586027.8,11.185251390163618,67.27905910110573,55.77940661294699,NaN,NaN,50
1678847400,1.07536,1.076,1.07534,1.07562,2085,2164.35,-581263,-584746.2,13.163393330084523,68.52379661722378,56.335086349627765,NaN,NaN,50
1678849200,1.07562,1.07574,1.07526,1.07536,1355,1946.85,-582618,-584121,14.857222751615032,65.82704445552358,56.96735068155359,NaN,NaN,50
1678851000,1.07536,1.07552,1.07495,1.0751,1465,1779.4,-584083,-583446.6,15.87523003206118,63.150579024576665,57.5423217086849,NaN,NaN,50
1678852800,1.0751,1.0754,1.07497,1.07512,1134,1605.4,-582949,-582852.2,16.820522506761176,63.27427880994187,58.13110207848122,NaN,NaN,50
1678854600,1.07512,1.07524,1.0743,1.07448,1030,1455.5,-583979,-582978.4,16.5498420651103,56.713445925998506,58.29358632291383,NaN,NaN,50
1678856400,1.07448,1.07464,1.07387,1.0739,1420,1341.6,-585399,-583805.6,15.65865423450001,51.50166944375928,57.9832084002692,NaN,NaN,50
1678858200,1.0739,1.07412,1.0736,1.07382,1639,1287.6,-587038,-584689.6,14.627348821940808,50.808116659431384,57.77428028646492,NaN,NaN,50
1678860000,1.07382,1.07414,1.07306,1.07332,1890,1339.8,-588928,-585658.6,14.366362160493482,46.58557116190795,57.340403902605544,NaN,NaN,50
1678861800,1.07332,1.07409,1.07318,1.07342,1854,1392.45,-587074,-586483.6,14.124017403435248,47.52488202192962,57.19061882106751,NaN,NaN,50
1678863600,1.07342,1.0745,1.07305,1.07378,3494,1562.95,-583580,-586403.8,13.264935585749104,50.874136422852615,57.118479624597796,NaN,NaN,50
1678865400,1.07378,1.07392,1.07277,1.07376,3622,1737.5,-587202,-586764.4,12.855753437859788,50.680606246382936,56.8000745557117,NaN,NaN,50
1678867200,1.07376,1.07437,1.07268,1.07336,4019,1886.35,-591221,-587601,12.073009916657588,46.842586630463394,56.274660100611634,NaN,NaN,50
1678869000,1.07336,1.07379,1.073,1.07316,3208,1984.25,-594429,-588701.2,11.346176646969832,45.00730350884265,55.32807685928142,NaN,NaN,50
1678870800,1.07316,1.0733,1.07076,1.07098,3842,2138.7,-598271,-590940.6,12.847099592368858,30.82880875392928,52.72448754876881,NaN,NaN,50
1678872600,1.07098,1.07104,1.06658,1.0678,8482,2523.4,-606753,-595575.2,16.188873415445972,20.622892184059097,49.302994374971334,NaN,NaN,50
1678874400,1.0678,1.06846,1.06649,1.06649,6612,2744.8,-613365,-600807.8,19.318657043085768,17.981939282513963,45.88548686261351,NaN,NaN,50
1678876200,1.06649,1.06678,1.06198,1.06272,7039,3000.4,-620404,-606644.4,23.176949787393582,12.872874934055929,42.294222284719176,NaN,NaN,50
1678878000,1.06272,1.06296,1.05854,1.06009,6684,3249.05,-627088,-613176.2,27.16900112792931,10.608458882250446,38.53237800416979,NaN,NaN,50
1678879800,1.06009,1.06082,1.05805,1.05876,6222,3483.45,-633310,-620184,30.923630787375295,9.681025712632675,35.1729194175008,NaN,NaN,50
1678881600,1.05876,1.05894,1.0562,1.05744,7457,3727.65,-640767,-626986.8,34.57634791464787,8.853725120850129,32.12663768015015,NaN,NaN,50
1678883400,1.05744,1.05951,1.05525,1.05564,9906,4118.7,-650673,-634448.4,38.044686034126414,7.866519050080868,29.05938070805368,NaN,NaN,50
1678885200,1.05564,1.05587,1.05224,1.05232,9397,4520.8,-660070,-642381.6,41.46925063591088,6.440160430078279,26.19185137006585,NaN,NaN,50
1678887000,1.05232,1.05543,1.05228,1.05452,9946,4944.85,-650124,-646988.8,44.64920348042503,17.159283546036235,24.02288005035918,NaN,NaN,50
1678888800,1.05452,1.0565,1.05296,1.05556,9816,5378.95,-640308,-648388.4,46.73527160120749,21.724794101292233,21.940784170247728,NaN,NaN,50
1678890600,1.05556,1.05618,1.05294,1.05472,7159,5685.4,-647467,-649728.4,48.67478430702876,20.73100006103425,19.801526585579968,NaN,NaN,50
1678892400,1.05472,1.05504,1.05301,1.0534,6582,5943.5,-654049,-650403.6,50.475760391005664,19.241441276436603,17.83001620314948,NaN,NaN,50
1678894200,1.0534,1.0535,1.05161,1.05338,5969,6160,-660018,-650393.2,52.32757827797503,19.21890890663279,15.987988017277347,NaN,NaN,50
1678896000,1.05338,1.05432,1.05276,1.05416,5527,6341.85,-654491,-651266.6,53.326065768348904,23.005748110609062,15.429197971325904,NaN,NaN,50
1678897800,1.05416,1.05504,1.05372,1.05422,4745,6486.4,-649746,-653154.2,53.64342394448992,23.303588455148102,15.620676276403687,NaN,NaN,50
1678899600,1.05422,1.056,1.05422,1.05587,5599,6591.65,-644147,-652490.2,53.16446756565887,31.186981957648925,16.563893610341896,NaN,NaN,50
1678901400,1.05587,1.05628,1.05512,1.05568,4415,6631.3,-648562,-651392.8,52.49817795489133,30.79445898516626,17.844006756849783,NaN,NaN,50
1678903200,1.05568,1.05899,1.05472,1.05784,5265,6693.6,-643297,-648048.6,50.026689224059076,40.03457602364066,19.945872266949085,NaN,NaN,50
1678905000,1.05784,1.05904,1.05721,1.05857,9293,6997.85,-634004,-643951.2,47.70166815673625,42.81354422707861,22.312480732266653,NaN,NaN,50
1678906800,1.05857,1.05926,1.05749,1.05864,8332,7222.35,-625672,-639136.4,45.403118038736494,43.085916115520234,24.757637231885944,NaN,NaN,50
1678908600,1.05864,1.05882,1.05745,1.05804,5059,7051.2,-630731,-636453.2,43.28834277413603,41.27141854620424,27.143701481609043,NaN,NaN,50
1678910400,1.05804,1.05834,1.05763,1.05764,1409,6791.05,-632140,-633168.8,41.32462288557845,40.06018623565098,29.545131896292805,NaN,NaN,50
1678912200,1.05764,1.05782,1.05741,1.05756,1546,6516.4,-633686,-631246.6,39.62321116702564,39.80855235525494,31.162936811237,NaN,NaN,50
1678914000,1.05756,1.05784,1.05756,1.05778,431,6203.75,-633255,-631096.8,38.026688388874156,40.90782023548996,32.5331529636797,NaN,NaN,50
1678915800,1.05778,1.05782,1.05761,1.05782,170,5901.15,-633085,-632579.4,36.54420295201922,41.11837763652306,33.989394219071755,NaN,NaN,50
1678917600,1.05782,1.05812,1.05745,1.05784,1681,5612.35,-631404,-632714,34.88833063988018,41.23113437276079,35.56008658309491,NaN,NaN,50
1678919400,1.05784,1.05818,1.05772,1.05785,1161,5175.1,-630243,-632334.6,33.29300267256306,41.2916708489544,37.13671243611788,NaN,NaN,50
1678921200,1.05785,1.05889,1.05782,1.05859,1108,4760.65,-629135,-631424.4,31.14199830655811,45.74539048504867,38.76097260572071,NaN,NaN,50
1678923000,1.05859,1.05881,1.05814,1.05817,1550,4340.85,-630685,-630910.4,29.14463710955351,43.718230684264526,40.21916133637188,NaN,NaN,50
1678924800,1.05817,1.05842,1.0573,1.05814,2912,3995.65,-633597,-631012.8,27.999256833524218,43.56971169664022,41.10364203201412,NaN,NaN,50
1678926600,1.05814,1.05981,1.05798,1.05898,4127,3844.05,-629470,-630626,26.31141793574975,48.813197744006835,42.39069480050273,NaN,NaN,50
1678928400,1.05898,1.05992,1.0588,1.05905,4460,3737.95,-625010,-629579.4,24.83292865831741,49.23651185076022,43.047975931011266,NaN,NaN,50
1678930200,1.05905,1.05967,1.05863,1.05939,2809,3579.95,-622201,-628192.6,23.300300699201223,51.341404129839255,43.65710878120846,NaN,NaN,50
1678932000,1.05939,1.0597,1.05874,1.0591,2444,3425.8,-624645,-626984.6,21.904809784579022,49.457685756962036,44.11223518416858,NaN,NaN,50
1678933800,1.0591,1.05953,1.0588,1.05924,2217,3299.4,-622428,-624750.8,20.60899679242984,50.40373111421873,44.76454322474105,NaN,NaN,50
1678935600,1.05924,1.05972,1.05899,1.0597,1682,3103.55,-620746,-623006,19.602333464545964,53.48456579053187,45.72342747866111,NaN,NaN,50
1678937400,1.0597,1.05989,1.05928,1.05987,1728,2969.2,-619018,-621807.6,18.846650702530063,54.60680619632443,46.78044561016607,NaN,NaN,50
1678939200,1.05987,1.06018,1.05982,1.06002,1700,2790.95,-617318,-620831,18.450071181392165,55.62413805425948,47.83161116864961,NaN,NaN,50
1678941000,1.06002,1.06034,1.05976,1.06028,1271,2389.85,-616047,-619111.4,18.249911632856943,57.40605139518053,48.99501643712515,NaN,NaN,50
1678942800,1.06028,1.06156,1.05984,1.06123,1697,2058.1,-614350,-617495.8,19.162150964093172,63.21786471154103,50.56549717560945,NaN,NaN,50
1678944600,1.06123,1.06151,1.06061,1.06074,1769,1893.6,-616119,-616570.4,20.009230343098242,58.764045372748235,51.813523927309014,NaN,NaN,50
1678946400,1.06074,1.06084,1.05994,1.06024,1930,1919.65,-618049,-616376.6,19.822436145934372,54.54146269011389,52.44181479909939,NaN,NaN,50
1678948200,1.06024,1.06083,1.06024,1.06054,1846,1934.65,-616203,-616153.6,19.648984391425063,56.558470226689536,53.358974766415464,NaN,NaN,50
1678950000,1.06054,1.0613,1.05928,1.06049,4376,2131.9,-620579,-617060,18.25222837768571,56.11160333933934,54.254824169465394,NaN,NaN,50
1678951800,1.06049,1.06284,1.06036,1.0625,4759,2361.35,-615820,-617354,18.403310988404456,67.29752703090114,55.57513340424356,NaN,NaN,50
1678953600,1.0625,1.06356,1.06178,1.06232,6637,2609.15,-622457,-618621.6,19.070878696869467,65.68303291663906,56.749884908949184,NaN,NaN,50
1678955400,1.06232,1.0629,1.06124,1.06126,4991,2800.65,-627448,-620501.4,19.055146663709174,57.009385504533824,57.154740721427366,NaN,NaN,50
1678957200,1.06126,1.06178,1.06054,1.06088,4559,2973.2,-632007,-623662.2,18.28818006020569,54.24395755438186,57.496617278385926,NaN,NaN,50
1678959000,1.06088,1.06203,1.06046,1.06175,3904,3090.9,-628103,-625167,17.791860207801307,59.13184663423106,58.12005410124395,NaN,NaN,50
1678960800,1.06175,1.06212,1.06046,1.06068,3161,3103.35,-631264,-628255.8,17.410900588236956,51.80238831775015,57.99989856747383,NaN,NaN,50
1678962600,1.06068,1.06164,1.06002,1.06161,3341,3064.05,-627923,-629349,16.556750994099776,56.81296466248799,58.15748131505694,NaN,NaN,50
1678964400,1.06161,1.0617,1.06072,1.0608,3480,3015.05,-631403,-630140,15.824833509301314,51.765330084528415,57.88185217436187,NaN,NaN,50
1678966200,1.0608,1.06152,1.06044,1.06132,3528,3051,-627875,-629313.6,14.814315145892529,54.55667535591968,57.678325314414664,NaN,NaN,50
1678968000,1.06132,1.06176,1.0602,1.06161,4261,3141.85,-623614,-628415.8,13.87597666558437,56.08306567207614,57.168696811595744,NaN,NaN,50
1678969800,1.06161,1.06204,1.0576,1.05878,9442,3503.1,-633056,-628774.2,15.084591545343127,41.45104988362055,55.93205427665806,NaN,NaN,50
1678971600,1.05878,1.06174,1.0551,1.05759,9846,3911.3,-642902,-631770,17.435379176085362,37.071244702719405,54.68418156327273,NaN,NaN,50
1678973400,1.05759,1.06211,1.05664,1.06066,11467,4398.25,-631435,-631776.4,19.215469045893567,51.352233065055934,54.312307480298905,NaN,NaN,50
1678975200,1.06066,1.0608,1.05729,1.05778,10210,4823.75,-641645,-634530.4,20.8684096392869,41.774563673563925,53.2882332184578,NaN,NaN,50
1678977000,1.05778,1.06078,1.05742,1.06004,7762,5148.3,-633883,-636584.2,22.403283047437846,49.70230113004636,52.031431368396746,NaN,NaN,50
1678978800,1.06004,1.06079,1.0593,1.06067,7333,5430.1,-626550,-635283,23.815461065327874,51.67746446523105,51.03103362186761,NaN,NaN,50
1678980600,1.06067,1.06268,1.05862,1.06214,7880,5735.65,-618670,-630436.6,23.021958672017554,56.01752722751899,50.96018660208084,NaN,NaN,50
1678982400,1.06214,1.0622,1.06073,1.06206,5921,5935.2,-624591,-629067.8,22.285135021086543,55.72420329460234,51.06591844066801,NaN,NaN,50
1678984200,1.06206,1.06254,1.06131,1.06186,4996,6092.7,-629587,-626656.2,21.2672513759991,54.949541160607765,50.7671823354092,NaN,NaN,50
1678986000,1.06186,1.06206,1.06078,1.06088,4697,6108.75,-634284,-626736.4,20.749425552190072,51.19403414923273,50.72372846622938,NaN,NaN,50
1678987800,1.06088,1.0611,1.05916,1.05921,4123,6076.95,-638407,-629107.8,21.3518237009485,45.48867635131105,49.91485072971674,NaN,NaN,50
1678989600,1.05921,1.0609,1.05916,1.06046,2880,5889.1,-635527,-632479.2,21.911193410509902,49.98200358436384,49.787470265419266,NaN,NaN,50
1678991400,1.06046,1.06205,1.06041,1.06122,3267,5802.9,-632260,-634013,21.260605504950554,52.54334071619528,49.6436606482961,NaN,NaN,50
1678993200,1.06122,1.06196,1.06114,1.0616,2806,5715.25,-629454,-633986.4,20.656488164074016,53.81678316366878,49.481783326267006,NaN,NaN,50
1678995000,1.0616,1.06176,1.06112,1.06148,2655,5652.8,-632109,-633551.4,20.11141028926832,53.330110474500856,50.330287654187025,NaN,NaN,50
1678996800,1.06148,1.06172,1.06105,1.06122,1155,5552.5,-633264,-632522.8,19.664431301066678,52.228063890604126,51.41291759617879,NaN,NaN,50
1678998600,1.06122,1.06168,1.06113,1.06124,715,5421.2,-632549,-631927.2,19.24937938345087,52.309703106809955,51.48130831344694,NaN,NaN,50
1679000400,1.06124,1.06124,1.06081,1.06106,92,5251.8,-632641,-632003.4,19.15973161664879,51.45738659483995,52.172938522109504,NaN,NaN,50
1679002200,1.06106,1.06142,1.06094,1.06133,886,5119.7,-631755,-632463.6,18.838034063161363,52.7022873430827,52.387223251612106,NaN,NaN,50
1679004000,1.06133,1.06152,1.06106,1.06142,1791,4996.2,-629964,-632034.6,18.402994427206814,53.13374211893133,52.49124308401927,NaN,NaN,50
1679005800,1.06142,1.06156,1.06111,1.06124,1490,4598.6,-631454,-631672.6,17.941694943960968,52.10990677603483,52.21212733748468,NaN,NaN,50
1679007600,1.06124,1.0616,1.06119,1.06152,1124,4162.5,-630330,-631228.8,17.452507015922777,53.607445996396464,52.06093038761283,NaN,NaN,50
1679009400,1.06152,1.06173,1.06132,1.06136,1010,3639.65,-631340,-630968.6,16.792428095168237,52.59533902465575,51.89277309218768,NaN,NaN,50
1679011200,1.06136,1.06205,1.06118,1.06132,1958,3227.05,-633298,-631277.2,15.682205712171454,52.329345359635916,51.973866750073626,NaN,NaN,50
1679013000,1.06132,1.06182,1.06118,1.06182,1975,2937.7,-631323,-631549,14.651284927960159,55.367893462824604,52.67952511518173,NaN,NaN,50
1679014800,1.06182,1.06295,1.06142,1.06287,2146,2678.35,-629177,-631093.6,15.023719336287353,60.99108468820889,53.465888051170666,NaN,NaN,50
1679016600,1.06287,1.06318,1.06238,1.06262,2366,2402.65,-631543,-631336.2,15.619762520700911,59.08242214004995,53.93296529573171,NaN,NaN,50
1679018400,1.06262,1.06335,1.06258,1.06332,2162,2214.7,-629381,-630944.4,16.357285591779096,62.610626242456505,54.56109694421655,NaN,NaN,50
1679020200,1.06332,1.06389,1.06324,1.06338,1640,2046.9,-627741,-629833,17.58780632622489,62.90587414294083,55.24508006339084,NaN,NaN,50
1679022000,1.06338,1.06438,1.06316,1.06425,1853,1904.7,-625888,-628746,19.16486953032576,66.97777875146672,56.29863112488102,NaN,NaN,50
1679023800,1.06425,1.0645,1.06372,1.06402,1783,1787.7,-627671,-628444.8,20.73091495454972,64.9479873049275,57.20136571046084,NaN,NaN,50
1679025600,1.06402,1.0646,1.0639,1.06444,1500,1718.7,-626171,-627370.4,22.272309474934897,66.91949701172615,58.305802168809855,NaN,NaN,50
1679027400,1.06444,1.06494,1.06422,1.06494,1570,1633.85,-624601,-626414.4,23.994251195163546,69.14446820507743,59.48024365895234,NaN,NaN,50
1679029200,1.06494,1.06496,1.06444,1.06475,1273,1557.2,-625874,-626041,25.610234301003963,67.29227710593845,60.4915675865957,NaN,NaN,50
1679031000,1.06475,1.06507,1.06449,1.06488,1836,1516.25,-624038,-625671,27.20867488690305,67.92536571576642,61.62124322514795,NaN,NaN,50
1679032800,1.06488,1.06499,1.06444,1.06476,2108,1563.9,-626146,-625366,28.561755320867178,66.64305965415639,62.552358486416516,NaN,NaN,50
1679034600,1.06476,1.0663,1.06449,1.06626,1976,1626.95,-624170,-624965.8,30.81572505972698,73.40230744669731,64.03857051656234,NaN,NaN,50
1679036400,1.06626,1.06694,1.06581,1.06654,3356,1790.15,-620814,-624208.4,33.250743129206015,74.44334783175941,65.61814212171403,NaN,NaN,50
1679038200,1.06654,1.06692,1.066,1.06626,3376,1914.65,-624190,-623871.6,35.511831336579405,71.43239793690375,66.76560672700539,NaN,NaN,50
1679040000,1.06626,1.067,1.06516,1.0652,4789,2064.55,-628979,-624859.8,35.791266145682144,61.32083658689758,66.7891604340546,NaN,NaN,50
1679041800,1.0652,1.06628,1.06519,1.06523,3604,2170.25,-625375,-624705.6,36.05074132556325,61.486998099023744,66.96091585969558,NaN,NaN,50
1679043600,1.06523,1.06598,1.0643,1.06441,3263,2277.2,-628638,-625599.2,34.702460972404204,54.58458909506144,66.38762749202449,NaN,NaN,50
1679045400,1.06441,1.06533,1.06402,1.06468,2955,2374.45,-625683,-626573,33.02118113971986,56.32320156825314,65.9174365938325,NaN,NaN,50
1679047200,1.06468,1.0647,1.06314,1.0638,3535,2453.3,-629218,-627578.6,31.039643124990135,49.651514948874464,64.67984632221878,NaN,NaN,50
1679049000,1.0638,1.06394,1.06252,1.06331,2686,2488.85,-631904,-628163.6,29.882386905422027,46.358626937909456,63.352034867431776,NaN,NaN,50
1679050800,1.06331,1.06402,1.06171,1.06171,3937,2578.4,-635841,-630256.8,29.56406752087237,37.59173893005663,61.257195004455376,NaN,NaN,50
1679052600,1.06171,1.0632,1.06156,1.06297,3769,2648.55,-632072,-630943.6,29.39736260932701,46.21739219840358,59.61954671826438,NaN,NaN,50
1679054400,1.06297,1.06335,1.06155,1.06156,3852,2733.05,-635924,-632991.8,29.011788080385752,39.61836765458133,57.64283890031031,NaN,NaN,50
1679056200,1.06156,1.06282,1.06123,1.06262,4931,2897.6,-630993,-633346.8,28.953007088211624,45.875038954484985,56.067815560218776,NaN,NaN,50
1679058000,1.06262,1.06343,1.0622,1.06288,4719,3040.9,-626274,-632220.8,27.967583769166865,47.317024644551644,54.68738448810416,NaN,NaN,50
1679059800,1.06288,1.06302,1.06172,1.0626,5657,3234.6,-631931,-631438.8,27.533218450422236,45.89883476849241,52.72285072537523,NaN,NaN,50
1679061600,1.0626,1.06444,1.0625,1.06334,6879,3503.55,-625052,-630034.8,25.75944448475419,50.15119525659083,50.98769697000604,NaN,NaN,50
1679063400,1.06334,1.06392,1.06264,1.06335,5787,3714.4,-619265,-626703,24.112368659491004,50.20815062638081,49.471679304968696,NaN,NaN,50
1679065200,1.06335,1.06406,1.06298,1.06388,4963,3898.9,-614302,-623364.8,22.73962930762334,53.25648001420664,48.89565383549077,NaN,NaN,50
1679067000,1.06388,1.06482,1.06367,1.06462,5011,4057.65,-609291,-619968.2,22.25604500248907,57.196707915901236,48.5892045366963,NaN,NaN,50
1679068800,1.06462,1.06734,1.06422,1.06712,4307,4167.6,-604984,-614578.8,23.569871169492576,67.24284458443348,49.493365643080026,NaN,NaN,50
1679070600,1.06712,1.06758,1.06652,1.06675,3894,4263.5,-608878,-611344,24.91382141089019,64.81810749931745,50.100144638156046,NaN,NaN,50
1679072400,1.06675,1.06706,1.06636,1.06698,2949,4243.15,-605929,-608676.8,25.9526417438886,65.64736503641151,51.24270535869441,NaN,NaN,50
1679074200,1.06698,1.0675,1.06657,1.06729,3279,4238.3,-602650,-606346.4,27.16549628970824,66.78378515161454,52.70164523110191,NaN,NaN,50
1679076000,1.06729,1.06734,1.06678,1.06729,3164,4157.05,-602650,-605018.2,28.291718367969338,66.78378515161454,54.78679138978462,NaN,NaN,50
1679077800,1.06729,1.06854,1.06668,1.06808,3592,4156.45,-599058,-603833,29.963866624198037,69.74214971507854,56.46713121240425,NaN,NaN,50
1679079600,1.06808,1.06828,1.06704,1.06712,2678,4127.2,-601736,-602404.6,31.516575719267543,62.46191065130762,58.09881285502756,NaN,NaN,50
1679081400,1.06712,1.06732,1.06608,1.06614,2425,4100.7,-604161,-602051,31.60627251285203,56.03172077968084,58.82429012825584,NaN,NaN,50
1679083200,1.06614,1.0665,1.06586,1.066,963,3972.1,-605124,-602545.8,31.406233511137838,55.15813659769981,59.38436955348071,NaN,NaN,50
1679085000,1.066,1.0667,1.06598,1.06656,1183,3896.95,-603941,-602804,31.364993739355544,57.980216382444894,60.24732538304875,NaN,NaN,50
1679259600,1.06656,1.0689,1.06656,1.06878,145,3707.35,-603796,-603751.6,32.57105411581836,66.8791301973798,61.4421778788194,NaN,NaN,50
1679261400,1.06878,1.06884,1.06846,1.06852,77,3522.75,-603873,-604179,33.69096732253383,65.13920452306284,62.5086817285824,NaN,NaN,50
1679263200,1.06852,1.06892,1.06754,1.06766,2142,3437.25,-606015,-604549.8,33.578234287442754,59.614584787698554,62.96283206954611,NaN,NaN,50
1679265000,1.06766,1.0678,1.06662,1.06703,1993,3290.35,-608008,-605126.6,32.48342155690207,55.87596130638331,62.86849302600911,NaN,NaN,50
1679266800,1.06703,1.06806,1.06679,1.06798,1689,3138.85,-606319,-605602.2,31.64750644134547,59.95429612087591,62.34788242146929,NaN,NaN,50
1679268600,1.06798,1.06828,1.06761,1.06806,1403,2926.15,-604916,-605826.2,31.026486599847303,60.287177452576756,62.02424456098781,NaN,NaN,50
1679270400,1.06806,1.06861,1.0679,1.06854,2757,2720.05,-602159,-605483.4,30.68329369742712,62.31149373098591,61.78596803917169,NaN,NaN,50
1679272200,1.06854,1.06886,1.06792,1.0681,2053,2533.35,-604212,-605122.8,30.5409077410182,59.326179074776896,61.25328189082615,NaN,NaN,50
1679274000,1.0681,1.069,1.068,1.06883,2477,2409.05,-601735,-603868.2,30.509421689249237,62.53334710898143,60.94967917349521,NaN,NaN,50
1679275800,1.06883,1.069,1.06693,1.06752,3465,2331.75,-605200,-603644.4,29.179326946713985,54.264323126867076,59.84412013148012,NaN,NaN,50
1679277600,1.06752,1.06832,1.0675,1.06766,1733,2203.05,-603467,-603354.6,27.944238971502678,54.94993669794172,59.307550563382556,NaN,NaN,50
1679279400,1.06766,1.06846,1.0674,1.06794,1851,2100.9,-601616,-603246,26.92828123639056,56.359009941246875,59.330928360637266,NaN,NaN,50
1679281200,1.06794,1.06794,1.06652,1.06696,2472,2077.05,-604088,-603221.2,25.02732486353362,50.415353390400604,58.992158131544464,NaN,NaN,50
1679283000,1.06696,1.06702,1.06649,1.06693,1626,1994.4,-605714,-604017,23.294269704362353,50.24068041194769,58.439334133651805,NaN,NaN,50
1679284800,1.06693,1.06744,1.06688,1.06709,1206,1896.5,-604508,-603878.6,22.034105830045217,51.21155535893529,57.32022164519149,NaN,NaN,50
1679286600,1.06709,1.06728,1.06658,1.06698,1660,1799.9,-606168,-604418.8,20.511558500390397,50.48229048000487,56.27329921354448,NaN,NaN,50
1679288400,1.06698,1.06772,1.06683,1.0675,1349,1733.45,-604819,-605059.4,19.584879498198855,53.82945942711431,55.86007597350275,NaN,NaN,50
1679290200,1.0675,1.0681,1.06708,1.06794,1783,1701.35,-603036,-604849,19.120986067802132,56.508361694033056,55.90524742976345,NaN,NaN,50
1679292000,1.06794,1.0681,1.06645,1.06674,3482,1827.3,-606518,-605009.8,17.90802594065343,48.280662845582945,55.07141648152823,NaN,NaN,50
1679293800,1.06674,1.06678,1.06588,1.06608,5051,2020.7,-611569,-606422,17.105055793581485,44.44747470991245,53.9400091427665,NaN,NaN,50
1679295600,1.06608,1.06694,1.06418,1.06676,6359,2331.4,-605210,-606230.4,17.80518496046785,48.945011785769076,52.98526043239387,NaN,NaN,50
1679297400,1.06676,1.06709,1.06536,1.06554,5877,2621.4,-611087,-607484,18.272281176368406,42.32441008291849,51.77084836154685,NaN,NaN,50
1679299200,1.06554,1.06687,1.06313,1.06318,7252,2876.9,-618339,-610544.6,20.026142842198944,33.019764236011554,49.66273529919186,NaN,NaN,50
1679301000,1.06318,1.06626,1.06316,1.06612,5448,3049.65,-612891,-611819.2,21.65472867475587,48.27528537756532,49.23494688852744,NaN,NaN,50
1679302800,1.06612,1.06682,1.06498,1.06534,5028,3216.6,-617919,-613089.2,22.489364216039636,45.325726270471094,48.54750328656525,NaN,NaN,50
1679304600,1.06534,1.06778,1.0653,1.06745,4967,3394.8,-612952,-614637.6,22.22404978658999,53.58695831007979,48.349499598624746,NaN,NaN,50
1679306400,1.06745,1.0691,1.06708,1.06878,4540,3483.95,-608412,-614102.6,20.79650937802958,57.90463344483234,48.8844481739413,NaN,NaN,50
1679308200,1.06878,1.06996,1.06864,1.0696,3843,3573.45,-604569,-611348.6,19.80103694945666,60.35348173225022,49.60679112539149,NaN,NaN,50
1679310000,1.0696,1.07,1.06887,1.06972,4051,3652.15,-600518,-608874,18.906193542770204,60.71366306335281,50.28551310427845,NaN,NaN,50
1679311800,1.06972,1.07088,1.06927,1.07071,3255,3641.65,-597263,-604742.8,18.705398887546096,63.64783186600676,51.225908917564304,NaN,NaN,50
1679313600,1.07071,1.07157,1.07016,1.07126,3926,3751.3,-593337,-600819.8,18.964609198312417,65.20272645978866,52.03828513418389,NaN,NaN,50
1679315400,1.07126,1.07176,1.0703,1.07052,4732,3895.35,-598069,-598751.2,19.324996198579072,61.39754514155169,52.387512523292365,NaN,NaN,50
1679317200,1.07052,1.07252,1.07032,1.07228,4102,3976.85,-593967,-596630.8,20.121213070693425,66.41738378477174,53.68299259037728,NaN,NaN,50
1679319000,1.07228,1.07308,1.07181,1.07238,6143,4202.7,-587824,-594092,21.174494087177756,66.68248968291859,55.271207945592,NaN,NaN,50
1679320800,1.07238,1.07296,1.07122,1.07168,5851,4434.95,-593675,-593374.4,21.507844873720188,62.93712193578791,56.27064438487907,NaN,NaN,50
1679322600,1.07168,1.07271,1.07168,1.07267,3527,4528.3,-590148,-592736.6,21.817384889795306,65.85787626902584,57.951606255315305,NaN,NaN,50
1679324400,1.07267,1.07268,1.07132,1.07184,3414,4631.55,-593562,-591835.2,21.69837454144451,61.483256303049,59.98471283153226,NaN,NaN,50
1679326200,1.07184,1.07222,1.07116,1.07212,3879,4736.35,-589683,-590978.4,21.406060349136816,62.39084852717969,60.992967342219,NaN,NaN,50
1679328000,1.07212,1.07242,1.07068,1.0717,4153,4769.9,-593836,-592180.8,20.59652731258192,60.10307090543147,62.048491959001886,NaN,NaN,50
1679329800,1.0717,1.07254,1.07164,1.07254,2896,4662.15,-590940,-591633.8,19.953716875785748,63.023417290720396,62.72252474333336,NaN,NaN,50
1679331600,1.07254,1.07284,1.07221,1.07244,1995,4443.95,-592935,-592191.2,19.63245880505699,62.437487320856356,63.04630002019222,NaN,NaN,50
1679333400,1.07244,1.07262,1.07152,1.0716,1594,4229.8,-594529,-592384.6,18.52948493972368,57.593724201261544,62.84917448226445,NaN,NaN,50
1679335200,1.0716,1.07254,1.07142,1.07238,2144,3974.4,-592385,-592925,17.39366047107952,60.646669165997395,62.84438920388192,NaN,NaN,50
1679337000,1.07238,1.07258,1.07213,1.07244,1985,3801.25,-590400,-592237.8,16.383619314010133,60.87997697466996,62.646685283072145,NaN,NaN,50
1679338800,1.07244,1.07256,1.0719,1.07238,1700,3634.85,-592100,-592469.8,15.2629920867244,60.49374967628696,62.31032979853631,NaN,NaN,50
1679340600,1.07238,1.07259,1.07194,1.07232,1604,3466.7,-593704,-592623.6,14.18398619372517,60.08325585101968,62.216451992069736,NaN,NaN,50
1679342400,1.07232,1.0724,1.07204,1.07226,733,3276.35,-594437,-592605.2,13.182052150225884,59.647370662955346,61.73287962622571,NaN,NaN,50
1679344200,1.07226,1.07242,1.07214,1.07238,658,3117.1,-593779,-592884,12.258696999426101,60.26819907291764,61.274716011225635,NaN,NaN,50
1679346000,1.07238,1.07238,1.07188,1.07215,572,2943.15,-594351,-593674.2,11.754793423247275,58.41320695756879,60.951579227067135,NaN,NaN,50
1679347800,1.07215,1.0722,1.07196,1.07216,3336,2947.2,-591015,-593457.2,11.28688295965265,58.473053724982286,60.42409190249259,NaN,NaN,50
1679349600,1.07216,1.07238,1.07206,1.07228,3807,2941.25,-587208,-592158,10.537615840063772,59.23124476387257,60.263233935408564,NaN,NaN,50
1679351400,1.07228,1.07246,1.07218,1.07228,635,2736.4,-587208,-590712.2,9.869505105031488,59.23124476387257,60.037547952315194,NaN,NaN,50
1679353200,1.07228,1.07244,1.07198,1.07202,755,2569.05,-587963,-589549,9.443206376972142,56.63300213341329,59.78968589717105,NaN,NaN,50
1679355000,1.07202,1.0721,1.07157,1.07185,904,2307.1,-588867,-588452.2,9.732913802579848,54.936137406477975,59.21202304829659,NaN,NaN,50
1679356800,1.07185,1.07259,1.07168,1.07182,1872,2108.15,-590739,-588397,9.078513351237705,54.62508983238027,58.653994656262576,NaN,NaN,50
1679358600,1.07182,1.07217,1.07153,1.07174,1951,2029.35,-592690,-589493.4,8.727887498733626,53.751093881674365,58.37952106200635,NaN,NaN,50
1679360400,1.07174,1.07208,1.07152,1.07186,1790,1948.15,-590900,-590231.8,8.420045958549808,54.916326137394805,57.970210845677585,NaN,NaN,50
1679362200,1.07186,1.07196,1.07152,1.07168,1821,1845.25,-592721,-591183.4,8.134193099807694,52.7686777161882,57.3908323272146,NaN,NaN,50
1679364000,1.07168,1.07211,1.0716,1.07186,1002,1687.7,-591719,-591753.8,7.559356068839309,54.67747788378324,56.97538434203576,NaN,NaN,50
1679365800,1.07186,1.07224,1.07162,1.0722,1257,1605.75,-590462,-591698.4,7.301807059985217,58.1203764276074,56.83517866893489,NaN,NaN,50
1679367600,1.0722,1.07221,1.07174,1.07186,985,1555.25,-591447,-591449.8,7.062654408906418,53.72523211694949,56.41216877279161,NaN,NaN,50
1679369400,1.07186,1.0719,1.07143,1.0716,936,1522.35,-592383,-591746.4,6.9937447745030985,50.57556553263964,55.7198378056289,NaN,NaN,50
1679371200,1.0716,1.0716,1.071,1.07114,910,1460.65,-593293,-591860.8,7.776283942097657,45.49387325435616,54.79702825539942,NaN,NaN,50
1679373000,1.07114,1.07154,1.07098,1.07122,784,1400.6,-592509,-592018.8,8.539745193854662,46.50064950752567,53.941856525581095,NaN,NaN,50
1679374800,1.07122,1.07147,1.07104,1.07131,822,1356.7,-591687,-592263.8,9.248673499057595,47.67166268698864,53.11617209151795,NaN,NaN,50
1679376600,1.07131,1.07158,1.07109,1.07158,1151,1334.05,-590536,-592081.6,9.580952668305347,51.12772651017343,52.53734935911087,NaN,NaN,50
1679378400,1.07158,1.07176,1.07069,1.07078,1390,1366.9,-591926,-591990.2,10.69574233232405,42.228345667933425,51.508445325862304,NaN,NaN,50
1679380200,1.07078,1.07103,1.0704,1.07074,1675,1417.75,-593601,-592051.8,12.227083102950264,41.83623326961812,50.57273788751518,NaN,NaN,50
1679382000,1.07074,1.072,1.0706,1.07154,2990,1538.65,-590611,-591672.2,11.423957208930716,51.53003051927535,50.35166222229339,NaN,NaN,50
1679383800,1.07154,1.07221,1.07133,1.0719,2914,1517.55,-587697,-590874.2,11.06867292190284,55.15228474829366,50.451747284194774,NaN,NaN,50
1679385600,1.0719,1.07374,1.07162,1.07328,4820,1568.2,-582877,-589342.4,12.758456556550374,65.72608619579927,51.223873002652276,NaN,NaN,50
1679387400,1.07328,1.07388,1.0725,1.07298,3427,1707.8,-586304,-588218,14.462393690478534,62.287960195853394,51.90382175119979,NaN,NaN,50
1679389200,1.07298,1.07366,1.07248,1.07346,2749,1807.5,-583555,-586208.8,16.001392727762116,65.4060514280122,52.67014843293042,NaN,NaN,50
1679391000,1.07346,1.07496,1.07339,1.07464,2612,1892.9,-580943,-584275.2,18.51237375614189,71.6185796395144,53.634305805209486,NaN,NaN,50
1679392800,1.07464,1.0751,1.07401,1.07457,2896,1944.1,-583839,-583503.6,20.93721602675769,70.80623474540769,54.854377421527936,NaN,NaN,50
1679394600,1.07457,1.07646,1.0743,1.07632,3330,2013.05,-580509,-583030,23.930652605394748,77.63579701168204,56.78725109860239,NaN,NaN,50
1679396400,1.07632,1.0779,1.07612,1.07789,2832,2065.15,-577677,-581304.6,27.239513975564705,81.7587132745787,59.37759681433257,NaN,NaN,50
1679398200,1.07789,1.07848,1.07769,1.07788,2897,2118.95,-580574,-580708.4,30.481180844392604,81.65545584082051,61.88865440956791,NaN,NaN,50
1679400000,1.07788,1.07822,1.07762,1.07792,3415,2239.6,-577159,-579951.6,33.365017626004935,81.7547177309795,64.32315834128154,NaN,NaN,50
1679401800,1.07792,1.07826,1.07739,1.07814,2979,2325.7,-574180,-578019.8,35.616064192966505,82.32131306574921,66.55127166667981,NaN,NaN,50
1679403600,1.07814,1.07837,1.07726,1.07834,3091,2431,-571089,-576135.8,37.46084058071619,82.84293681520917,69.45231389148523,NaN,NaN,50
1679405400,1.07834,1.07886,1.07754,1.0777,4066,2587.5,-575155,-575631.4,39.38868924224781,75.1968110594588,71.83521230504529,NaN,NaN,50
1679407200,1.0777,1.07799,1.07608,1.07696,4698,2776.9,-579853,-575487.2,38.82718019775318,67.44549691898771,72.97203133359616,NaN,NaN,50
1679409000,1.07696,1.07788,1.07635,1.07742,3637,2919.55,-576216,-575298.6,38.30577894215103,69.54694007580896,74.00022099984726,NaN,NaN,50
1679410800,1.07742,1.07828,1.0772,1.07736,3035,3030.2,-579251,-576312.8,38.114134564365756,68.9219940473476,74.22850013210072,NaN,NaN,50
1679412600,1.07736,1.07784,1.07654,1.07686,3861,3165.7,-583112,-578717.4,37.005565844172686,63.77867554139093,74.3349797996391,NaN,NaN,50
1679414400,1.07686,1.07784,1.07622,1.07776,2675,3229.95,-580437,-579773.8,35.55792493944479,68.35620673417638,74.54570517865082,NaN,NaN,50
1679416200,1.07776,1.07782,1.07648,1.07675,2314,3261.9,-582751,-580353.4,34.213686956483166,59.2992962946705,73.66575636830484,NaN,NaN,50
1679418000,1.07675,1.07722,1.07628,1.07638,2532,3239,-585283,-582166.8,32.686433834340455,56.35359452864656,72.63342492425048,NaN,NaN,50
1679419800,1.07638,1.07668,1.07609,1.07644,1642,3175.4,-583641,-583044.8,31.00148517891581,56.72897410258304,71.1400804307434,NaN,NaN,50
1679421600,1.07644,1.0765,1.07564,1.07596,1574,3013.1,-585215,-583465.4,28.830176222890707,52.815535605979065,69.07271059727199,NaN,NaN,50
1679423400,1.07596,1.0767,1.07591,1.07648,1456,2914.55,-583759,-584129.8,27.069028470359534,56.33018287748113,67.26376252846204,NaN,NaN,50
1679425200,1.07648,1.07684,1.0764,1.0765,1103,2832.25,-582656,-584110.8,25.614162784424533,56.46450191442385,65.45731854156521,NaN,NaN,50
1679427000,1.0765,1.07745,1.07626,1.07696,1101,2756.7,-581555,-583365.2,24.9969897399682,59.546450235297996,63.83054262510442,NaN,NaN,50
1679428800,1.07696,1.0772,1.07658,1.07658,713,2647.55,-582268,-583090.6,24.423900484401603,56.01849000415104,61.914510710028836,NaN,NaN,50
1679430600,1.07658,1.077,1.07658,1.07694,406,2501.35,-581862,-582420,23.891746175661194,58.52548086643797,60.72370141052735,NaN,NaN,50
1679432400,1.07694,1.07698,1.07676,1.07697,68,2363.15,-581794,-582027,23.397602888973672,58.736562988717445,60.10163470122233,NaN,NaN,50
1679434200,1.07697,1.07698,1.07681,1.07684,187,2227.65,-581981,-581892,22.93875555133526,57.37389146276524,59.23213122886206,NaN,NaN,50
1679436000,1.07684,1.07703,1.07678,1.07688,520,2082.9,-581461,-581873.2,22.589211490401176,57.69907892854206,58.430494434661675,NaN,NaN,50
1679437800,1.07688,1.07702,1.07687,1.07701,363,1952.1,-581098,-581639.2,22.264634862390956,58.79917858741116,58.074816080805974,NaN,NaN,50
1679439600,1.07701,1.07722,1.0769,1.07712,458,1820.45,-580640,-581394.8,22.293886945016812,59.752962816957975,57.460298658147515,NaN,NaN,50
1679441400,1.07712,1.0774,1.07699,1.07728,698,1652.05,-579942,-581024.4,22.60772554864798,61.16134469623689,57.59330211540226,NaN,NaN,50
1679443200,1.07728,1.07762,1.07676,1.07692,1135,1473.9,-581077,-580843.6,22.29592101067393,56.38072322521774,57.59523987944306,NaN,NaN,50
1679445000,1.07692,1.07731,1.0766,1.0768,1223,1353.2,-582300,-581011.4,21.604660666604758,54.84191888301771,57.46045022090268,NaN,NaN,50
1679446800,1.0768,1.07718,1.07669,1.07678,1946,1298.75,-584246,-581641,20.96277606139767,54.5745711380768,57.586095616052525,NaN,NaN,50
1679448600,1.07678,1.0777,1.07672,1.07727,1843,1197.85,-582403,-581993.6,21.315625151767804,59.751417123854345,57.83046949079346,NaN,NaN,50
1679450400,1.07727,1.07754,1.07688,1.07736,1451,1136.65,-580952,-582195.6,21.643270735682933,60.638709300360354,58.128627161217494,NaN,NaN,50
1679452200,1.07736,1.07746,1.07654,1.07693,1421,1092,-582373,-582454.8,21.017931302396793,54.46119378568796,57.76539455767392,NaN,NaN,50
1679454000,1.07693,1.07712,1.0766,1.07702,1144,1022.6,-581229,-582240.6,20.43725897148823,55.483414044014914,57.727174846235634,NaN,NaN,50
1679455800,1.07702,1.07724,1.07684,1.077,1385,1009.75,-582614,-581914.2,20.150645287124274,55.18695042377945,57.48870838604574,NaN,NaN,50
1679457600,1.077,1.07719,1.0768,1.0769,714,966.75,-583328,-582099.2,19.765063221304544,53.643543732474384,57.12492129631409,NaN,NaN,50
1679459400,1.0769,1.07704,1.07682,1.07688,632,925.55,-583960,-582700.8,19.40702273161479,53.32234935251479,56.835525431296205,NaN,NaN,50
1679461200,1.07688,1.07702,1.0767,1.07694,808,910.8,-583152,-582856.6,18.684450483484238,54.20816723193046,56.58617459582394,NaN,NaN,50
1679463000,1.07694,1.07752,1.07684,1.07726,992,905.35,-582160,-583042.8,19.15369493949054,58.70882607634657,56.57972084503361,NaN,NaN,50
1679464800,1.07726,1.07744,1.07692,1.07718,1251,932.25,-583411,-583202.2,19.58942193435353,57.19535705608743,56.39703471925714,NaN,NaN,50
1679466600,1.07718,1.07719,1.07638,1.07668,1237,973.8,-584648,-583466.2,18.378153791111853,48.73853303706437,55.50969102931625,NaN,NaN,50
1679468400,1.07668,1.07718,1.07594,1.07642,2923,1116.55,-587571,-584188.4,17.88033557391318,45.01154130534221,54.697606606468,NaN,NaN,50
1679470200,1.07642,1.07678,1.07591,1.07659,2285,1221.45,-585286,-584615.2,17.481007961477108,47.82111867796197,54.19612087753544,NaN,NaN,50
1679472000,1.07659,1.078,1.07652,1.07786,3745,1382.7,-581541,-584491.4,17.788007526505247,63.021592773992296,54.79947956581511,NaN,NaN,50
1679473800,1.07786,1.07832,1.07746,1.07803,3167,1522.9,-578374,-583484,18.51411614735589,64.51189734740854,55.13951386749756,NaN,NaN,50
1679475600,1.07803,1.07931,1.07758,1.07897,2946,1647.3,-575428,-581640,20.259959810891583,71.38029717813465,55.906770144481435,NaN,NaN,50
1679477400,1.07897,1.07908,1.07821,1.07866,2370,1730.9,-577798,-579685.4,21.881100355603298,66.78938726294551,56.78735539285698,NaN,NaN,50
1679479200,1.07866,1.07896,1.07796,1.07842,2604,1804.35,-580402,-578708.6,22.799514053496743,63.39018750723112,57.35212492594385,NaN,NaN,50
1679481000,1.07842,1.07949,1.07816,1.07923,2209,1853.65,-578193,-578039,24.193092272376123,69.10515438340275,58.34628235163124,NaN,NaN,50
1679482800,1.07923,1.07952,1.07884,1.07948,2032,1857.95,-576161,-577596.4,25.516064475325624,70.62911224876422,59.55953724565194,NaN,NaN,50
1679484600,1.07948,1.07982,1.07906,1.07972,2458,1888.7,-573703,-577251.4,27.032207786043465,72.0542555322492,60.89753054420439,NaN,NaN,50
1679486400,1.07972,1.08002,1.07922,1.07932,2424,1937.35,-576127,-576917.2,28.622840876594047,66.28169499876324,61.75992538469245,NaN,NaN,50
1679488200,1.07932,1.0794,1.07792,1.0782,2953,2013.95,-579080,-576652.8,27.4157454847131,53.38518193847162,61.37966508912995,NaN,NaN,50
1679490000,1.0782,1.07881,1.07794,1.07859,2420,2077.75,-576660,-576346.2,26.294871192252224,56.55510496316125,61.33393279677808,NaN,NaN,50
1679491800,1.07859,1.07895,1.07759,1.07814,3503,2183.65,-580163,-577146.6,24.67259853317458,52.148546643025185,61.577505197203855,NaN,NaN,50
1679493600,1.07814,1.07864,1.07756,1.07842,2878,2291.85,-577285,-577863,23.116772411789206,54.52292764730777,62.25688993591568,NaN,NaN,50
1679495400,1.07842,1.07985,1.07798,1.07952,2689,2394.7,-574596,-577556.8,23.232195800524877,62.4134698739518,63.29920073562924,NaN,NaN,50
1679497200,1.07952,1.07958,1.07876,1.07896,2681,2488.35,-577277,-577196.2,23.339374661493714,56.992100038614396,62.86852268310225,NaN,NaN,50
1679499000,1.07896,1.07934,1.07838,1.07914,2958,2586.65,-574319,-576728,22.764290851497087,58.247500680232434,62.42106577830396,NaN,NaN,50
1679500800,1.07914,1.08002,1.07886,1.07926,2250,2636.6,-572069,-575109.2,23.000781440345623,59.10454364182571,61.54422623999618,NaN,NaN,50
1679502600,1.07926,1.08006,1.07892,1.0799,1556,2652.55,-570513,-573754.8,23.26263346913678,63.41751638107721,61.30337831986274,NaN,NaN,50
1679504400,1.0799,1.08,1.07904,1.07904,1690,2590.9,-572203,-573276.2,23.50578178158571,55.02042707698605,60.705538289130935,NaN,NaN,50
1679506200,1.07904,1.07972,1.07898,1.07955,2240,2588.65,-569963,-571813.4,23.60734202594481,58.52743574385481,59.94998695773466,NaN,NaN,50
1679508000,1.07955,1.08586,1.07944,1.08522,11276,2965.2,-558687,-568687,26.93019380339835,78.55063614984739,60.515810093526305,NaN,NaN,50
1679509800,1.08522,1.09124,1.08377,1.08808,13602,3486.95,-545085,-563290.2,30.788764394995376,83.0072412641208,61.298166217231426,NaN,NaN,50
1679511600,1.08808,1.08928,1.08526,1.08922,10885,3883.9,-534200,-556027.6,34.37172280147833,84.39871087192907,62.59223877960041,NaN,NaN,50
1679513400,1.08922,1.08927,1.08594,1.08654,6277,4079.25,-540477,-549682.4,37.698755607498214,69.90629618557386,63.77231836867914,NaN,NaN,50
1679515200,1.08654,1.08656,1.08546,1.08554,2278,4062.95,-542755,-544240.8,40.28658128620755,65.39404730589403,64.40367139316005,NaN,NaN,50
1679517000,1.08554,1.0862,1.0855,1.08561,802,3992.6,-541953,-540894,42.68956227358051,65.56161959232904,65.36174803239604,NaN,NaN,50
1679518800,1.08561,1.08591,1.08561,1.08586,211,3901.55,-541742,-540225.4,44.9209017618554,66.19128054104331,66.19520181052,NaN,NaN,50
1679520600,1.08586,1.08598,1.08574,1.0859,220,3789.65,-541522,-541689.8,47.00593019065383,66.29745776541769,66.47262951705328,NaN,NaN,50
1679522400,1.0859,1.08643,1.08579,1.08628,1898,3763.35,-539624,-541519.2,49.0277162788674,67.34661163945805,67.21223748854212,NaN,NaN,50
1679524200,1.08628,1.08644,1.08572,1.0858,827,3657.05,-540451,-541058.4,50.80863245312528,64.6105716862063,67.6667425603974,NaN,NaN,50
1679526000,1.0858,1.08686,1.0858,1.08662,780,3575.05,-539671,-540602,52.55052555423922,67.07169491756653,68.23582479437887,NaN,NaN,50
1679527800,1.08662,1.0872,1.0865,1.08691,1099,3454.85,-538572,-539968,54.23832520027737,67.9213539362284,68.55752747688967,NaN,NaN,50
1679529600,1.08691,1.08754,1.08686,1.08733,1975,3409.7,-536597,-538983,55.87531721074216,69.16241082331153,69.56766917305579,NaN,NaN,50
1679531400,1.08733,1.08837,1.08722,1.08836,1963,3373.4,-534634,-537985,57.55412462756625,72.02117152062583,70.53150744282514,NaN,NaN,50
1679533200,1.08836,1.08856,1.0879,1.088,1879,3333.3,-536513,-537197.4,59.14751670196681,69.5928187856185,69.89166334538022,NaN,NaN,50
1679535000,1.088,1.08884,1.08794,1.08864,1768,3273.8,-534745,-536212.2,60.678648526554056,71.43665687947686,69.06519303219137,NaN,NaN,50
1679536800,1.08864,1.08924,1.08822,1.08912,1883,3255.45,-532862,-535070.2,62.17288822117706,72.77028769088818,68.23459137640273,NaN,NaN,50
1679538600,1.08912,1.08992,1.08896,1.08957,2108,3283.05,-530754,-533901.6,63.67516689107229,73.9960920555908,68.52671965283251,NaN,NaN,50
1679540400,1.08957,1.09058,1.08932,1.08968,2228,3309.95,-528526,-532680,65.17047186293975,74.3006466537792,69.1629053205386,NaN,NaN,50
1679542200,1.08968,1.09024,1.08964,1.0901,1382,3267.05,-527144,-530806.2,66.55896933681667,75.48141118766205,69.87146186306238,NaN,NaN,50
1679544000,1.0901,1.09016,1.0895,1.09014,1249,2765.7,-525895,-529036.2,67.58245093953647,75.59640917069504,70.54325676518036,NaN,NaN,50
1679545800,1.09014,1.09044,1.08976,1.09038,1114,2141.3,-524781,-527420,68.58963738077097,76.31423343001484,71.25874074122301,NaN,NaN,50
1679547600,1.09038,1.09114,1.09022,1.09101,1574,1675.75,-523207,-525910.6,69.65669992868537,78.1325771885696,72.02916685187382,NaN,NaN,50
1679549400,1.09101,1.09115,1.09036,1.09047,1981,1460.95,-525188,-525243,70.64936454987894,72.96217628826632,72.62571003773526,NaN,NaN,50
1679551200,1.09047,1.09298,1.09035,1.0924,2330,1463.55,-522858,-524385.8,71.84567445186411,78.45088053854091,73.43850901066199,NaN,NaN,50
1679553000,1.0924,1.09268,1.0914,1.09154,2460,1546.45,-525318,-524270.4,72.95653364656464,71.48700462824212,73.69319834580584,NaN,NaN,50
1679554800,1.09154,1.0927,1.09102,1.09242,3714,1721.6,-521604,-523635,73.274788443379,74.02759299695757,74.04071135820912,NaN,NaN,50
1679556600,1.09242,1.09244,1.09002,1.09062,3480,1884.6,-525084,-524010.4,71.90771567344498,61.88172890736233,73.31646545726174,NaN,NaN,50
1679558400,1.09062,1.09106,1.08921,1.08938,4374,2008.4,-529458,-524864.4,69.50766924352557,55.166730721702336,72.28603059555344,NaN,NaN,50
1679560200,1.08938,1.09094,1.08912,1.08998,4264,2180.25,-525194,-525331.6,67.15913340788327,57.566170928863976,71.2952815990811,NaN,NaN,50
1679562000,1.08998,1.09037,1.08828,1.08857,3893,2335.9,-529087,-526085.4,63.9171036584454,50.69922832183175,69.71877735843421,NaN,NaN,50
1679563800,1.08857,1.0889,1.08806,1.08858,3111,2436.5,-525976,-526959.8,60.647810213015276,50.74410491306073,68.05792113396777,NaN,NaN,50
1679565600,1.08858,1.0886,1.08668,1.08692,3068,2491.15,-529044,-527751.8,56.432131547097455,43.64233083324286,65.86804143250089,NaN,NaN,50
1679567400,1.08692,1.0879,1.0869,1.08772,2467,2516.35,-526577,-527175.6,52.51757278588804,47.45868586135844,63.86641819490778,NaN,NaN,50
1679569200,1.08772,1.08807,1.08702,1.08751,2267,2535.75,-528844,-527905.6,48.819546292260334,46.56724954128812,61.79290679280729,NaN,NaN,50
1679571000,1.08751,1.08787,1.08697,1.08759,2506,2572.65,-526338,-527355.8,45.332822729060105,46.97585453513482,59.697308300315854,NaN,NaN,50
1679572800,1.08759,1.08939,1.08708,1.08886,4211,2689.05,-522127,-526586,43.47943536475056,53.10651253684526,57.90973225376411,NaN,NaN,50
1679574600,1.08886,1.08901,1.08696,1.08734,4235,2795.4,-526362,-526049.6,41.620195734199285,46.21877772050552,55.999489498924056,NaN,NaN,50
1679576400,1.08734,1.08904,1.0873,1.08892,3327,2850.35,-523035,-525341.2,39.91938154382398,53.037157578953476,54.184223573239244,NaN,NaN,50
1679578200,1.08892,1.08931,1.08775,1.08869,4277,2995.1,-527312,-525034.8,38.577323938914624,52.0035890559786,52.792551032363285,NaN,NaN,50
1679580000,1.08869,1.08934,1.08808,1.08932,3791,3122.2,-523521,-524471.4,37.35824029903726,54.61268995700859,51.405772243795504,NaN,NaN,50
1679581800,1.08932,1.08954,1.08816,1.08914,3632,3248.1,-527153,-525476.6,36.41348257633171,53.71425161054586,50.822381008308604,NaN,NaN,50
1679583600,1.08914,1.0908,1.089,1.09032,2895,3314.15,-524258,-525055.8,36.53733237770528,58.530587629465245,51.06265650172025,NaN,NaN,50
1679585400,1.09032,1.09076,1.08836,1.08898,3816,3405.9,-528074,-526063.6,35.7466949384951,51.92308356652265,50.65957883298158,NaN,NaN,50
1679587200,1.08898,1.08978,1.08834,1.0892,3631,3470.95,-524443,-525489.8,34.984935795379144,52.86391247205226,50.8141991294259,NaN,NaN,50
1679589000,1.0892,1.08988,1.08912,1.08956,2718,3483.85,-521725,-525130.6,34.36486656648774,54.435243212149956,51.077851865075125,NaN,NaN,50
1679590800,1.08956,1.08956,1.08692,1.08692,2723,3434.3,-524448,-524589.6,32.54588027552777,43.09076782214138,51.03845450713931,NaN,NaN,50
1679592600,1.08692,1.08789,1.08641,1.08688,2444,3382.5,-526892,-525116.4,31.280148637109086,42.9447335099194,50.71602933917938,NaN,NaN,50
1679594400,1.08688,1.08768,1.08666,1.08672,2717,3299.65,-529609,-525423.4,30.104826401434586,42.3268153691603,50.413141184027396,NaN,NaN,50
1679596200,1.08672,1.08682,1.0828,1.0842,4355,3304.2,-533964,-527327.6,31.22482307217111,34.02328900413062,49.48795793181281,NaN,NaN,50
1679598000,1.0842,1.08534,1.08302,1.08371,6715,3445.3,-540679,-531118.4,32.26481998071217,32.68077286181557,48.02897652645355,NaN,NaN,50
1679599800,1.08371,1.08429,1.08242,1.08399,4450,3512.25,-536229,-533474.6,33.468676962310944,34.276686217935946,47.17596999055572,NaN,NaN,50
1679601600,1.08399,1.08409,1.0831,1.08342,1114,3414.55,-537343,-535564.8,34.58654415950981,32.58326018446304,45.71497731952069,NaN,NaN,50
1679603400,1.08342,1.0838,1.08308,1.0832,1140,3348.2,-538483,-537339.6,35.63318346278244,31.9276186778293,44.280979435367165,NaN,NaN,50
1679605200,1.0832,1.08354,1.08312,1.08328,529,3261.3,-537954,-538137.6,36.60506281582131,32.45983235005215,42.69863246344171,NaN,NaN,50
1679607000,1.08328,1.08339,1.08319,1.08334,720,3172,-537234,-537448.6,37.50752221507169,32.88366000947299,41.210733063365076,NaN,NaN,50
1679608800,1.08334,1.08388,1.08328,1.0835,1021,3012.5,-536213,-537445.4,37.62422274745704,34.07175749226619,39.46367376785086,NaN,NaN,50
1679610600,1.0835,1.08352,1.08272,1.08319,1124,2856.95,-537337,-537444.2,38.06677443138341,32.85810940376554,38.10188989908249,NaN,NaN,50
1679612400,1.08319,1.08358,1.08316,1.08332,1056,2743.4,-536281,-537003.8,38.38739222564553,33.921095096323654,36.74883151510188,NaN,NaN,50
1679614200,1.08332,1.08354,1.08314,1.08348,907,2574.9,-535374,-536487.8,38.698018663650714,35.279217539146444,35.3805439670302,NaN,NaN,50
1679616000,1.08348,1.08348,1.08246,1.08331,1746,2472.65,-537120,-536465,39.40899400611867,34.46860481625585,34.76467518089552,NaN,NaN,50
1679617800,1.08331,1.08345,1.08296,1.08326,1467,2364.4,-538587,-536939.8,40.069185395553205,34.21956162115205,34.14144861741214,NaN,NaN,50
1679619600,1.08326,1.08354,1.08212,1.08222,3244,2381.85,-541831,-537838.6,41.155054851216235,29.45277971486918,33.221874642105625,NaN,NaN,50
1679621400,1.08222,1.0827,1.08204,1.08252,2312,2306.65,-539519,-538486.2,42.205054835344775,32.378987159052556,33.10442451031433,NaN,NaN,50
1679623200,1.08252,1.08282,1.08236,1.08246,2087,2229.45,-541606,-539732.6,42.950222806761424,32.09227874442587,33.06238921621507,NaN,NaN,50
1679625000,1.08246,1.08256,1.08198,1.08206,1530,2170.05,-543136,-540935.8,43.86468187211698,30.174034156113123,32.76934264037058,NaN,NaN,50
1679626800,1.08206,1.08242,1.08173,1.08234,1011,2084.45,-542125,-541643.4,44.85454883044664,33.184696793104465,32.81230239813068,NaN,NaN,50
1679628600,1.08234,1.08288,1.08234,1.08288,1354,2029.95,-540771,-541431.4,44.860303790857564,38.67623911189762,33.29434671484985,NaN,NaN,50
1679630400,1.08288,1.08304,1.08233,1.08278,1202,1954.2,-541973,-541922.2,44.560509071601146,38.05251479201656,33.693824032133016,NaN,NaN,50
1679632200,1.08278,1.08344,1.08268,1.08343,1227,1797.8,-540746,-541750.2,43.54343489302705,44.33626386671873,34.51186716479343,NaN,NaN,50
1679634000,1.08343,1.08364,1.08309,1.08358,1437,1533.9,-539309,-540984.8,42.2445277856807,45.70499337382018,35.34281258490442,NaN,NaN,50
1679635800,1.08358,1.08372,1.08322,1.08336,1577,1390.25,-540886,-540737,40.89388573001852,43.996249242366595,36.138394001947354,NaN,NaN,50
1679637600,1.08336,1.08354,1.08257,1.08294,1522,1410.65,-542408,-541064.4,40.31734206295677,40.855889851921866,36.633736484490086,NaN,NaN,50
1679639400,1.08294,1.08328,1.08246,1.08248,1710,1439.15,-544118,-541493.4,39.8878075856689,37.683354437191824,36.805460548636184,NaN,NaN,50
1679641200,1.08248,1.0833,1.08228,1.08279,2155,1520.45,-541963,-541736.8,39.66451116945374,41.00791389516552,37.27255405427259,NaN,NaN,50
1679643000,1.08279,1.08354,1.08267,1.08282,2161,1592.5,-539802,-541835.4,38.9591508672719,41.334095938302916,37.78073507692623,NaN,NaN,50
1679644800,1.08282,1.0831,1.07728,1.0787,6899,1886.4,-546701,-542998.4,41.07334840915736,22.739002884129263,37.30117958901623,NaN,NaN,50
1679646600,1.0787,1.07941,1.0768,1.078,6036,2132,-552737,-545064.2,43.149481901693484,21.009610944664942,36.48908128798855,NaN,NaN,50
1679648400,1.078,1.07908,1.07738,1.07862,4333,2295.85,-548404,-545921.4,45.07732014476274,26.352295825534114,36.07908250806771,NaN,NaN,50
1679650200,1.07862,1.07871,1.07214,1.07258,6249,2562.95,-554653,-548459.4,47.69722211530326,15.414280949886702,35.02481442190867,NaN,NaN,50
1679652000,1.07258,1.07426,1.07215,1.07368,7113,2831.3,-547540,-550007,50.129988230805175,21.781773521153397,34.2103199024836,NaN,NaN,50
1679653800,1.07368,1.07408,1.07248,1.07278,4568,2986.35,-552108,-551088.4,52.38898533805696,20.426871864745166,32.90679367054413,NaN,NaN,50
1679655600,1.07278,1.07472,1.07132,1.07454,4685,3058.4,-547423,-550025.6,54.61318311609996,29.643528872132478,32.30615181912385,NaN,NaN,50
1679657400,1.07454,1.07482,1.07321,1.07383,3416,3113.6,-550839,-550512.6,56.561371768813785,28.22334105507673,31.15522876114942,NaN,NaN,50
1679659200,1.07383,1.0739,1.07231,1.07378,4287,3223.6,-555126,-550607.2,58.4735188920021,28.12116584458785,29.899241080489965,NaN,NaN,50
1679661000,1.07378,1.07524,1.07378,1.07493,5238,3409,-549888,-551076.8,58.76519027323047,34.036175578057325,29.18780724732502,NaN,NaN,50
1679662800,1.07493,1.07636,1.07414,1.07632,3781,3547.5,-546107,-549876.6,57.961325051367105,40.4183491953804,29.15655434328634,NaN,NaN,50
1679664600,1.07632,1.07658,1.07422,1.0757,7459,3852.75,-553566,-551105.2,57.012541505914626,38.62331034052171,29.223694050667053,NaN,NaN,50
1679666400,1.0757,1.07675,1.07495,1.07561,5904,4087.85,-559470,-552831.4,55.96898068737951,38.3570076803468,29.034343606751428,NaN,NaN,50
1679668200,1.07561,1.0761,1.07494,1.075,4552,4254.1,-564022,-554610.6,55.00405519449524,36.519122590028246,28.690416939017524,NaN,NaN,50
1679670000,1.075,1.07544,1.07416,1.07476,4549,4409.7,-568571,-558347.2,54.42519494500735,35.79246250741579,29.622806912109418,NaN,NaN,50
1679671800,1.07476,1.0764,1.07444,1.07612,4564,4559.05,-564007,-561927.2,52.91409008253364,42.744905765802486,31.175327970762105,NaN,NaN,50
1679673600,1.07612,1.0767,1.07537,1.07584,3598,4662.85,-567605,-564735,51.22267256670118,41.742747582531244,32.27464595340476,NaN,NaN,50
1679675400,1.07584,1.07636,1.07512,1.07574,2717,4713.2,-570322,-566905.4,49.78579727077595,41.36970280353466,34.12860465723675,NaN,NaN,50
1679677200,1.07574,1.07646,1.07554,1.07634,2637,4737.3,-567685,-567638,48.346034133895074,44.57049074175716,35.75637017299417,NaN,NaN,50
1679679000,1.07634,1.07676,1.07594,1.07616,1957,4727.1,-569642,-567852.2,46.683876053667035,43.797996958014316,37.425736251084814,NaN,NaN,50
1679680800,1.07616,1.0762,1.07542,1.07546,1883,4476.3,-571525,-569355.8,45.469751851542064,40.8339874865939,38.22505472354635,NaN,NaN,50
1679682600,1.07546,1.07627,1.07542,1.07608,1612,4255.1,-569913,-569817.4,44.26044839632142,44.42163244258044,39.382075536939475,NaN,NaN,50
1679684400,1.07608,1.07665,1.0758,1.07656,1622,4119.55,-568291,-569411.2,42.6862682740413,47.096227453404374,40.73743708042637,NaN,NaN,50
1679686200,1.07656,1.07658,1.07576,1.0759,1479,3881.05,-569770,-569828.2,41.2553111871372,43.96343756545283,41.44652722238319,NaN,NaN,50
1679688000,1.0759,1.0763,1.0759,1.07596,632,3557,-569138,-569727.4,39.92656532072624,44.3260056127599,41.725645537910296,NaN,NaN,50
1679689800,1.07596,1.07618,1.07584,1.07598,927,3374.95,-568211,-569064.6,38.74547383999861,44.455016485395156,42.142195976829825,NaN,NaN,50
1679864400,1.07598,1.0775,1.07598,1.07702,186,3150,-568025,-568687,36.02295622744374,50.834979786405775,43.03347969869118,NaN,NaN,50
1679866200,1.07702,1.07702,1.07664,1.07666,60,2982.2,-568085,-568645.8,33.4949041586428,48.74769702448752,43.90694930115256,NaN,NaN,50
1679868000,1.07666,1.078,1.0766,1.0779,1351,2835.4,-566734,-568038.6,32.0425633869556,55.52204241441829,45.31620500879559,NaN,NaN,50
1679869800,1.0779,1.0779,1.07746,1.07776,1296,2638.3,-568030,-567817,30.69396124181748,54.643856779341185,46.16613008119121,NaN,NaN,50
1679871600,1.07776,1.0778,1.07742,1.07774,1154,2506.95,-569184,-568011.6,29.389583000692195,54.51121102035049,47.078163183892585,NaN,NaN,50
1679873400,1.07774,1.07789,1.0771,1.07776,1208,2194.4,-567976,-568001.8,27.755831887801236,54.629817178155655,48.02531421065123,NaN,NaN,50
1679875200,1.07776,1.07778,1.07651,1.07652,1796,1989,-569772,-568339.2,26.02743204066052,46.52941109610027,48.16523709310432,NaN,NaN,50
1679877000,1.07652,1.07694,1.0761,1.07611,1602,1841.5,-571374,-569267.2,24.877885398472042,44.19592035946361,48.19366019320783,NaN,NaN,50
1679878800,1.07611,1.07672,1.07608,1.0767,1953,1711.7,-569421,-569545.4,23.832713644978277,48.22023078732485,48.7212490004029,NaN,NaN,50
1679880600,1.0767,1.07672,1.07578,1.07616,2087,1587.85,-571508,-570010.2,23.201632010069254,45.02016409604568,48.7640012613647,NaN,NaN,50
1679882400,1.07616,1.07682,1.07614,1.07652,1374,1476.65,-570134,-570441.8,22.462421688034937,47.5205796871284,48.79431213520213,NaN,NaN,50
1679884200,1.07652,1.07704,1.07643,1.07698,1119,1396.75,-569015,-570290.4,21.434876720789724,50.61141159393407,49.26916742295079,NaN,NaN,50
1679886000,1.07698,1.07712,1.0769,1.07694,1010,1315.4,-570025,-570020.6,20.354875618172965,50.333802975058845,49.69829580597214,NaN,NaN,50
1679887800,1.07694,1.07748,1.07686,1.07716,1429,1289,-568596,-569855.6,19.00592177937642,51.8966176566518,50.22983874677618,NaN,NaN,50
1679889600,1.07716,1.07725,1.07693,1.07706,989,1244.3,-569585,-569471,17.753321786208193,51.10937405407659,50.249438337324094,NaN,NaN,50
1679891400,1.07706,1.07707,1.07642,1.07679,1034,1215.4,-570619,-569568,17.158549526936806,48.95026974956505,50.26390781768678,NaN,NaN,50
1679893200,1.07679,1.0769,1.07638,1.07666,1624,1215.5,-572243,-570213.6,16.664412246842478,47.90101238778717,49.71954853007027,NaN,NaN,50
1679895000,1.07666,1.07708,1.07638,1.07654,1508,1216.95,-573751,-570958.8,15.876885723073627,46.90161702762251,49.16653140494751,NaN,NaN,50
1679896800,1.07654,1.0766,1.07516,1.07573,2976,1334.15,-576727,-572585,16.71959268529389,40.725104827639534,48.18180953403958,NaN,NaN,50
1679898600,1.07573,1.07666,1.07512,1.07634,2433,1409.45,-574294,-573526.8,17.390689673091266,46.444963598790125,47.59717713551347,NaN,NaN,50
1679900400,1.07634,1.07822,1.07615,1.07621,3990,1599.65,-578284,-575059.8,16.579240921696396,45.4386391411305,47.51926485301563,NaN,NaN,50
1679902200,1.07621,1.07652,1.0745,1.07518,3314,1762.35,-581598,-576930.8,16.66837149053957,38.34889156982708,47.101619939470176,NaN,NaN,50
1679904000,1.07518,1.07724,1.07505,1.07689,3564,1873,-578034,-577787.4,15.9463272492921,51.79607738588286,47.35703755365288,NaN,NaN,50
1679905800,1.07689,1.07726,1.07632,1.07666,2585,1937.45,-580619,-578565.8,15.254146477688272,50.20974234118619,47.727721714020056,NaN,NaN,50
1679907600,1.07666,1.07691,1.07566,1.0763,2522,2005.85,-583141,-580335.2,15.227715804652936,47.74492569973157,47.743746429206,NaN,NaN,50
1679909400,1.0763,1.07694,1.07567,1.0766,2431,2067,-580710,-580820.4,15.166366624657734,49.94990719538569,47.696496115023976,NaN,NaN,50
1679911200,1.0766,1.07693,1.07622,1.07652,2333,2093.85,-583043,-581109.4,15.109399528947904,49.35186277222582,47.62635752910733,NaN,NaN,50
1679913000,1.07652,1.07696,1.07616,1.07678,2229,2125.2,-580814,-581665.4,15.119481095702822,51.38891479398762,47.59009303891703,NaN,NaN,50
1679914800,1.07678,1.07782,1.0767,1.07708,2244,2139.75,-578570,-581255.6,14.079164137327748,53.70271957232359,47.775332004506105,NaN,NaN,50
1679916600,1.07708,1.07809,1.07693,1.07718,2401,2155.45,-576169,-579861.2,13.427921602103442,54.4804917216595,48.170347859655706,NaN,NaN,50
1679918400,1.07718,1.07802,1.0768,1.07781,2646,2219.05,-573523,-578423.8,12.654799294608962,59.13788566995,48.97298166552448,NaN,NaN,50
1679920200,1.07781,1.07804,1.0768,1.07732,2920,2309.1,-576443,-577103.8,11.962693005753575,54.46977436413075,49.51356433241792,NaN,NaN,50
1679922000,1.07732,1.07946,1.07702,1.07942,3472,2432.2,-572971,-575535.2,12.850899859600956,66.62790445136497,51.363764305541174,NaN,NaN,50
1679923800,1.07942,1.07949,1.07814,1.07844,4380,2579.75,-577351,-575291.4,13.702664968995629,58.744310328380365,52.242289071940476,NaN,NaN,50
1679925600,1.07844,1.07917,1.07787,1.0786,3360,2698.3,-573991,-574855.8,14.081627166430069,59.58510158090147,53.25275067478126,NaN,NaN,50
1679927400,1.0786,1.07874,1.07756,1.07815,3756,2834.4,-577747,-575700.6,13.973952969026357,56.120877317572706,54.522178228191656,NaN,NaN,50
1679929200,1.07815,1.07861,1.07776,1.0782,2553,2880.85,-575194,-575450.8,13.87396978572291,56.424027322050165,54.852746080775034,NaN,NaN,50
1679931000,1.0782,1.07899,1.078,1.07879,1970,2903.95,-573224,-575501.4,14.22683078917337,59.94098096588594,55.54783455396788,NaN,NaN,50
1679932800,1.07879,1.07949,1.07866,1.07938,2017,2856,-571207,-574272.6,15.087106473322415,63.144359088936696,56.64779408176825,NaN,NaN,50
1679934600,1.07938,1.07948,1.07869,1.07912,1605,2814.6,-572812,-574036.8,15.885933894317962,60.83563537823116,57.42534609482863,NaN,NaN,50
1679936400,1.07912,1.07928,1.07862,1.07922,1944,2712.3,-570868,-572661,16.495174450501395,61.41990331077867,58.287348990439554,NaN,NaN,50
1679938200,1.07922,1.0796,1.07894,1.0794,1227,2607.95,-569641,-571550.4,17.42510035221106,62.504230687010114,59.081300125655446,NaN,NaN,50
1679940000,1.0794,1.07966,1.07892,1.07928,1423,2500.9,-571064,-571118.4,18.356261303027786,61.26793102650998,59.621672372383046,NaN,NaN,50
1679941800,1.07928,1.0796,1.07923,1.07958,1390,2441.15,-569674,-570811.8,19.220910757357608,63.226222238500604,60.24636740930026,NaN,NaN,50
1679943600,1.07958,1.07989,1.07946,1.07952,1258,2377.95,-570932,-570435.8,20.371752182893083,62.545116307777214,60.489741026287916,NaN,NaN,50
1679945400,1.07952,1.07973,1.07922,1.07973,1351,2323.95,-569581,-570178.4,20.87233266230191,64.00659694469067,61.17094263918506,NaN,NaN,50
1679947200,1.07973,1.08002,1.07964,1.07996,505,2232.55,-569076,-570065.4,21.70563962351651,65.59024760145212,61.09682429276271,NaN,NaN,50
1679949000,1.07996,1.08,1.07976,1.07992,647,2153.45,-569723,-569797.2,22.479424658930068,65.05416902952544,61.54752848570165,NaN,NaN,50
1679950800,1.07992,1.07992,1.07962,1.0798,121,2047.3,-569844,-569831.2,22.83581060800062,63.38057059698366,61.81863341542179,NaN,NaN,50
1679952600,1.0798,1.07981,1.07955,1.07973,163,1935.4,-570007,-569646.2,22.982991450136616,62.37254612231088,62.26518118718881,NaN,NaN,50
1679954400,1.07973,1.08014,1.0797,1.07978,438,1825,-569569,-569643.8,23.618222545111127,62.82731994017444,62.72255923134054,NaN,NaN,50
1679956200,1.07978,1.0801,1.07978,1.07998,513,1704.65,-569056,-569639.8,24.208079990444595,64.66689333840787,63.06012440080639,NaN,NaN,50
1679958000,1.07998,1.08076,1.07992,1.08073,593,1560.7,-568463,-569387.8,25.618738623262026,70.55212043944988,63.58925021155733,NaN,NaN,50
1679959800,1.08073,1.08079,1.08059,1.08064,826,1383,-569289,-569276.8,26.96308725817726,69.06547187922561,64.17709567591407,NaN,NaN,50
1679961600,1.08064,1.08112,1.08035,1.08078,1149,1272.45,-568140,-568903.4,28.578580999318522,70.12021317001037,64.79854638014491,NaN,NaN,50
1679963400,1.08078,1.0818,1.08076,1.08158,1575,1163.4,-566565,-568302.6,30.6921416964827,75.302308998917,65.7126948309954,NaN,NaN,50
1679965200,1.08158,1.08196,1.08109,1.08136,1776,1124.55,-568341,-568159.6,32.778365772212766,71.62355138852095,66.45238199971047,NaN,NaN,50
1679967000,1.08136,1.08178,1.08105,1.08152,1632,1107.65,-566709,-567808.8,34.5897431153902,72.66929611312268,67.12688727646919,NaN,NaN,50
1679968800,1.08152,1.08154,1.08109,1.08144,1100,1061.8,-567809,-567512.8,36.271736362626385,71.25532781928574,67.74904524157694,NaN,NaN,50
1679970600,1.08144,1.08179,1.08112,1.08139,1321,1047.6,-569130,-567710.8,38.05471669967302,70.3341998501627,68.20101687768208,NaN,NaN,50
1679972400,1.08139,1.0818,1.08135,1.08164,1173,1009.05,-567957,-567989.2,39.71913442635853,72.26478454388486,68.67776951642728,NaN,NaN,50
1679974200,1.08164,1.08168,1.08122,1.08152,979,996.65,-568936,-568108.2,40.77408456205035,69.91289983335017,69.02482171670047,NaN,NaN,50
1679976000,1.08152,1.08154,1.08102,1.08108,1039,977.45,-569975,-568761.4,41.02674617075693,61.95137294897179,68.92273617041391,NaN,NaN,50
1679977800,1.08108,1.08152,1.081,1.08123,861,951,-569114,-569022.4,41.18874748883545,63.47828316472496,69.0017173877292,NaN,NaN,50
1679979600,1.08123,1.08132,1.08062,1.0808,1476,961.9,-570590,-569314.4,40.04972863590184,56.480866411036665,68.54839927850507,NaN,NaN,50
1679981400,1.0808,1.08162,1.0808,1.08104,1155,952.1,-569435,-569610,39.50867580353468,59.185185096913315,68.1568486898269,NaN,NaN,50
1679983200,1.08104,1.08191,1.08091,1.0816,2303,1042,-567132,-569249.2,39.447593012836094,64.69761570407705,67.73866978015741,NaN,NaN,50
1679985000,1.0816,1.08186,1.0808,1.08082,2248,1122.05,-569380,-569130.2,39.034039369432755,53.798594594794665,66.6481785455552,NaN,NaN,50
1679986800,1.08082,1.08283,1.08082,1.08246,3055,1268.75,-566325,-568572.4,39.85807506400841,66.55576619516684,66.39357519020923,NaN,NaN,50
1679988600,1.08246,1.08342,1.08196,1.08206,3127,1416.95,-569452,-568344.8,41.1284695829064,62.05509310296551,65.44734548335556,NaN,NaN,50
1679990400,1.08206,1.0824,1.08183,1.08192,2556,1522.85,-572008,-568859.4,41.93834087008866,60.51271397146383,64.65371423928005,NaN,NaN,50
1679992200,1.08192,1.08204,1.08116,1.08123,2415,1617.95,-574423,-570317.6,41.01139465562756,53.46011289625278,63.28162972378935,NaN,NaN,50
1679994000,1.08123,1.08201,1.08103,1.08154,2160,1696.3,-572263,-570894.2,39.86317734215806,55.94439626170047,62.18799175539039,NaN,NaN,50
1679995800,1.08154,1.0823,1.08108,1.08164,2180,1764,-570083,-571645.8,39.17093261286539,56.7464809800078,61.21744040752219,NaN,NaN,50
1679997600,1.08164,1.08288,1.08145,1.0828,2487,1830.9,-567596,-571274.6,39.17954640964431,64.76111831182067,60.68146424808903,NaN,NaN,50
1679999400,1.0828,1.08294,1.08168,1.08227,1858,1845.05,-569454,-570763.8,39.24973324492374,59.35001500668206,59.926972474755594,NaN,NaN,50
1680001200,1.08227,1.08304,1.08204,1.0829,1910,1851.75,-567544,-569388,39.4221650964174,63.277814983271085,60.0217183343484,NaN,NaN,50
1680003000,1.0829,1.08367,1.0826,1.08314,2543,1897.3,-565001,-567935.6,40.18850982917903,64.67801305402693,60.107413326441396,NaN,NaN,50
1680004800,1.08314,1.08455,1.08301,1.08417,3171,2000.85,-561830,-566285,41.53945368825106,69.97008489679301,61.070928932566844,NaN,NaN,50
1680006600,1.08417,1.0847,1.08305,1.08396,4024,2136,-565854,-565936.6,42.88711714172756,67.74163420795526,61.68210386906985,NaN,NaN,50
1680008400,1.08396,1.08396,1.08272,1.08279,3076,2231.15,-568930,-565831.8,43.33320924994089,56.873566374350794,61.123243202660824,NaN,NaN,50
1680010200,1.08279,1.08315,1.08224,1.08241,3821,2373.25,-572751,-566873.2,42.69095370605041,53.851678581821396,61.12703491601987,NaN,NaN,50
1680012000,1.08241,1.08298,1.08163,1.08264,4076,2525.1,-568675,-567608,40.94774706107755,55.39645685799489,60.32994139193617,NaN,NaN,50
1680013800,1.08264,1.0841,1.0817,1.08322,3817,2672.9,-564858,-568213.6,40.44470424632766,59.11332284408889,60.119814944873546,NaN,NaN,50
1680015600,1.08322,1.08429,1.08312,1.0842,3012,2749.7,-561846,-567412,40.136891820065586,64.4967454679807,60.40438862319617,NaN,NaN,50
1680017400,1.0842,1.08461,1.08391,1.08427,2052,2794.55,-559794,-565584.8,40.114146766252276,64.85272494935091,61.21814662698889,NaN,NaN,50
1680019200,1.08427,1.08441,1.08314,1.08388,2130,2785.9,-561924,-563419.4,38.79456173906306,61.17258061204011,61.591588366298865,NaN,NaN,50
1680021000,1.08388,1.08431,1.08362,1.08421,1605,2753.75,-560319,-561748.2,37.56923278524451,63.081613255840296,62.044097814572616,NaN,NaN,50
1680022800,1.08421,1.08444,1.08366,1.08426,1581,2680.05,-558738,-560524.2,36.57037926444367,63.375437764268035,61.94512063260457,NaN,NaN,50
1680024600,1.08426,1.08434,1.08377,1.08378,1099,2578.65,-559837,-560122.4,35.64287242370005,58.55726873668567,61.888495899033394,NaN,NaN,50
1680026400,1.08378,1.08416,1.08356,1.08384,1335,2517.6,-558502,-559864,34.38929760160007,58.97710702207027,61.581302473233336,NaN,NaN,50
1680028200,1.08384,1.0844,1.08364,1.08432,1426,2468.15,-557076,-558894.4,33.52868242535502,62.270122245971926,61.40931027265798,NaN,NaN,50
1680030000,1.08432,1.08462,1.08414,1.08453,1104,2415.35,-555972,-558025,32.999702720716726,63.64509230599424,60.95752508760093,NaN,NaN,50
1680031800,1.08453,1.08487,1.08442,1.08478,910,2351.85,-555062,-557289.8,32.80533254078253,65.26781869990249,60.780823979882875,NaN,NaN,50
1680033600,1.08478,1.08478,1.08437,1.0844,574,2256.2,-555636,-556449.6,32.51345524963122,60.82372183456574,61.06297794132679,NaN,NaN,50
1680035400,1.0844,1.08468,1.0844,1.08454,416,2184.1,-555220,-555793.2,32.242426336419285,61.854249613075346,61.63459015784493,NaN,NaN,50
1680037200,1.08454,1.08454,1.08417,1.0843,366,2106.9,-555586,-555495.2,31.4388552269474,58.98954741159096,61.8912394831018,NaN,NaN,50
1680039000,1.0843,1.08446,1.08416,1.0842,1019,2030.7,-556605,-555621.8,30.668459786556657,57.78859576399933,61.79661612023826,NaN,NaN,50
1680040800,1.0842,1.08449,1.08418,1.08437,404,1892.35,-556201,-555849.6,30.003952601289985,59.305370754212454,61.42580364068339,NaN,NaN,50
1680042600,1.08437,1.08444,1.08408,1.08416,391,1710.7,-556592,-556040.8,29.1163672331897,56.59978563170904,60.83630797513755,NaN,NaN,50
1680044400,1.08416,1.08418,1.08364,1.08385,433,1578.55,-557025,-556401.8,27.210229067239794,52.77240918008943,60.23629572999821,NaN,NaN,50
1680046200,1.08385,1.08414,1.08377,1.08392,996,1437.3,-556029,-556490.4,25.440243627429165,53.53645562568757,59.554498756415875,NaN,NaN,50
1680048000,1.08392,1.08473,1.08392,1.08456,1320,1299.5,-554709,-556111.2,24.95989954482041,59.92071534997511,59.30773286968066,NaN,NaN,50
1680049800,1.08456,1.08476,1.08424,1.08472,1510,1184.15,-553199,-555510.8,24.566450040512365,61.35048778492324,59.50724851598335,NaN,NaN,50
1680051600,1.08472,1.08497,1.08438,1.08456,1637,1115.4,-554836,-555159.6,24.56881335586714,59.080740165211736,59.514650883350605,NaN,NaN,50
1680053400,1.08456,1.08462,1.08396,1.0845,1255,1075.55,-556091,-554972.8,23.494125097113603,58.211017691566525,59.22471484375021,NaN,NaN,50
1680055200,1.0845,1.08463,1.0841,1.08432,1083,1023.2,-557174,-555201.8,22.516188748747403,55.56820100709949,58.64779403668631,NaN,NaN,50
1680057000,1.08432,1.08436,1.08368,1.08379,1016,993.75,-558190,-555898,21.170228395351806,48.57518729867546,57.45546322231295,NaN,NaN,50
1680058800,1.08379,1.08392,1.08348,1.08365,1031,966.25,-559221,-557102.4,20.32780533697008,46.89633012627288,56.46064952886345,NaN,NaN,50
1680060600,1.08365,1.08382,1.0835,1.08366,837,953.15,-558384,-557812,19.54555535418705,47.03713813555537,55.40228442332631,NaN,NaN,50
1680062400,1.08366,1.08438,1.08336,1.08426,1258,949.3,-557126,-558019,18.739627903184257,54.784077441145676,55.10189371115165,NaN,NaN,50
1680064200,1.08426,1.08439,1.08372,1.08376,973,926.65,-558099,-558204,18.01152570138966,48.42710079169076,54.433215498843886,NaN,NaN,50
1680066000,1.08376,1.08409,1.08352,1.08352,1169,929.9,-559268,-558419.6,16.85136660761921,45.686712562636124,53.46045419944557,NaN,NaN,50
1680067800,1.08352,1.0839,1.08316,1.0832,1542,961.5,-560810,-558737.4,16.306097759474422,42.253433909597696,52.43571479072334,NaN,NaN,50
1680069600,1.0832,1.08342,1.08232,1.08267,2559,1060.75,-563369,-559734.4,17.18350824754007,37.259257135037835,51.32763250179107,NaN,NaN,50
1680071400,1.08267,1.08314,1.08226,1.08229,2208,1150.35,-565577,-561424.6,18.08062163936945,34.143245226445345,49.942403187559485,NaN,NaN,50
1680073200,1.08229,1.08342,1.08178,1.0833,2560,1260.05,-563017,-562408.2,19.526604156614873,46.86313400030319,49.009718805440066,NaN,NaN,50
1680075000,1.0833,1.08376,1.08272,1.0837,2300,1324.1,-560717,-562698,20.027194454405635,50.90725038449293,48.2637732768379,NaN,NaN,50
1680076800,1.0837,1.08374,1.08324,1.08356,2204,1414.1,-562921,-563120.2,20.4920283023542,49.4876145381464,47.578550017761806,NaN,NaN,50
1680078600,1.08356,1.08396,1.08268,1.08329,2896,1539.35,-565817,-563609.8,21.65837778482831,46.7782838679078,46.76192617321476,NaN,NaN,50
1680080400,1.08329,1.08454,1.08322,1.08434,2473,1641.35,-563344,-563163.2,21.421350568784952,56.70514601589551,46.84313653098591,NaN,NaN,50
1680082200,1.08434,1.08628,1.08434,1.08598,2863,1734.7,-560481,-562656,21.149328450088454,67.04444291413526,48.16236907494732,NaN,NaN,50
1680084000,1.08598,1.08626,1.08538,1.08554,2349,1786.15,-562830,-563078.6,20.896736482727416,62.716979795078856,49.29241547986203,NaN,NaN,50
1680085800,1.08554,1.08584,1.08508,1.08576,1850,1803.15,-560980,-562690.4,20.18105965120829,63.96925148022368,50.50185214733834,NaN,NaN,50
1680087600,1.08576,1.08618,1.08524,1.0861,2049,1823.75,-558931,-561313.2,19.932405758364744,65.87681061814133,51.29419023140946,NaN,NaN,50
1680089400,1.0861,1.08718,1.08545,1.08552,2485,1885.25,-561416,-560927.6,20.721677979433206,60.0375060288098,52.123504891203666,NaN,NaN,50
1680091200,1.08552,1.086,1.08391,1.08484,3078,1985,-564494,-561730.2,19.38320124438207,53.99461683691763,52.71692662508092,NaN,NaN,50
1680093000,1.08484,1.08558,1.08428,1.08538,3431,2105.75,-561063,-561376.8,18.140329990406016,57.640806075997126,53.816024636966596,NaN,NaN,50
1680094800,1.08538,1.08586,1.08326,1.08366,3185,2213.45,-564248,-562030.4,17.761742701225995,45.31998433055787,54.39179086521803,NaN,NaN,50
1680096600,1.08366,1.08502,1.0833,1.08468,3764,2359.8,-560484,-562341,17.410197361273116,51.88780396041078,55.659259346215556,NaN,NaN,50
1680098400,1.08468,1.08529,1.0835,1.08364,3525,2473.15,-564009,-562859.6,16.739475088704854,45.84175482849062,55.58630369108609,NaN,NaN,50
1680100200,1.08364,1.08399,1.0826,1.08312,5132,2681.1,-569141,-563789,16.990150595644373,43.135340407326645,55.03116726414563,NaN,NaN,50
1680102000,1.08312,1.08385,1.0829,1.08341,3454,2795.35,-565687,-564713.8,17.222920709231072,45.08259358426021,54.716522910296625,NaN,NaN,50
1680103800,1.08341,1.08438,1.08246,1.08252,2640,2850.25,-568327,-565529.6,16.724070205090904,40.49904867185955,54.26800611057889,NaN,NaN,50
1680105600,1.08252,1.08356,1.08252,1.08266,1830,2813.8,-566497,-566732.2,16.260851879817892,41.50649736704192,53.1823883499465,NaN,NaN,50
1680107400,1.08266,1.08322,1.08235,1.08276,1672,2787,-564825,-566895.4,16.02329862191163,42.2585416693042,51.41196683245856,NaN,NaN,50
1680109200,1.08276,1.08354,1.08259,1.08353,1577,2737.85,-563248,-565716.8,15.339731297473522,47.82146514726382,50.34800150047177,NaN,NaN,50
1680111000,1.08353,1.08482,1.08348,1.08465,1659,2705.8,-561589,-564897.2,15.290353459806333,54.66336346787259,49.68329521387526,NaN,NaN,50
1680112800,1.08465,1.08472,1.08375,1.0838,1349,2663.05,-562938,-563819.4,15.244502610543945,49.37218214571752,48.504393180130705,NaN,NaN,50
1680114600,1.0838,1.0845,1.08371,1.08446,1039,2570.2,-561899,-562899.8,15.143513663024901,53.16317878367917,48.01336980547852,NaN,NaN,50
1680116400,1.08446,1.0847,1.08398,1.08426,1848,2538.95,-563747,-562684.2,15.277395651645076,51.89505710194476,47.86340125298045,NaN,NaN,50
1680118200,1.08426,1.0843,1.08392,1.08394,1504,2471,-565251,-563084.8,15.303012138169553,49.84631310369797,47.306651754959084,NaN,NaN,50
1680120000,1.08394,1.08436,1.08384,1.0841,507,2378.9,-564744,-563715.8,15.189080986424367,50.8902732170297,47.704529532564216,NaN,NaN,50
1680121800,1.0841,1.08454,1.0841,1.08453,427,2307.75,-564317,-563991.6,15.322638242391912,53.68073365549885,47.83259593935622,NaN,NaN,50
1680123600,1.08453,1.08453,1.08416,1.08419,433,2226.95,-564750,-564561.8,15.44665569436178,51.20330318220222,48.21556367890704,NaN,NaN,50
1680125400,1.08419,1.08428,1.08413,1.08414,2870,2246.2,-567620,-565336.4,15.49952186886757,50.83177303335276,48.76530886648034,NaN,NaN,50
1680127200,1.08414,1.08482,1.08414,1.08474,451,2114.85,-567169,-565720,16.304085621440116,55.0469975917334,49.47705200987128,NaN,NaN,50
1680129000,1.08474,1.08484,1.08394,1.08444,602,1973.4,-567771,-566325.4,16.617275641155015,52.61801011360647,50.34269211285319,NaN,NaN,50
1680130800,1.08444,1.08456,1.08401,1.08444,426,1835.45,-567771,-567016.2,16.908094945175993,52.61801011360647,51.13637159475066,NaN,NaN,50
1680132600,1.08444,1.0846,1.08426,1.08426,883,1691.4,-568654,-567797,17.24041935353109,51.05049332865272,51.764368141846994,NaN,NaN,50
1680134400,1.08426,1.08434,1.08372,1.08392,1398,1585.05,-570052,-568283.4,16.352491602660272,48.13362107139556,51.78666499357069,NaN,NaN,50
1680136200,1.08392,1.08414,1.08356,1.08378,1366,1396.75,-571418,-569133.2,15.212669812946858,46.944206456013525,51.23529663558075,NaN,NaN,50
1680138000,1.08378,1.08379,1.08302,1.08324,1398,1293.95,-572816,-570142.2,15.049880310152714,42.57420400607147,50.74972676846318,NaN,NaN,50
1680139800,1.08324,1.08354,1.08286,1.0832,1696,1246.75,-574512,-571490.4,15.15146628340936,42.26038155720701,49.97095553800089,NaN,NaN,50
1680141600,1.0832,1.08344,1.0829,1.0833,1058,1208.15,-573454,-572450.4,15.245796115719104,43.38395556947803,49.363019714253255,NaN,NaN,50
1680143400,1.0833,1.08347,1.08274,1.08306,926,1170.85,-574380,-573316,15.601944433058348,41.30645284045232,48.753029695449996,NaN,NaN,50
1680145200,1.08306,1.08356,1.08265,1.08345,948,1139.4,-573432,-573718.8,15.93265358487336,45.84473207310347,48.39263389945527,NaN,NaN,50
1680147000,1.08345,1.08363,1.08328,1.0833,857,1099.3,-574289,-574013.4,16.047978254538943,44.4220407006118,47.7312986883919,NaN,NaN,50
1680148800,1.0833,1.08374,1.0832,1.08362,530,1058.35,-573759,-573862.8,15.849343292985814,48.12081480215293,47.51112094695981,NaN,NaN,50
1680150600,1.08362,1.0841,1.08359,1.08391,882,1050.5,-572877,-573747.4,14.744710356916752,51.28492287710471,47.54348879294209,NaN,NaN,50
1680152400,1.08391,1.08454,1.08384,1.08432,985,1007.35,-571892,-573249.8,14.597710365868446,55.42422919599647,47.57043390753232,NaN,NaN,50
1680154200,1.08432,1.08466,1.08363,1.08416,2383,1051.3,-574275,-573418.4,13.956305010885913,53.51329099806798,47.6343825421367,NaN,NaN,50
1680156000,1.08416,1.08462,1.08326,1.08384,2557,1153.8,-576832,-573927,13.360560719307776,49.814042979243766,47.43409917539651,NaN,NaN,50
1680157800,1.08384,1.08505,1.0835,1.08466,2176,1241.25,-574656,-574106.4,12.891377993485525,57.85404637109939,47.920067249856984,NaN,NaN,50
1680159600,1.08466,1.08475,1.08236,1.08428,4485,1443.85,-579141,-575359.2,13.401364068797061,53.57095044792044,48.30844791960875,NaN,NaN,50
1680161400,1.08428,1.08578,1.08396,1.08548,2727,1436.7,-576414,-576263.6,12.69715090117924,62.90932229038029,49.44881333634925,NaN,NaN,50
1680163200,1.08548,1.08678,1.08504,1.08628,3273,1577.8,-573141,-576036.8,13.216991568565723,67.58948287231883,51.23561896965263,NaN,NaN,50
1680165000,1.08628,1.08794,1.08624,1.08733,3145,1704.95,-569996,-574669.6,14.702728285881467,72.49506551068814,53.395239252044135,NaN,NaN,50
1680166800,1.08733,1.08764,1.08635,1.08656,2603,1813.8,-572599,-574258.2,16.082340951960376,64.75469089927601,54.92172034702971,NaN,NaN,50
1680168600,1.08656,1.08686,1.0859,1.08606,1924,1865.85,-574523,-573334.6,16.662969474714824,60.25569501555536,56.27523764525136,NaN,NaN,50
1680170400,1.08606,1.0868,1.086,1.08634,1973,1894.6,-572550,-572561.8,17.202124531558244,61.85402268465817,57.41875840321955,NaN,NaN,50
1680172200,1.08634,1.08846,1.08624,1.08786,2378,1945.2,-570172,-571968,18.99339873950108,69.11518513673589,59.18255443437126,NaN,NaN,50
1680174000,1.08786,1.08811,1.08724,1.08751,1969,1973.75,-572141,-572397,20.65672478973372,65.99981765445939,60.45962606667887,NaN,NaN,50
1680175800,1.08751,1.08792,1.08725,1.08788,1360,1956.95,-570781,-572033.4,22.201241836378312,67.65941249140083,61.62923246770002,NaN,NaN,50
1680177600,1.08788,1.0897,1.08788,1.08938,3178,2062.95,-567603,-570649.4,24.63324544131711,73.34066787807096,62.9089780878482,NaN,NaN,50
1680179400,1.08938,1.09111,1.08902,1.09102,4451,2239.2,-563152,-568769.8,27.426317267671735,77.90979660934842,64.65158563151108,NaN,NaN,50
1680181200,1.09102,1.09264,1.09072,1.09178,5082,2445.9,-558070,-566349.4,30.451551658081744,79.65038009375044,66.78275256826156,NaN,NaN,50
1680183000,1.09178,1.09206,1.09146,1.09172,3911,2598.6,-561981,-564317.4,33.26069787774818,79.12034374849236,68.30177380950391,NaN,NaN,50
1680184800,1.09172,1.0921,1.0908,1.09182,3792,2761.7,-558189,-561799,34.93592336055224,79.36678765187614,70.14433360978647,NaN,NaN,50
1680186600,1.09182,1.09192,1.09126,1.09126,3444,2889.8,-561633,-560605,36.491489880298865,74.09275075875544,70.94314992895612,NaN,NaN,50
1680188400,1.09126,1.09134,1.09009,1.09024,2812,2981.15,-564445,-560863.6,36.40680033919687,65.54867472758852,70.79737791861824,NaN,NaN,50
1680190200,1.09024,1.09028,1.08946,1.08984,2375,2980.75,-566820,-562613.6,35.6187637941678,62.50466309805672,70.08377774628742,NaN,NaN,50
1680192000,1.08984,1.09068,1.08966,1.09046,1952,2950.5,-564868,-563191,35.141755898774626,65.20210296612376,70.11573575106232,NaN,NaN,50
1680193800,1.09046,1.09062,1.0902,1.09049,1813,2932.35,-563055,-564164.2,34.69881999590953,65.33206506999728,70.47833361209389,NaN,NaN,50
1680195600,1.09049,1.09055,1.08951,1.08954,1814,2798.8,-564869,-564811.4,33.48380709561113,57.95111051700586,70.19955417154729,NaN,NaN,50
1680197400,1.08954,1.09,1.08922,1.09,1473,2736.1,-563396,-564601.6,32.036164678688635,60.29048443704562,69.56921840728371,NaN,NaN,50
1680199200,1.09,1.09035,1.08962,1.09016,1286,2636.75,-562110,-563659.6,30.98365276512957,61.10112620272442,69.21931187501693,NaN,NaN,50
1680201000,1.09016,1.09062,1.08998,1.09054,1061,2532.55,-561049,-562895.8,30.228582707437678,63.031386368312674,68.88873858051063,NaN,NaN,50
1680202800,1.09054,1.09064,1.09025,1.09044,999,2452.35,-562048,-562694.4,29.544458368644698,62.15726486686107,68.08992407970992,NaN,NaN,50
1680204600,1.09044,1.09078,1.09041,1.0907,996,2405.95,-561052,-561931,29.03424082620742,63.57179043284949,67.06578078138855,NaN,NaN,50
1680206400,1.0907,1.09075,1.09022,1.09039,506,2332.6,-561558,-561563.4,28.287366150978734,60.660360777292716,65.70935083021301,NaN,NaN,50
1680208200,1.09039,1.09062,1.09028,1.09062,380,2232.7,-561178,-561377,27.59383966683781,62.04908168201987,64.48997496832212,NaN,NaN,50
1680210000,1.09062,1.09068,1.0905,1.09063,92,2138.85,-561086,-561384.4,27.01563260447654,62.11170650231058,63.25746917192458,NaN,NaN,50
1680211800,1.09063,1.0907,1.09055,1.09062,169,2079.3,-561255,-561225.8,26.501978527918745,62.00152434945234,62.39381014268865,NaN,NaN,50
1680213600,1.09062,1.09064,1.09026,1.09037,362,1938.5,-561617,-561338.8,25.516652274523043,59.17532286297614,61.93857072378777,NaN,NaN,50
1680215400,1.09037,1.09046,1.09024,1.09025,325,1732.2,-561942,-561415.6,24.56634869724284,57.81308539337955,61.603458030596535,NaN,NaN,50
1680217200,1.09025,1.09052,1.09021,1.09048,585,1507.35,-561357,-561451.4,23.771654810236182,59.72672607521826,61.21235968124615,NaN,NaN,50
1680219000,1.09048,1.09062,1.09026,1.09042,938,1358.7,-562295,-561693.2,23.185183893771054,58.97517249382383,60.75829592580518,NaN,NaN,50
1680220800,1.09042,1.0912,1.09038,1.09117,1710,1254.6,-560585,-561559.2,23.440997035683473,64.91773268092285,61.2559117946564,NaN,NaN,50
1680222600,1.09117,1.09172,1.09078,1.09156,2003,1182.55,-558582,-560952.2,24.27265371726739,67.54999754253092,61.7744484450482,NaN,NaN,50
1680224400,1.09156,1.09238,1.09131,1.09207,2082,1146.05,-556500,-559863.8,25.668015007280935,70.6511510113337,62.45659307423458,NaN,NaN,50
1680226200,1.09207,1.09258,1.09077,1.09083,2302,1142.4,-558802,-559352.8,25.87620510090004,56.510383763113616,61.99080717386322,NaN,NaN,50
1680228000,1.09083,1.09102,1.0904,1.09094,1878,1138.7,-556924,-558278.6,25.40401286937935,57.32634450224073,61.64574143353319,NaN,NaN,50
1680229800,1.09094,1.09126,1.09072,1.09075,1244,1110.25,-558168,-557795.2,25.243380537156746,55.39310785760081,61.061549821015426,NaN,NaN,50
1680231600,1.09075,1.09083,1.09022,1.0904,1134,1076.25,-559302,-557939.2,24.236111580758823,51.91965286197363,60.43721354134978,NaN,NaN,50
1680233400,1.0904,1.09076,1.09014,1.09069,920,1048.6,-558382,-558315.6,23.16956049749091,54.46732616054398,59.895659575530075,NaN,NaN,50
1680235200,1.09069,1.09095,1.09058,1.09064,790,1023.8,-559172,-558389.6,22.44198013453608,53.93666546237436,59.3117280726775,NaN,NaN,50
1680237000,1.09064,1.09068,1.09022,1.09033,927,1017.1,-560099,-559024.6,21.149445899647695,50.64230793150338,58.50035547139543,NaN,NaN,50
1680238800,1.09033,1.09042,1.08968,1.08978,1305,1032.4,-561404,-559671.8,20.147530810127982,45.34995087152947,57.5128289005778,NaN,NaN,50
1680240600,1.08978,1.09014,1.08946,1.08956,1290,1047.1,-562694,-560350.2,19.522387742997363,43.396359964966265,56.48306279854828,NaN,NaN,50
1680242400,1.08956,1.08988,1.08879,1.08923,2125,1128.05,-564819,-561637.6,19.771642011378486,40.572978025217814,55.11493793783397,NaN,NaN,50
1680244200,1.08923,1.09052,1.08923,1.0904,2366,1227.35,-562453,-562293.8,18.958899591904995,52.39791664575036,54.64513394868586,NaN,NaN,50
1680246000,1.0904,1.09109,1.08886,1.08932,3221,1383.8,-565674,-563408.8,17.797377863840858,43.74494335054775,53.132791853659064,NaN,NaN,50
1680247800,1.08932,1.08938,1.088,1.08847,2987,1524.7,-568661,-564860.2,17.379157997806786,38.37380801054712,51.04877831566023,NaN,NaN,50
1680249600,1.08847,1.08874,1.0873,1.08755,3601,1686.65,-572262,-566773.8,17.689469872711516,33.56944336639964,48.40008491245066,NaN,NaN,50
1680251400,1.08755,1.0892,1.08732,1.08897,3439,1842.35,-568823,-567574.6,17.343961498846802,45.01267866684613,47.578820262717265,NaN,NaN,50
1680253200,1.08897,1.08962,1.08754,1.08933,3751,2000.65,-565072,-568098.4,16.484108697977447,47.482599306744234,46.87569560589609,NaN,NaN,50
1680255000,1.08933,1.08934,1.08811,1.08837,2387,2073.1,-567459,-568455.4,15.685673954313046,42.05739364331053,45.92314459058964,NaN,NaN,50
1680256800,1.08837,1.08887,1.08797,1.0881,1735,2074.35,-569194,-568562,15.114714942762623,40.650614093421005,45.11821324997873,NaN,NaN,50
1680258600,1.0881,1.08858,1.08676,1.08693,1943,2071.35,-571137,-568337,15.837199306360525,35.16198529472719,43.73926033099182,NaN,NaN,50
1680260400,1.08693,1.08794,1.08642,1.08789,1800,2057.25,-569337,-568439.8,16.798431104931808,42.0730856464315,42.891861772710186,NaN,NaN,50
1680262200,1.08789,1.08789,1.08656,1.08672,2061,2045.2,-571398,-569705,17.691003489319428,36.90946266189587,41.910944253452506,NaN,NaN,50
1680264000,1.08672,1.08789,1.08672,1.0877,1883,2045.45,-569515,-570116.2,18.51982070339364,43.197857143870856,41.757223272905456,NaN,NaN,50
1680265800,1.0877,1.08946,1.08745,1.08872,5131,2239.8,-564384,-569154.2,17.30899765247852,48.90611114840002,42.150776928865014,NaN,NaN,50
1680267600,1.08872,1.08886,1.08777,1.08796,3432,2354.7,-567816,-568490,16.184661962343053,45.256725171811176,42.48533029647883,NaN,NaN,50
1680269400,1.08796,1.08941,1.08774,1.08916,3613,2489.35,-564203,-567463.2,15.76221287374588,51.42069246216332,42.41552856907976,NaN,NaN,50
1680271200,1.08916,1.09019,1.08798,1.08827,3530,2626.35,-567733,-566730.2,16.132382897768526,47.177812048767635,42.660733476095466,NaN,NaN,50
1680273000,1.08827,1.08884,1.08575,1.0867,5364,2848.2,-573097,-567446.6,15.799921698478178,40.78467256905838,42.832938087417695,NaN,NaN,50
1680274800,1.0867,1.08691,1.08588,1.0864,4568,3011.35,-577665,-570102.8,15.491207727708572,39.67821492145634,43.26927891277889,NaN,NaN,50
1680276600,1.0864,1.08758,1.08626,1.0872,2396,3066.65,-575269,-571593.4,14.524281712772938,44.03818046562694,43.199671898406095,NaN,NaN,50
1680278400,1.0872,1.08724,1.08588,1.08645,2295,3075.15,-577564,-574265.6,13.97373398121949,41.043122540035306,42.739709272212586,NaN,NaN,50
1680280200,1.08645,1.08694,1.08598,1.08694,1500,3031.85,-576064,-575931.8,13.462511087634146,43.73546377549557,42.85957142451152,NaN,NaN,50
1680282000,1.08694,1.08712,1.08572,1.08576,1547,2948.15,-577611,-576834.6,13.239818701202674,39.10429412575837,42.7491199982499,NaN,NaN,50
1680283800,1.08576,1.0858,1.08482,1.08534,1489,2873.25,-579100,-577121.6,13.825124057546315,37.57899817041073,42.92176377508445,NaN,NaN,50
1680285600,1.08534,1.0858,1.08518,1.0856,1190,2752.7,-577910,-577649.8,14.368621888436838,39.16104791070958,42.713761079675734,NaN,NaN,50
1680287400,1.0856,1.08622,1.08552,1.08555,1324,2646.95,-579234,-577983.8,14.329077313321056,38.95656763400092,42.859982863397526,NaN,NaN,50
1680289200,1.08555,1.08566,1.08435,1.08481,1725,2545.65,-580959,-578962.8,15.267544483815007,35.96357037404,42.343248094123894,NaN,NaN,50
1680291000,1.08481,1.08488,1.08432,1.08458,1720,2512.3,-582679,-579976.4,16.16154210935926,35.06191198275728,41.35437672514941,NaN,NaN,50
1680292800,1.08458,1.08461,1.08384,1.08386,863,2468.7,-583542,-580864.8,17.351760057698254,32.32937597461374,40.4309946396353,NaN,NaN,50
1680294600,1.08386,1.08442,1.08368,1.08422,715,2407.3,-582827,-581848.2,18.57425880362142,35.05478774157237,39.26200144530738,NaN,NaN,50
1680469200,1.08422,1.08443,1.08414,1.08418,110,2322.8,-582937,-582588.8,19.693658650485595,34.88666226048804,38.38406217471597,NaN,NaN,50
1680471000,1.08418,1.0842,1.08404,1.08415,102,2224.85,-583039,-583004.8,20.814744014396062,34.75204136795509,37.95315994606574,NaN,NaN,50
1680472800,1.08415,1.08425,1.08292,1.08332,1896,2225.5,-584935,-583456,22.655658330172983,31.16851446325495,37.345324199051355,NaN,NaN,50
1680474600,1.08332,1.08334,1.08052,1.08196,1997,2068.8,-586932,-584134,25.455088927054213,26.37019471547957,36.08332521689798,NaN,NaN,50
1680476400,1.08196,1.08231,1.081,1.08103,1421,1968.25,-588353,-585239.2,28.05456019558679,23.685003276368477,34.843459555207495,NaN,NaN,50
1680478200,1.08103,1.08136,1.08012,1.08027,1485,1861.85,-589838,-586619.4,30.76357951812682,21.737052827690974,33.27214448750717,NaN,NaN,50
1680480000,1.08027,1.08114,1.07987,1.08075,2200,1795.35,-587638,-587539.2,33.357051136137386,25.883098117988823,32.32777334409506,NaN,NaN,50
1680481800,1.08075,1.08148,1.08064,1.08139,1733,1613.8,-585905,-587733.2,35.229724893054545,31.122465551279873,31.866592442728567,NaN,NaN,50
1680483600,1.08139,1.0817,1.08098,1.08134,1958,1483.3,-587863,-587919.4,36.62300374920703,30.93845828174551,31.279264612088276,NaN,NaN,50
1680485400,1.08134,1.08165,1.08028,1.08076,2228,1474.9,-590091,-588267,38.22108632458518,28.810539492408566,30.55454831626025,NaN,NaN,50
1680487200,1.08076,1.0808,1.08028,1.08054,1548,1437.55,-591639,-588627.2,39.70502014457918,28.02321509044188,29.98738008171753,NaN,NaN,50
1680489000,1.08054,1.08054,1.07908,1.07939,1326,1428.85,-592965,-589692.6,41.54465397441822,24.286968932889906,29.217741292441286,NaN,NaN,50
1680490800,1.07939,1.0798,1.07909,1.0793,1190,1411,-594155,-591342.6,43.25288538784018,24.017091060095524,28.624006655689985,NaN,NaN,50
1680492600,1.0793,1.07952,1.07882,1.07902,989,1386,-595144,-592798.8,44.936576662227985,23.155027155833935,27.77402375670867,NaN,NaN,50
1680494400,1.07902,1.07949,1.07898,1.07924,703,1361.65,-594441,-593668.8,46.500004274159515,25.42014055791286,27.097843635096158,NaN,NaN,50
1680496200,1.07924,1.0796,1.07908,1.0793,1016,1346.25,-593425,-594026,47.73338429285833,26.060266783603126,26.477002593356733,NaN,NaN,50
1680498000,1.0793,1.07956,1.07911,1.07935,1103,1315.15,-592322,-593897.4,48.87866573879295,26.6254547671781,26.152498329351243,NaN,NaN,50
1680499800,1.07935,1.07958,1.07891,1.07953,1503,1304.3,-590819,-593230.2,50.03843152640145,28.737311381324346,26.3215780911973,NaN,NaN,50
1680501600,1.07953,1.08083,1.07914,1.08072,2580,1390.15,-588239,-591849.2,48.75337378002454,40.85676916997838,27.54813279788372,NaN,NaN,50
1680503400,1.08072,1.08164,1.08066,1.08149,2248,1466.8,-585991,-590159.2,46.40354942011503,47.12312709442517,29.361423816936163,NaN,NaN,50
1680505200,1.08149,1.08329,1.08126,1.08288,3349,1628.75,-582642,-588002.6,43.71064245854609,56.15433037746098,31.523654692612748,NaN,NaN,50
1680507000,1.08288,1.0842,1.08256,1.08392,2607,1754,-580035,-585545.2,41.93930551397617,61.45843865512979,33.69050991431631,NaN,NaN,50
1680508800,1.08392,1.08397,1.08298,1.08342,2073,1762.85,-582108,-583803,40.29449263687553,57.83596678208774,35.61176052148362,NaN,NaN,50
1680510600,1.08342,1.08498,1.08308,1.08428,2036,1764.8,-580072,-582169.6,39.495959990290366,61.98624663503115,37.9814538888138,NaN,NaN,50
1680512400,1.08428,1.08539,1.08428,1.08472,2365,1812,-577707,-580512.8,39.018458905288966,63.941836370788195,40.547069694552825,NaN,NaN,50
1680514200,1.08472,1.08544,1.08445,1.08508,1916,1833.55,-575791,-579142.6,38.607704635706604,65.50542430809026,43.49124507849569,NaN,NaN,50
1680516000,1.08508,1.08714,1.08498,1.08643,2624,1854.75,-573167,-577769,39.176620108441625,70.64590117636023,46.82187437251459,NaN,NaN,50
1680517800,1.08643,1.08722,1.08613,1.08705,2109,1873.55,-571058,-575559,39.743072443374196,72.66091997707873,50.358009574032074,NaN,NaN,50
1680519600,1.08705,1.08726,1.08608,1.08626,2509,1901.1,-573567,-574258,40.19879177437575,66.40578940788575,53.28555592045871,NaN,NaN,50
1680521400,1.08626,1.08779,1.08622,1.08766,2986,1939,-570581,-572832.8,40.89491534285411,71.14627661617337,56.50598519421373,NaN,NaN,50
1680523200,1.08766,1.08766,1.08652,1.0866,2816,2002.4,-573397,-572354,41.5413157992983,63.80493668966716,59.16166247439152,NaN,NaN,50
1680525000,1.0866,1.087,1.08618,1.08652,2632,2067.7,-576029,-572926.4,41.60468714539637,63.27427329822379,61.62858832559863,NaN,NaN,50
1680526800,1.08652,1.08766,1.08645,1.08764,2628,2139.6,-573401,-573395,42.05357024446131,67.36634540402498,63.52212948517339,NaN,NaN,50
1680528600,1.08764,1.0897,1.08691,1.08854,3783,2279.3,-569618,-572605.2,43.3635662218128,70.23626348928408,65.17306779909188,NaN,NaN,50
1680530400,1.08854,1.09166,1.08854,1.09092,6776,2582.95,-562842,-571057.4,45.142684620191545,76.19760033814173,66.6047299391405,NaN,NaN,50
1680532200,1.09092,1.09094,1.08842,1.08872,5387,2801.5,-568229,-570023.8,46.639138421131676,63.53070229834374,66.75274877079865,NaN,NaN,50
1680534000,1.08872,1.08916,1.08784,1.08836,3915,2942.1,-572144,-569246.8,47.279806203419255,61.722540550904334,67.03036118285696,NaN,NaN,50
1680535800,1.08836,1.08942,1.08834,1.08904,2317,2982.8,-569827,-568532,47.9684818734072,63.81735256853605,67.1611544638216,NaN,NaN,50
1680537600,1.08904,1.08938,1.08856,1.08886,1778,2942.7,-571605,-568929.4,48.60796642411029,62.83703694248493,67.0822402189428,NaN,NaN,50
1680539400,1.08886,1.08897,1.0884,1.08886,1510,2905.8,-571605,-570682,48.97009255713773,62.83703694248493,66.89164112139956,NaN,NaN,50
1680541200,1.08886,1.08888,1.088,1.08826,1549,2815.8,-573154,-571667,48.72769127203435,59.31464875116533,66.08226594817135,NaN,NaN,50
1680543000,1.08826,1.08881,1.0882,1.0887,1212,2746.05,-571942,-571626.6,48.502604364438355,61.039425847513435,65.25215922463097,NaN,NaN,50
1680544800,1.0887,1.09004,1.0886,1.08974,1561,2720.45,-570381,-571737.4,48.90876981340932,64.83415915409955,65.13989992078909,NaN,NaN,50
1680546600,1.08974,1.09008,1.08952,1.08966,1377,2687.5,-571758,-571768,49.30395867151001,64.31522644601941,64.6519677657781,NaN,NaN,50
1680548400,1.08966,1.09,1.08948,1.08983,1132,2625.85,-570626,-571572.2,49.605827491794635,64.95710194004792,64.73426528366244,NaN,NaN,50
1680550200,1.08983,1.09074,1.08976,1.09062,1310,2595.55,-569316,-570804.6,50.23529361701611,67.8510913523028,65.0611808589538,NaN,NaN,50
1680552000,1.09062,1.09082,1.09031,1.0906,686,2498.65,-570002,-570416.6,50.85573227457589,67.69866340375384,65.08491785893443,NaN,NaN,50
1680553800,1.0906,1.09072,1.09021,1.09028,494,2417.9,-570496,-570439.6,51.249938406873696,65.17577166260678,64.7234541570289,NaN,NaN,50
1680555600,1.09028,1.0906,1.09028,1.09041,125,2298.7,-570371,-570162.2,51.61598695829309,65.73444044753947,63.97608559341445,NaN,NaN,50
1680557400,1.09041,1.09046,1.09007,1.09014,297,2164.25,-570668,-570170.6,51.53631011871437,63.457452999817754,63.9708535006626,NaN,NaN,50
1680559200,1.09014,1.09062,1.09014,1.09047,531,2050,-570137,-570334.8,51.56804272862393,65.05090315329045,64.20859368654733,NaN,NaN,50
1680561000,1.09047,1.0905,1.09034,1.09037,284,1932.6,-570421,-570418.6,51.59750872353997,64.13820491453257,64.23151171126136,NaN,NaN,50
1680562800,1.09037,1.09091,1.09037,1.09084,651,1833.75,-569770,-570273.4,51.90478561711418,66.51609882475398,64.49430184570916,NaN,NaN,50
1680564600,1.09084,1.09096,1.09068,1.09068,622,1675.7,-570392,-570277.6,52.223517941307826,64.93753176724468,64.64433719033485,NaN,NaN,50
1680566400,1.09068,1.09098,1.09024,1.09081,1590,1416.4,-568802,-569904.4,51.4995421060508,65.65081297350903,65.0969203490737,NaN,NaN,50
1680568200,1.09081,1.09082,1.08987,1.09011,1471,1220.6,-570273,-569931.6,50.05207898009514,58.723431656483775,64.93149219257158,NaN,NaN,50
1680570000,1.09011,1.09017,1.0895,1.08981,1376,1093.65,-571649,-570177.2,47.99554502598756,55.996359215882656,64.30022076841323,NaN,NaN,50
1680571800,1.08981,1.09002,1.08902,1.08932,1510,1053.3,-573159,-570855,45.25447311002457,51.76769154495045,63.40396827547973,NaN,NaN,50
1680573600,1.08932,1.08958,1.08884,1.08921,1354,1032.1,-574513,-571679.2,42.41698021786345,50.839523684437474,62.395569828650416,NaN,NaN,50
1680575400,1.08921,1.08946,1.08884,1.08909,996,1006.4,-575509,-573020.6,39.78216538942812,49.79073141560961,61.10554411888661,NaN,NaN,50
1680577200,1.08909,1.08916,1.0889,1.08891,907,974.3,-576416,-574249.2,37.33555162016675,48.18498960288519,59.71171027596743,NaN,NaN,50
1680579000,1.08891,1.08926,1.08888,1.08888,841,955.75,-577257,-575370.8,35.23402175633897,47.907679444879754,58.47827511755835,NaN,NaN,50
1680580800,1.08888,1.08923,1.0888,1.08919,938,924.6,-576319,-576002.8,33.11854431055778,51.043081273749266,57.428892319430474,NaN,NaN,50
1680582600,1.08919,1.08988,1.0888,1.08944,1907,951.1,-574412,-575982.6,32.212565599669034,53.4751055073635,56.71586749854089,NaN,NaN,50
1680584400,1.08944,1.08958,1.08904,1.08924,1040,946.5,-575452,-575971.2,31.371299653843778,51.280382345777994,55.73225886943285,NaN,NaN,50
1680586200,1.08924,1.0893,1.08828,1.08857,1278,944.9,-576730,-576034,29.180786877258242,44.66672489782305,54.341438868239315,NaN,NaN,50
1680588000,1.08857,1.09009,1.08853,1.08994,2116,1016.4,-574614,-575505.4,28.22740004559344,56.905604957026306,53.65497502054448,NaN,NaN,50
1680589800,1.08994,1.09084,1.08965,1.09072,2207,1102.05,-572407,-574723,28.206381113227636,62.05199784188079,53.44886545444705,NaN,NaN,50
1680591600,1.09072,1.09202,1.09055,1.09068,3098,1250.7,-575505,-574941.6,29.19513180937688,61.645429922514126,53.16276666509027,NaN,NaN,50
1680593400,1.09068,1.09382,1.09021,1.09252,3708,1421.25,-571797,-574210.6,31.1209359009957,71.0439450647938,54.04280333711241,NaN,NaN,50
1680595200,1.09252,1.0926,1.09163,1.092,3021,1545.75,-574818,-573828.2,32.90918255749888,66.11332720643854,54.765443907866405,NaN,NaN,50
1680597000,1.092,1.0923,1.09138,1.09172,2716,1667.35,-577534,-574412.2,34.14882295823783,63.55552500819838,55.60743201238411,NaN,NaN,50
1680598800,1.09172,1.09338,1.0916,1.0929,3171,1793.35,-574363,-574803.4,35.83042487343042,68.99885151021626,56.90452685708261,NaN,NaN,50
1680600600,1.0929,1.0936,1.09245,1.09314,2650,1894.75,-571713,-574045,37.48777216155785,69.98092483039082,58.34668352956698,NaN,NaN,50
1680602400,1.09314,1.09354,1.09242,1.09284,2180,1924.25,-573893,-574464.2,38.97406799239126,67.11869609950296,59.699091136468255,NaN,NaN,50
1680604200,1.09284,1.09288,1.09162,1.09208,2023,1951.85,-575916,-574683.8,39.025565131059956,60.381131707988494,60.5900520124046,NaN,NaN,50
1680606000,1.09208,1.09209,1.09022,1.09062,2460,2006.05,-578376,-574852.2,37.26428676762659,49.99784887129835,60.51539255508668,NaN,NaN,50
1680607800,1.09062,1.09095,1.08958,1.08975,1909,2026,-580285,-576036.6,34.95940708717313,45.02878329645529,59.91208382573609,NaN,NaN,50
1680609600,1.08975,1.09094,1.0895,1.09023,2611,2088.85,-577674,-577228.8,32.737335947881654,48.093909735916945,59.68447863931744,NaN,NaN,50
1680611400,1.09023,1.09042,1.08868,1.08912,3044,2191.25,-580718,-578593.8,30.921272131993334,42.22984261762561,59.51041561930334,NaN,NaN,50
1680613200,1.08912,1.09013,1.08884,1.08998,2882,2290,-577836,-578977.8,29.234927160097037,47.564364937455274,58.84318418933399,NaN,NaN,50
1680615000,1.08998,1.09112,1.08988,1.0904,3485,2422.2,-574351,-578172.8,27.627145431571478,49.992978929018406,57.9818256955581,NaN,NaN,50
1680616800,1.0904,1.09576,1.0904,1.09557,8246,2787.6,-566105,-575336.8,28.783828090107527,69.01643129102041,58.50832579330853,NaN,NaN,50
1680618600,1.09557,1.09734,1.0953,1.09695,5971,2990.8,-560134,-571828.8,30.368630327920982,72.07060101552305,58.581658361217755,NaN,NaN,50
1680620400,1.09695,1.09702,1.09554,1.09557,4492,3163.4,-564626,-568610.4,31.840232405890625,65.15407527220745,58.51314036591554,NaN,NaN,50
1680622200,1.09557,1.09579,1.09491,1.09506,2964,3247.7,-567590,-566561.2,32.60729863721741,62.75707373828778,58.456108132350494,NaN,NaN,50
1680624000,1.09506,1.0954,1.09438,1.09496,2729,3278.35,-570319,-565754.8,32.831286044783845,62.27329908743576,57.97571153072332,NaN,NaN,50
1680625800,1.09496,1.09513,1.09433,1.09463,1614,3248.7,-571933,-566920.4,32.992273402119906,60.61278231585201,57.30655849397055,NaN,NaN,50
1680627600,1.09463,1.09506,1.09436,1.09474,1752,3181.4,-570181,-568929.8,33.14176166250339,60.98622401196379,56.868524773432036,NaN,NaN,50
1680629400,1.09474,1.09502,1.09462,1.09484,1136,3052.8,-569045,-569813.6,33.28057219000234,61.34503422395423,56.93737495314387,NaN,NaN,50
1680631200,1.09484,1.09496,1.09441,1.09483,1080,2955.75,-570125,-570320.6,33.17019437543291,61.28433530277158,57.74355255539196,NaN,NaN,50
1680633000,1.09483,1.09539,1.09464,1.09534,1103,2875.1,-569022,-570061.2,33.32051121774115,63.27987586292218,59.04720202442531,NaN,NaN,50
1680634800,1.09534,1.09564,1.09511,1.09516,1402,2786.65,-570424,-569759.4,33.6054546231389,62.063968759877916,60.04506338327967,NaN,NaN,50
1680636600,1.09516,1.09578,1.0951,1.09573,1432,2725.75,-568992,-569521.6,33.95337384951724,64.39693875007754,61.62842739274053,NaN,NaN,50
1680638400,1.09573,1.09581,1.09542,1.09565,431,2638.3,-569423,-569597.2,34.295232910009226,63.80387128072858,62.788392131545756,NaN,NaN,50
1680640200,1.09565,1.09573,1.09548,1.09566,380,2556.15,-569043,-569380.8,34.61267346618036,63.84868981177474,63.778085766028354,NaN,NaN,50
1680642000,1.09566,1.09566,1.09506,1.09552,165,2441.4,-569208,-569418,34.26407405044328,62.678578040033365,63.325381962386416,NaN,NaN,50
1680643800,1.09552,1.0956,1.09542,1.09554,184,2355.15,-569024,-569138,33.94037459297313,62.78350750109818,62.6620181399275,NaN,NaN,50
1680645600,1.09554,1.09571,1.09539,1.09564,787,2263.95,-568237,-568987,33.73685777645636,63.3385214822407,62.53233572635844,NaN,NaN,50
1680647400,1.09564,1.09601,1.09553,1.09576,831,2153.3,-567406,-568583.6,33.812414901214126,64.03171445265768,62.62338149167059,NaN,NaN,50
1680649200,1.09576,1.09606,1.09569,1.09604,466,2032.5,-566940,-568163,33.92707494755962,65.66313627718608,62.8655127195099,NaN,NaN,50
1680651000,1.09604,1.09616,1.09566,1.09576,695,1893,-567635,-567848.4,34.12656094275066,62.60511145098751,63.00782194344815,NaN,NaN,50
1680652800,1.09576,1.09699,1.0957,1.09665,1603,1560.85,-566032,-567250,35.00204717270872,67.74683151944234,63.49072247969661,NaN,NaN,50
1680654600,1.09665,1.09674,1.0959,1.09606,1286,1326.6,-567318,-567066.2,35.8149986719555,61.691115549552755,63.51544257438222,NaN,NaN,50
1680656400,1.09606,1.09636,1.096,1.09612,1074,1155.7,-566244,-566833.8,36.56988220697036,62.062504592780776,63.57102609509717,NaN,NaN,50
1680658200,1.09612,1.09614,1.09564,1.09575,997,1057.35,-567241,-566894,36.471949900270836,58.30848531643773,63.215926770348275,NaN,NaN,50
1680660000,1.09575,1.09641,1.09568,1.09591,2165,1029.15,-565076,-566382.2,36.650054832386374,59.45071474654626,63.02926576939601,NaN,NaN,50
1680661800,1.09591,1.09646,1.09591,1.0961,1130,1004.95,-563946,-565965,36.8653952750048,60.823338157418874,62.77400858420611,NaN,NaN,50
1680663600,1.0961,1.09628,1.09586,1.09613,1020,968.35,-562926,-565086.6,36.94374462348161,61.04754834018755,62.57712837416746,NaN,NaN,50
1680665400,1.09613,1.09613,1.09554,1.09596,809,952,-563735,-564584.8,36.252715629056006,58.98739534226622,62.22989305491685,NaN,NaN,50
1680667200,1.09596,1.09598,1.09536,1.09555,928,944.4,-564663,-564069.2,35.20337122160964,54.233813161453426,61.626695563589706,NaN,NaN,50
1680669000,1.09555,1.09562,1.09536,1.09548,799,929.2,-565462,-564146.4,34.22897998612374,53.4419629178116,60.959442379069245,NaN,NaN,50
1680670800,1.09548,1.0955,1.09518,1.09532,568,887.5,-566030,-564563.2,32.89491190634051,51.58788796032652,60.12011141321823,NaN,NaN,50
1680672600,1.09532,1.0959,1.09512,1.09578,1136,872.7,-564894,-564956.8,32.29430478796949,56.28370109077347,59.56668188736936,NaN,NaN,50
1680674400,1.09578,1.09596,1.09496,1.09519,2068,954.55,-566962,-565602.2,31.34902016155573,49.63382727406946,58.421731244289596,NaN,NaN,50
1680676200,1.09519,1.09543,1.09466,1.09484,2014,1036.25,-568976,-566464.8,29.78330764817505,46.150398550884645,57.24639460856796,NaN,NaN,50
1680678000,1.09484,1.09656,1.09476,1.09614,2499,1152.95,-566477,-566667.8,29.927796170610588,57.953985225834025,56.54690558759593,NaN,NaN,50
1680679800,1.09614,1.09675,1.09491,1.09502,2845,1286,-569322,-567326.2,30.270549824761567,48.15966477644753,55.58037338951699,NaN,NaN,50
1680681600,1.09502,1.09516,1.0944,1.09502,2742,1383.75,-569322,-568211.8,29.528811284559126,48.159664776447535,54.58731340263605,NaN,NaN,50
1680683400,1.09502,1.09547,1.09409,1.09512,2748,1479.6,-566574,-568134.2,28.840054068656855,49.0512762671288,53.92608418482826,NaN,NaN,50
1680685200,1.09512,1.09603,1.09444,1.09444,2436,1578.1,-569010,-568141,28.90444600792435,43.564309986148224,52.79134098765697,NaN,NaN,50
1680687000,1.09444,1.0955,1.0944,1.0952,1752,1630.95,-567258,-568297.2,28.877366232219654,50.26111138302752,52.036896218057585,NaN,NaN,50
1680688800,1.0952,1.09536,1.09462,1.09496,1457,1623.65,-568715,-568175.8,28.85222072620815,48.31150697734283,51.1271789778544,NaN,NaN,50
1680690600,1.09496,1.09497,1.09413,1.09458,1885,1653.6,-570600,-568431.4,27.749929852705247,45.314364802868724,50.15053393932601,NaN,NaN,50
1680692400,1.09458,1.0947,1.09349,1.09396,1886,1694.2,-572486,-569613.8,25.95848914022684,40.860350343427676,49.195286595181315,NaN,NaN,50
1680694200,1.09396,1.09438,1.09364,1.09412,2108,1749.75,-570378,-569887.4,24.29500847863974,42.43289536998414,48.40892462747935,NaN,NaN,50
1680696000,1.09412,1.09575,1.09376,1.09518,4932,1888.1,-565446,-569525,24.279031471497454,51.61257312575693,48.41068785358152,NaN,NaN,50
1680697800,1.09518,1.0963,1.09514,1.09578,3979,2030.55,-561467,-568075.4,24.813103653894423,55.8993250710986,48.38323242360474,NaN,NaN,50
1680699600,1.09578,1.096,1.09398,1.0942,3393,2149.2,-564860,-566927.4,23.54996469489189,44.67519269737185,48.02904423955492,NaN,NaN,50
1680701400,1.0942,1.09494,1.09388,1.09402,4412,2329.35,-569272,-566284.6,22.246530942166913,43.60109517379143,47.846951141191106,NaN,NaN,50
1680703200,1.09402,1.0967,1.09276,1.0932,6817,2623.8,-576089,-567426.8,22.688731627347476,39.0008840577532,46.493158200613905,NaN,NaN,50
1680705000,1.0932,1.09328,1.09028,1.09102,5478,2857.75,-581567,-570651,21.51812186290424,29.95298416985169,45.19268101442849,NaN,NaN,50
1680706800,1.09102,1.09208,1.09055,1.09199,4122,3035.45,-577445,-573846.6,20.43112708163552,36.96081847754869,44.392763421649995,NaN,NaN,50
1680708600,1.09199,1.09235,1.09136,1.09174,2534,3105.35,-579979,-576870.4,19.171041673744732,35.96221387322642,43.45783039351411,NaN,NaN,50
1680710400,1.09174,1.09198,1.09089,1.09098,1702,3087.05,-581681,-579352.2,18.405745179794213,33.03976327637589,42.70607705710181,NaN,NaN,50
1680712200,1.09098,1.09108,1.08962,1.08968,1615,3067.1,-583296,-580793.6,18.643475812871518,28.73778258368033,41.16869642857701,NaN,NaN,50
1680714000,1.08968,1.09006,1.08927,1.08978,1756,3029.95,-581540,-580788.2,19.094936574969406,29.498236396959314,39.82489138712104,NaN,NaN,50
1680715800,1.08978,1.09008,1.08911,1.09008,1122,2943.8,-580418,-581382.8,19.620875200514625,31.84786339619258,38.86299842950131,NaN,NaN,50
1680717600,1.09008,1.09034,1.09002,1.09023,1404,2876.9,-579014,-581189.8,19.80508482728561,33.049321451732936,38.30506779438026,NaN,NaN,50
1680719400,1.09023,1.09095,1.08994,1.09091,1166,2797.8,-577848,-580423.2,19.29173937602163,38.354869491552236,38.01378023163512,NaN,NaN,50
1680721200,1.09091,1.09098,1.0903,1.09034,981,2725.05,-578829,-579529.8,18.781793756076965,35.7942823834977,36.88390232147375,NaN,NaN,50
1680723000,1.09034,1.09065,1.09019,1.09037,1111,2693,-577718,-578765.4,18.409096980128645,36.03632038980104,35.46511627280963,NaN,NaN,50
1680724800,1.09037,1.0905,1.09012,1.09016,510,2645.65,-578228,-578327.4,18.130266949328693,35.04054043039173,34.776926825168196,NaN,NaN,50
1680726600,1.09016,1.09076,1.09014,1.09076,368,2569.8,-577860,-578096.6,17.529897151101963,40.13083356362697,34.52905099587074,NaN,NaN,50
1680728400,1.09076,1.09076,1.09016,1.09026,211,2486.05,-578071,-578141.2,16.972410909891426,37.49409709163157,34.42142335543348,NaN,NaN,50
1680730200,1.09026,1.0908,1.09026,1.09065,1732,2467.25,-576339,-577643.2,16.396795885077715,40.76341993639969,35.19359733875833,NaN,NaN,50
1680732000,1.09065,1.09092,1.09064,1.09078,618,2251.55,-575721,-577243.8,15.68079555693562,41.85514059746958,35.543191775895544,NaN,NaN,50
1680733800,1.09078,1.09106,1.09078,1.091,310,2068.1,-575411,-576680.4,14.79956164151682,43.74465142208487,36.09908017224258,NaN,NaN,50
1680735600,1.091,1.091,1.09082,1.09094,494,1923.15,-575905,-576289.4,13.981273005770795,43.33107971237805,36.834174203385594,NaN,NaN,50
1680737400,1.09094,1.09094,1.0903,1.0903,809,1743,-576714,-576018,13.975833229937892,39.08622352411195,37.57334855627357,NaN,NaN,50
1680739200,1.0903,1.09046,1.09014,1.0902,949,1449.6,-577663,-576282.8,14.185665182260193,38.452366578080444,38.212929283496514,NaN,NaN,50
1680741000,1.0902,1.09022,1.0893,1.0894,1101,1230.75,-578764,-576891.4,15.359554137245086,33.73858859634481,38.34798108350738,NaN,NaN,50
1680742800,1.0894,1.0894,1.08846,1.08895,1315,1090.4,-580079,-577825,17.197197132804423,31.406361259015668,38.23062678402757,NaN,NaN,50
1680744600,1.08895,1.08943,1.0888,1.08924,958,1011.6,-579121,-578468.2,18.845444966989987,34.54648741671953,37.9585994929681,NaN,NaN,50
1680746400,1.08924,1.08934,1.0889,1.08892,1030,978,-580151,-579155.6,20.37596081301944,32.76411535953547,37.74215899125651,NaN,NaN,50
1680748200,1.08892,1.08902,1.08853,1.08866,909,942.7,-581060,-579835,22.12234691726256,31.34889284468008,37.407342738033584,NaN,NaN,50
1680750000,1.08866,1.08914,1.0886,1.08906,676,888.7,-580384,-580159,23.47572518159922,35.933760878442015,37.4711441986086,NaN,NaN,50
1680751800,1.08906,1.08926,1.08899,1.08921,516,858.4,-579868,-580116.8,24.45866935483588,37.616304540936824,37.29153498270216,NaN,NaN,50
1680753600,1.08921,1.08942,1.08897,1.0892,665,821.45,-580533,-580399.2,25.00334448265961,37.545511826313884,37.2952074637509,NaN,NaN,50
1680755400,1.0892,1.0896,1.08914,1.08928,710,798.65,-579823,-580333.6,25.098613225258344,38.54198505943375,37.136533543967616,NaN,NaN,50
1680757200,1.08928,1.08934,1.08898,1.08926,899,794.55,-580722,-580266,25.39746574819321,38.377131175925555,36.888104299571616,NaN,NaN,50
1680759000,1.08926,1.08959,1.08902,1.08944,1035,790.75,-579687,-580126.6,25.09281673606934,40.83010598298298,36.679922482492906,NaN,NaN,50
1680760800,1.08944,1.09012,1.08934,1.09008,1687,849.6,-578000,-579753,23.72129779171946,48.655985378577775,37.06027288722146,NaN,NaN,50
1680762600,1.09008,1.09066,1.08992,1.09024,1719,917.15,-576281,-578902.6,22.523625943149874,50.42141802175618,37.86992963705319,NaN,NaN,50
1680764400,1.09024,1.09173,1.09012,1.09136,2525,1032.85,-573756,-577689.2,22.778147150421276,60.62708927351773,39.453838401012995,NaN,NaN,50
1680766200,1.09136,1.09158,1.09057,1.09068,2851,1088.8,-576607,-576866.2,23.014488271459008,53.43509062452174,40.86073140302563,NaN,NaN,50
1680768000,1.09068,1.09103,1.0896,1.08969,2663,1191.05,-579270,-576782.8,21.63298165064069,45.05519323259045,41.83564797256669,NaN,NaN,50
1680769800,1.08969,1.09038,1.08934,1.08994,2423,1296.7,-576847,-576552.2,20.186821233284363,47.302645424437316,42.74680211597511,NaN,NaN,50
1680771600,1.08994,1.09039,1.08923,1.08958,1793,1361.65,-578640,-577024,18.997191484122048,44.48110330253851,43.583729826189604,NaN,NaN,50
1680773400,1.08958,1.09104,1.08952,1.09088,1772,1409.8,-576868,-577646.4,18.287231722997912,54.93476191797208,45.268434759996175,NaN,NaN,50
1680775200,1.09088,1.09088,1.09016,1.09064,1878,1456.25,-578746,-578074.2,17.627983373382644,52.95247584459675,46.48405725757866,NaN,NaN,50
1680777000,1.09064,1.09073,1.08978,1.08998,1380,1470.2,-580126,-578245.4,16.42248406566215,47.8400386883287,47.214323982392365,NaN,NaN,50
1680778800,1.08998,1.09118,1.08998,1.09106,1404,1474.65,-578722,-578620.4,15.930753670760843,55.42416716135124,48.49137079203789,NaN,NaN,50
1680780600,1.09106,1.09169,1.09089,1.09154,1383,1495.9,-577339,-578360.2,16.10429561216729,58.32452225889688,49.90440916342811,NaN,NaN,50
1680782400,1.09154,1.09172,1.09079,1.09097,1840,1536.4,-579179,-578822.4,16.094854581893188,53.844203006877635,51.009200008496116,NaN,NaN,50
1680784200,1.09097,1.09196,1.08894,1.08924,5123,1747.1,-584302,-579933.6,16.179568857082195,43.038145954343975,51.166917149307615,NaN,NaN,50
1680786000,1.08924,1.08956,1.08858,1.08912,3415,1884.05,-587717,-581451.8,16.593142172462144,42.40246495085624,50.720237118756074,NaN,NaN,50
1680787800,1.08912,1.08998,1.08892,1.08968,3162,2016.35,-584555,-582618.4,16.397975426021144,46.382472764119896,50.43174102892492,NaN,NaN,50
1680789600,1.08968,1.09183,1.08926,1.09136,3700,2168.1,-580855,-583321.6,16.18653175911313,56.16787147522606,50.11322547190408,NaN,NaN,50
1680791400,1.09136,1.0924,1.09109,1.09232,3157,2290.45,-577698,-583025.4,16.44581895991335,60.593603391993646,50.6245478124378,NaN,NaN,50
1680793200,1.09232,1.09285,1.09196,1.09218,2859,2388.45,-580557,-582276.4,17.02425983937233,59.64774084730873,51.666872642060525,NaN,NaN,50
1680795000,1.09218,1.09278,1.0921,1.09261,1607,2417.05,-578950,-580523,17.56138351315567,61.6289487391711,52.69018002168438,NaN,NaN,50
1680796800,1.09261,1.09368,1.09261,1.09341,1441,2404.75,-577509,-579113.8,18.70853640239379,65.06550083140363,54.16049413088903,NaN,NaN,50
1680798600,1.09341,1.09378,1.09336,1.09342,1188,2378.2,-576321,-578207,19.841033248319253,65.10756818272999,54.8871231498003,NaN,NaN,50
1680800400,1.09342,1.09362,1.09293,1.09297,994,2301.65,-577315,-578130.4,20.29995725660923,61.517626332025436,55.49891961318807,NaN,NaN,50
1680802200,1.09297,1.0935,1.09297,1.09338,746,2196.4,-576569,-577332.8,20.72610097859278,63.49273616167246,56.61696943271262,NaN,NaN,50
1680804000,1.09338,1.09352,1.09297,1.093,790,2102.75,-577359,-577014.6,21.139266090452534,60.39859137990569,56.97228544832365,NaN,NaN,50
1680805800,1.093,1.0932,1.09294,1.09312,929,2028.05,-576430,-576798.8,21.47478401293242,61.0442025273667,57.166548324642925,NaN,NaN,50
1680807600,1.09312,1.09313,1.09247,1.09252,801,1978.45,-577231,-576980.8,21.04514476482733,56.1179479008308,57.328958674211016,NaN,NaN,50
1680809400,1.09252,1.09254,1.09214,1.09232,933,1936.5,-578164,-577150.6,20.162147707749885,54.53802721913894,58.150378764553516,NaN,NaN,50
1680811200,1.09232,1.09234,1.09208,1.09234,286,1856.9,-577878,-577412.4,19.25402000119323,54.675447777327,59.02702039501571,NaN,NaN,50
1680813000,1.09234,1.09234,1.0917,1.09217,542,1815,-578420,-577624.6,17.89868027443032,53.203319121393825,59.51422370624955,NaN,NaN,50
1680814800,1.09217,1.0923,1.09215,1.09216,33,1746.45,-578453,-578029.2,16.640150528150475,53.11272755168591,59.295999140282404,NaN,NaN,50
1680816600,1.09216,1.09216,1.0918,1.09187,140,1684.3,-578593,-578301.6,15.979689810683759,50.43091401428601,58.57009275616043,NaN,NaN,50
1680818400,1.09187,1.09198,1.0918,1.0919,379,1611.25,-578214,-578311.6,15.366404858750382,50.708190267945525,57.93155342906306,NaN,NaN,50
1680820200,1.0919,1.09194,1.09158,1.09168,411,1375.65,-578625,-578461,15.123944275201046,48.562869596200954,56.99826206170804,NaN,NaN,50
1680822000,1.09168,1.09178,1.09164,1.09172,277,1218.75,-578348,-578446.6,14.898802304762373,48.98547007944154,55.849688436567895,NaN,NaN,50
1680823800,1.09172,1.09208,1.09172,1.09198,318,1076.55,-578030,-578362,14.109759049766051,51.75981384152265,54.89627741219594,NaN,NaN,50
1680825600,1.09198,1.09242,1.09166,1.0918,507,916.9,-578537,-578350.8,13.429922584862991,49.74292687558205,54.055227451021416,NaN,NaN,50
1680827400,1.0918,1.0918,1.09142,1.0916,378,777.95,-578915,-578491,12.577535303971793,47.52692197609637,52.91481215205169,NaN,NaN,50
1680829200,1.0916,1.09189,1.09149,1.09182,350,652.5,-578565,-578479,11.738765540113116,50.15730081661406,52.18329139753086,NaN,NaN,50
1680831000,1.09182,1.092,1.0916,1.09178,459,595.1,-579024,-578614.2,11.1677677224586,49.669776856297965,51.37083242102595,NaN,NaN,50
1680832800,1.09178,1.09215,1.09172,1.09214,338,539.95,-578686,-578745.4,10.921605514848666,54.003067966866034,51.219769568599894,NaN,NaN,50
1680834600,1.09214,1.09217,1.09188,1.09206,253,493.2,-578939,-578825.8,10.731897335904776,52.9128278657658,51.103683900501814,NaN,NaN,50
1680836400,1.09206,1.09212,1.09191,1.09201,309,458.95,-579248,-578892.4,10.555739741171164,52.20346612818798,50.92711378270617,NaN,NaN,50
1680838200,1.09201,1.09202,1.09188,1.09198,341,438.7,-579589,-579097.2,10.313633315003061,51.755137791237416,50.82367225912357,NaN,NaN,50
1680840000,1.09198,1.09208,1.09176,1.09178,273,412.85,-579862,-579264.8,9.76800012616418,48.74934486513802,50.5120020672273,NaN,NaN,50
1680841800,1.09178,1.09187,1.09148,1.09148,367,384.75,-580229,-579573.4,9.57801400714217,44.56809956496371,50.093229606561415,NaN,NaN,50
1680843600,1.09148,1.0917,1.09144,1.0917,415,365.45,-579814,-579748.4,9.497455084641167,48.08466447312822,49.90583490693161,NaN,NaN,50
1680845400,1.0917,1.0919,1.09154,1.0917,616,349.6,-579814,-579861.6,8.863542146725969,48.08466447312822,49.871677398140704,NaN,NaN,50
1680847200,1.0917,1.09194,1.09116,1.0919,692,369.9,-579122,-579768.2,9.188325581598267,51.339381079192975,50.039813898122944,NaN,NaN,50
1680849000,1.0919,1.09192,1.09161,1.09182,577,371.65,-579699,-579735.6,9.489910199693973,49.989362372104274,49.91335307887878,NaN,NaN,50
1680850800,1.09182,1.09197,1.09158,1.09186,483,394.15,-579216,-579533,9.613945586395376,50.6875948258725,49.98082936104238,NaN,NaN,50
1680852600,1.09186,1.09195,1.0914,1.09156,388,406.55,-579604,-579491,10.16966669068269,45.550934189961986,49.8396873763185,NaN,NaN,50
1680854400,1.09156,1.09168,1.09133,1.09164,260,400.6,-579344,-579397,10.852522691250508,47.09073427802946,49.620646909276736,NaN,NaN,50
1680856200,1.09164,1.09178,1.09149,1.09156,253,392.7,-579597,-579492,11.130105075626584,45.69897212441256,49.33701799985636,NaN,NaN,50
1680858000,1.09156,1.0916,1.09114,1.09139,453,401.5,-580050,-579562.2,12.21481413219828,42.80391791388389,48.537078710357626,NaN,NaN,50
1680859800,1.09139,1.09154,1.09126,1.09136,381,404.65,-580431,-579805.2,13.222043970443426,42.294712094561554,47.778641869557326,NaN,NaN,50
1680861600,1.09136,1.09164,1.09105,1.09158,393,398.95,-580038,-579892,14.611701051531325,47.25051649305338,47.424859752762,NaN,NaN,50
1680863400,1.09158,1.09218,1.09152,1.09218,322,396.15,-579716,-579966.4,14.073582653289336,57.87585737765717,47.862054008934834,NaN,NaN,50
1680865200,1.09218,1.09218,1.09176,1.09188,405,398.9,-580121,-580071.2,13.573901283493203,52.212736829587435,48.10943914925265,NaN,NaN,50
1680867000,1.09188,1.09188,1.0914,1.09174,398,395.85,-580519,-580165,13.97152125489605,49.76548815811618,48.4806811916207,NaN,NaN,50
1680868800,1.09174,1.09177,1.09116,1.09162,943,426.1,-581462,-580371.2,14.833138496183068,47.70166229549329,48.45332389321819,NaN,NaN,50
1680870600,1.09162,1.09162,1.08765,1.09037,4798,653.35,-586260,-581615.6,18.661325734267567,32.55597612650617,47.34413186845948,NaN,NaN,50
1680872400,1.09037,1.09082,1.08966,1.09025,1363,706.05,-587623,-583197,22.216071026774603,31.52127451431666,45.928552828111165,NaN,NaN,50
1680874200,1.09025,1.09045,1.08934,1.08986,816,729.8,-588439,-584860.6,25.645762509800342,28.36591240398134,44.384020687530956,NaN,NaN,50
1680876000,1.08986,1.09138,1.08986,1.09131,712,751.75,-587727,-586302.2,26.985854710034246,48.862211778149266,44.25363618412216,NaN,NaN,50
1680877800,1.09131,1.0915,1.09093,1.0915,1301,798.45,-586426,-587295,28.01727580224477,50.84683246627605,44.63191463243031,NaN,NaN,50
1680879600,1.0915,1.09156,1.09059,1.09084,595,807.45,-587021,-587447.2,29.222964728172705,44.40068466634393,44.43976823159562,NaN,NaN,50
1680881400,1.09084,1.09126,1.09078,1.09118,264,789.85,-586757,-587274,30.342533016534368,48.05416482831744,44.60799628187454,NaN,NaN,50
1680883200,1.09118,1.09127,1.09103,1.09115,392,774.85,-587149,-587016,31.361252943989726,47.75597553073632,44.961714683078284,NaN,NaN,50
1680885000,1.09115,1.09122,1.0909,1.09099,235,757.75,-587384,-586947.4,32.41588989029264,46.11250052819975,45.23441385690959,NaN,NaN,50
1680886800,1.09099,1.09104,1.09094,1.091,118,739.5,-587266,-587115.4,33.39519562614534,46.23703320087451,45.16202219318252,NaN,NaN,50
1680888600,1.091,1.09103,1.0908,1.0908,158,728,-587424,-587196,34.43218596144943,44.04471417770693,44.17408339318608,NaN,NaN,50
1680890400,1.0908,1.09097,1.09033,1.09096,393,734.65,-587031,-587250.8,35.79347878512765,46.24076090133885,43.74751368402547,NaN,NaN,50
1680892200,1.09096,1.09096,1.09044,1.09072,604,752.2,-587635,-587348,37.05753640711457,43.483959489880185,43.298833064865754,NaN,NaN,50
1680894000,1.09072,1.09084,1.09056,1.09057,20,730.55,-587655,-587402.2,38.23130419895956,41.8063626668583,42.87774023424897,NaN,NaN,50
1680895800,1.09057,1.09071,1.0901,1.09057,105,716.75,-587655,-587480,39.70573378106151,41.8063626668583,43.53848212998842,NaN,NaN,50
1680897600,1.09057,1.09099,1.09023,1.09058,85,701.35,-587570,-587509.2,40.27458623931775,41.97943139448273,44.285493335714555,NaN,NaN,50
1680899400,1.09058,1.09089,1.08993,1.09012,149,692.7,-587719,-587646.8,41.08406652946081,36.588863367505745,44.8728469759663,NaN,NaN,50
1681074000,1.09012,1.09057,1.08997,1.09012,43,674.6,-587719,-587663.6,41.83572679887938,36.588863367505745,43.9961792323489,NaN,NaN,50
1681075800,1.09012,1.0906,1.0901,1.09034,86,659,-587633,-587659.2,42.440011913064616,40.805023049433586,43.27890713114588,NaN,NaN,50
1681077600,1.09034,1.09114,1.09028,1.09082,911,657.4,-586722,-587472.6,41.459352851179524,48.803304512356014,43.593379977289594,NaN,NaN,50
1681079400,1.09082,1.09116,1.09072,1.09095,884,461.7,-585838,-587126.2,40.49637705260397,50.74443155983663,43.785541886683816,NaN,NaN,50
1681081200,1.09095,1.09105,1.09066,1.0908,699,428.5,-586537,-586889.8,39.695139717874056,48.46125610077139,43.83591907025775,NaN,NaN,50
1681083000,1.0908,1.09136,1.09076,1.09132,695,422.45,-585842,-586514.4,38.107562160065015,55.87346265270552,44.53313065057959,NaN,NaN,50
1681084800,1.09132,1.09147,1.0906,1.09089,1068,440.25,-586910,-586369.8,36.91825060260622,49.52992982969343,44.76833755263808,NaN,NaN,50
1681086600,1.09089,1.09093,1.09034,1.09035,1419,446.15,-588329,-586691.2,36.25132630116409,42.937146919927436,44.689225605653824,NaN,NaN,50
1681088400,1.09035,1.09068,1.0901,1.09038,1127,472.75,-587202,-586964,36.004140072923555,43.38798630005188,44.48545599127619,NaN,NaN,50
1681090200,1.09038,1.09038,1.08974,1.09006,1097,514.4,-588299,-587316.4,36.27438223109819,39.77785399609465,44.22073417029151,NaN,NaN,50
1681092000,1.09006,1.0903,1.08997,1.09013,854,537.5,-587445,-587637,36.52532137797463,40.93559705821921,44.15853662681729,NaN,NaN,50
1681093800,1.09013,1.0902,1.08984,1.08986,710,561.25,-588155,-587886,36.93801875914772,37.90839271202042,43.88011020147172,NaN,NaN,50
1681095600,1.08986,1.09018,1.08969,1.09016,657,588.2,-587498,-587719.8,37.52462533153654,42.95607683267005,43.94987058991368,NaN,NaN,50
1681097400,1.09016,1.09018,1.08978,1.08992,719,616.25,-588217,-587922.8,38.06933143446902,40.14443928758431,44.20384029849072,NaN,NaN,50
1681099200,1.08992,1.08992,1.08952,1.08961,761,634.65,-588978,-588058.6,38.928732657050524,36.79438809326109,44.21852063604467,NaN,NaN,50
1681101000,1.08961,1.09008,1.08958,1.08963,701,639.5,-588277,-588225,39.1216467385863,37.15874239420465,43.95807201781404,NaN,NaN,50
1681102800,1.08963,1.08963,1.08909,1.08938,664,671.7,-588941,-588382.2,39.95506128603551,34.482864497566766,42.93518344532909,NaN,NaN,50
1681104600,1.08938,1.08998,1.08936,1.08996,969,714.9,-587972,-588477,39.56882450414669,44.473210251666615,42.487239066174084,NaN,NaN,50
1681106400,1.08996,1.09014,1.08954,1.08966,892,755.25,-588864,-588606.4,38.72621978170021,40.99146492513232,41.95368255362843,NaN,NaN,50
1681108200,1.08966,1.09056,1.08964,1.0905,794,787.5,-588070,-588424.8,36.80648905431444,52.26117958358509,41.69566233440555,NaN,NaN,50
1681110000,1.0905,1.09116,1.09042,1.09074,1153,843,-586917,-588152.8,34.616291366518304,54.91082071204199,42.08001168314473,NaN,NaN,50
1681111800,1.09074,1.09171,1.09066,1.09168,1060,891.7,-585857,-587536,33.50129949413991,63.464161036189616,43.546226977163464,NaN,NaN,50
1681113600,1.09168,1.09174,1.09108,1.09146,881,890.2,-586738,-587289.2,32.51215095947671,60.568232548583836,44.77338742348718,NaN,NaN,50
1681115400,1.09146,1.09152,1.09088,1.09121,721,882.05,-587459,-587008.2,31.130202224284513,57.36486147018685,46.02960224306519,NaN,NaN,50
1681117200,1.09121,1.0916,1.09086,1.0916,830,888.6,-586629,-586720,29.98854155146767,60.8439869750546,47.45163009426771,NaN,NaN,50
1681119000,1.0916,1.09166,1.09046,1.09062,858,896.75,-587487,-586834,28.028181615188856,49.838411409584545,48.30377428695086,NaN,NaN,50
1681120800,1.09062,1.09106,1.0905,1.09096,823,884.5,-586664,-586995.4,26.20784738864424,53.01384152471817,49.022186050668594,NaN,NaN,50
1681122600,1.09096,1.09111,1.09064,1.09064,929,860,-587593,-587166.4,24.62627018292866,49.8173908998571,49.71311116583093,NaN,NaN,50
1681124400,1.09064,1.09084,1.08934,1.08936,1297,868.5,-588890,-587452.6,24.8386279626737,39.546061880217756,49.9096592934707,NaN,NaN,50
1681126200,1.08936,1.09004,1.08866,1.0889,1885,907.9,-590775,-588281.8,25.792528950906064,36.62365991861188,49.87143911664264,NaN,NaN,50
1681128000,1.0889,1.08915,1.08566,1.0862,3768,1053.6,-594543,-589693,28.488793646682915,24.96298220598416,49.19144752438674,NaN,NaN,50
1681129800,1.0862,1.0872,1.08472,1.0849,3145,1175.35,-597688,-591897.8,31.309044971803168,21.42575850268105,47.54520097088778,NaN,NaN,50
1681131600,1.0849,1.08573,1.0847,1.0853,2927,1288.85,-594761,-593331.4,33.934204105260605,24.949631213712863,46.399355705786384,NaN,NaN,50
1681133400,1.0853,1.08534,1.08381,1.08381,3077,1406.75,-597838,-595121,36.63985123892973,21.14540017866105,44.1768000340061,NaN,NaN,50
1681135200,1.08381,1.08442,1.08324,1.08339,2641,1500.75,-600479,-597061.8,39.30313991471066,20.209960219602095,41.69816714168896,NaN,NaN,50
1681137000,1.08339,1.08398,1.08314,1.08384,2100,1570.7,-598379,-597829,41.80219904125958,24.08499445572366,38.88536952879854,NaN,NaN,50
1681138800,1.08384,1.08477,1.08381,1.08424,2150,1645,-596229,-597537.2,42.800887629917824,27.45749160959126,36.520316604584785,NaN,NaN,50
1681140600,1.08424,1.08436,1.08374,1.08393,1035,1648.3,-597264,-598037.8,43.759920478306114,26.475834083703248,34.31395750555024,NaN,NaN,50
1681142400,1.08393,1.08474,1.0838,1.08461,1069,1657.15,-596195,-597709.2,44.03233242298392,32.20180545086684,32.26808739667969,NaN,NaN,50
1681144200,1.08461,1.08524,1.08461,1.08477,887,1661.8,-595308,-596675,43.51813925599021,33.51384236430489,31.10204675058828,NaN,NaN,50
1681146000,1.08477,1.08568,1.08477,1.08559,1360,1672.15,-593948,-595788.8,42.41005947042836,39.92985430303068,30.167476234753458,NaN,NaN,50
1681147800,1.08559,1.08572,1.08511,1.08558,900,1664.15,-594848,-595512.6,41.32373568446606,39.87931230343098,29.45761347786588,NaN,NaN,50
1681149600,1.08558,1.08576,1.08552,1.08559,1372,1688.7,-593476,-594755,40.25399945709696,39.96115345241582,29.487262875880027,NaN,NaN,50
1681151400,1.08559,1.08596,1.08538,1.08594,1155,1710.4,-592321,-593980.2,38.94576500073727,42.89138624478365,29.934957613463727,NaN,NaN,50
1681153200,1.08594,1.086,1.08551,1.08578,1161,1726.95,-593482,-593615,37.66600452935461,41.88499947186401,31.14367313245514,NaN,NaN,50
1681155000,1.08578,1.08632,1.08574,1.08629,1272,1747.65,-592210,-593267.4,35.95562677979054,46.21687294844226,32.914467021438085,NaN,NaN,50
1681156800,1.08629,1.0863,1.08594,1.08594,543,1733.65,-592753,-592848.4,34.36741886948105,43.8037399365444,34.26118907306891,NaN,NaN,50
1681158600,1.08594,1.08618,1.08594,1.08614,258,1700.1,-592495,-592652.2,32.89265438133652,45.55318308165963,36.00460213756881,NaN,NaN,50
1681160400,1.08614,1.08637,1.08606,1.0862,218,1646.15,-592277,-592643.4,31.17507196616019,46.09533958527437,37.8535578065454,NaN,NaN,50
1681162200,1.0862,1.08623,1.08588,1.086,3290,1716.4,-595567,-593060.4,29.852962673771184,44.50452425198762,39.31209564913569,NaN,NaN,50
1681164000,1.086,1.0866,1.086,1.08641,501,1553.05,-595066,-593631.6,27.942261324831115,48.43341258544448,40.810375718839495,NaN,NaN,50
1681165800,1.08641,1.08658,1.0863,1.0865,311,1411.35,-594755,-594032,26.16803864367248,49.28223252121335,42.43940417866164,NaN,NaN,50
1681167600,1.0865,1.08678,1.08639,1.08678,359,1282.95,-594396,-594412.2,24.44929156324409,51.93313170970786,43.84878462572171,NaN,NaN,50
1681169400,1.08678,1.08701,1.08674,1.08688,372,1147.7,-594024,-594761.6,23.265045139937364,52.880375050723266,45.232108389037315,NaN,NaN,50
1681171200,1.08688,1.08764,1.08686,1.08724,1528,1092.05,-592496,-594147.4,23.139260730933007,56.22486869607882,46.396037988540755,NaN,NaN,50
1681173000,1.08724,1.0879,1.08722,1.08776,1159,1045,-591337,-593401.6,23.36848039949531,60.577557377478314,47.87448406525842,NaN,NaN,50
1681174800,1.08776,1.08786,1.08701,1.0872,1562,1015.6,-592899,-593030.4,23.121552805286232,54.31412616512553,48.89969640188055,NaN,NaN,50
1681176600,1.0872,1.08792,1.08672,1.08784,2055,1066.6,-590844,-592320,22.289033895527048,59.471595894814854,50.08399709116849,NaN,NaN,50
1681178400,1.08784,1.08854,1.08777,1.08826,1754,1100.85,-589090,-591333.2,22.398338454598104,62.466148091754164,51.55407913544635,NaN,NaN,50
1681180200,1.08826,1.08846,1.088,1.08825,1055,1109.25,-590145,-590863,22.499835545164085,62.34802617468517,52.70630436589228,NaN,NaN,50
1681182000,1.08825,1.08879,1.08814,1.08847,1229,1102.7,-588916,-590378.8,23.025592729786634,63.962559675046386,54.146220061499555,NaN,NaN,50
1681183800,1.08847,1.08851,1.08796,1.08815,1157,1115.55,-590073,-589813.6,23.100945467134565,59.93665232645801,55.1736107218423,NaN,NaN,50
1681185600,1.08815,1.08859,1.08808,1.08826,875,1090.7,-589198,-589484.4,23.284029882424058,60.84889288761472,56.227435957723756,NaN,NaN,50
1681187400,1.08826,1.08847,1.08816,1.08825,853,1075.6,-590051,-589676.6,23.454036839478594,60.71354865360101,57.38522341498186,NaN,NaN,50
1681189200,1.08825,1.08882,1.08824,1.08876,900,1062.55,-589151,-589477.8,24.12008082805869,64.99044326865308,58.56786846378247,NaN,NaN,50
1681191000,1.08876,1.08945,1.08862,1.08944,1673,1082.6,-587478,-589190.2,25.489953010136762,69.7232467218054,60.027940906681906,NaN,NaN,50
1681192800,1.08944,1.08977,1.08893,1.08899,2264,1168.65,-589742,-589124,27.081340399153593,63.59619850740523,60.86101710651743,NaN,NaN,50
1681194600,1.08899,1.0891,1.0881,1.08842,1677,1239.6,-591419,-589568.2,26.653882992379526,56.78876868118395,61.14018808012177,NaN,NaN,50
1681196400,1.08842,1.09046,1.08834,1.08982,3421,1399.75,-587998,-589157.6,27.61842183064646,66.32364320795948,61.86152911668467,NaN,NaN,50
1681198200,1.08982,1.09045,1.0894,1.08956,3007,1385.6,-591005,-589528.4,28.51406503760861,63.520395166562245,62.071731815904954,NaN,NaN,50
1681200000,1.08956,1.09084,1.08944,1.09019,2054,1463.25,-588951,-589823,29.663609024221927,67.1441420144817,62.98816151943039,NaN,NaN,50
1681201800,1.09019,1.09103,1.08962,1.09068,2023,1548.85,-586928,-589260.2,30.87961825999112,69.66791455131556,63.71646999489474,NaN,NaN,50
1681203600,1.09068,1.09166,1.09063,1.09152,2349,1648.35,-584579,-587892.2,32.459014640220005,73.43507320083773,64.49996464554356,NaN,NaN,50
1681205400,1.09152,1.092,1.09092,1.0913,2161,1737.8,-586740,-587640.6,34.141501139677075,70.94970735328556,65.11437044401502,NaN,NaN,50
1681207200,1.0913,1.09168,1.09091,1.09104,2153,1769.05,-588893,-587218.2,35.68116010710033,68.01977666726368,65.40417165774483,NaN,NaN,50
1681209000,1.09104,1.09269,1.09085,1.09227,1991,1810.65,-586902,-586808.4,37.68377605428939,73.578559169671,66.3785935751172,NaN,NaN,50
1681210800,1.09227,1.09244,1.09116,1.09124,2253,1845.2,-589155,-587253.8,39.543348005250664,63.607856873121015,66.57566243122479,NaN,NaN,50
1681212600,1.09124,1.09138,1.0905,1.0905,2285,1856.7,-591440,-588626,39.85913366775238,57.5716725231089,66.3512427076182,NaN,NaN,50
1681214400,1.0905,1.09126,1.09022,1.09068,2292,1883.6,-589148,-589107.6,39.61512272149626,58.60079994389334,65.8948396129925,NaN,NaN,50
1681216200,1.09068,1.09183,1.09068,1.0912,2812,1971.45,-586336,-588596.2,39.855076502767986,61.505662629543416,65.30786932068807,NaN,NaN,50
1681218000,1.0912,1.09216,1.09074,1.09205,2816,2050.8,-583520,-587919.8,40.323159818038434,65.73770818144567,65.46083429740523,NaN,NaN,50
1681219800,1.09205,1.09243,1.09148,1.09216,3550,2170.45,-579970,-586082.8,40.95067408524279,66.2547487192232,66.13697572869374,NaN,NaN,50
1681221600,1.09216,1.09282,1.09202,1.09203,3082,2280.8,-583052,-584405.2,41.797557625821675,65.0062202480278,66.04287408869864,NaN,NaN,50
1681223400,1.09203,1.09232,1.0911,1.09112,3058,2391.05,-586110,-583797.6,40.88280851844935,56.92026919786055,65.57143651950565,NaN,NaN,50
1681225200,1.09112,1.09162,1.09088,1.09128,2431,2467.6,-583679,-583266.2,39.67786099533262,57.91156271873627,64.91196656980955,NaN,NaN,50
1681227000,1.09128,1.09142,1.09032,1.09048,1752,2471.55,-585431,-583648.4,37.71160485954702,51.527161216855916,63.61619847449101,NaN,NaN,50
1681228800,1.09048,1.0907,1.08984,1.09008,1688,2442.75,-587119,-585078.2,35.23582187614237,48.63979839183623,61.84510741670518,NaN,NaN,50
1681230600,1.09008,1.09028,1.08976,1.0899,1250,2421.4,-588369,-586141.6,32.83122299737182,47.35386702048382,60.15969025007649,NaN,NaN,50
1681232400,1.0899,1.09003,1.08962,1.08998,1134,2307.05,-587235,-586366.6,30.564986120471698,48.01172717079797,58.730543857471794,NaN,NaN,50
1681234200,1.08998,1.09108,1.08998,1.09104,1177,2215.55,-586058,-586842.4,29.56977286080965,55.87882783028612,57.46627733323002,NaN,NaN,50
1681236000,1.09104,1.09118,1.09058,1.0907,1167,2171.2,-587225,-587201.2,28.750892798257993,53.10303897170681,56.715933197414714,NaN,NaN,50
1681237800,1.0907,1.09084,1.09042,1.09074,782,2109.15,-586443,-587066,27.74118565649122,53.396347609443474,56.417695703581465,NaN,NaN,50
1681239600,1.09074,1.09148,1.09074,1.09142,906,2037,-585537,-586499.6,27.492360751813305,58.184332690377914,56.38794804261608,NaN,NaN,50
1681241400,1.09142,1.0917,1.09104,1.09142,1407,1999.3,-585537,-586160,27.478412012238646,58.18433269037792,56.15071018981855,NaN,NaN,50
1681243200,1.09142,1.09157,1.09121,1.0913,314,1907.35,-585851,-586118.6,27.465459611205027,56.986093767943146,55.52559487456837,NaN,NaN,50
1681245000,1.0913,1.09137,1.09125,1.09131,177,1816.65,-585674,-585808.4,27.453432381673814,57.06544392287624,54.86921596054359,NaN,NaN,50
1681246800,1.09131,1.09135,1.09111,1.09124,78,1707.9,-585752,-585670.2,27.16122337154444,56.28274117341121,54.24611031235669,NaN,NaN,50
1681248600,1.09124,1.09139,1.09116,1.09122,105,1598.9,-585857,-585734.2,26.941456561261845,56.04621099694342,54.18367758371975,NaN,NaN,50
1681250400,1.09122,1.09162,1.09122,1.09154,375,1503.05,-585482,-585723.2,27.036280798240874,59.01411785758518,54.26243152220895,NaN,NaN,50
1681252200,1.09154,1.09178,1.09153,1.09169,289,1376.9,-585193,-585591.6,27.32751893817943,60.365124279840295,54.893714598136405,NaN,NaN,50
1681254000,1.09169,1.09171,1.09146,1.09152,416,1256.9,-585609,-585578.6,27.426179335290872,58.030475261543316,55.564477231686915,NaN,NaN,50
1681255800,1.09152,1.09172,1.09146,1.09164,373,1098.05,-585236,-585475.4,27.532121407657804,59.22915247110717,56.41271190673143,NaN,NaN,50
1681257600,1.09164,1.09184,1.09148,1.09157,797,983.8,-586033,-585510.6,27.80866888996273,58.18519650736913,57.13938828791509,NaN,NaN,50
1681259400,1.09157,1.09276,1.09157,1.09254,1030,882.4,-585003,-585414.8,29.16606825956043,66.89325793962956,57.926133295725336,NaN,NaN,50
1681261200,1.09254,1.09262,1.09214,1.09252,1003,811,-586006,-585577.4,30.426510531329725,66.58535552712507,58.889155906826645,NaN,NaN,50
1681263000,1.09252,1.09289,1.0924,1.09262,1542,800.5,-584464,-585348.4,31.866752611480916,67.39350110432193,59.88895258503225,NaN,NaN,50
1681264800,1.09262,1.09274,1.09224,1.09228,981,765.15,-585445,-585390.2,32.73771242595691,61.91093682755956,60.15513859483094,NaN,NaN,50
1681266600,1.09228,1.09254,1.0917,1.0919,1054,755.35,-586499,-585483.4,32.14553907311129,56.38948596047593,60.02693525698079,NaN,NaN,50
1681268400,1.0919,1.09217,1.09164,1.09216,973,747.3,-585526,-585588,31.453175406967937,59.078608913578215,60.17640062452615,NaN,NaN,50
1681270200,1.09216,1.09254,1.09216,1.09242,566,716.75,-584960,-585378.8,31.343189271615717,61.62680089269347,60.50221183665595,NaN,NaN,50
1681272000,1.09242,1.09278,1.09224,1.09278,745,695.65,-584215,-585329,31.556325056129026,64.8871332911857,61.11681127363984,NaN,NaN,50
1681273800,1.09278,1.09286,1.09253,1.09256,519,682.5,-584734,-585186.8,31.85793781644886,61.45101732088306,61.50286886820696,NaN,NaN,50
1681275600,1.09256,1.0929,1.09252,1.09278,804,677.4,-583930,-584673,32.19196902351173,63.53080991512188,61.82548972945958,NaN,NaN,50
1681277400,1.09278,1.09357,1.09269,1.09355,872,650.65,-583058,-584179.4,33.295695521967424,69.69379822769712,62.49182358287793,NaN,NaN,50
1681279200,1.09355,1.09374,1.09166,1.09176,1583,714.1,-584641,-584115.6,31.950979990703765,48.97425915554176,61.84495100387782,NaN,NaN,50
1681281000,1.09176,1.09274,1.0916,1.09267,2136,812.05,-582505,-583773.6,30.58866545623062,56.1168644620269,61.62264471751494,NaN,NaN,50
1681282800,1.09267,1.09342,1.09212,1.09222,2381,927.2,-584886,-583804,30.226250901492584,52.223799895033025,61.19683067377664,NaN,NaN,50
1681284600,1.09222,1.09302,1.09195,1.09268,1970,1020.45,-582916,-583601.2,29.552785182267804,55.613629331847804,60.39114291607795,NaN,NaN,50
1681286400,1.09268,1.09302,1.09199,1.09213,2032,1103.3,-584948,-583979.2,28.927424157273364,50.95810056616659,59.27491041886663,NaN,NaN,50
1681288200,1.09213,1.0926,1.0918,1.09238,1536,1165.65,-583412,-583733.4,27.94592934058271,52.888626093813365,58.238847918116015,NaN,NaN,50
1681290000,1.09238,1.0927,1.09219,1.09242,1426,1216.15,-581986,-583629.6,27.189952081832818,53.206023145498875,57.617068369397394,NaN,NaN,50
1681291800,1.09242,1.09294,1.09208,1.0928,1431,1269.05,-580555,-582763.4,26.85500991556821,56.22338622506071,57.60520410258203,NaN,NaN,50
1681293600,1.0928,1.0936,1.09247,1.09248,1474,1302.9,-582029,-582586,27.40486377913968,53.11722455871278,57.17939093437735,NaN,NaN,50
1681295400,1.09248,1.09312,1.09246,1.09246,1280,1315.4,-583309,-582258.2,27.891116163951263,52.92043810990855,56.55750787846415,NaN,NaN,50
1681297200,1.09246,1.09268,1.09218,1.09267,1529,1341.7,-581780,-581931.8,27.662847383450806,54.81340665386351,55.83795597579827,NaN,NaN,50
1681299000,1.09267,1.09308,1.0921,1.09226,1382,1333.7,-583162,-582167,27.97996423899971,50.54071446416229,55.05864862888966,NaN,NaN,50
1681300800,1.09226,1.09272,1.09197,1.09248,2134,1391.35,-581028,-582261.6,27.960393889062917,52.67253932836144,54.28305787269248,NaN,NaN,50
1681302600,1.09248,1.099,1.09236,1.09641,9556,1816.45,-571472,-580150.2,31.215526401370592,74.1266603842356,54.5996908838738,NaN,NaN,50
1681304400,1.09641,1.0984,1.09582,1.09782,5351,2035.35,-566121,-576712.6,34.238149448513425,77.98293681461125,56.67173928809304,NaN,NaN,50
1681306200,1.09782,1.09882,1.09648,1.09748,6694,2341.75,-572815,-574919.6,37.1334671613297,75.07712303658674,58.02604347199018,NaN,NaN,50
1681308000,1.09748,1.1,1.09724,1.0993,5374,2573.2,-567441,-571775.4,40.04574679537582,79.48405940072806,59.97320486525411,NaN,NaN,50
1681309800,1.0993,1.09962,1.09756,1.09762,5695,2832,-573136,-570197,42.750006455561504,67.60132497094962,60.829468839475666,NaN,NaN,50
1681311600,1.09762,1.09808,1.09702,1.098,3834,2983.5,-569302,-569763,44.475361954019995,68.7397079186203,62.09958365036521,NaN,NaN,50
1681313400,1.098,1.09876,1.0975,1.09868,2172,3048.5,-567130,-569964.8,46.26036497409783,70.72219191878096,63.373409780720046,NaN,NaN,50
1681315200,1.09868,1.09958,1.09852,1.09932,1954,3067.05,-565176,-568437,48.1169920129274,72.49048917062171,64.75087163965738,NaN,NaN,50
1681317000,1.09932,1.09964,1.09896,1.09962,1732,3046.85,-563444,-567637.6,49.85515929255578,73.3044100678257,65.97094477128346,NaN,NaN,50
1681318800,1.09962,1.0998,1.09926,1.09968,1759,3015.75,-561685,-565347.4,51.50872449066994,73.47345211576757,67.42496102535878,NaN,NaN,50
1681320600,1.09968,1.0999,1.09929,1.09935,1138,2974.15,-562823,-564051.6,53.06991658140067,70.81736474042754,68.70331292753872,NaN,NaN,50
1681322400,1.09935,1.10006,1.09892,1.09908,2762,3010.65,-565585,-563742.6,53.894210589406676,68.63127255679916,69.69030334917699,NaN,NaN,50
1681324200,1.09908,1.09964,1.09902,1.09948,1901,3028.9,-563684,-563444.2,54.65962645398369,70.10367789793662,71.08765788016088,NaN,NaN,50
1681326000,1.09948,1.09966,1.09887,1.09892,1726,3043.9,-565410,-563837.4,55.09765541238901,65.47040152035416,72.00179089387463,NaN,NaN,50
1681327800,1.09892,1.09928,1.09866,1.09886,1445,3044.6,-566855,-564871.4,55.116334452197414,64.97490459850076,71.34809405203643,NaN,NaN,50
1681329600,1.09886,1.09902,1.09868,1.09877,513,2996.55,-567368,-565780.4,55.13367927487665,64.19013853893966,70.36289417520274,NaN,NaN,50
1681331400,1.09877,1.0992,1.09876,1.09904,375,2951.3,-566993,-566062,55.25340530368671,65.53500367750098,69.68131422098233,NaN,NaN,50
1681333200,1.09904,1.09929,1.09904,1.09916,121,2880.9,-566872,-566699.6,55.41763340274267,66.14358584007348,68.72842325236415,NaN,NaN,50
1681335000,1.09916,1.09921,1.09894,1.09921,114,2817.5,-566758,-566969.2,55.343220562883374,66.4097366748849,68.64330980264523,NaN,NaN,50
1681336800,1.09921,1.09927,1.09895,1.09912,329,2727.25,-567087,-567015.6,55.316034869205545,65.41293739801435,68.40568333688766,NaN,NaN,50
1681338600,1.09912,1.09952,1.0991,1.09952,263,2262.6,-566824,-566906.8,55.4663096911529,67.73119157039032,68.19204045485976,NaN,NaN,50
1681340400,1.09952,1.09968,1.09932,1.09957,540,2022.05,-566284,-566765,55.71607805474513,68.01974351734611,67.8727014796258,NaN,NaN,50
1681342200,1.09957,1.09996,1.09953,1.0997,692,1721.95,-565592,-566509,56.135413120827046,68.80090550365063,67.55102258218471,NaN,NaN,50
1681344000,1.0997,1.09976,1.0988,1.0997,1271,1516.8,-565592,-566275.8,54.76822669511693,68.80090550365063,67.21726925274778,NaN,NaN,50
1681345800,1.0997,1.1005,1.09968,1.10022,1526,1308.35,-564066,-565671.6,54.139873051489474,71.97640707757316,67.30005799111534,NaN,NaN,50
1681347600,1.10022,1.10035,1.09946,1.09986,1437,1188.5,-565503,-565407.4,53.101547140522,66.899740766098,67.1763771489224,NaN,NaN,50
1681349400,1.09986,1.10019,1.09953,1.09961,1953,1177.55,-567456,-565641.8,52.1373873660522,63.54769127006586,66.70809238978877,NaN,NaN,50
1681351200,1.09961,1.09984,1.09944,1.09949,1287,1144.2,-568743,-566272,51.03989061975033,61.94331455914392,66.45615760684518,NaN,NaN,50
1681353000,1.09949,1.0997,1.09924,1.09929,1156,1115.4,-569899,-567133.4,49.568631039105604,59.25804833606664,66.04781073095702,NaN,NaN,50
1681354800,1.09929,1.09934,1.09838,1.09868,1423,1098.6,-571322,-568584.6,46.557990710154336,51.87202562161518,65.16794552257672,NaN,NaN,50
1681356600,1.09868,1.09917,1.09868,1.09884,844,1083.9,-570478,-569579.6,43.7623961189853,53.50887304734758,64.30893619185147,NaN,NaN,50
1681358400,1.09884,1.09934,1.09884,1.09912,776,984.6,-569702,-570028.8,41.42365659886255,56.30928850128285,63.60648638193785,NaN,NaN,50
1681360200,1.09912,1.09916,1.09881,1.099,769,928,-570471,-570374.4,39.19379152543234,54.78617840344451,62.77623221969211,NaN,NaN,50
1681362000,1.099,1.09906,1.09851,1.09882,811,882.25,-571282,-570651,36.546803106778256,52.492540828613215,61.85334675044918,NaN,NaN,50
1681363800,1.09882,1.09891,1.0983,1.0984,939,856.95,-572221,-570830.8,34.16538309402006,47.4959703177911,60.40797380383494,NaN,NaN,50
1681365600,1.0984,1.09891,1.09828,1.0987,1707,916.65,-570514,-570838,31.990960933320174,51.07804685324308,59.197852613541876,NaN,NaN,50
1681367400,1.0987,1.09917,1.09767,1.09812,1678,981.8,-572192,-571336,30.99750786679727,44.724975185240034,57.478143305083975,NaN,NaN,50
1681369200,1.09812,1.10002,1.09811,1.09994,2777,1114.6,-569415,-571124.8,29.034285520316622,61.08262984811269,56.926837901116976,NaN,NaN,50
1681371000,1.09994,1.10008,1.09955,1.09992,2179,1217.85,-571594,-571187.2,27.305793365044984,60.86945557172465,56.1334842221278,NaN,NaN,50
1681372800,1.09992,1.10252,1.09992,1.10176,3475,1375.15,-568119,-570366.8,28.25113919584701,70.9233436275492,56.42088442651716,NaN,NaN,50
1681374600,1.10176,1.10219,1.10126,1.10146,1897,1456.85,-570016,-570267.2,29.128960324448887,67.86185940839407,56.72903929354061,NaN,NaN,50
1681376400,1.10146,1.1024,1.10108,1.10236,1876,1523.65,-568140,-569456.8,30.097393398199006,71.7952813273995,57.432751205558866,NaN,NaN,50
1681378200,1.10236,1.10318,1.10203,1.10232,2052,1591.65,-570192,-569612.2,31.513185032121477,71.37715148503953,58.298401430485505,NaN,NaN,50
1681380000,1.10232,1.10268,1.10156,1.10173,1588,1607.5,-571780,-569649.4,32.017429201655055,65.33313723162783,59.25990940262926,NaN,NaN,50
1681381800,1.10173,1.1022,1.10131,1.10142,1585,1610.45,-573365,-570698.6,32.07438495949531,62.34590775606488,59.89112616753764,NaN,NaN,50
1681383600,1.10142,1.10182,1.10116,1.1016,1868,1632,-571497,-570994.8,31.879229499793443,63.39255418422616,60.397073716319305,NaN,NaN,50
1681385400,1.1016,1.10186,1.10084,1.101,1679,1618.3,-573176,-572002,31.174497857657464,57.6410297038807,60.60099166635046,NaN,NaN,50
1681387200,1.101,1.10228,1.10084,1.10202,2287,1668.3,-570889,-572141.4,30.933184201772292,63.674771028046976,61.39972239488144,NaN,NaN,50
1681389000,1.10202,1.10536,1.10195,1.10489,6543,1937.65,-564346,-570654.6,32.61393519899325,74.62659496765272,63.337624155585836,NaN,NaN,50
1681390800,1.10489,1.10565,1.10434,1.10543,3629,2047.95,-560717,-568125,34.292045927815536,76.08742910819143,65.12400860236787,NaN,NaN,50
1681392600,1.10543,1.10678,1.10532,1.10646,4455,2228.5,-556262,-565078,36.26273020954896,78.61633385441931,67.54481993588067,NaN,NaN,50
1681394400,1.10646,1.10658,1.10474,1.10536,3718,2375.6,-559980,-562438.8,37.308832299311426,70.09104890155415,68.18827843969791,NaN,NaN,50
1681396200,1.10536,1.10586,1.10445,1.10471,3504,2512.35,-563484,-560957.8,37.90062167446598,65.56642021887244,68.52377591449418,NaN,NaN,50
1681398000,1.10471,1.10548,1.10462,1.10544,2616,2602.6,-560868,-560262.2,38.45014037996664,68.06013962635669,68.31926134298044,NaN,NaN,50
1681399800,1.10544,1.10616,1.1052,1.10529,2036,2657.45,-562904,-560699.6,39.300043580430234,66.98662834855261,68.25674483870606,NaN,NaN,50
1681401600,1.10529,1.1057,1.10476,1.10559,1423,2643.25,-561481,-561743.4,39.472758814511835,68.0713275396716,67.99074813958262,NaN,NaN,50
1681403400,1.10559,1.10569,1.10496,1.10558,1131,2615.9,-562612,-562269.8,39.63313724615903,67.99113478101897,67.74888980358115,NaN,NaN,50
1681405200,1.10558,1.10597,1.10504,1.10506,1540,2554.05,-564152,-562403.4,39.95126297484628,63.78323395682615,67.6381824268096,NaN,NaN,50
1681407000,1.10506,1.10559,1.10506,1.10527,978,2494,-563174,-562864.6,40.24666543719873,64.73250121217825,67.80865338796056,NaN,NaN,50
1681408800,1.10527,1.1053,1.10476,1.10488,1244,2382.45,-564418,-563167.4,40.02616425835897,61.508155982583574,67.67405351641466,NaN,NaN,50
1681410600,1.10488,1.10489,1.1044,1.10486,980,2336.6,-565398,-563950.8,39.24832318920335,61.33941954294695,67.93822421920511,NaN,NaN,50
1681412400,1.10486,1.10488,1.10444,1.10474,1036,2294.6,-566434,-564715.2,38.526042196415986,60.27105153071235,67.69510139796692,NaN,NaN,50
1681414200,1.10474,1.10496,1.10459,1.10466,763,2230.15,-567197,-565324.2,37.93052850821725,59.526685848140566,66.61653646085891,NaN,NaN,50
1681416000,1.10466,1.10488,1.10463,1.10486,529,2177.2,-566668,-566023,37.37755151203271,60.82914849949019,65.5266592745231,NaN,NaN,50
1681417800,1.10486,1.10486,1.10466,1.10472,252,2110.55,-566920,-566523.4,36.864072872718495,59.38842369860865,64.15323712053662,NaN,NaN,50
1681419600,1.10472,1.10478,1.10462,1.10475,59,2020.1,-566861,-566816,36.301815151972114,59.60918847237122,63.404532804166415,NaN,NaN,50
1681421400,1.10475,1.10476,1.10463,1.10469,128,1942.55,-566989,-566927,35.77971869699334,58.91934192257343,62.929741497287914,NaN,NaN,50
1681423200,1.10469,1.1049,1.10466,1.10478,184,1837.4,-566805,-566848.6,35.47730691457439,59.67323305508496,62.33067674219708,NaN,NaN,50
1681425000,1.10478,1.10492,1.10472,1.10482,151,1517.8,-566654,-566845.8,35.2233983842528,60.024363747572636,61.833372127841365,NaN,NaN,50
1681426800,1.10482,1.10506,1.1048,1.105,286,1350.65,-566368,-566735.4,35.18128100663853,61.642885403975725,61.37419768957737,NaN,NaN,50
1681428600,1.105,1.1052,1.1049,1.10519,405,1148.15,-565963,-566555.8,35.334182853939936,63.33057662040334,61.04130067810483,NaN,NaN,50
1681430400,1.10519,1.10574,1.10488,1.10562,1455,1035,-564508,-566059.6,36.12936365988944,66.88206093421377,61.26264546220394,NaN,NaN,50
1681432200,1.10562,1.1059,1.10542,1.10544,1174,918.5,-565682,-565835,37.037845458234045,64.08408027171957,61.216329680742604,NaN,NaN,50
1681434000,1.10544,1.10623,1.10531,1.10602,1138,844.6,-564544,-565413,38.20998345681589,68.63702598015192,61.72553468056892,NaN,NaN,50
1681435800,1.10602,1.10638,1.10586,1.10638,1242,804.9,-563302,-564799.8,39.43859194768369,71.08698100291468,62.42178907056661,NaN,NaN,50
1681437600,1.10638,1.10752,1.10633,1.10712,1459,806.7,-561843,-563975.8,41.39654108253211,75.34961866355486,63.498829580055364,NaN,NaN,50
1681439400,1.10712,1.10734,1.10668,1.10704,1128,806.55,-562971,-563668.4,43.21463670774849,74.07811432766333,64.53821732859271,NaN,NaN,50
1681441200,1.10704,1.10704,1.10664,1.10678,1216,790.35,-564187,-563369.4,44.77973330284199,69.94693973683283,65.18948813126003,NaN,NaN,50
1681443000,1.10678,1.10736,1.10668,1.10704,1122,797.55,-563065,-563073.6,46.436647191905045,71.6495981666386,66.0652863075479,NaN,NaN,50
1681444800,1.10704,1.10729,1.10678,1.10712,1224,796.55,-561841,-562781.4,47.97521008889216,72.17202061010373,66.96263146024307,NaN,NaN,50
1681446600,1.10712,1.10717,1.10686,1.1069,691,782.1,-562532,-562919.2,49.40387563609448,68.43717985401784,67.64247702677481,NaN,NaN,50
1681448400,1.1069,1.10718,1.10672,1.10701,747,767.65,-561785,-562682,50.21751284959342,69.29283283137224,68.32959129650962,NaN,NaN,50
1681450200,1.10701,1.10748,1.10621,1.10744,1571,808.05,-560214,-561887.4,49.323316427158744,72.43832056736031,69.21630249792302,NaN,NaN,50
1681452000,1.10744,1.1076,1.10652,1.1067,1711,867.15,-561925,-561659.4,48.649271324215334,60.88053459700775,69.16184886885388,NaN,NaN,50
1681453800,1.1067,1.10708,1.10632,1.1067,1507,929.9,-561925,-561676.2,47.43089711294566,60.88053459700776,68.98684586718277,NaN,NaN,50
1681455600,1.1067,1.10684,1.10594,1.10668,2354,1044.65,-564279,-562025.6,45.282530550415615,60.57757424540763,68.5365253894109,NaN,NaN,50
1681457400,1.10668,1.10716,1.10629,1.10655,1909,1133.7,-566188,-562906.2,43.81511813054145,58.538436800430205,68.14040799860452,NaN,NaN,50
1681459200,1.10655,1.10663,1.1054,1.1055,2219,1235.45,-568407,-564544.8,40.7995866934436,45.28048770496163,66.47208383609093,NaN,NaN,50
1681461000,1.1055,1.10636,1.10548,1.10591,1840,1319.9,-566567,-565473.2,37.9994503589956,50.03874384215914,64.96863832460839,NaN,NaN,50
1681462800,1.10591,1.10646,1.10576,1.10602,1428,1377,-565139,-566116,35.36539775204709,51.263235427808404,63.24818237919793,NaN,NaN,50
1681464600,1.10602,1.1064,1.10554,1.10628,1413,1427.4,-563726,-566005.4,33.18999089932504,54.12518593574019,61.82297320834628,NaN,NaN,50
1681466400,1.10628,1.10668,1.10579,1.10648,1755,1442.4,-561971,-565162,31.034976962190473,56.25328668913055,60.84485513351041,NaN,NaN,50
1681468200,1.10648,1.10656,1.10564,1.10588,1471,1457.25,-563442,-564169,28.909964040031305,48.92129812303253,59.22140513039569,NaN,NaN,50
1681470000,1.10588,1.10588,1.10479,1.10524,2252,1512.95,-565694,-563994.4,28.369385064486686,42.5505241346654,57.10558395357866,NaN,NaN,50
1681471800,1.10524,1.1056,1.1048,1.1054,1558,1528.75,-564136,-563793.8,27.867418872909543,44.4965079577641,55.39553596098911,NaN,NaN,50
1681473600,1.1054,1.10608,1.10532,1.10571,2042,1557.9,-562094,-563467.4,26.38341604091033,48.16038835942241,53.88607564156412,NaN,NaN,50
1681475400,1.10571,1.10744,1.10186,1.10347,9376,1970.3,-571470,-565367.2,28.170263080886237,31.81677336431723,50.98453655563247,NaN,NaN,50
1681477200,1.10347,1.10366,1.10214,1.10248,4467,2132.85,-575937,-567866.2,29.8294781894353,27.39232704238296,48.592521730302124,NaN,NaN,50
1681479000,1.10248,1.1032,1.10186,1.10305,4374,2295.45,-571563,-569040,31.51889991779634,33.15588076718018,46.61218931388587,NaN,NaN,50
1681480800,1.10305,1.10305,1.10002,1.1004,7132,2590.85,-578695,-571951.8,33.8606820867664,23.726281944782684,43.97995414955551,NaN,NaN,50
1681482600,1.1004,1.10087,1.09964,1.10063,4532,2782.9,-574163,-574365.6,36.16063343846576,25.70134180681916,41.63444736429758,NaN,NaN,50
1681484400,1.10063,1.10096,1.09858,1.0989,3787,2934.9,-577950,-575661.6,38.60845620247052,21.245114185960063,39.91763497008319,NaN,NaN,50
1681486200,1.0989,1.09914,1.09753,1.09789,3076,3010.15,-581026,-576679.4,41.13651469085666,19.156805856523917,37.71178225682353,NaN,NaN,50
1681488000,1.09789,1.09853,1.09778,1.09802,2258,3037.5,-578768,-578120.4,43.4839975729295,20.243502403857633,35.49608704082705,NaN,NaN,50
1681489800,1.09802,1.09806,1.09724,1.09778,1881,3056.2,-580649,-578511.2,45.788583262957076,19.71657726258421,33.03832927845876,NaN,NaN,50
1681491600,1.09778,1.09896,1.09752,1.09872,1905,3033.75,-578744,-579427.4,46.57752147134256,27.658935262148958,30.995875605102942,NaN,NaN,50
1681493400,1.09872,1.09902,1.09854,1.09872,1338,3005.2,-578744,-579586.2,47.224212413105974,27.658935262148958,29.477135400754115,NaN,NaN,50
1681495200,1.09872,1.0993,1.09872,1.09922,1373,2962.9,-577371,-578855.2,47.41224011898918,31.819888218600425,28.710661406749473,NaN,NaN,50
1681497000,1.09922,1.09991,1.099,1.0999,1456,2943.7,-575915,-578284.6,46.72964423951194,37.11728817172392,28.183574279175172,NaN,NaN,50
1681498800,1.0999,1.09992,1.09922,1.09952,1190,2931.8,-577105,-577575.8,46.08190346131099,35.459252033146655,27.276350255869765,NaN,NaN,50
1681500600,1.09952,1.09986,1.09947,1.09966,1011,2911.7,-576094,-577045.8,45.48042988155298,36.583212698702326,27.616810208325838,NaN,NaN,50
1681502400,1.09966,1.09977,1.09947,1.09965,499,2848.9,-576593,-576615.6,44.9219187003491,36.534271543215134,28.269806244099563,NaN,NaN,50
1681504200,1.09965,1.09966,1.09936,1.09944,597,2805.2,-577190,-576579.4,44.488025018278734,35.461389195720486,28.43448541756673,NaN,NaN,50
1681678800,1.09944,1.09959,1.09901,1.09938,100,2697.6,-577290,-576854.4,44.35248113887665,35.14383530262877,29.25002494312717,NaN,NaN,50
1681680600,1.09938,1.09945,1.09922,1.09928,116,2625.5,-577406,-576914.6,44.226618965146145,34.587906209912035,29.88477954334809,NaN,NaN,50
1681682400,1.09928,1.0994,1.09872,1.0988,940,2570.4,-578346,-577365,44.48730562441393,31.973426094618077,30.65108753682366,NaN,NaN,50
1681684200,1.0988,1.09916,1.09856,1.0987,493,2126.25,-578839,-577814.2,44.8438715866682,31.44022605090754,31.528474693565347,NaN,NaN,50
1681686000,1.0987,1.09905,1.09843,1.09856,598,1932.8,-579437,-578263.6,45.269530130329734,30.66911840003364,32.27316155043506,NaN,NaN,50
1681687800,1.09856,1.09866,1.09832,1.09844,540,1741.1,-579977,-578801,45.74673811560462,29.99015562311945,33.006988576187574,NaN,NaN,50
1681689600,1.09844,1.09916,1.09816,1.09862,1118,1440.4,-578859,-579091.6,45.077754048509746,32.407395750981536,33.34616432538991,NaN,NaN,50
1681691400,1.09862,1.09894,1.09728,1.09728,1303,1278.95,-580162,-579454.8,45.195560982666066,25.381585618712805,33.18349649371589,NaN,NaN,50
1681693200,1.09728,1.09756,1.09618,1.09694,1653,1172.25,-581815,-580050,45.988373048169414,23.96208470150698,32.6222248139235,NaN,NaN,50
1681695000,1.09694,1.09754,1.09678,1.09712,1164,1076.65,-580651,-580292.8,46.72455568042252,26.311684142859548,31.850395954718902,NaN,NaN,50
1681696800,1.09712,1.09776,1.09712,1.09765,1195,1023.5,-579456,-580188.6,46.96167632123805,32.887575163581275,31.666704749749947,NaN,NaN,50
1681698600,1.09765,1.09822,1.09752,1.0981,1298,994.35,-578158,-580048.4,46.296446754266135,37.95065208719747,31.764378991785314,NaN,NaN,50
1681700400,1.0981,1.09812,1.09782,1.0979,806,939.4,-578964,-579808.8,45.678733584935074,36.6280548350556,31.771077798345345,NaN,NaN,50
1681702200,1.0979,1.09795,1.09764,1.09764,842,914.6,-579806,-579407,45.266086125777036,34.92408670796296,31.732699049219807,NaN,NaN,50
1681704000,1.09764,1.0982,1.0976,1.09799,878,889.85,-578928,-579062.4,44.370478015229914,39.035614157913045,32.010683253168686,NaN,NaN,50
1681705800,1.09799,1.09849,1.09796,1.09846,889,861.5,-578039,-578779,42.968081306713465,44.13951384705504,32.692940941536044,NaN,NaN,50
1681707600,1.09846,1.09889,1.09842,1.09882,1190,861.5,-576849,-578517.2,40.93448686866153,47.747946594339595,33.81969240580187,NaN,NaN,50
1681709400,1.09882,1.09948,1.09878,1.09886,1381,880,-575468,-577818,38.10276924334292,48.148735261151785,35.01315734939074,NaN,NaN,50
1681711200,1.09886,1.09936,1.09834,1.09889,2100,960.05,-573368,-576530.4,36.071118297115966,48.46798835404891,36.284505203248976,NaN,NaN,50
1681713000,1.09889,1.09908,1.09843,1.09868,1631,1011.75,-574999,-575744.6,34.18458527561952,46.31813164062042,37.45078920449904,NaN,NaN,50
1681714800,1.09868,1.09988,1.09864,1.0994,2286,1121.05,-572713,-574679.4,32.240853371365404,53.872711729954084,38.98402606013993,NaN,NaN,50
1681716600,1.0994,1.09999,1.09902,1.0992,2227,1226.6,-574940,-574297.6,30.581915854613822,51.696380343060135,40.863654254736176,NaN,NaN,50
1681718400,1.0992,1.09934,1.09752,1.0977,2476,1303.4,-577416,-574687.2,29.65268855333349,38.97822348769212,41.936235596606544,NaN,NaN,50
1681720200,1.0977,1.09786,1.09642,1.0965,2425,1400,-579841,-575981.8,29.74073003210611,32.16150868314371,42.35408020662685,NaN,NaN,50
1681722000,1.0965,1.09768,1.09648,1.09754,2138,1477,-577703,-576522.6,29.82248283382355,41.68073970145981,42.98216338790388,NaN,NaN,50
1681723800,1.09754,1.09848,1.09746,1.09806,2156,1557.8,-575547,-577089.4,28.777526834403833,45.7776697712975,43.541236079625314,NaN,NaN,50
1681725600,1.09806,1.09806,1.09723,1.09794,2199,1611.85,-577746,-577650.6,28.024025228831572,44.99216998756908,44.13867287623342,NaN,NaN,50
1681727400,1.09794,1.0985,1.09792,1.09816,1388,1616.1,-576358,-577439,26.7443950617478,46.794663459839136,44.98657121565314,NaN,NaN,50
1681729200,1.09816,1.09844,1.0974,1.09748,1854,1626.15,-578212,-577113.2,26.07226014648053,42.19256380501485,45.21206761901755,NaN,NaN,50
1681731000,1.09748,1.09798,1.09724,1.09768,1774,1656.65,-576438,-576860.2,25.601322115271678,43.93889694437695,45.19773784025483,NaN,NaN,50
1681732800,1.09768,1.09844,1.09755,1.09814,2087,1701.25,-574351,-576621,24.529483058020666,47.84172255776484,45.204436123356636,NaN,NaN,50
1681734600,1.09814,1.09814,1.09517,1.09538,4344,1853.55,-578695,-576810.8,25.404854641888612,32.99804169372311,44.12224372568316,NaN,NaN,50
1681736400,1.09538,1.0957,1.09392,1.09452,3453,1985.9,-582148,-577968.8,26.859489846377,29.886446231445234,42.794990716925746,NaN,NaN,50
1681738200,1.09452,1.09537,1.09297,1.09322,4635,2175.55,-586783,-579683,28.613884195689423,25.909231189789423,41.33721211329497,NaN,NaN,50
1681740000,1.09322,1.0936,1.09195,1.0924,4502,2356.75,-591285,-582652.4,30.616108344351794,23.761255488672077,39.18639381034625,NaN,NaN,50
1681741800,1.0924,1.09254,1.09092,1.09144,4400,2532.3,-595685,-586919.2,32.7995493069638,21.512661498737657,37.03041389289465,NaN,NaN,50
1681743600,1.09144,1.0924,1.0914,1.09164,3394,2642.5,-592291,-589638.4,34.8270302008178,23.14443702682803,35.899429145690064,NaN,NaN,50
1681745400,1.09164,1.09217,1.09122,1.0914,2783,2712.6,-595074,-592223.6,36.76730275375176,22.538874533252283,35.21209813498353,NaN,NaN,50
1681747200,1.0914,1.09151,1.09106,1.09139,1950,2705.1,-597024,-594271.8,38.62193486670084,22.512443847477684,33.84293414541337,NaN,NaN,50
1681749000,1.09139,1.0918,1.09118,1.09118,1437,2695.4,-598461,-595707,39.91781682432614,21.930829329270907,32.139588399554334,NaN,NaN,50
1681750800,1.09118,1.09228,1.09117,1.09217,1429,2652.55,-597032,-595976.4,40.434078714902505,30.983304476418,31.138955148757827,NaN,NaN,50
1681752600,1.09217,1.09257,1.09212,1.09238,1036,2593,-595996,-596717.4,40.50997436427914,32.76427467799651,30.13678452148336,NaN,NaN,50
1681754400,1.09238,1.09242,1.0919,1.09217,1090,2523.7,-597086,-597119.8,40.70752528639802,31.878377369605275,29.400056918954103,NaN,NaN,50
1681756200,1.09217,1.09274,1.09206,1.0926,1017,2453.3,-596069,-596928.8,40.42563818344925,35.71147707284767,28.812384070987726,NaN,NaN,50
1681758000,1.0926,1.09298,1.09254,1.09294,911,2391.95,-595158,-596268.2,39.8178421112061,38.6509413058847,28.15589969585343,NaN,NaN,50
1681759800,1.09294,1.09312,1.09268,1.09309,1032,2335.75,-594126,-595687,39.04833891488232,39.95532763156646,28.65284869141367,NaN,NaN,50
1681761600,1.09309,1.09309,1.09268,1.0927,480,2249.8,-594606,-595409,38.33380023258167,37.71032604405068,29.21169724945691,NaN,NaN,50
1681763400,1.0927,1.09289,1.09264,1.09274,339,2197.35,-594267,-594845.2,37.70659741514493,38.09452051951751,30.0820750587232,NaN,NaN,50
1681765200,1.09274,1.09274,1.09238,1.09266,68,2108.05,-594335,-594498.4,37.36441410761634,37.595083431267035,31.07020562605141,NaN,NaN,50
1681767000,1.09266,1.09276,1.09258,1.09268,237,2031.2,-594098,-594286.4,37.00927434735976,37.81458191718773,32.234628513083564,NaN,NaN,50
1681768800,1.09268,1.09288,1.09266,1.09278,276,1940.65,-593822,-594225.6,36.444778597672176,38.97044818655313,33.36505788163535,NaN,NaN,50
1681770600,1.09278,1.0928,1.09236,1.09242,253,1736.1,-594075,-594119.4,36.23780249908299,36.350928175755755,34.35163314181417,NaN,NaN,50
1681772400,1.09242,1.09265,1.09238,1.09256,367,1581.8,-593708,-594007.6,36.0456104075359,38.093664312047295,35.464577460712,NaN,NaN,50
1681774200,1.09256,1.09263,1.09239,1.09245,348,1367.45,-594056,-593951.8,35.86714632252787,37.23109363938698,36.557453482863146,NaN,NaN,50
1681776000,1.09245,1.09265,1.09223,1.09251,746,1179.65,-593310,-593794.2,35.891553670905715,38.05502543984652,37.06257640882233,NaN,NaN,50
1681777800,1.09251,1.09291,1.09228,1.09254,1009,1010.1,-592301,-593490,35.2769175383239,38.489784498360905,37.47154139599122,NaN,NaN,50
1681779600,1.09254,1.09285,1.09235,1.09261,1104,895.6,-591197,-592914.4,34.70618398664079,39.5557882851227,38.01992788995675,NaN,NaN,50
1681781400,1.09261,1.09345,1.0925,1.0933,1674,840.15,-589523,-592077.4,32.82004358647133,48.94785606242715,38.965383532069566,NaN,NaN,50
1681783200,1.0933,1.09362,1.09282,1.09336,1635,824.4,-587888,-590843.8,30.731872274344447,49.68006232225313,39.75317789038159,NaN,NaN,50
1681785000,1.09336,1.09349,1.09294,1.0934,1244,814.75,-586644,-589510.6,28.79285605594091,50.192928295103215,40.48443508063422,NaN,NaN,50
1681786800,1.0934,1.09392,1.09333,1.09384,1306,808.6,-585338,-588118,27.317979854274316,55.558652853448976,41.75931556701981,NaN,NaN,50
1681788600,1.09384,1.09386,1.09347,1.09358,773,795.45,-586111,-587100.8,25.948451952726764,51.994163542919466,42.75214721154852,NaN,NaN,50
1681790400,1.09358,1.09378,1.09346,1.09358,712,776.55,-586111,-586418.4,24.65322622505418,51.99416354291947,43.78065293380941,NaN,NaN,50
1681792200,1.09358,1.0937,1.09338,1.0937,569,754.15,-585542,-585949.2,23.253653505709032,53.58803335867923,44.90732803677309,NaN,NaN,50
1681794000,1.0937,1.09388,1.09344,1.09385,715,744.35,-584827,-585585.8,22.34960227445031,55.57364444654207,46.0932706267723,NaN,NaN,50
1681795800,1.09385,1.09438,1.09376,1.09424,1526,769.05,-583301,-585178.4,22.458844759943272,60.32618873019329,47.805789237803545,NaN,NaN,50
1681797600,1.09424,1.09448,1.09352,1.09404,2240,857.05,-585541,-585064.4,21.92921765166595,56.96097266930527,49.153454120464836,NaN,NaN,50
1681799400,1.09404,1.09526,1.09398,1.09492,1945,937.35,-583596,-584561.4,22.64958802464429,65.95899059363921,51.20544676005433,NaN,NaN,50
1681801200,1.09492,1.09608,1.09469,1.09598,2572,1062.55,-581024,-583657.8,24.21416756954678,73.22139240727711,53.7173301148708,NaN,NaN,50
1681803000,1.09598,1.0971,1.09572,1.09704,2559,1178.65,-578465,-582385.4,26.45164793213281,78.22441401351806,56.55551793738203,NaN,NaN,50
1681804800,1.09704,1.0977,1.09666,1.09692,2377,1283.7,-580842,-581893.6,28.883447904218055,76.48234386016188,59.193129049884824,NaN,NaN,50
1681806600,1.09692,1.0983,1.09692,1.09812,2376,1389.85,-578466,-580478.6,31.444070436746113,81.03158575911819,61.484824028219904,NaN,NaN,50
1681808400,1.09812,1.0983,1.09726,1.09745,2639,1503.45,-581105,-579980.4,33.82179135980788,72.58867666250057,63.121153623951855,NaN,NaN,50
1681810200,1.09745,1.09771,1.09705,1.0975,1700,1571.05,-579405,-579656.6,35.53894696145252,72.81630490780958,64.73710909628802,NaN,NaN,50
1681812000,1.0975,1.09771,1.09692,1.09748,1802,1623.85,-581207,-580205,36.828421294027905,72.55675631301298,65.95125934339974,NaN,NaN,50
1681813800,1.09748,1.09802,1.09732,1.09784,1381,1642.45,-579826,-580001.8,38.24111442043325,74.33039983779935,67.54670479303402,NaN,NaN,50
1681815600,1.09784,1.09787,1.09688,1.09693,1665,1670.5,-581491,-580606.8,38.54255844885793,63.20956758319022,68.34780508162478,NaN,NaN,50
1681817400,1.09693,1.09742,1.09658,1.09664,2342,1703.9,-583833,-581152.4,38.18958872603531,60.12247969208072,68.81455124829633,NaN,NaN,50
1681819200,1.09664,1.09748,1.09656,1.09721,2494,1746.85,-581339,-581539.2,37.92452469707698,63.858692276712105,69.40634037902275,NaN,NaN,50
1681821000,1.09721,1.09782,1.09544,1.09558,3011,1835.2,-584350,-582167.8,35.66176876281645,49.559084094230684,68.637261476454,NaN,NaN,50
1681822800,1.09558,1.09613,1.09464,1.095,3150,1927.4,-587500,-583702.6,33.723533978571545,45.642573437413866,67.82880438846175,NaN,NaN,50
1681824600,1.095,1.0965,1.09428,1.09579,3554,2066.45,-583946,-584193.6,31.42167576584594,51.28915360045221,66.78095888894839,NaN,NaN,50
1681826400,1.09579,1.09694,1.09532,1.09659,3634,2212.55,-580312,-583489.4,29.62558476482532,56.24586150018148,65.568420967013,NaN,NaN,50
1681828200,1.09659,1.09712,1.09598,1.09622,3666,2367.4,-583978,-584017.2,28.17630907736346,53.53265496819357,63.80472389234695,NaN,NaN,50
1681830000,1.09622,1.09664,1.09596,1.09642,2371,2450.2,-581607,-583468.6,26.800168052227818,54.80184298307471,62.25611668684072,NaN,NaN,50
1681831800,1.09642,1.09666,1.09562,1.09572,1895,2468.65,-583502,-582669,25.005052216654622,49.686558971652325,60.01718620202173,NaN,NaN,50
1681833600,1.09572,1.0963,1.09548,1.09618,1414,2427.35,-582088,-582297.4,23.307788226257138,52.804175129284545,58.60400752107773,NaN,NaN,50
1681835400,1.09618,1.09704,1.09618,1.09704,1188,2389.5,-580900,-582415,22.56787050759275,58.03908143139956,57.54849155847701,NaN,NaN,50
1681837200,1.09704,1.09712,1.09682,1.0969,1242,2323,-582142,-582047.8,21.980653234940313,56.932008817421334,56.432438165934755,NaN,NaN,50
1681839000,1.0969,1.09708,1.09672,1.09684,1065,2248.3,-583207,-582367.8,21.262557188937322,56.43517250218707,55.15420764196245,NaN,NaN,50
1681840800,1.09684,1.09742,1.09674,1.09738,913,2175.1,-582294,-582126.2,21.04810333591679,59.83265438983485,54.91299955672279,NaN,NaN,50
1681842600,1.09738,1.09744,1.09683,1.09713,1401,2126.35,-583695,-582447.6,20.87544216104696,57.593293950739856,54.732343432341295,NaN,NaN,50
1681844400,1.09713,1.09748,1.09713,1.0972,1035,2046.15,-582660,-582799.6,20.771328445496078,58.06654231386666,54.318618434995194,NaN,NaN,50
1681846200,1.0972,1.09742,1.09698,1.09709,1161,2019.2,-583821,-583135.4,20.35399994029011,56.99023970536339,54.849415264361824,NaN,NaN,50
1681848000,1.09709,1.09736,1.09702,1.09736,402,1949.2,-583419,-583177.8,19.96648061402743,58.99913458969864,55.803455346667874,NaN,NaN,50
1681849800,1.09736,1.09738,1.09704,1.09738,397,1900,-583022,-583323.4,19.641759887365613,59.15133609985405,56.365039810910865,NaN,NaN,50
1681851600,1.09738,1.09738,1.09688,1.09688,83,1820.9,-583105,-583205.4,18.94920454938223,53.7767482272896,56.18867457713288,NaN,NaN,50
1681853400,1.09688,1.09733,1.09688,1.09724,4118,1909.7,-578987,-582470.8,18.306117449826235,56.81896945022766,56.4234113258496,NaN,NaN,50
1681855200,1.09724,1.09754,1.0972,1.0974,881,1829.05,-578106,-581327.8,18.142100141497014,58.13769847199072,56.661686717915025,NaN,NaN,50
1681857000,1.0974,1.0974,1.09724,1.0974,268,1691.9,-578106,-580265.2,17.989798355191304,58.13769847199072,57.265339539367766,NaN,NaN,50
1681858800,1.0974,1.09762,1.09734,1.09749,411,1554.95,-577695,-579199.8,18.302075584320647,58.9554289334547,57.70471481109421,NaN,NaN,50
1681860600,1.09749,1.09766,1.09739,1.0975,603,1407.4,-577092,-577997.2,18.672967167586936,59.05114195869166,57.77700484875793,NaN,NaN,50
1681862400,1.0975,1.0979,1.0974,1.0975,1162,1283.8,-577092,-577618.2,19.48821026620838,59.05114195869166,57.92837150170582,NaN,NaN,50
1681864200,1.0975,1.09829,1.09748,1.09828,1106,1155.8,-575986,-577194.2,20.89954322034007,66.18451467290136,58.624753085328265,NaN,NaN,50
1681866000,1.09828,1.09842,1.09787,1.09806,1171,1095.8,-577157,-577004.4,22.405006352214315,62.85845828435947,58.840881934937165,NaN,NaN,50
1681867800,1.09806,1.09806,1.09684,1.09695,1420,1072.05,-578577,-577180.8,20.99291928905698,49.37587758944658,58.25392362341622,NaN,NaN,50
1681869600,1.09695,1.09713,1.0965,1.0971,1425,1072.6,-577152,-577192.8,19.962536798216497,50.90827209243049,57.742618607599354,NaN,NaN,50
1681871400,1.0971,1.09742,1.09708,1.0974,983,1062.35,-576169,-577008.2,18.64678965902396,53.913006788120185,57.5228162563677,NaN,NaN,50
1681873200,1.0974,1.09755,1.09706,1.09736,769,1038.7,-576938,-577198.6,17.674231651130206,53.44331322573778,57.125971873227634,NaN,NaN,50
1681875000,1.09736,1.09748,1.09698,1.09742,732,1022.05,-576206,-577008.4,16.59900372272489,54.08942804171646,56.764407011932086,NaN,NaN,50
1681876800,1.09742,1.09746,1.09718,1.09718,573,1005.05,-576779,-576648.8,15.60057778920567,51.038246465001144,56.568799743197204,NaN,NaN,50
1681878600,1.09718,1.09722,1.09673,1.09687,692,969.6,-577471,-576712.6,15.253387456326273,47.32478081496797,55.890643412107224,NaN,NaN,50
1681880400,1.09687,1.09703,1.09662,1.09668,693,952.5,-578164,-577111.6,15.142276987160944,45.156190312479914,54.96339282928502,NaN,NaN,50
1681882200,1.09668,1.09676,1.09602,1.0961,1201,954.5,-579365,-577597,16.043541437968408,39.24432087489677,53.613865858064024,NaN,NaN,50
1681884000,1.0961,1.09706,1.09465,1.09522,3590,1113.9,-582955,-578946.8,18.35647146024309,32.32864797489708,51.71195293245277,NaN,NaN,50
1681885800,1.09522,1.09626,1.09494,1.09562,3349,1261.5,-579606,-579512.2,20.504192195212433,37.702551755852326,50.18705363224995,NaN,NaN,50
1681887600,1.09562,1.09718,1.09562,1.09714,3263,1420.5,-576343,-579286.6,20.566922365917453,52.98226002721956,49.753562065716224,NaN,NaN,50
1681889400,1.09714,1.09725,1.09562,1.09628,2485,1338.85,-578828,-579419.4,20.497638869511125,46.09373484416344,48.318506363663516,NaN,NaN,50
1681891200,1.09628,1.09632,1.09486,1.09592,2737,1431.65,-581565,-579859.4,21.276088922765556,43.541681764749235,46.93873661226279,NaN,NaN,50
1681893000,1.09592,1.09623,1.09506,1.09556,2347,1535.6,-583912,-580050.8,21.998935400787527,41.091573587238535,46.34700061210507,NaN,NaN,50
1681894800,1.09556,1.09633,1.09424,1.09443,2232,1626.65,-586144,-581358.4,23.43038508887519,34.524548259394834,45.17673462403109,NaN,NaN,50
1681896600,1.09443,1.09454,1.09258,1.093,3779,1785.45,-589923,-584074.4,25.805950905426872,28.349929136842917,43.35080050608271,NaN,NaN,50
1681898400,1.093,1.09356,1.09272,1.09342,2340,1844.35,-587583,-585825.4,28.011833449367714,32.18610739268328,41.832428660864544,NaN,NaN,50
1681900200,1.09342,1.09418,1.09331,1.09338,1807,1879.4,-589390,-587390.4,28.955772564733408,32.01032811915714,40.255350094967454,NaN,NaN,50
1681902000,1.09338,1.09339,1.09193,1.09198,2228,1932.25,-591618,-588931.6,30.635311022500222,26.545851234488126,38.50589329278795,NaN,NaN,50
1681903800,1.09198,1.09326,1.09172,1.09312,2388,1980.65,-589230,-589548.8,32.298074027762304,36.11012511546243,37.704846457108985,NaN,NaN,50
1681905600,1.09312,1.09433,1.09276,1.09419,2526,2035.7,-586704,-588905,32.270591480263285,43.540886843424126,37.58946763789071,NaN,NaN,50
1681907400,1.09419,1.09498,1.09384,1.09498,2793,2126.2,-583911,-588170.6,31.439306223966213,48.320045190351266,38.23773366042317,NaN,NaN,50
1681909200,1.09498,1.09578,1.09473,1.0956,2786,2227.05,-581125,-586517.6,29.7901640710046,51.77052272819006,39.62643899994409,NaN,NaN,50
1681911000,1.0956,1.0964,1.09524,1.09602,3454,2363.15,-577671,-583728.2,27.671885973904605,54.01057101870399,40.79129751871922,NaN,NaN,50
1681912800,1.09602,1.09794,1.09602,1.0967,3617,2515.35,-574054,-580693,26.940428083957897,57.455883671794346,41.11084206476028,NaN,NaN,50
1681914600,1.0967,1.09761,1.0957,1.09572,3219,2641.7,-577273,-578806.8,25.94823829885532,51.47125479174467,41.494950632444656,NaN,NaN,50
1681916400,1.09572,1.09623,1.09533,1.09611,2678,2740.95,-574595,-576943.6,24.668399278846604,53.545013708871224,42.209474342739085,NaN,NaN,50
1681918200,1.09611,1.09616,1.09512,1.0953,1974,2779.6,-576569,-576032.4,23.276102537560586,48.873695244236806,42.765340175381816,NaN,NaN,50
1681920000,1.0953,1.09576,1.0952,1.09554,1469,2673.55,-575100,-575518.2,21.983255563509285,50.25838112476459,43.88918538005108,NaN,NaN,50
1681921800,1.09554,1.09668,1.09554,1.09658,1481,2580.15,-573619,-575431.2,21.58437219679923,55.83980062943168,45.852747629521716,NaN,NaN,50
1681923600,1.09658,1.09668,1.0955,1.09568,1754,2504.7,-575373,-575051.2,21.168160442404922,50.553301917811964,47.16469009560233,NaN,NaN,50
1681925400,1.09568,1.09598,1.09542,1.09562,1068,2433.85,-576441,-575420.4,20.68468394600041,50.21201054728493,48.46481026904003,NaN,NaN,50
1681927200,1.09562,1.09606,1.0954,1.09588,1392,2366.6,-575049,-575116.4,20.312020607397827,51.732683140169385,50.2638696908744,NaN,NaN,50
1681929000,1.09588,1.0959,1.09518,1.09528,1233,2310.9,-576282,-575352.8,19.672109846429283,48.08292102624337,51.119069398787325,NaN,NaN,50
1681930800,1.09528,1.09549,1.0952,1.0953,934,2246,-575348,-575698.6,19.07790699695849,48.21407297211468,51.45286840797951,NaN,NaN,50
1681932600,1.0953,1.09559,1.0952,1.0955,1093,2111.7,-574255,-575475,18.64288676056511,49.5855981697485,51.54326504936502,NaN,NaN,50
1681934400,1.0955,1.09552,1.09518,1.09548,496,2019.5,-574751,-575137,18.207018162377974,49.4445734148614,51.377125812698694,NaN,NaN,50
1681936200,1.09548,1.0957,1.09544,1.09561,354,1946.85,-574397,-575006.6,18.032928049349504,50.43140812971022,51.1214713206277,NaN,NaN,50
1681938000,1.09561,1.09598,1.0955,1.09574,536,1862.25,-573861,-574522.4,18.22171279610898,51.45195526095078,50.69261929128174,NaN,NaN,50
1681939800,1.09574,1.0959,1.09549,1.09564,284,1757.05,-574145,-574281.8,18.377745619206202,50.589125751665726,50.62961007413325,NaN,NaN,50
1681941600,1.09564,1.09572,1.09555,1.09558,318,1646.65,-574463,-574323.4,18.522633240653622,50.04683072607867,50.37973986107663,NaN,NaN,50
1681943400,1.09558,1.09562,1.09518,1.09528,314,1522.7,-574777,-574328.6,17.90443679291138,47.31572428446561,50.26845622109297,NaN,NaN,50
1681945200,1.09528,1.09531,1.09484,1.09488,481,1407.45,-575258,-574500.8,16.704863039179244,43.87755038075055,49.81268259652054,NaN,NaN,50
1681947000,1.09488,1.09524,1.0947,1.09519,570,1263.25,-574688,-574666.2,15.67890494303527,47.08658585204984,49.187452969564696,NaN,NaN,50
1681948800,1.09519,1.09575,1.09509,1.09548,1017,1133.25,-573671,-574571.4,15.255152608763392,49.96863409357102,49.14569098211892,NaN,NaN,50
1681950600,1.09548,1.09592,1.09528,1.09567,1201,1032.35,-572470,-574172.8,15.1238862310841,51.82020642696211,49.26056211638157,NaN,NaN,50
1681952400,1.09567,1.09572,1.09492,1.0956,1587,977.8,-574057,-574028.8,14.31430921542805,51.070319095113376,49.21325039887757,NaN,NaN,50
1681954200,1.0956,1.09616,1.09548,1.09602,1563,957.25,-572494,-573476,14.253223620808647,55.25425088164426,49.72548824569191,NaN,NaN,50
1681956000,1.09602,1.0961,1.09558,1.0958,1125,940.05,-573619,-573262.2,14.196501282947773,52.71165724263335,50.04674426501468,NaN,NaN,50
1681957800,1.0958,1.09604,1.09522,1.0954,1190,925.5,-574809,-573489.8,13.438251968189673,48.35480445337713,49.958830428131016,NaN,NaN,50
1681959600,1.0954,1.09586,1.09531,1.09572,1153,895.45,-573656,-573727,12.734163318771438,51.78798150129873,50.12621672001939,NaN,NaN,50
1681961400,1.09572,1.09618,1.09568,1.09595,893,886.7,-572763,-573468.2,12.647594107151608,54.14733697469428,50.39164020894683,NaN,NaN,50
1681963200,1.09595,1.09596,1.09564,1.09573,763,855.25,-573526,-573674.6,12.479858581341484,51.54875869257464,50.398554739777104,NaN,NaN,50
1681965000,1.09573,1.09593,1.09552,1.09592,739,830.55,-572787,-573508.2,12.054541377170068,53.618970082798725,50.61497219200089,NaN,NaN,50
1681966800,1.09592,1.09616,1.09552,1.09558,738,820.75,-573525,-573251.4,12.100032468754824,49.53978073205329,50.57875433528479,NaN,NaN,50
1681968600,1.09558,1.0964,1.09553,1.0962,1063,819.25,-572462,-573012.6,12.572653288679577,56.09867304627013,51.20610781827083,NaN,NaN,50
1681970400,1.0962,1.09732,1.096,1.09695,2130,900.95,-570332,-572526.4,14.298843849543003,62.456020257263205,52.53314138087888,NaN,NaN,50
1681972200,1.09695,1.09726,1.09663,1.09672,1700,968.25,-572032,-572227.6,15.901735084630467,59.60542643618525,53.4273442797457,NaN,NaN,50
1681974000,1.09672,1.09692,1.09499,1.09562,3071,1095,-575103,-572690.8,15.211609268062212,48.26048524393654,53.30533364762895,NaN,NaN,50
1681975800,1.09562,1.09624,1.0951,1.09613,3051,1233.35,-572052,-572396.2,14.570778152677402,52.750765054347454,53.371802121013616,NaN,NaN,50
1681977600,1.09613,1.09778,1.09562,1.09735,2879,1361.4,-569173,-571738.4,15.019474718783412,61.384310593366216,54.10851579946024,NaN,NaN,50
1681979400,1.09735,1.09785,1.09664,1.09715,2348,1463.1,-571521,-571976.2,15.505823395216053,59.46600405201163,54.409355311629334,NaN,NaN,50
1681981200,1.09715,1.09732,1.09563,1.09588,2608,1569.45,-574129,-572395.6,14.558355792056568,48.99534826555308,54.14390467040932,NaN,NaN,50
1681983000,1.09588,1.09668,1.09577,1.09618,1823,1632.1,-572306,-571836.2,13.678564446265614,51.1820371454111,54.34584986269747,NaN,NaN,50
1681984800,1.09618,1.09666,1.09576,1.0961,1698,1666.15,-574004,-572226.6,12.848157774640148,50.55954513223322,54.258104407764215,NaN,NaN,50
1681986600,1.0961,1.09784,1.0961,1.09712,1793,1695.75,-572211,-572834.2,13.40453041392885,57.634496463700856,54.50718722840754,NaN,NaN,50
1681988400,1.09712,1.09745,1.097,1.0971,2035,1718.15,-574246,-573379.2,13.921162150411218,57.46086530319206,54.92948055773736,NaN,NaN,50
1681990200,1.0971,1.09749,1.09538,1.09549,2161,1748.05,-576407,-573834.8,13.451952131381814,45.561501196585695,54.35394706586499,NaN,NaN,50
1681992000,1.09549,1.09549,1.09336,1.09404,3606,1872.1,-580013,-575376.2,14.588269668378903,37.94094682491644,53.52545892964093,NaN,NaN,50
1681993800,1.09404,1.09852,1.09402,1.09776,6490,2137.1,-573523,-575280,14.011480432880088,57.55522708176136,53.62949850360459,NaN,NaN,50
1681995600,1.09776,1.09794,1.09646,1.09656,3753,2267.1,-577276,-576293,13.475890428488333,51.86104341979155,52.872714443785185,NaN,NaN,50
1681997400,1.09656,1.09818,1.09656,1.09728,3622,2403.55,-573654,-576174.6,13.144442558206244,54.75350485151062,52.52614861630843,NaN,NaN,50
1681999200,1.09728,1.09898,1.09712,1.09818,3999,2565.35,-569655,-574824.2,13.369819184530604,58.139382287237005,53.23178411940132,NaN,NaN,50
1682001000,1.09818,1.09888,1.09721,1.09797,3197,2688.25,-572852,-573392,13.579097480403227,57.066313467626365,53.54003757749267,NaN,NaN,50
1682002800,1.09797,1.09807,1.09658,1.09708,2830,2792.85,-575682,-573823.8,13.195459194233974,52.63260226957406,52.91491555436466,NaN,NaN,50
1682004600,1.09708,1.09736,1.09671,1.09695,2018,2840.6,-577700,-573908.6,12.839223642791097,51.997117883772944,52.38142368520475,NaN,NaN,50
1682006400,1.09695,1.0972,1.09636,1.09658,1719,2820.05,-579419,-575061.6,12.176816106591437,50.14149230034003,52.46329111626096,NaN,NaN,50
1682008200,1.09658,1.09677,1.09633,1.09672,1226,2796.35,-578193,-576769.2,11.532541482368952,50.85613892852603,52.44001267219774,NaN,NaN,50
1682010000,1.09672,1.09706,1.0965,1.09684,1161,2700.85,-577032,-577605.2,11.207152751764225,51.49786666165355,52.50703563858491,NaN,NaN,50
1682011800,1.09684,1.09707,1.09638,1.09704,1121,2604.35,-575911,-577651,10.773006537176034,52.60861174011237,52.14804387261431,NaN,NaN,50
1682013600,1.09704,1.09727,1.09644,1.09648,1260,2523.4,-577171,-577545.2,10.5736626592423,49.210380016032445,51.55872349496004,NaN,NaN,50
1682015400,1.09648,1.09657,1.09588,1.09651,1423,2477.15,-575748,-576811,9.889528328564547,49.39895044299131,51.83282701256045,NaN,NaN,50
1682017200,1.09651,1.09656,1.09564,1.09566,1509,2422.2,-577257,-576623.8,9.515600852406237,44.37215204663535,52.29219881411179,NaN,NaN,50
1682019000,1.09566,1.09636,1.09564,1.09636,1223,2392.2,-576034,-576424.2,9.168382481687809,48.9768856228636,51.679460138476244,NaN,NaN,50
1682020800,1.09636,1.09678,1.09632,1.09675,594,2337,-575440,-576330,8.702594567683938,51.391118325900145,51.64589406034115,NaN,NaN,50
1682022600,1.09675,1.09705,1.09666,1.09705,451,2269.9,-574989,-575893.6,8.590489726446345,53.22457738171447,51.5366849553557,NaN,NaN,50
1682024400,1.09705,1.09705,1.09662,1.09696,180,2177.15,-575169,-575777.8,8.430547234029003,52.583790789781276,51.139856991251726,NaN,NaN,50
1682026200,1.09696,1.09714,1.09686,1.09698,199,2079.05,-574970,-575320.4,8.398259153875784,52.720013872517555,50.82940702017253,NaN,NaN,50
1682028000,1.09698,1.09714,1.09686,1.09704,300,1913.75,-574670,-575047.6,8.36827736516208,53.15481907561695,50.86670822060417,NaN,NaN,50
1682029800,1.09704,1.09718,1.09672,1.09684,379,1608.2,-575049,-574969.4,8.10601230749748,51.45611467734183,50.82806513443051,NaN,NaN,50
1682031600,1.09684,1.097,1.09664,1.09671,512,1446.15,-575561,-575083.8,7.725172039037252,50.33020917295848,50.841544911046114,NaN,NaN,50
1682033400,1.09671,1.09692,1.09658,1.09678,455,1287.8,-575106,-575071.2,7.264258848817717,50.95253933530717,50.84843065438763,NaN,NaN,50
1682035200,1.09678,1.09687,1.09619,1.09631,842,1129.95,-575948,-575266.8,7.325787673627135,46.719867279649705,50.5071449842445,NaN,NaN,50
1682037000,1.09631,1.09723,1.09626,1.09702,948,1017.5,-575000,-575332.8,6.874413177382442,53.06307066152404,50.5396063357739,NaN,NaN,50
1682038800,1.09702,1.09733,1.09694,1.09702,1027,927.35,-575000,-575323,6.6295290908804105,53.06307066152404,50.81479852473758,NaN,NaN,50
1682040600,1.09702,1.09704,1.09652,1.09652,1315,892.2,-576315,-575473.8,6.650845449121843,48.36069920977881,50.74063772236526,NaN,NaN,50
1682042400,1.09652,1.09704,1.09646,1.09664,1143,863.4,-575172,-575487,6.771648360711644,49.516986496253686,51.10812589733799,NaN,NaN,50
1682044200,1.09664,1.09667,1.09632,1.09654,886,846.4,-576058,-575509,7.124591419483006,48.541542351580205,51.07702994938917,NaN,NaN,50
1682046000,1.09654,1.09666,1.09638,1.0965,719,824.3,-576777,-575864.4,7.4523242597707,48.13309446098489,50.84431395903808,NaN,NaN,50
1682047800,1.0965,1.09666,1.09631,1.09641,596,798.05,-577373,-576339,7.888322568126703,47.17133068595885,50.41193919505554,NaN,NaN,50
1682049600,1.09641,1.09641,1.09602,1.09608,666,768.35,-578039,-576683.8,8.819366083818103,43.72166183852939,49.77892998425183,NaN,NaN,50
1682051400,1.09608,1.0961,1.09588,1.09604,498,722.1,-578537,-577356.8,9.92353891202006,43.308233272350925,49.106659941382794,NaN,NaN,50
1682053200,1.09604,1.0961,1.0958,1.09588,693,681.3,-579230,-577991.2,11.08645921942689,41.61319481997313,48.28225820883681,NaN,NaN,50
1682055000,1.09588,1.09613,1.09553,1.09608,1147,677.5,-578083,-578252.4,12.612509144757231,44.535457289314095,47.787925538263394,NaN,NaN,50
1682056800,1.09608,1.09637,1.09522,1.09542,1773,736.45,-579856,-578749,14.486711342443412,37.81015789867011,46.89363616152851,NaN,NaN,50
1682058600,1.09542,1.09544,1.0938,1.09418,2795,853.65,-582651,-579671.4,17.618266000224686,28.961316059040627,45.32283449893804,NaN,NaN,50
1682060400,1.09418,1.09498,1.09414,1.09462,2939,991.6,-579712,-579906.4,20.526138182450154,34.792924294587266,44.470910000005006,NaN,NaN,50
1682062200,1.09462,1.09579,1.09386,1.09564,3150,1139.15,-576562,-579372.8,21.258003100326576,45.88352590140725,43.95808537428238,NaN,NaN,50
1682064000,1.09564,1.09722,1.0956,1.09566,3081,1278.2,-573481,-578452.4,19.86396543635455,46.07718923806148,43.45909384403505,NaN,NaN,50
1682065800,1.09566,1.09614,1.09526,1.09596,2816,1400.05,-570665,-576614.2,18.755675432168818,49.024047252866,43.50647584711271,NaN,NaN,50
1682067600,1.09596,1.09622,1.09526,1.09579,2125,1480.7,-572790,-574642,17.615199179579662,47.441849897138695,43.35825180431878,NaN,NaN,50
1682069400,1.09579,1.09592,1.09516,1.09548,1874,1551.65,-574664,-573632.4,16.693074508867696,44.614221912853225,43.077728915838286,NaN,NaN,50
1682071200,1.09548,1.09641,1.0949,1.09638,1748,1596.95,-572916,-572903.2,15.869337013997223,53.314078447462066,43.44779920058665,NaN,NaN,50
1682073000,1.09638,1.09713,1.09632,1.09652,1562,1627.65,-571354,-572477.8,15.9834623915841,54.51106644210454,43.97206604031135,NaN,NaN,50
1682074800,1.09652,1.09811,1.09628,1.0973,2011,1676.85,-569343,-572213.4,17.031535814995983,60.57587591669858,45.17593847446629,NaN,NaN,50
1682076600,1.0973,1.09858,1.09728,1.09814,2025,1712.35,-567318,-571119,18.382396338795566,65.85548451935557,46.786456420680906,NaN,NaN,50
1682078400,1.09814,1.09824,1.09736,1.09809,2339,1772.15,-569657,-570117.6,19.63676682518089,65.29495984432984,48.47801106527781,NaN,NaN,50
1682080200,1.09809,1.09903,1.0978,1.0988,2473,1851.5,-567184,-568971.2,21.393596731302132,69.29190907464641,50.24632904994441,NaN,NaN,50
1682082000,1.0988,1.09939,1.09819,1.09833,2951,1963.1,-570135,-568727.4,23.26278971330713,64.03447174643664,52.119494324784874,NaN,NaN,50
1682083800,1.09833,1.09922,1.09534,1.09557,5782,2222.4,-575917,-570042.2,21.759478022087144,43.271502512268874,53.141650500015466,NaN,NaN,50
1682085600,1.09557,1.0979,1.09424,1.09742,5414,2459.8,-570503,-570679.2,21.222462734895355,54.03092023550559,54.51579306722392,NaN,NaN,50
1682087400,1.09742,1.09794,1.09604,1.09718,4113,2640.55,-574616,-571671,20.68469694112334,52.63617149529711,54.998124895358906,NaN,NaN,50
1682089200,1.09718,1.09798,1.09711,1.09764,2990,2755.4,-571626,-572559.4,20.143642966219776,55.032171438138775,55.63776648107871,NaN,NaN,50
1682091000,1.09764,1.09786,1.09702,1.09721,2465,2821.3,-574091,-573350.6,19.71750800003334,52.365435402494555,55.876437063195034,NaN,NaN,50
1682092800,1.09721,1.09778,1.09692,1.09753,2074,2836.35,-572017,-572570.6,19.410649283058483,54.14619370690579,56.35531876389268,NaN,NaN,50
1682094600,1.09753,1.09799,1.09713,1.09792,1559,2774.55,-570458,-572561.6,18.86408095768791,56.29083470255278,57.189362534585506,NaN,NaN,50
1682096400,1.09792,1.0981,1.0972,1.09735,1491,2702.15,-571949,-572028.2,18.216164758087892,52.43105316199802,57.12628929990951,NaN,NaN,50
1682098200,1.09735,1.09811,1.09729,1.09808,1411,2615.2,-570538,-571810.6,17.601048883454638,56.54101079490679,57.27128532510967,NaN,NaN,50
1682100000,1.09808,1.0988,1.09806,1.09822,1549,2538.6,-568989,-570790.2,16.544450687774052,57.302917625167076,57.03750259000028,NaN,NaN,50
1682101800,1.09822,1.09832,1.09748,1.09766,970,2446.3,-569959,-570378.6,15.844947677245951,53.279224806049314,56.139198324764116,NaN,NaN,50
1682103600,1.09766,1.09844,1.09748,1.09844,1011,2390.6,-568948,-570076.6,15.040631183916862,57.73126051206619,55.598934086745295,NaN,NaN,50
1682105400,1.09844,1.09904,1.09838,1.09902,1186,2356.2,-567762,-569239.2,14.374887454134615,60.72800449764791,54.98722661695968,NaN,NaN,50
1682107200,1.09902,1.0993,1.09882,1.09892,748,2306.2,-568510,-568833.6,14.0527318576777,59.93896942696467,54.694690736997394,NaN,NaN,50
1682109000,1.09892,1.099,1.09853,1.09893,464,2251.3,-568046,-568645,13.359996723719894,59.994946068719294,55.88922241960099,NaN,NaN,50
1682283600,1.09893,1.09912,1.09893,1.09908,38,2152.65,-568008,-568254.8,12.866097613484836,60.87798903485133,56.378298762411404,NaN,NaN,50
1682285400,1.09908,1.09912,1.09878,1.09884,189,2060.85,-568197,-568104.6,12.190116843008369,58.647395834974354,56.8076719295312,NaN,NaN,50
1682287200,1.09884,1.09914,1.0988,1.09908,390,1963.4,-567807,-568113.6,11.590627863920052,60.21718132169657,57.178029778356766,NaN,NaN,50
1682289000,1.09908,1.09932,1.09896,1.09926,384,1858.95,-567423,-567896.2,11.295859742614665,61.40066749002613,57.823403498894734,NaN,NaN,50
1682290800,1.09926,1.09962,1.09918,1.09924,413,1732.05,-567836,-567854.2,11.445356453085266,61.18287660371175,58.32602370580945,NaN,NaN,50
1682292600,1.09924,1.0995,1.09912,1.09918,402,1463.05,-568238,-567900.2,11.474000312081767,60.489684089102795,58.62594151913445,NaN,NaN,50
1682294400,1.09918,1.09918,1.09861,1.09898,909,1237.8,-569147,-568090.2,10.692904225710608,58.12564221333175,59.032697879944,NaN,NaN,50
1682296200,1.09898,1.0995,1.09846,1.09949,1026,1083.45,-568121,-568153,10.390577776405404,62.184202287984924,59.435782986592436,NaN,NaN,50
1682298000,1.09949,1.09949,1.09884,1.0992,1134,990.65,-569255,-568519.4,10.109846073479146,58.70021912961082,59.53559023690985,NaN,NaN,50
1682299800,1.0992,1.09937,1.09869,1.09876,1457,940.25,-570712,-569094.6,9.571872923532272,53.777179185286485,59.57115840685536,NaN,NaN,50
1682301600,1.09876,1.0991,1.09867,1.09895,1212,897.15,-569500,-569347,9.03416165013166,55.51225954291704,59.41265833763042,NaN,NaN,50
1682303400,1.09895,1.09898,1.09804,1.0981,1257,882.05,-570757,-569669,9.337393768340874,47.01051311661461,58.43283752469947,NaN,NaN,50
1682305200,1.0981,1.09848,1.09798,1.09828,903,852.65,-569854,-570015.6,9.712920980950361,48.79880180554446,57.6371112660266,NaN,NaN,50
1682307000,1.09828,1.09833,1.09798,1.09817,793,821.75,-570647,-570294,10.061624821230598,47.73851899510015,56.76165218933953,NaN,NaN,50
1682308800,1.09817,1.09821,1.09798,1.0982,667,777.65,-569980,-570147.6,10.385421244347961,48.06991316498884,55.84678962720648,NaN,NaN,50
1682310600,1.0982,1.09828,1.09794,1.09804,678,763.05,-570658,-570379.2,10.509091870431888,46.380702237607856,54.97059722739459,NaN,NaN,50
1682312400,1.09804,1.09813,1.09742,1.0975,855,755.25,-571513,-570530.4,11.54970050330084,41.12774459367308,53.607066032535776,NaN,NaN,50
1682314200,1.0975,1.09786,1.09726,1.09784,1119,751.9,-570394,-570638.4,12.765318833094646,45.32643464060638,52.458906543291505,NaN,NaN,50
1682316000,1.09784,1.09866,1.09752,1.0986,2010,815,-568384,-570185.8,12.052264635680892,53.33750359136027,51.89852275669498,NaN,NaN,50
1682317800,1.0986,1.09862,1.09732,1.09749,1679,875.75,-570063,-570202.4,11.745895289960169,43.347396159926475,50.67407361889667,NaN,NaN,50
1682319600,1.09749,1.09803,1.0966,1.09786,2406,994.15,-567657,-569602.2,12.553138196360985,46.91650976704906,49.873421301305044,NaN,NaN,50
1682321400,1.09786,1.09884,1.0977,1.09868,2146,1092,-565511,-568401.8,11.83324183337312,53.85495801985424,49.27847528215285,NaN,NaN,50
1682323200,1.09868,1.09944,1.09852,1.09853,2478,1196.4,-567989,-567920.8,11.672615075794369,52.50304283047451,48.83581983221455,NaN,NaN,50
1682325000,1.09853,1.10097,1.09839,1.10088,2238,1289.1,-565751,-567394.2,13.10079532725891,66.63440247209235,49.75419292412925,NaN,NaN,50
1682326800,1.10088,1.10206,1.10021,1.10192,2916,1414.25,-562835,-565948.6,15.197226266873365,70.7780057890919,50.84460337028459,NaN,NaN,50
1682328600,1.10192,1.10205,1.09994,1.10004,2161,1502.2,-564996,-565416.4,16.73286826171966,56.998033842417506,51.55799770784194,NaN,NaN,50
1682330400,1.10004,1.1012,1.09991,1.10102,2340,1573.75,-562656,-564845.4,18.111850780464806,61.23489195311828,52.44628986124007,NaN,NaN,50
1682332200,1.10102,1.10172,1.10059,1.10165,1698,1607.35,-560958,-563439.2,19.76878666873724,63.71025381160209,53.58712806241878,NaN,NaN,50
1682334000,1.10165,1.10176,1.10012,1.1003,1781,1639.7,-562739,-562836.8,20.557933549167544,55.52775889548996,54.11983132888314,NaN,NaN,50
1682335800,1.1003,1.10084,1.0999,1.10024,1859,1659.8,-564598,-563189.4,20.953596212463825,55.18850316722357,54.74895996671284,NaN,NaN,50
1682337600,1.10024,1.10089,1.09994,1.10089,2065,1702.45,-562533,-562696.8,21.367202489622052,58.17011115904229,55.96627186423921,NaN,NaN,50
1682339400,1.10089,1.10254,1.10057,1.1023,2652,1772.2,-559881,-562141.8,22.99276352936486,63.79731125973662,57.28562019417708,NaN,NaN,50
1682341200,1.1023,1.10313,1.10154,1.10168,3073,1880.7,-562954,-562541,24.83633332524722,59.97659559410945,57.75984105151631,NaN,NaN,50
1682343000,1.10168,1.10254,1.10128,1.1024,3637,2022.9,-559317,-561856.6,26.14207369063997,62.76537891448267,59.14683981969889,NaN,NaN,50
1682344800,1.1024,1.10292,1.10208,1.10214,3153,2147.2,-562470,-561431,27.58505482305356,61.109476114007144,60.160623130195894,NaN,NaN,50
1682346600,1.10214,1.1037,1.10206,1.10294,3852,2305.9,-558618,-560648,29.352043344169143,64.236002272598,60.902126291106164,NaN,NaN,50
1682348400,1.10294,1.10324,1.1021,1.1021,3007,2413.5,-561625,-560996.8,30.99281839949075,58.883172229087144,61.3578498195785,NaN,NaN,50
1682350200,1.1021,1.10272,1.10204,1.10258,2059,2460.5,-559566,-560319.2,32.40929710027083,60.88881050304712,60.94745039321812,NaN,NaN,50
1682352000,1.10258,1.1034,1.10248,1.10302,1582,2439.1,-557984,-560052.6,34.1013409452963,62.68563312879461,60.36942377462545,NaN,NaN,50
1682353800,1.10302,1.10342,1.10298,1.10339,1109,2410.6,-556875,-558933.6,35.68314159092384,64.1760619473602,60.88214006783566,NaN,NaN,50
1682355600,1.10339,1.10403,1.10336,1.10392,1212,2350.9,-555663,-558342.6,37.464723928198914,66.2552790204204,61.240739144071526,NaN,NaN,50
1682357400,1.10392,1.10485,1.10392,1.10442,1408,2314,-554255,-556868.6,39.47495663184361,68.13428839481375,61.556741614300925,NaN,NaN,50
1682359200,1.10442,1.10494,1.1042,1.10492,1248,2252.5,-553007,-555556.8,41.37780402403068,69.9370542421154,62.585976996202746,NaN,NaN,50
1682361000,1.10492,1.10502,1.10445,1.10466,1249,2203.05,-554256,-554811.2,43.17840364416459,67.78939447105937,63.48604066076244,NaN,NaN,50
1682362800,1.10466,1.1047,1.10418,1.10436,747,2094.6,-555003,-554436.8,44.27771419271497,65.29773408551702,63.99515658408207,NaN,NaN,50
1682364600,1.10436,1.1045,1.1042,1.10433,873,2030.2,-555876,-554479.4,45.29850255922604,65.04028331223367,64.08394030211757,NaN,NaN,50
1682366400,1.10433,1.10453,1.10433,1.10448,471,1936.75,-555405,-554709.4,46.26461805823319,65.76705014821822,64.49754419883962,NaN,NaN,50
1682368200,1.10448,1.10458,1.10439,1.10458,330,1868.35,-555075,-555123,47.19390700201235,66.27047065472038,64.74790789457089,NaN,NaN,50
1682370000,1.10458,1.10487,1.10439,1.10452,278,1793.2,-555353,-555342.4,48.242911943598195,65.64668510061921,65.07199425075747,NaN,NaN,50
1682371800,1.10452,1.10485,1.10429,1.10468,1066,1753.55,-554287,-555199.2,48.94866963792873,66.55086239885661,65.23734140263308,NaN,NaN,50
1682373600,1.10468,1.10502,1.10462,1.10489,307,1665.65,-553980,-554820,49.72591273945405,67.75061148591112,65.87072992097765,NaN,NaN,50
1682375400,1.10489,1.1052,1.10481,1.10512,261,1546.1,-553719,-554482.8,50.57504886855961,69.05956765910462,66.45435543212461,NaN,NaN,50
1682377200,1.10512,1.10542,1.10495,1.10538,652,1425.05,-553067,-554081.2,51.51493881140017,70.51641519382211,67.01369700819801,NaN,NaN,50
1682379000,1.10538,1.10573,1.10536,1.10572,626,1274.5,-552441,-553498.8,52.58798002900477,72.34988958265015,67.59754183929014,NaN,NaN,50
1682380800,1.10572,1.10578,1.10535,1.10576,977,1165.7,-551464,-552934.2,53.61604946426895,72.56603641563055,68.0483102246623,NaN,NaN,50
1682382600,1.10576,1.10666,1.10576,1.10592,1427,1044.45,-550037,-552145.6,55.04415272654784,73.45975663250049,68.4287008130685,NaN,NaN,50
1682384400,1.10592,1.10671,1.10575,1.10666,1201,954.15,-548836,-551169,56.39312266009087,77.16495391813274,68.94497936135545,NaN,NaN,50
1682386200,1.10666,1.10666,1.10562,1.10568,1533,927.85,-550369,-550629.4,57.23749679173141,64.35204280252617,68.69945424217451,NaN,NaN,50
1682388000,1.10568,1.1057,1.10534,1.10551,1350,916.25,-551719,-550485,57.17060879364079,62.41592986824877,68.4936110837982,NaN,NaN,50
1682389800,1.10551,1.10551,1.1052,1.10538,1334,927.5,-553053,-550802.8,56.698385434775375,60.906845332813795,68.19836551383965,NaN,NaN,50
1682391600,1.10538,1.10568,1.10515,1.10537,1063,920.05,-554116,-551618.6,56.421757585068924,60.78509880566817,67.84251184651464,NaN,NaN,50
1682393400,1.10537,1.10554,1.10518,1.10529,715,885.4,-554831,-552817.6,56.16488886748435,59.756024248004366,67.37719424603492,NaN,NaN,50
1682395200,1.10529,1.10588,1.10526,1.10572,1445,895.25,-553386,-553421,56.25018317429987,63.34782786587517,67.21299015783892,NaN,NaN,50
1682397000,1.10572,1.10574,1.10508,1.10512,1013,883.45,-554399,-553957,55.74554351026314,55.85658977670741,66.44911354197113,NaN,NaN,50
1682398800,1.10512,1.10544,1.10462,1.10463,1139,903.05,-555538,-554454,53.94413473526121,50.59453906760158,65.22367979780617,NaN,NaN,50
1682400600,1.10463,1.1053,1.1045,1.10492,1325,925.65,-554213,-554473.4,51.954915181682736,53.392994613586474,64.10463886598345,NaN,NaN,50
1682402400,1.10492,1.10566,1.10472,1.10537,2041,1004.15,-552172,-553941.6,50.629504914586676,57.42310246496845,63.169402242493895,NaN,NaN,50
1682404200,1.10537,1.10552,1.10462,1.10517,2339,1104.6,-554511,-554166.6,49.12514706645313,55.14096401042149,61.94019327304899,NaN,NaN,50
1682406000,1.10517,1.10517,1.10262,1.1027,4302,1305.8,-558813,-555049.4,47.04086036609868,36.073433274513185,59.33357876296918,NaN,NaN,50
1682407800,1.1027,1.10343,1.10246,1.1033,3032,1404.1,-555781,-555098,45.28771144588833,41.37654180264611,57.04192056083672,NaN,NaN,50
1682409600,1.1033,1.10337,1.10256,1.1027,2547,1516.1,-558328,-555921,43.659787448550155,37.983216060463604,54.243224999574636,NaN,NaN,50
1682411400,1.1027,1.10414,1.10255,1.10397,2218,1613.95,-556110,-556708.6,40.82666273757029,47.750819114001295,53.05742330753714,NaN,NaN,50
1682413200,1.10397,1.1044,1.10354,1.10374,2091,1685.9,-558201,-557446.6,38.01176471604874,46.32774117823316,51.908266972536026,NaN,NaN,50
1682415000,1.10374,1.10394,1.103,1.10304,2045,1756.85,-560246,-557733.2,35.95090407592662,42.2051679425876,50.572432873234156,NaN,NaN,50
1682416800,1.10304,1.1036,1.10266,1.10268,1617,1788.85,-561863,-558949.6,34.46582000821924,40.222780722297095,49.10369586727908,NaN,NaN,50
1682418600,1.10268,1.10322,1.10196,1.10206,1931,1814.05,-563794,-560042.8,33.860914729969885,36.999537869415846,47.478232554522755,NaN,NaN,50
1682420400,1.10206,1.10238,1.1016,1.10184,1868,1847.4,-565662,-561953.2,33.64847483477364,35.90019437275532,45.51768730501419,NaN,NaN,50
1682422200,1.10184,1.10214,1.10096,1.1017,2192,1880.35,-567854,-563883.8,34.00556713521677,35.18377134020125,44.04105741669232,NaN,NaN,50
1682424000,1.1017,1.1028,1.10164,1.10264,2732,1949.45,-565122,-564859,33.23903370591504,43.35716181421475,43.52410189859326,NaN,NaN,50
1682425800,1.10264,1.10296,1.10142,1.10173,2686,2017.05,-567808,-566048,32.73704541207363,38.31942274290195,42.44741819354437,NaN,NaN,50
1682427600,1.10173,1.10188,1.10068,1.1012,2906,2109.2,-570714,-567432,32.91276746008373,35.71649105654896,40.89694595008583,NaN,NaN,50
1682429400,1.1012,1.10148,1.09944,1.09994,3718,2259.35,-574432,-569186,33.909888256149635,30.42525229288114,39.131537970261526,NaN,NaN,50
1682431200,1.09994,1.10038,1.09785,1.09844,4593,2416.75,-579025,-571420.2,35.59181132421307,25.568939170312973,38.38121696281865,NaN,NaN,50
1682433000,1.09844,1.09898,1.09752,1.09768,4377,2584.95,-583402,-575076.2,37.283144056275944,23.520487037718908,37.10578447960956,NaN,NaN,50
1682434800,1.09768,1.09876,1.09744,1.0984,3203,2688.15,-580199,-577554.4,38.88569020642984,29.299321809404503,36.48550631881964,NaN,NaN,50
1682436600,1.0984,1.0984,1.09686,1.09686,2555,2749.65,-582754,-579962.4,40.601472472369565,24.95582077321879,34.85729215162088,NaN,NaN,50
1682438400,1.09686,1.09734,1.09653,1.09692,2146,2754.9,-580608,-581197.6,42.31723647520667,25.41971780827633,33.36386191090968,NaN,NaN,50
1682440200,1.09692,1.09719,1.0966,1.09682,1757,2725.8,-582365,-581865.6,43.91044590641256,25.14077404065999,32.14497663220057,NaN,NaN,50
1682442000,1.09682,1.0973,1.09648,1.09682,2316,2626.5,-582365,-581658.2,45.43819970563211,25.14077404065999,31.067690440655053,NaN,NaN,50
1682443800,1.09682,1.09704,1.09642,1.09688,1836,2566.7,-580529,-581724.2,46.88210179177145,25.708068062260693,30.261156883001117,NaN,NaN,50
1682445600,1.09688,1.09732,1.09682,1.09726,1805,2529.6,-578724,-580918.2,47.64608675877609,29.359263840960836,29.793947559301508,NaN,NaN,50
1682447400,1.09726,1.09738,1.09647,1.09725,1761,2506.75,-580485,-580893.6,48.54209505603845,29.318428588545657,29.374994505611827,NaN,NaN,50
1682449200,1.09725,1.09762,1.0971,1.09744,1103,2457.35,-579382,-580297,48.876416792870145,31.2743317047468,28.511935212078406,NaN,NaN,50
1682451000,1.09744,1.09752,1.09686,1.09699,1247,2417.45,-580629,-579949.8,49.33636461155896,29.212498889388186,27.861440651113135,NaN,NaN,50
1682452800,1.09699,1.09753,1.09696,1.09751,778,2375.5,-579851,-579814.2,49.74122894686727,34.579763790622735,27.780245846404114,NaN,NaN,50
1682454600,1.09751,1.09756,1.09718,1.09748,653,2311.6,-580504,-580170.2,50.04595912883183,34.417627596460505,28.065415510945503,NaN,NaN,50
1682456400,1.09748,1.09748,1.09686,1.09725,376,2237,-580880,-580249.2,50.55495546141737,33.13489874051906,28.605841194531653,NaN,NaN,50
1682458200,1.09725,1.0976,1.0972,1.09754,633,2159.05,-580247,-580422.2,50.724085806037046,36.355730816385034,29.522644321579236,NaN,NaN,50
1682460000,1.09754,1.09802,1.0974,1.0979,766,2060.75,-579481,-580192.6,49.87100087615459,40.20620220540226,30.30170720700764,NaN,NaN,50
1682461800,1.0979,1.098,1.09773,1.09782,479,1950.4,-579960,-580214.4,49.07885058412088,39.632380560782806,31.35003290611936,NaN,NaN,50
1682463600,1.09782,1.09806,1.09728,1.09778,698,1840,-580658,-580245.2,48.793980593131955,39.33013219095073,32.34363393345325,NaN,NaN,50
1682465400,1.09778,1.098,1.09762,1.0978,710,1689.6,-579948,-580058.8,48.529458458642246,39.578252194822284,33.374882373036264,NaN,NaN,50
1682467200,1.0978,1.09802,1.0972,1.09764,1193,1519.6,-581141,-580237.6,48.677485711274336,38.231209267133146,34.30991346064149,NaN,NaN,50
1682469000,1.09764,1.09788,1.09726,1.09782,1276,1364.55,-579865,-580314.4,48.814939588718424,40.67735613426882,35.37914832292778,NaN,NaN,50
1682470800,1.09782,1.09786,1.09684,1.09716,1333,1271.05,-581198,-580562,49.31047418064221,35.17658891626688,35.7946715425925,NaN,NaN,50
1682472600,1.09716,1.0978,1.09694,1.09756,1856,1236.1,-579342,-580298.8,49.770613444571445,40.43397540516017,36.588639172350675,NaN,NaN,50
1682474400,1.09756,1.09789,1.09726,1.09762,1371,1197.35,-577971,-579903.4,49.91688662705475,41.20427508274057,37.297920842207375,NaN,NaN,50
1682476200,1.09762,1.09786,1.09742,1.09773,1291,1174.05,-576680,-579011.2,50.05271172507497,42.66808165060401,38.259033896579936,NaN,NaN,50
1682478000,1.09773,1.09786,1.09744,1.09748,852,1100.85,-577532,-578544.6,50.17883503037945,40.21741574049831,38.66172332157105,NaN,NaN,50
1682479800,1.09748,1.09774,1.09738,1.09753,721,1045.1,-576811,-577667.2,50.366837845455045,40.94793348805735,39.1281737423994,NaN,NaN,50
1682481600,1.09753,1.09759,1.09722,1.09744,955,1002.6,-577766,-577352,50.729659953698615,40.000436142682496,39.61856927112535,NaN,NaN,50
1682483400,1.09744,1.09818,1.09744,1.09812,935,961.3,-576831,-577124,49.051028964747516,49.507086659137585,40.557951831321965,NaN,NaN,50
1682485200,1.09812,1.09834,1.09798,1.0983,1161,964.2,-575670,-576922,47.03477573498228,51.689174212111546,41.37816411751549,NaN,NaN,50
1682487000,1.0983,1.09906,1.09812,1.09888,1571,980.4,-574099,-576235.4,43.88039480099421,57.989206800651424,42.68936599179182,NaN,NaN,50
1682488800,1.09888,1.09945,1.09848,1.09944,1850,1034,-572249,-575323,41.66356142615514,63.00547254673046,44.380461731490364,NaN,NaN,50
1682490600,1.09944,1.10118,1.09938,1.10068,2463,1124.5,-569786,-573727,41.65355742382836,71.20450410600063,46.63947972514596,NaN,NaN,50
1682492400,1.10068,1.1026,1.10042,1.10241,3450,1278.2,-566336,-571628,42.585433106261235,78.39785259154533,49.50852567688969,NaN,NaN,50
1682494200,1.10241,1.10256,1.10122,1.10192,3214,1407.25,-569550,-570404,43.4507462399489,72.84708104841144,51.80636317075702,NaN,NaN,50
1682496000,1.10192,1.10384,1.1016,1.10364,3151,1526.5,-566399,-568864,44.87114625314616,78.58010310256144,54.90661418406377,NaN,NaN,50
1682497800,1.10364,1.10432,1.10309,1.10419,2953,1650.2,-563446,-567103.4,46.37730806612559,80.03195264817332,57.735041129993284,NaN,NaN,50
1682499600,1.10419,1.10544,1.10412,1.10473,3430,1786.8,-560016,-565149.4,48.14618246886887,81.367304397519,60.60382893819174,NaN,NaN,50
1682501400,1.10473,1.105,1.10369,1.10412,2656,1884.1,-562672,-564416.6,49.06460934475058,75.24573562766707,62.930804222267675,NaN,NaN,50
1682503200,1.10412,1.10508,1.10388,1.10486,2222,1935.55,-560450,-562596.6,49.95010386612211,77.46103925875784,65.5910630450005,NaN,NaN,50
1682505000,1.10486,1.10628,1.10443,1.10452,2917,2017.6,-563367,-561990.2,51.21082269927547,74.17644933715579,67.96452846279324,NaN,NaN,50
1682506800,1.10452,1.10484,1.10313,1.10466,3310,2116.45,-560057,-561312.4,50.50542973601916,74.65305291337226,70.43971537498537,NaN,NaN,50
1682508600,1.10466,1.10584,1.10434,1.10462,4515,2249.4,-564572,-562223.6,50.33190517904702,74.23150567434506,72.20574530464305,NaN,NaN,50
1682510400,1.10462,1.10504,1.10356,1.105,3184,2340.05,-561388,-561966.8,49.239769018086236,75.63886343238917,73.91643739180574,NaN,NaN,50
1682512200,1.105,1.10576,1.10374,1.10538,3988,2474.9,-557400,-561356.8,48.598972501599754,76.9921100291665,75.27378762241395,NaN,NaN,50
1682514000,1.10538,1.10956,1.10482,1.10876,4980,2681.3,-552420,-559167.4,49.34282941564517,84.9828224338479,76.84359832863663,NaN,NaN,50
1682515800,1.10876,1.10934,1.10779,1.10852,5430,2916.75,-557850,-558726,50.03355369297305,82.78427528166023,77.67072484118376,NaN,NaN,50
1682517600,1.10852,1.1086,1.10608,1.10666,5517,3144.85,-563367,-558485,49.07654253263179,68.0837044963281,76.93399997723965,NaN,NaN,50
1682519400,1.10666,1.10701,1.10419,1.10434,4437,3319.95,-567804,-559768.2,46.78763539263867,54.97130633803969,75.65715892649882,NaN,NaN,50
1682521200,1.10434,1.10546,1.10364,1.1048,4189,3471.35,-563615,-561011.2,44.30252845158051,56.74991516719611,74.09785978825845,NaN,NaN,50
1682523000,1.1048,1.10569,1.10452,1.10509,2583,3521.95,-561032,-562733.6,42.11442271082163,57.8794762182692,72.51554004326529,NaN,NaN,50
1682524800,1.10509,1.10528,1.10333,1.10342,2543,3556.6,-563575,-563878.6,39.304993828152995,49.81164528677679,70.26156439249799,NaN,NaN,50
1682526600,1.10342,1.10418,1.1033,1.1041,2209,3543.9,-561366,-563478.4,36.67719816256337,52.7026332507433,68.65134279414629,NaN,NaN,50
1682528400,1.1041,1.1042,1.10349,1.10395,1548,3448.8,-562914,-562500.4,34.25004336774767,51.99119024446873,66.83206786455422,NaN,NaN,50
1682530200,1.10395,1.1041,1.10349,1.10376,1580,3367.1,-564494,-562676.2,31.996256772561672,51.05112044046495,65.18025865764773,NaN,NaN,50
1682532000,1.10376,1.1039,1.10324,1.10354,1540,3286.55,-566034,-563676.6,29.71099922690777,49.92546309877137,63.4140022423191,NaN,NaN,50
1682533800,1.10354,1.10398,1.10326,1.1039,1913,3234.55,-564121,-563785.8,27.652975408727777,51.79841553184498,61.81163866071195,NaN,NaN,50
1682535600,1.1039,1.1041,1.10352,1.1039,1351,3130.6,-564121,-564336.8,25.842951322760214,51.79841553184498,60.10874952495879,NaN,NaN,50
1682537400,1.1039,1.1039,1.10324,1.10357,1274,3061.5,-565395,-564833,24.084782796537436,49.81747111528575,58.16770388825302,NaN,NaN,50
1682539200,1.10357,1.10388,1.10351,1.10388,741,2987.45,-564654,-564865,22.452197736473426,51.6866688022955,55.78940720028499,NaN,NaN,50
1682541000,1.10388,1.1042,1.10382,1.10405,449,2864.05,-564205,-564499.2,21.07787473801306,52.726569153249635,53.642428191112806,NaN,NaN,50
1682542800,1.10405,1.10427,1.10387,1.10422,171,2707.1,-564034,-564481.8,19.872425736781963,53.79753247046021,52.62198733212225,NaN,NaN,50
1682544600,1.10422,1.10426,1.10396,1.10414,524,2507.55,-564558,-564569.2,18.7530802356388,53.186888870490606,52.49452894158303,NaN,NaN,50
1682546400,1.10414,1.10444,1.10352,1.10404,848,2390.75,-565406,-564571.4,17.62989430720399,52.38643012451403,52.18285143853431,NaN,NaN,50
1682548200,1.10404,1.10418,1.10372,1.104,364,2209.55,-565770,-564794.6,16.58693594508595,52.0489941490254,51.76638843358832,NaN,NaN,50
1682550000,1.104,1.1046,1.1039,1.10436,549,1988,-565221,-564997.8,15.710791015443107,54.866707365765926,52.12746429637326,NaN,NaN,50
1682551800,1.10436,1.10466,1.10436,1.10454,647,1748.85,-564574,-565105.8,14.971415099414603,56.25098139285825,52.38091773509576,NaN,NaN,50
1682553600,1.10454,1.10477,1.1041,1.10466,1323,1539.15,-563251,-564844.4,13.92199817720651,57.19358125574201,52.75251709304384,NaN,NaN,50
1682555400,1.10466,1.1047,1.10418,1.10457,1275,1381.05,-564526,-564668.4,12.947539606584707,56.21530928985417,53.12138772514307,NaN,NaN,50
1682557200,1.10457,1.1046,1.1039,1.10426,1399,1241.55,-565925,-564699.4,12.409589747238476,52.86137434255281,53.331095671127464,NaN,NaN,50
1682559000,1.10426,1.10492,1.10414,1.10456,1320,1178.4,-564605,-564576.2,11.62830333684032,55.62083018285863,53.604125289057016,NaN,NaN,50
1682560800,1.10456,1.10504,1.10428,1.10494,1205,1111.5,-563400,-564341.4,11.083753957184681,58.90259851842019,54.11156693095524,NaN,NaN,50
1682562600,1.10494,1.10538,1.10493,1.1053,1030,1052.55,-562370,-564165.2,11.07685464943835,61.78568958946998,54.966439679111254,NaN,NaN,50
1682564400,1.1053,1.10542,1.10496,1.10498,844,1017.35,-563214,-563902.8,11.128507228069397,57.89759616536919,55.41007734790223,NaN,NaN,50
1682566200,1.10498,1.10522,1.10457,1.10457,850,980.85,-564064,-563530.6,10.477779624989333,53.272013299599855,55.449037644070096,NaN,NaN,50
1682568000,1.10457,1.10542,1.10457,1.10528,848,946.25,-563216,-563252.8,10.196117840388355,59.33134731305056,55.84431013282655,NaN,NaN,50
1682569800,1.10528,1.1055,1.10506,1.10507,872,894.2,-564088,-563390.4,10.064548946090154,56.97792387921487,56.11509834773543,NaN,NaN,50
1682571600,1.10507,1.10565,1.105,1.10564,1100,881.65,-562988,-563514,10.189982516376148,61.4478902609942,56.76234550034115,NaN,NaN,50
1682573400,1.10564,1.10635,1.10562,1.10596,1894,912.65,-561094,-563090,11.312516287103659,63.72646155204657,57.59645031484267,NaN,NaN,50
1682575200,1.10596,1.10598,1.10536,1.10552,1817,966.45,-562911,-562859.4,11.814781949301569,58.59802668287454,57.86297312320757,NaN,NaN,50
1682577000,1.10552,1.10618,1.10489,1.1056,2064,1047.2,-560847,-562385.6,11.396347496760518,59.2402972810527,58.07649568665003,NaN,NaN,50
1682578800,1.1056,1.10566,1.104,1.1041,3152,1196.25,-563999,-562367.8,11.488186946550103,45.109888908893645,57.21337480473229,NaN,NaN,50
1682580600,1.1041,1.10586,1.10402,1.10497,2896,1314.85,-561103,-561990.8,11.24481508140461,52.22741264539599,56.928525044413846,NaN,NaN,50
1682582400,1.10497,1.10516,1.10414,1.10508,2332,1389.05,-558771,-561526.2,11.018826920912367,53.056252613761664,56.942444920928764,NaN,NaN,50
1682584200,1.10508,1.10594,1.10493,1.1053,2186,1480.15,-556585,-560261,10.858091145247101,54.74728243461724,56.88004865319724,NaN,NaN,50
1682586000,1.1053,1.10558,1.1047,1.10472,1953,1550.35,-558538,-559799.2,10.342359928556913,49.66759872969027,56.2204058111451,NaN,NaN,50
1682587800,1.10472,1.1048,1.1034,1.1038,2179,1626.95,-560717,-559142.8,10.995129598505692,42.872477585580306,54.86946209658156,NaN,NaN,50
1682589600,1.1038,1.10434,1.10346,1.1038,1865,1654.05,-560717,-559065.6,11.60127286345813,42.872477585580306,53.796239340882344,NaN,NaN,50
1682591400,1.1038,1.10476,1.10365,1.10448,1806,1680.6,-558911,-559093.6,11.505804408150258,48.86899156358104,53.48173778830958,NaN,NaN,50
1682593200,1.10448,1.10498,1.10356,1.1036,2430,1732.15,-561341,-560044.8,11.088733610533692,42.63234509189077,52.28895191536959,NaN,NaN,50
1682595000,1.1036,1.10426,1.10306,1.10345,2271,1779.7,-563612,-561059.6,11.325456133013459,41.65647164450449,51.194562470033134,NaN,NaN,50
1682596800,1.10345,1.10482,1.10334,1.10474,2233,1831.1,-561379,-561192,10.724211869301321,51.86180538280928,50.50984212159135,NaN,NaN,50
1682598600,1.10474,1.10576,1.10006,1.10132,8208,2190,-569587,-562966,12.856199181855626,34.58818491290263,48.42853664736678,NaN,NaN,50
1682600400,1.10132,1.10247,1.09978,1.1,4939,2394.75,-574526,-566089,14.98207112282508,30.382031913135933,46.41310844952831,NaN,NaN,50
1682602200,1.1,1.10128,1.09922,1.10102,5337,2619.1,-569189,-567658.6,17.239091750772857,36.779741007293204,44.80878300140263,NaN,NaN,50
1682604000,1.10102,1.10234,1.10088,1.10122,4484,2800.9,-564705,-567877.2,18.04308944942146,37.98318833653497,44.29973296051987,NaN,NaN,50
1682605800,1.10122,1.10214,1.1005,1.10108,3387,2926.65,-568092,-569219.8,19.021884825685635,37.44583852565421,43.243906237681166,NaN,NaN,50
1682607600,1.10108,1.10266,1.10061,1.1026,3452,3044.25,-564640,-568230.4,19.339815762582298,46.32440387354513,42.763059899094266,NaN,NaN,50
1682609400,1.1026,1.10271,1.10152,1.10156,2673,3083.2,-567313,-566787.8,19.578057531924724,41.93836461558963,41.84813719773515,NaN,NaN,50
1682611200,1.10156,1.10202,1.10116,1.10128,2105,3097.6,-569418,-566833.6,20.062767523756495,40.81783832215518,41.2160114543398,NaN,NaN,50
1682613000,1.10128,1.10141,1.1007,1.10085,1382,3063.5,-570800,-568052.6,20.836863054693687,39.09050195984003,40.94587033821549,NaN,NaN,50
1682614800,1.10085,1.10192,1.10056,1.10189,1591,2985.45,-569209,-568276,20.915077256471186,45.137653602049,41.10766862510611,NaN,NaN,50
1682616600,1.10189,1.10248,1.10183,1.10226,1356,2908.45,-567853,-568918.6,20.334984572312,47.14804208474077,40.9847436623318,NaN,NaN,50
1682618400,1.10226,1.10244,1.10188,1.10242,1088,2846.25,-566765,-568809,19.796327079878466,48.03483228442779,41.370635604655874,NaN,NaN,50
1682620200,1.10242,1.10274,1.1023,1.1027,1047,2789.3,-565718,-568069,18.9376921309222,49.627680828662456,41.940007689238584,NaN,NaN,50
1682622000,1.1027,1.103,1.10251,1.10288,1282,2755.75,-564436,-566796.2,17.83346213353533,50.674408271862866,41.85519360988527,NaN,NaN,50
1682623800,1.10288,1.10294,1.10228,1.10244,1264,2710,-565700,-566094.4,17.060388401238217,48.046166801461446,42.81647803049661,NaN,NaN,50
1682625600,1.10244,1.10295,1.10234,1.10276,1120,2672.75,-564580,-565439.8,16.32946039337677,50.07423830210213,44.22306420113705,NaN,NaN,50
1682627400,1.10276,1.10296,1.10274,1.1029,423,2603.6,-564157,-564918.2,15.636711946448841,50.97588861468324,45.23707474452205,NaN,NaN,50
1682629200,1.1029,1.10298,1.1025,1.10276,260,2495.1,-564417,-564658,15.295996159243758,50.00337115645281,46.09565923165904,NaN,NaN,50
1682631000,1.10276,1.1028,1.10254,1.10264,1002,2431.65,-565419,-564854.6,14.979617213981895,49.138028284008485,46.93081564297006,NaN,NaN,50
1682632800,1.10264,1.10294,1.10256,1.10286,543,2347.15,-564876,-564689.8,14.4500311853212,50.818446186372704,47.25181866531489,NaN,NaN,50
1682634600,1.10286,1.10288,1.10264,1.10268,1080,1990.75,-565956,-564965,13.958272730136267,49.38091347879494,47.78342929840098,NaN,NaN,50
1682636400,1.10268,1.103,1.10266,1.10272,520,1769.8,-565436,-565220.8,13.280748207527306,49.72128459239207,48.419389746275044,NaN,NaN,50
1682638200,1.10272,1.10339,1.1027,1.10316,1131,1559.5,-564305,-565198.4,12.694871901167723,53.4307791032161,49.4436952565162,NaN,NaN,50
1682640000,1.10316,1.10354,1.10302,1.1035,1280,1399.3,-563025,-564719.6,12.398226673813458,56.12456408797946,50.228474576939796,NaN,NaN,50
1682641800,1.1035,1.10394,1.10308,1.10345,1450,1302.45,-564475,-564639.4,12.742359966649005,55.61507806134918,50.833262860983254,NaN,NaN,50
1682643600,1.10345,1.10346,1.10316,1.10326,905,1175.1,-565380,-564524.2,13.061912309996302,53.62303391583835,51.232420120369724,NaN,NaN,50
1682645400,1.10326,1.10346,1.10252,1.10268,2794,1181.15,-568174,-565071.8,12.152203073534702,47.97403221110058,51.11430236197244,NaN,NaN,50
1682647200,1.10268,1.1027,1.10189,1.10224,1671,1159.45,-569845,-566179.8,12.28232982842453,44.172314664998815,50.6498671043393,NaN,NaN,50
1682649000,1.10224,1.10224,1.10156,1.10172,1054,1143.05,-570899,-567754.6,12.843751270124622,40.12536357323815,50.08409544518049,NaN,NaN,50
1682650800,1.10172,1.10208,1.10124,1.10184,1717,1149.35,-569182,-568696,13.762430192444802,41.4582888297011,49.46867048286612,NaN,NaN,50
1682652600,1.10184,1.10214,1.10182,1.10194,1396,1151.35,-567786,-569177.2,14.4909405684241,42.604964696909555,48.87074734588229,NaN,NaN,50
1682654400,1.10194,1.1022,1.10082,1.1011,3303,1262.1,-571089,-569760.2,16.250094307584167,36.192088265458246,47.88422713938268,NaN,NaN,50
1682656200,1.1011,1.10146,1.10099,1.10136,1515,1285.5,-569574,-569706,17.8835942082328,39.24058003218148,47.17726654996647,NaN,NaN,50
1682658000,1.10136,1.10179,1.10112,1.10153,1549,1298.85,-568025,-569131.2,18.696035709228614,41.21807133921641,46.4915254894553,NaN,NaN,50
1682659800,1.10153,1.10224,1.10056,1.10122,2228,1347.05,-570253,-569345.4,20.029948679267154,38.74190727280798,45.73159647474195,NaN,NaN,50
1682661600,1.10122,1.10132,1.10063,1.1011,3076,1444.85,-573329,-570454,21.2685821514458,37.79537666175842,44.87974590826813,NaN,NaN,50
1682663400,1.1011,1.10364,1.10061,1.10252,4261,1636.75,-569068,-570049.8,20.566001654145033,52.564349938350006,44.817858110777685,NaN,NaN,50
1682665200,1.10252,1.10252,1.09939,1.10059,4531,1850.3,-573599,-570854.8,19.61355729282753,39.00818066064544,43.59525929453954,NaN,NaN,50
1682667000,1.10059,1.1009,1.09964,1.10088,2877,1944.05,-570722,-571394.2,18.729144671604136,41.45153563415606,42.58357769259717,NaN,NaN,50
1682668800,1.10088,1.10098,1.0979,1.09796,4338,2133.8,-575060,-572355.6,19.345447124463206,28.898277241291197,40.81752364441523,NaN,NaN,50
1682670600,1.09796,1.09914,1.09766,1.09913,3005,2230.05,-572055,-572100.8,20.079716871554517,37.115869657550704,40.041940604875954,NaN,NaN,50
1682672400,1.09913,1.0994,1.09817,1.09886,2840,2346.05,-574895,-573266.2,20.43615697564959,36.079562908182936,39.46388690796054,NaN,NaN,50
1682674200,1.09886,1.09919,1.0983,1.09881,2351,2407.05,-577246,-573995.6,20.767137072309303,35.87977494487339,39.16063057736306,NaN,NaN,50
1682676000,1.09881,1.09986,1.09827,1.0994,2230,2454.55,-575016,-574854.4,20.22538471440413,40.09515459328004,39.063263846190125,NaN,NaN,50
1682677800,1.0994,1.09942,1.09824,1.09838,1982,2481.15,-576998,-575242,19.750620294700163,35.722758590319316,38.571677695719394,NaN,NaN,50
1682679600,1.09838,1.09884,1.09812,1.0988,1869,2529.35,-575129,-575856.8,19.428743825440755,38.68765370379521,38.749932369886324,NaN,NaN,50
1682681400,1.0988,1.09882,1.09725,1.0974,1933,2486.3,-577062,-576290.2,19.921721530943078,33.19167867738642,38.31786798740096,NaN,NaN,50
1682683200,1.0974,1.09843,1.09718,1.09768,2859,2545.7,-574203,-575681.6,20.438457543275028,35.175161666633045,37.88623158221644,NaN,NaN,50
1682685000,1.09768,1.09956,1.09626,1.09846,6589,2822.45,-567614,-574201.2,19.437306907818154,40.476747864493184,38.010148767336815,NaN,NaN,50
1682686800,1.09846,1.10158,1.09828,1.10057,5227,2997.95,-562387,-571279,19.406281836009477,51.929621357307084,39.01973767416171,NaN,NaN,50
1682688600,1.10057,1.10108,1.09942,1.10011,4374,3146.85,-566761,-569605.4,19.37747284075856,49.68514797458225,38.81408039103544,NaN,NaN,50
1682690400,1.10011,1.10158,1.0991,1.1011,4670,3215.2,-562091,-566611.2,19.722046373435916,54.26652037952208,39.903961799526634,NaN,NaN,50
1682692200,1.1011,1.10412,1.101,1.1037,6594,3469.15,-555497,-562870,21.449021252752654,63.63219940286614,41.488294925863066,NaN,NaN,50
1682694000,1.1037,1.10442,1.10289,1.10357,4948,3639.1,-560445,-561436.2,23.180859586026695,62.93817639703302,43.91971629413034,NaN,NaN,50
1682695800,1.10357,1.1045,1.10357,1.10396,3397,3697.55,-557048,-560368.4,24.824314242787835,64.19968360206532,45.85427443302425,NaN,NaN,50
1682697600,1.10396,1.10409,1.10319,1.1033,2472,3667.35,-559520,-558920.2,25.885660983093466,60.44976712521498,47.59500330566939,NaN,NaN,50
1682699400,1.1033,1.10362,1.10282,1.10308,2082,3558.4,-561602,-558822.4,26.426347878504718,59.208301389789234,49.26132662316338,NaN,NaN,50
1682701200,1.10308,1.10312,1.10253,1.1027,1633,3413.5,-563235,-560370,26.582680750210443,57.02965643967948,50.4709338979062,NaN,NaN,50
1682703000,1.1027,1.10282,1.10218,1.10238,1736,3356.45,-564971,-561275.2,26.31427851312346,55.18803708554952,51.86131093327979,NaN,NaN,50
1682704800,1.10238,1.1026,1.10219,1.10224,1517,3215.4,-566488,-563163.2,26.065047864399826,54.36095440085788,52.9808324116414,NaN,NaN,50
1682706600,1.10224,1.10233,1.10153,1.10172,1596,3144.95,-568084,-564876,25.04728642130597,51.28650682193405,54.27332013625195,NaN,NaN,50
1682708400,1.10172,1.10207,1.1012,1.10207,1337,3069.8,-566747,-565905,23.734508373674164,53.20486674105056,55.56115621299606,NaN,NaN,50
1682710200,1.10207,1.1021,1.10172,1.10196,1489,3026.7,-568236,-566905.2,22.54541402445516,52.505039040732214,56.4203198684417,NaN,NaN,50
1682712000,1.10196,1.10204,1.10142,1.10196,968,2963.6,-568236,-567558.2,21.088664674564555,52.505039040732214,56.461421131543496,NaN,NaN,50
1682713800,1.10196,1.102,1.10144,1.1017,689,2898.95,-568925,-568045.6,19.735968849666136,50.67775051341481,56.532321312888676,NaN,NaN,50
1682888400,1.1017,1.10254,1.1017,1.10212,252,2818.1,-568673,-568163.4,19.093416607634346,53.49341692316824,56.47709963743483,NaN,NaN,50
1682890200,1.10212,1.10224,1.10186,1.10203,357,2739.3,-569030,-568620,18.49676095431911,52.797860207085144,55.703218266307616,NaN,NaN,50
1682892000,1.10203,1.10216,1.10134,1.10142,782,2635.45,-569812,-568935.2,17.23650035496208,48.22126196402123,54.65201009252106,NaN,NaN,50
1682893800,1.10142,1.1015,1.10108,1.10114,556,2333.8,-570368,-569361.6,16.274821764032744,46.23993319567649,53.369170777779004,NaN,NaN,50
1682895600,1.10114,1.10135,1.10106,1.10126,554,2100.15,-569814,-569539.4,15.407853465352254,47.24045580393966,52.425648540545055,NaN,NaN,50
1682897400,1.10126,1.10134,1.101,1.10108,590,1910.95,-570404,-569885.6,14.685542726162112,45.861681986009735,51.47231858313223,NaN,NaN,50
1682899200,1.10108,1.10145,1.10064,1.1007,1249,1739.9,-571653,-570410.2,14.504693972583565,43.00788663767244,50.47076359727458,NaN,NaN,50
1682901000,1.1007,1.10105,1.10046,1.10057,980,1459.2,-572633,-570974.4,14.572254003668682,42.04401008037159,49.53190452547616,NaN,NaN,50
1682902800,1.10057,1.10066,1.10026,1.1006,921,1257.85,-571712,-571243.2,14.894541156118251,42.365022642690235,48.67505225703561,NaN,NaN,50
1682904600,1.1006,1.10086,1.10022,1.1004,891,1132.55,-572603,-571801,14.817533484466153,40.744747551379895,47.92206945199604,NaN,NaN,50
1682906400,1.1004,1.10043,1.10008,1.1003,840,1050.95,-573443,-572408.8,14.944686632699353,39.92259063253122,46.97333544424465,NaN,NaN,50
1682908200,1.1003,1.10083,1.10025,1.10082,837,988.7,-572606,-572599.4,14.310479168854338,46.022001491490784,46.510261333584545,NaN,NaN,50
1682910000,1.10082,1.10122,1.10054,1.10114,885,951.3,-571721,-572417,13.511330260095884,49.42486889737789,46.290249180487805,NaN,NaN,50
1682911800,1.10114,1.10141,1.10085,1.10141,928,910.9,-570793,-572233.2,13.070092675049155,52.16500689364708,46.39648177907583,NaN,NaN,50
1682913600,1.10141,1.10144,1.101,1.10136,844,877.25,-571637,-572040,12.708942362372886,51.60738706063669,46.26176536032357,NaN,NaN,50
1682915400,1.10136,1.10137,1.10033,1.10064,831,839,-572468,-571845,12.386126197010885,44.26892440505639,45.65255566017866,NaN,NaN,50
1682917200,1.10064,1.10064,1.10028,1.10034,820,813.15,-573288,-571981.4,12.164489449551217,41.61368988417524,45.180586225903944,NaN,NaN,50
1682919000,1.10034,1.1009,1.1001,1.1006,959,786.65,-572329,-572103,11.470513753962756,44.70893905310489,45.07122950143455,NaN,NaN,50
1682920800,1.1006,1.10066,1.0995,1.09969,1352,805.85,-573681,-572680.6,11.76339509877539,37.26306211476109,44.35855852363608,NaN,NaN,50
1682922600,1.09969,1.10056,1.09948,1.09979,1378,840.3,-572303,-572813.8,12.064336726809866,38.47564613980977,43.8309845346218,NaN,NaN,50
1682924400,1.09979,1.10059,1.09974,1.10023,1685,911.95,-570618,-572443.8,12.279970930487625,43.637613548120726,43.87596502822525,NaN,NaN,50
1682926200,1.10023,1.10047,1.09964,1.10034,1540,971.1,-569078,-571601.8,12.64341028207794,44.88264761961059,44.0787248524566,NaN,NaN,50
1682928000,1.10034,1.10034,1.0992,1.09944,1507,1007.35,-570585,-571253,13.648333964840653,37.57009979552259,43.736230363373195,NaN,NaN,50
1682929800,1.09944,1.09974,1.09914,1.09922,1176,1038.35,-571761,-570869,14.66698968791113,36.02499126467072,43.39910491432254,NaN,NaN,50
1682931600,1.09922,1.1001,1.09883,1.10004,1155,1068.4,-570606,-570529.6,14.740600459752024,45.089564906270105,43.76817450530389,NaN,NaN,50
1682933400,1.10004,1.10046,1.09988,1.10034,975,1087.65,-569631,-570332.2,14.038475621532017,47.9928657285418,43.90895052223611,NaN,NaN,50
1682935200,1.10034,1.10069,1.09998,1.10022,1420,1096.2,-571051,-570726.8,13.136667569065821,46.924111406387624,43.73032498716537,NaN,NaN,50
1682937000,1.10022,1.10096,1.10008,1.1009,802,1087.3,-570249,-570659.6,12.797915781134488,53.274077873092,43.809544342840006,NaN,NaN,50
1682938800,1.1009,1.1012,1.10064,1.1011,1003,1091.4,-569246,-570156.6,12.898736402486206,54.9800992079144,44.05045235335984,NaN,NaN,50
1682940600,1.1011,1.1014,1.10084,1.10134,1383,1116,-567863,-569608,13.32264772628192,57.008595151257296,44.96042883523133,NaN,NaN,50
1682942400,1.10134,1.102,1.10078,1.10167,2290,1188.5,-565573,-568796.4,14.576129060716742,59.69757861181548,46.25213517291992,NaN,NaN,50
1682944200,1.10167,1.10337,1.10132,1.1033,2890,1291.15,-562683,-567122.8,17.05961548274755,69.75902871340139,48.041427291512534,NaN,NaN,50
1682946000,1.1033,1.10358,1.1021,1.10249,2502,1372,-565185,-566110,19.51858023797597,61.537519924175754,49.775317135042144,NaN,NaN,50
1682947800,1.10249,1.10276,1.10179,1.10184,2545,1452.85,-567730,-565806.8,21.12087695632766,55.84923490204245,51.016287760915915,NaN,NaN,50
1682949600,1.10184,1.10184,1.09836,1.09854,5909,1706.1,-573639,-566962,20.961070585608525,37.09951286410864,50.54928056920077,NaN,NaN,50
1682951400,1.09854,1.09921,1.0978,1.09816,4031,1866.1,-577670,-569381.4,21.21867334531467,35.61670236308878,49.88742733659207,NaN,NaN,50
1682953200,1.09816,1.09822,1.0968,1.09691,3421,1996.15,-581091,-573063,22.097707021227873,31.199242650537926,49.43236611195031,NaN,NaN,50
1682955000,1.09691,1.09718,1.09663,1.09694,2163,2056.35,-578928,-575811.6,23.014984199045294,31.419088397850203,49.10337305003456,NaN,NaN,50
1682956800,1.09694,1.09707,1.09644,1.09662,1754,2076.45,-580682,-578402,23.982785837281565,30.306649457178494,48.04745051795659,NaN,NaN,50
1682958600,1.09662,1.09717,1.09649,1.09676,1641,2089.6,-579041,-579482.4,24.745323380301905,31.450190083445293,46.86583082902113,NaN,NaN,50
1682960400,1.09676,1.09717,1.09663,1.09712,1484,2079.55,-577557,-579459.8,25.453393955963655,34.42958016184181,45.97336431155357,NaN,NaN,50
1682962200,1.09712,1.09722,1.09654,1.09722,1418,2073.45,-576139,-578469.4,26.177900534985284,35.27117108859068,44.687442398374905,NaN,NaN,50
1682964000,1.09722,1.09758,1.09689,1.09742,1481,2072.15,-574658,-577615.4,26.286505686365686,37.01242711773592,43.404037249076445,NaN,NaN,50
1682965800,1.09742,1.09748,1.0969,1.09695,1488,2087.75,-576146,-576708.2,26.387353326933198,34.65324565863666,41.80722657103211,NaN,NaN,50
1682967600,1.09695,1.09706,1.09668,1.09676,1679,2113.95,-577825,-576465,26.685743837208648,33.717601142478,39.951513894650866,NaN,NaN,50
1682969400,1.09676,1.09735,1.09658,1.09728,1810,2155.7,-576015,-576156.6,26.46591392665802,38.60350549226798,37.72611937885562,NaN,NaN,50
1682971200,1.09728,1.09752,1.09716,1.09747,1465,2157.95,-574550,-575838.8,25.974467704649317,40.33414863313403,36.21159285806692,NaN,NaN,50
1682973000,1.09747,1.0977,1.0974,1.0977,791,2157.4,-573759,-575659,25.21250572614929,42.44898070710229,35.25443184414262,NaN,NaN,50
1682974800,1.0977,1.09772,1.09734,1.09746,178,2116.15,-573937,-575217.2,24.58168274766125,40.82297240410363,35.52039323985655,NaN,NaN,50
1682976600,1.09746,1.09776,1.09738,1.0977,497,2071.85,-573440,-574340.2,23.92091848041156,43.167404541409404,36.05972910973659,NaN,NaN,50
1682978400,1.0977,1.0977,1.09738,1.09747,377,1976.2,-573817,-573900.6,23.307351660822558,41.47174707048693,36.79347942544723,NaN,NaN,50
1682980200,1.09747,1.09758,1.09735,1.09742,200,1841.7,-574017,-573794,22.78470226147152,41.09383935308965,37.48453306510719,NaN,NaN,50
1682982000,1.09742,1.09744,1.09694,1.09722,540,1743.6,-574557,-573953.6,22.91636721431613,39.54169060802271,38.14417886159606,NaN,NaN,50
1682983800,1.09722,1.09724,1.09674,1.09688,750,1653.85,-575307,-574227.6,23.31451861756014,36.984241829915526,38.53946827205822,NaN,NaN,50
1682985600,1.09688,1.09787,1.09687,1.09767,1160,1416.4,-574147,-574369,22.325026075445866,45.76208042591518,39.34893257663489,NaN,NaN,50
1682987400,1.09767,1.09794,1.09748,1.09791,1064,1268.05,-573083,-574222.2,21.27007047628686,48.12612650546395,40.267143677840124,NaN,NaN,50
1682989200,1.09791,1.09943,1.09784,1.09927,1358,1164.9,-571725,-573763.8,21.402741851972664,59.02505184330429,41.83947401538072,NaN,NaN,50
1682991000,1.09927,1.09946,1.09865,1.09881,1689,1141.2,-573414,-573535.2,21.559692698592812,54.82892743461777,43.28059414223651,NaN,NaN,50
1682992800,1.09881,1.09915,1.09867,1.09886,1084,1107.7,-572330,-572939.8,21.705432770454376,55.20172249599239,44.8151742389161,NaN,NaN,50
1682994600,1.09886,1.09894,1.09861,1.09886,787,1065,-572330,-572576.4,21.7166408641031,55.20172249599239,46.000761167753566,NaN,NaN,50
1682996400,1.09886,1.09888,1.09855,1.09865,717,1026.65,-573047,-572569.2,21.597223467531073,53.068362761210494,46.91034789118759,NaN,NaN,50
1682998200,1.09865,1.09871,1.09834,1.09842,878,999.65,-573925,-573009.2,21.029950914083336,50.75479732770487,47.50362050694492,NaN,NaN,50
1683000000,1.09842,1.09858,1.09816,1.09822,786,964.9,-574711,-573268.6,20.123020382900616,48.76397703530523,48.070835123459325,NaN,NaN,50
1683001800,1.09822,1.09893,1.09792,1.09845,2638,1022.4,-572073,-573217.2,19.865610397414606,51.13760283647977,48.64013500167863,NaN,NaN,50
1683003600,1.09845,1.09916,1.09836,1.0991,1577,1017.3,-570496,-572850.4,19.981044755475732,57.17566614885276,49.76184350727619,NaN,NaN,50
1683005400,1.0991,1.09927,1.09834,1.09836,1232,988.4,-571728,-572586.6,20.254844106771177,49.65300534870489,50.373212506963,NaN,NaN,50
1683007200,1.09836,1.09922,1.09832,1.09898,1720,1001.15,-570008,-571803.2,20.45794119106823,54.995684130258,51.47706918712266,NaN,NaN,50
1683009000,1.09898,1.09949,1.09848,1.09916,1968,1060,-568040,-570469,21.072549978527668,56.44089094123404,52.86682983793112,NaN,NaN,50
1683010800,1.09916,1.10068,1.099,1.09967,3062,1204.2,-564978,-569050,23.006623550538734,60.3281268381474,53.90726172451914,NaN,NaN,50
1683012600,1.09967,1.10047,1.09824,1.09858,3135,1336.1,-568113,-568573.4,23.15002754165928,50.04817344563735,54.04455079167438,NaN,NaN,50
1683014400,1.09858,1.09868,1.09599,1.09706,4166,1525.55,-572279,-568683.6,22.67784144856557,39.85039245159064,52.67493226369483,NaN,NaN,50
1683016200,1.09706,1.09848,1.09668,1.09716,2805,1655.8,-569474,-568576.8,22.23938293354998,40.70637817881376,51.66617874542312,NaN,NaN,50
1683018000,1.09716,1.09818,1.09536,1.09552,2719,1764.75,-572193,-569407.4,22.931800496192427,32.53022041946977,50.046785739957215,NaN,NaN,50
1683019800,1.09552,1.09607,1.09492,1.09528,2386,1846.55,-574579,-571327.6,23.876679848418934,31.532080325871092,48.35609701351999,NaN,NaN,50
1683021600,1.09528,1.09602,1.09483,1.09548,2128,1894.95,-572451,-572195.2,24.81560294781426,33.366918759187584,46.94885101337549,NaN,NaN,50
1683023400,1.09548,1.096,1.09494,1.0957,1842,1933.85,-570609,-571861.2,25.687460111538496,35.417161090669865,45.853305567872994,NaN,NaN,50
1683025200,1.0957,1.09763,1.09569,1.09714,2654,1998.65,-567955,-571557.4,24.33553695781836,46.92796237440936,45.72216166352329,NaN,NaN,50
1683027000,1.09714,1.09714,1.0965,1.09677,2094,2018.9,-570049,-571128.6,23.080179743649662,44.72231240969803,45.26392663303887,NaN,NaN,50
1683028800,1.09677,1.09684,1.0961,1.0965,2455,2087.45,-572504,-570713.6,22.30834451441352,43.1292827805198,44.260613535300806,NaN,NaN,50
1683030600,1.0965,1.09708,1.09544,1.09553,2835,2189.85,-575339,-571291.2,22.187487408701887,37.905400881707415,43.42149893051527,NaN,NaN,50
1683032400,1.09553,1.0958,1.09488,1.09547,3189,2313.45,-578528,-572875,22.52856060212422,37.6020142620424,42.17909393992845,NaN,NaN,50
1683034200,1.09547,1.09594,1.09422,1.09435,3838,2461.45,-582366,-575757.2,23.325853596958748,32.39049476757337,40.46120849895268,NaN,NaN,50
1683036000,1.09435,1.09715,1.09431,1.09588,6899,2767.1,-575467,-576840.8,22.596671958252728,43.84113282011847,39.283566069093474,NaN,NaN,50
1683037800,1.09588,1.09934,1.09588,1.09792,6008,2935.6,-569459,-576231.8,21.910000377401612,54.82679528265016,39.624896200308676,NaN,NaN,50
1683039600,1.09792,1.09912,1.09776,1.09824,4359,3074.7,-565100,-574184,21.272376766611288,56.27181527443492,40.797854973368985,NaN,NaN,50
1683041400,1.09824,1.09977,1.09801,1.09968,3677,3196.95,-561423,-570763,21.13764042201141,62.140783671556356,42.32888393713632,NaN,NaN,50
1683043200,1.09968,1.10026,1.09954,1.09974,2489,3235.4,-558934,-566076.6,21.337105991313475,62.36742426980206,44.46011278358862,NaN,NaN,50
1683045000,1.09974,1.10032,1.0994,1.1,1844,3229.2,-557090,-562401.2,21.37140826861315,63.39017665756415,46.735691092995275,NaN,NaN,50
1683046800,1.1,1.10014,1.09947,1.09988,1560,3154.1,-558650,-560239.4,21.40326038324856,62.545299025383436,48.819861112009264,NaN,NaN,50
1683048600,1.09988,1.10036,1.09974,1.09974,1594,3077.05,-560244,-559268.2,21.601121657744045,61.51518416588814,50.68400561738199,NaN,NaN,50
1683050400,1.09974,1.10017,1.09972,1.10006,1745,2956,-558499,-558683.4,21.75875998370147,63.014619350780244,51.83305254426563,NaN,NaN,50
1683052200,1.10006,1.10014,1.09984,1.10012,1347,2883.1,-557152,-558327,21.905138429233364,63.303322146668954,53.16026752547783,NaN,NaN,50
1683054000,1.10012,1.10052,1.10002,1.10036,1389,2816.6,-555763,-558061.6,22.372346714075828,64.49711564548828,54.686541301547,NaN,NaN,50
1683055800,1.10036,1.1008,1.10028,1.10057,1096,2752.1,-554667,-557265,23.041687306839158,65.55307135301638,56.6613749066405,NaN,NaN,50
1683057600,1.10057,1.1007,1.10016,1.10018,497,2670.55,-555164,-556249,23.467260335653137,61.872544133606496,58.39498418318079,NaN,NaN,50
1683059400,1.10018,1.10024,1.09988,1.1,357,2596.3,-555521,-555653.4,23.404257943324243,60.19275867011263,60.380860176219315,NaN,NaN,50
1683061200,1.1,1.10038,1.1,1.10026,303,2478.75,-555218,-555266.6,23.489950049768595,61.80577610048721,61.66404898195994,NaN,NaN,50
1683063000,1.10026,1.10034,1.10012,1.1002,633,2405.7,-555851,-555284.2,23.56952129146692,61.189582681375576,62.11853379615461,NaN,NaN,50
1683064800,1.1002,1.10052,1.10008,1.10042,614,2313.65,-555237,-555398.2,23.8449760881916,62.659602018883696,62.57480427790095,NaN,NaN,50
1683066600,1.10042,1.10064,1.1004,1.10064,326,2188.2,-554911,-555347.6,24.236408827838126,64.12304237209284,62.71639418508213,NaN,NaN,50
1683068400,1.10064,1.10136,1.1005,1.1011,532,2055.35,-554379,-555119.2,25.330016734955045,67.03243780138106,63.04960943733777,NaN,NaN,50
1683070200,1.1011,1.10138,1.10098,1.10109,662,1896.55,-555041,-555083.8,26.3641119355941,66.90541687456562,63.300698024266445,NaN,NaN,50
1683072000,1.10109,1.10132,1.10048,1.10121,999,1601.55,-554042,-554722,26.28647697780747,67.69647093327373,63.66863887483003,NaN,NaN,50
1683073800,1.10121,1.10206,1.10121,1.10174,938,1348.05,-553104,-554295.4,26.972866110981837,70.994189302878,64.34571067032931,NaN,NaN,50
1683075600,1.10174,1.10194,1.10128,1.1019,952,1177.7,-552152,-553743.6,27.610227448929457,71.92593561220339,64.98223326043096,NaN,NaN,50
1683077400,1.1019,1.10242,1.10157,1.10228,1147,1051.2,-551005,-553068.8,28.644289356156357,74.05738362227868,65.75038050868879,NaN,NaN,50
1683079200,1.10228,1.10247,1.10198,1.10203,996,976.55,-552001,-552460.8,29.648826856113253,70.27710004249174,66.16323653704619,NaN,NaN,50
1683081000,1.10203,1.10258,1.10203,1.10255,797,924.2,-551204,-551893.2,30.682957196920917,73.32693889899623,66.71851279033046,NaN,NaN,50
1683082800,1.10255,1.10296,1.10251,1.10276,785,885.45,-550419,-551356.2,31.979898612876887,74.46639722418121,67.61807372537152,NaN,NaN,50
1683084600,1.10276,1.10299,1.10253,1.10296,545,833,-549874,-550900.6,33.21022435632975,75.53818700547268,68.7141757493258,NaN,NaN,50
1683086400,1.10296,1.10296,1.10236,1.10238,913,791.4,-550787,-550857,33.908808445423595,66.78334410089178,69.06971632078327,NaN,NaN,50
1683088200,1.10238,1.10257,1.10212,1.10218,614,754.75,-551401,-550737,33.94928114911082,64.02761932934354,69.27243322420955,NaN,NaN,50
1683090000,1.10218,1.10266,1.10212,1.10226,919,731.25,-550482,-550592.6,34.09677567562218,64.65586529233121,69.41502345802724,NaN,NaN,50
1683091800,1.10226,1.10234,1.10184,1.102,1018,727.35,-551500,-550808.8,33.525079519130585,60.93135315972115,69.18704565714354,NaN,NaN,50
1683093600,1.102,1.10238,1.10143,1.10194,1439,774.45,-552939,-551421.8,32.06510675563333,60.071366797175536,68.68982629970029,NaN,NaN,50
1683095400,1.10194,1.1032,1.10178,1.10308,1890,851.1,-551049,-551474.2,31.838033925869922,69.0186209018218,68.84076944450429,NaN,NaN,50
1683097200,1.10308,1.10412,1.1026,1.10386,2817,976.8,-548232,-550840.4,32.54198903768544,73.40910767952636,69.24881492637948,NaN,NaN,50
1683099000,1.10386,1.10414,1.10296,1.10344,2457,1068,-550689,-550881.8,33.213147737584755,67.83464686201066,69.02313332346039,NaN,NaN,50
1683100800,1.10344,1.10446,1.10344,1.10377,2592,1166.9,-548097,-550201.2,34.11615884158983,69.77662868995584,68.86961140044271,NaN,NaN,50
1683102600,1.10377,1.1047,1.10344,1.10396,1936,1247.4,-546161,-548845.6,35.15451937567746,70.86722261105106,68.64174275678359,NaN,NaN,50
1683104400,1.10396,1.10469,1.10389,1.10444,1671,1304.35,-544490,-547533.8,36.11871130018739,73.47159796218264,68.86992117961866,NaN,NaN,50
1683106200,1.10444,1.10444,1.10367,1.10404,1847,1363.6,-546337,-547154.8,36.46109281832938,68.01490847039958,68.4904904347189,NaN,NaN,50
1683108000,1.10404,1.10406,1.10326,1.10362,1770,1402.15,-548107,-546638.4,35.826604257852665,62.74545010723538,67.65327992636561,NaN,NaN,50
1683109800,1.10362,1.10384,1.10296,1.1033,1733,1441.9,-549840,-546987,34.60510558442894,58.995170152017124,66.47163586540451,NaN,NaN,50
1683111600,1.1033,1.10396,1.1032,1.10384,1492,1468.9,-548348,-547424.4,33.639347036623704,63.01272864014308,66.20230618963673,NaN,NaN,50
1683113400,1.10384,1.10438,1.10326,1.10396,2070,1515.05,-546278,-547782,33.2984109058479,63.86012388566157,66.19034222937374,NaN,NaN,50
1683115200,1.10396,1.10436,1.1022,1.10376,3747,1652.6,-550025,-548519.6,31.0362713592797,61.337830653651125,65.95333975518231,NaN,NaN,50
1683117000,1.10376,1.1042,1.10316,1.10386,3307,1778.1,-546718,-548241.8,28.935713208894942,62.142962728125994,66.03988329578264,NaN,NaN,50
1683118800,1.10386,1.10436,1.10337,1.10382,2799,1878.8,-549517,-548177.2,27.235908744863558,61.59045419359456,66.14838953838401,NaN,NaN,50
1683120600,1.10382,1.10407,1.10294,1.1032,3543,2028.7,-553060,-549119.6,25.62640072145866,53.631063440392495,65.04927829113906,NaN,NaN,50
1683122400,1.1032,1.10538,1.1032,1.10454,4450,2205.55,-548610,-549586,25.217137249319883,64.35326504279993,64.40243238851573,NaN,NaN,50
1683124200,1.10454,1.10595,1.10438,1.10528,3339,2341.8,-545271,-548635.2,25.404546512759012,68.66278446513203,64.46158507445298,NaN,NaN,50
1683126000,1.10528,1.10587,1.105,1.1055,2959,2443.8,-542312,-547754,25.578569400238205,69.83054085996537,64.46543594373937,NaN,NaN,50
1683127800,1.1055,1.10566,1.10478,1.10478,2481,2516.95,-544793,-546809.2,25.35201862766628,61.723920224845294,63.81234291615324,NaN,NaN,50
1683129600,1.10478,1.10526,1.10448,1.10514,1645,2527.25,-543148,-544826.8,24.62794393478051,63.97579158889784,63.134071032347194,NaN,NaN,50
1683131400,1.10514,1.10529,1.10444,1.10471,1398,2502.65,-544546,-544014,23.886740631615837,59.474881371945955,62.524069096743354,NaN,NaN,50
1683133200,1.10471,1.10497,1.10418,1.10496,1404,2432,-543142,-543588.2,22.747013104165244,61.18467669938991,62.41258528189725,NaN,NaN,50
1683135000,1.10496,1.10532,1.10465,1.105,1561,2387.2,-541581,-543442,22.176960975675136,61.46482105531759,62.58898891784728,NaN,NaN,50
1683136800,1.105,1.1092,1.10488,1.1063,8233,2669.25,-533348,-541153,24.508330838325783,69.23603724028291,63.03351096071441,NaN,NaN,50
1683138600,1.1063,1.10642,1.10373,1.10601,10169,3080.9,-543517,-541226.8,25.23093497786237,66.03672613228932,63.188982549759245,NaN,NaN,50
1683140400,1.10601,1.10638,1.10402,1.10546,7888,3391.75,-551405,-542598.6,25.901924536003484,60.34175432661781,63.11783424068544,NaN,NaN,50
1683142200,1.10546,1.10582,1.10407,1.10544,4289,3513.85,-555694,-545109,26.524986268563094,60.13865348013635,62.974669294400464,NaN,NaN,50
1683144000,1.10544,1.10586,1.10516,1.10578,1158,3483.25,-554536,-547700,27.12985212855528,62.452368936268975,63.03623463316292,NaN,NaN,50
1683145800,1.10578,1.10623,1.1055,1.10608,999,3446.55,-553537,-551737.8,27.93826208929237,64.4150569868786,63.80651988648343,NaN,NaN,50
1683147600,1.10608,1.10642,1.10579,1.10636,457,3394.8,-553080,-553650.4,28.814444295213697,66.19136328351037,63.937812617962734,NaN,NaN,50
1683149400,1.10636,1.10674,1.10629,1.10632,363,3309.45,-553443,-554058,29.838311302571352,65.6869144916762,63.72525047700161,NaN,NaN,50
1683151200,1.10632,1.10781,1.10632,1.1075,1810,3212.6,-551633,-553245.8,31.400535992526496,72.37528428781492,63.907017864705146,NaN,NaN,50
1683153000,1.1075,1.10784,1.10673,1.1068,1548,3124.65,-553181,-552974.8,32.86678536147259,64.36068393698395,64.0953581298579,NaN,NaN,50
1683154800,1.1068,1.10712,1.10642,1.10688,994,3034.4,-552187,-552704.8,33.707920483688966,64.83988579779086,64.15707914477883,NaN,NaN,50
1683156600,1.10688,1.10729,1.10682,1.10687,938,2904.15,-553125,-552713.8,34.59786839820244,64.72273622738058,64.53192592016703,NaN,NaN,50
1683158400,1.10687,1.10874,1.10687,1.10778,1870,2775.15,-551255,-552276.2,36.200567724053684,70.02938339474345,65.16369068412085,NaN,NaN,50
1683160200,1.10778,1.1081,1.10746,1.10759,1289,2672.65,-552544,-552458.4,37.68878852662984,67.73822035395034,65.6117906340232,NaN,NaN,50
1683162000,1.10759,1.10783,1.10714,1.1078,1675,2608.45,-550869,-551996,38.519568133764835,68.94748900375592,65.59118004569983,NaN,NaN,50
1683163800,1.1078,1.10844,1.1078,1.10815,1711,2569.95,-549158,-551390.2,39.622695767273655,70.90492422686457,65.93890848102663,NaN,NaN,50
1683165600,1.10815,1.10858,1.10808,1.10844,1227,2549.05,-547931,-550351.4,40.71984903344749,72.45430798498391,66.80409088519563,NaN,NaN,50
1683167400,1.10844,1.10878,1.10805,1.10842,1475,2552.9,-549406,-549981.6,41.84457539017097,72.16887371447535,67.66339233050556,NaN,NaN,50
1683169200,1.10842,1.1086,1.10814,1.10848,887,2527.05,-548519,-549176.6,42.88896414998562,72.51864645500183,68.3824121532722,NaN,NaN,50
1683171000,1.10848,1.1085,1.10804,1.10814,674,2482.7,-549193,-548841.4,43.64923294962689,67.35300228220635,68.59226538865275,NaN,NaN,50
1683172800,1.10814,1.10838,1.10795,1.10819,735,2107.8,-548458,-548701.4,44.159486046378824,67.71718718340128,68.70125281007354,NaN,NaN,50
1683174600,1.10819,1.10874,1.10812,1.10816,827,1640.7,-549285,-548972.2,44.88420479014204,67.2325749580118,68.81165712909751,NaN,NaN,50
1683176400,1.10816,1.10856,1.10798,1.10837,930,1292.8,-548355,-548762,45.237201405304795,68.9098379509115,68.56412524789012,NaN,NaN,50
1683178200,1.10837,1.10878,1.10822,1.1084,1113,1134,-547242,-548506.6,45.73280184120672,69.15275715306146,68.90641619189566,NaN,NaN,50
1683180000,1.1084,1.10917,1.10806,1.10886,2402,1196.2,-544840,-547636,46.47332047288225,72.67788186074415,69.46627305353518,NaN,NaN,50
1683181800,1.10886,1.10886,1.10728,1.10754,2883,1290.4,-547723,-547489,45.48624247750412,53.710153884290655,68.67966002902877,NaN,NaN,50
1683183600,1.10754,1.10768,1.10656,1.10679,3554,1445.25,-551277,-547887.4,43.33871683830323,46.31412600711141,66.98571307276931,NaN,NaN,50
1683185400,1.10679,1.1069,1.10522,1.1058,3180,1586.1,-554457,-549107.8,40.844783394891486,38.73229663274454,64.91386137839748,NaN,NaN,50
1683187200,1.1058,1.10582,1.10417,1.10426,2647,1627.95,-557104,-551080.2,39.50003119049388,30.396391359222335,62.16021154664508,NaN,NaN,50
1683189000,1.10426,1.10478,1.1037,1.10405,2597,1680.4,-559701,-554052.4,38.623316910624055,29.465130920434262,59.200226310471486,NaN,NaN,50
1683190800,1.10405,1.10478,1.10366,1.10472,2352,1748.3,-557349,-555977.6,37.840848167984184,36.18291835631119,56.60941276556629,NaN,NaN,50
1683192600,1.10472,1.10562,1.10467,1.10552,2451,1823.95,-554898,-556701.8,36.011374762921626,43.14574002099356,54.53633178746046,NaN,NaN,50
1683194400,1.10552,1.10592,1.10492,1.10531,2106,1835.75,-557004,-557211.2,33.95626440659608,41.85479559014241,52.34605672568478,NaN,NaN,50
1683196200,1.10531,1.10633,1.10492,1.10606,2204,1881.5,-554800,-556750.4,31.577606249247932,47.85553161347209,50.953380249346615,NaN,NaN,50
1683198000,1.10606,1.10722,1.10602,1.10668,2472,1921.35,-552328,-555275.8,30.17774152523654,52.24326617693469,49.84810017745615,NaN,NaN,50
1683199800,1.10668,1.10768,1.10644,1.10746,2295,1950.55,-550033,-553812.6,29.28845152353071,57.130550507110144,49.126527002391754,NaN,NaN,50
1683201600,1.10746,1.10837,1.10337,1.10358,5685,2173.45,-555718,-553976.6,28.61631926071465,36.90079848569987,46.84016704059092,NaN,NaN,50
1683203400,1.10358,1.10364,1.10014,1.10095,7214,2460.4,-562932,-555162.2,29.513075682040586,29.32166599701236,43.99508910087312,NaN,NaN,50
1683205200,1.10095,1.10554,1.10028,1.10316,6675,2749.8,-556257,-555453.6,28.892814717557346,40.399499863503436,41.6894903867845,NaN,NaN,50
1683207000,1.10316,1.1044,1.10118,1.1024,6014,3016.8,-562271,-557442.2,28.31685810768006,38.18311149952002,40.580415930729465,NaN,NaN,50
1683208800,1.1024,1.10304,1.10027,1.10263,6248,3292.45,-556023,-558640.2,28.201116014639112,39.26898525708123,40.07719159144159,NaN,NaN,50
1683210600,1.10263,1.10382,1.0986,1.10008,7662,3634.2,-563685,-560233.6,28.762529966600773,32.46083786459154,39.62923025085923,NaN,NaN,50
1683212400,1.10008,1.10088,1.09954,1.10018,4886,3832,-558799,-559407,29.283842921993745,32.95175836278135,39.811756465399164,NaN,NaN,50
1683214200,1.10018,1.10138,1.09966,1.10082,4013,3977,-554786,-559112.8,29.355123184692793,36.15048942428308,40.28928207281693,NaN,NaN,50
1683216000,1.10082,1.10254,1.10078,1.10244,3178,4015.8,-551608,-556980.2,28.528508913028684,43.49850394713698,40.81182390073305,NaN,NaN,50
1683217800,1.10244,1.10305,1.10198,1.10248,2305,3986.9,-549303,-555636.2,27.39538009079328,43.670879259337745,40.84933384632908,NaN,NaN,50
1683219600,1.10248,1.10288,1.10207,1.10272,2508,3934.6,-546795,-552258.2,26.343189041574693,44.759824649533265,41.05683592199985,NaN,NaN,50
1683221400,1.10272,1.10316,1.10206,1.10217,1913,3871.25,-548708,-550240,25.1494995211814,42.72157885854147,40.69012501093338,NaN,NaN,50
1683223200,1.10217,1.10227,1.10116,1.1013,2400,3858.9,-551108,-549504.4,24.591336718748575,39.646118727391894,39.79032876453747,NaN,NaN,50
1683225000,1.1013,1.10182,1.10112,1.10159,1698,3813.95,-549410,-549064.8,24.097036973197834,41.166494571656585,38.650039054862205,NaN,NaN,50
1683226800,1.10159,1.102,1.10136,1.10152,1613,3777,-551023,-549408.8,23.475719501001226,40.89867658714407,38.93560177639394,NaN,NaN,50
1683228600,1.10152,1.10176,1.1014,1.10147,1643,3736.6,-552666,-550583,22.898781848247236,40.695022191900996,39.74798436174313,NaN,NaN,50
1683230400,1.10147,1.10156,1.10125,1.10126,603,3661.45,-553269,-551495.2,22.473779953097743,39.79865308481007,39.7050667346936,NaN,NaN,50
1683232200,1.10126,1.10153,1.10126,1.10132,510,3576.75,-552759,-551825.4,22.07913533617321,40.20391424722814,39.84940978810133,NaN,NaN,50
1683234000,1.10132,1.10147,1.10112,1.10128,99,3458.1,-552858,-552515,21.828050078488147,40.01054089562159,39.90237804799706,NaN,NaN,50
1683235800,1.10128,1.10149,1.10128,1.10144,177,3352.2,-552681,-552846.6,21.569636170965495,41.22824459059259,40.52862138556856,NaN,NaN,50
1683237600,1.10144,1.10162,1.10098,1.10154,466,3091.25,-552215,-552756.4,21.598260064290677,42.0203931641115,41.17638101423501,NaN,NaN,50
1683239400,1.10154,1.10216,1.10146,1.10215,401,2750.6,-551814,-552465.4,20.911967722380133,46.73648569986606,41.93252360534808,NaN,NaN,50
1683241200,1.10215,1.10232,1.10195,1.10232,648,2449.25,-551166,-552146.8,20.071154199800624,48.0057901545874,42.25447262016598,NaN,NaN,50
1683243000,1.10232,1.10245,1.10224,1.1023,491,2173.1,-551657,-551906.6,19.120611425069786,47.86128408442723,42.55378725052951,NaN,NaN,50
1683244800,1.1023,1.10233,1.1019,1.10225,669,1894.15,-552326,-551835.6,18.622883397140637,47.47651867133661,42.74783682351546,NaN,NaN,50
1683246600,1.10225,1.10297,1.10204,1.1025,788,1550.45,-551538,-551700.2,17.320550097388473,49.65581208949035,43.24313919715467,NaN,NaN,50
1683248400,1.1025,1.10371,1.1025,1.10325,1026,1357.45,-550512,-551439.8,16.883769006425833,55.6067459261705,44.38318399706742,NaN,NaN,50
1683250200,1.10325,1.10369,1.10325,1.10355,1405,1227.05,-549107,-551028,16.47818656481767,57.75768527544304,45.56826904733788,NaN,NaN,50
1683252000,1.10355,1.10373,1.103,1.10303,1190,1127.65,-550297,-550756,15.757649359311078,52.967144744952414,46.430302487181336,NaN,NaN,50
1683253800,1.10303,1.10344,1.10274,1.10312,1130,1068.9,-549167,-550124.2,14.737105437721402,53.68318473503998,47.35802838311984,NaN,NaN,50
1683255600,1.10312,1.10397,1.10311,1.10396,1048,995.9,-548119,-549440.4,14.438162937346958,59.830111262468314,48.78884682438114,NaN,NaN,50
1683257400,1.10396,1.10447,1.10389,1.10441,1072,953.85,-547047,-548747.4,14.707655680462015,62.68702495883483,50.394783303781615,NaN,NaN,50
1683259200,1.10441,1.10449,1.10412,1.10444,740,870.85,-546307,-548187.4,14.979368435695232,62.876581110192376,52.02807189053668,NaN,NaN,50
1683261000,1.10444,1.10447,1.10404,1.10418,482,810.05,-546789,-547485.8,15.099752857587271,60.03025304215094,53.37107249421941,NaN,NaN,50
1683262800,1.10418,1.10464,1.10416,1.10438,1050,781.9,-545739,-546800.2,15.41651501012719,61.47496224877992,54.76068457169573,NaN,NaN,50
1683264600,1.10438,1.1045,1.10381,1.104,1660,782.75,-547399,-546656.2,15.105005121164764,57.24147603442839,55.51104102416447,NaN,NaN,50
1683266400,1.104,1.104,1.10301,1.10316,1933,849.25,-549332,-547113.2,14.41558551371099,49.17913542983517,55.59485140096789,NaN,NaN,50
1683268200,1.10316,1.10468,1.10312,1.10454,2162,931.85,-547170,-547285.8,13.89857949666149,59.317024044317414,56.41311854096004,NaN,NaN,50
1683270000,1.10454,1.10479,1.1031,1.10371,2938,1073.8,-550108,-547949.6,13.55401850185861,52.52976238950877,56.774064520829484,NaN,NaN,50
1683271800,1.10371,1.10419,1.10258,1.10269,2512,1190.55,-552620,-549325.8,12.671967510830653,45.6211858925857,56.48587693533629,NaN,NaN,50
1683273600,1.10269,1.10308,1.10244,1.10269,2151,1274.8,-552620,-550370,12.040625599267914,45.6211858925857,55.7726226472231,NaN,NaN,50
1683275400,1.10269,1.10318,1.10242,1.10284,2415,1375.5,-550205,-550544.6,11.305669735066132,46.81418308798062,54.99094391954721,NaN,NaN,50
1683277200,1.10284,1.1032,1.10222,1.10274,1811,1433.65,-552016,-551513.8,10.913735578926795,46.08825536336713,54.49959467800541,NaN,NaN,50
1683279000,1.10274,1.10315,1.10246,1.10274,1609,1489.55,-552016,-551895.4,10.549796719654552,46.08825536336713,53.95709972288592,NaN,NaN,50
1683280800,1.10274,1.10312,1.10242,1.10308,1443,1528.25,-550573,-551486,10.275837343616539,49.19476484586287,53.19743212169982,NaN,NaN,50
1683282600,1.10308,1.10308,1.10214,1.10251,1265,1552.1,-551838,-551329.6,10.467235822868783,44.559155104146264,51.90258427493635,NaN,NaN,50
1683284400,1.10251,1.10258,1.10192,1.10212,1313,1566.45,-553151,-551918.8,10.978075777957965,41.66617126689881,50.38755500041538,NaN,NaN,50
1683286200,1.10212,1.10226,1.10084,1.10095,2026,1597.5,-555177,-552551,12.751257969096955,34.44178925056765,48.55980758673086,NaN,NaN,50
1683288000,1.10095,1.10186,1.10074,1.10112,2607,1668.35,-552570,-552661.8,14.496536916749209,36.17346323097872,46.752557656887916,NaN,NaN,50
1683289800,1.10112,1.1012,1.09667,1.0976,8653,2044.5,-561223,-554791.8,18.295829423698233,22.764881203336017,44.28994374038132,NaN,NaN,50
1683291600,1.0976,1.09962,1.0976,1.09859,5038,2244,-556185,-555661.2,21.82374389443661,30.560919100566906,42.96007114543358,NaN,NaN,50
1683293400,1.09859,1.09946,1.09787,1.09912,4877,2434.25,-551308,-555292.6,25.099664474407962,34.379682973587265,41.17883249752428,NaN,NaN,50
1683295200,1.09912,1.10078,1.09855,1.10057,3773,2585.9,-547535,-553764.2,26.172892175859385,43.52958849932795,40.53596293393995,NaN,NaN,50
1683297000,1.10057,1.10078,1.09982,1.1007,3169,2720.25,-544366,-552123.4,27.169460755778562,44.27974421141293,40.44014567099902,NaN,NaN,50
1683298800,1.1007,1.10228,1.10049,1.10192,3211,2828.3,-541155,-548109.8,26.31276161495878,50.87503413394671,40.81542054538195,NaN,NaN,50
1683300600,1.10192,1.1027,1.10142,1.10248,2520,2871.3,-538635,-544599.8,25.098071781968617,53.59047762009256,41.29944158338994,NaN,NaN,50
1683302400,1.10248,1.10282,1.10212,1.10221,1810,2865.15,-540445,-542427.2,23.84962736570008,52.095284327076946,41.728515080797784,NaN,NaN,50
1683304200,1.10221,1.10368,1.1022,1.10323,1761,2845.1,-538684,-540657,22.420114828313388,56.97860548604458,42.506397232417605,NaN,NaN,50
1683306000,1.10323,1.10346,1.10209,1.10209,1865,2791.45,-540549,-539893.6,20.985526111463034,50.75163993022911,42.61760259558662,NaN,NaN,50
1683307800,1.10209,1.10222,1.10098,1.10116,1768,2754.25,-542317,-540126,20.31185346288354,46.30571596005714,42.74235694243739,NaN,NaN,50
1683309600,1.10116,1.10196,1.10108,1.1019,1520,2722.7,-540797,-540558.4,19.68630028920258,50.05491231334436,43.34155273146922,NaN,NaN,50
1683311400,1.1019,1.1027,1.10164,1.10266,1773,2690.6,-539024,-540274.2,18.348649392310666,53.63556086776464,44.712536418411865,NaN,NaN,50
1683313200,1.10266,1.10266,1.10212,1.10228,1402,2670.15,-540426,-540622.6,17.106544988053884,51.64201256320746,45.81743279928535,NaN,NaN,50
1683315000,1.10228,1.10252,1.10166,1.10182,1409,2660.15,-541835,-540879.8,16.40650959003331,49.25537492932038,47.709610922569944,NaN,NaN,50
1683316800,1.10182,1.10199,1.10168,1.10173,685,2622.25,-542520,-540920.4,15.75647672044278,48.78037036796209,49.01100029881246,NaN,NaN,50
1683318600,1.10173,1.10194,1.10172,1.10188,755,2596.75,-541765,-541114,15.152874770108715,49.65185761364673,50.10186991595957,NaN,NaN,50
1683493200,1.10188,1.10233,1.10188,1.10218,143,2538.25,-541622,-541633.6,14.105320994292258,51.43174205684995,50.66630945578256,NaN,NaN,50
1683495000,1.10218,1.10234,1.1021,1.1022,208,2447.35,-541414,-541831.2,13.12001966201172,51.55469910754437,51.18594909122053,NaN,NaN,50
1683496800,1.1022,1.1023,1.10176,1.10178,440,2339,-541854,-541835,12.634272595586305,48.76283767140175,51.03507791532446,NaN,NaN,50
1683498600,1.10178,1.1018,1.10144,1.10166,540,1933.35,-542394,-541809.8,12.568469897935989,47.96363969735445,50.63316092084317,NaN,NaN,50
1683500400,1.10166,1.10208,1.10142,1.10206,499,1706.4,-541895,-541835.8,12.096743734706001,50.85503745977034,50.544571858892695,NaN,NaN,50
1683502200,1.10206,1.10219,1.10181,1.10184,609,1493,-542504,-542012.2,11.497437956142392,49.2346489784849,49.99143210835272,NaN,NaN,50
1683504000,1.10184,1.1025,1.10168,1.10234,1273,1368,-541231,-541975.6,10.861381436731497,52.907230207339374,50.14540284243202,NaN,NaN,50
1683505800,1.10234,1.10254,1.10197,1.10244,990,1259.05,-540241,-541653,10.32899061724772,53.629763734942564,50.668549112066685,NaN,NaN,50
1683507600,1.10244,1.1025,1.10187,1.10225,1178,1157.4,-541419,-541458,9.671855989897248,51.997375420176624,50.80729647684042,NaN,NaN,50
1683509400,1.10225,1.10322,1.10225,1.10314,1325,1097.65,-540094,-541097.8,10.092286497825265,58.38690264754646,51.14667803253913,NaN,NaN,50
1683511200,1.10314,1.10328,1.10282,1.10328,898,1052.05,-539196,-540436.2,10.560659327500009,59.30454275397715,51.694001617594104,NaN,NaN,50
1683513000,1.10328,1.10372,1.10318,1.1032,1195,1023.75,-540391,-540268.2,11.547096913766,58.51053805852672,52.3550846982517,NaN,NaN,50
1683514800,1.1032,1.10385,1.10314,1.1037,875,974.25,-539516,-540123.2,12.617743261820952,61.94030864597423,53.29508028953829,NaN,NaN,50
1683516600,1.1037,1.104,1.10364,1.10392,793,925.5,-538723,-539584,13.792190203797716,63.37494844146506,54.27530106295388,NaN,NaN,50
1683518400,1.10392,1.10418,1.10386,1.10406,1199,909.45,-537524,-539070,15.098152179498816,64.29724249785113,55.194265380168254,NaN,NaN,50
1683520200,1.10406,1.10445,1.10403,1.10436,831,862.35,-536693,-538569.4,16.622591283871966,66.25806828496101,56.244506035698016,NaN,NaN,50
1683522000,1.10436,1.10445,1.10408,1.10418,895,837,-537588,-538008.8,18.03814188078989,63.98732954644957,57.33196974105857,NaN,NaN,50
1683523800,1.10418,1.10429,1.10368,1.10388,1188,825.95,-538776,-537860.8,18.38358573736088,60.27940579810741,58.21166731968379,NaN,NaN,50
1683525600,1.10388,1.10466,1.10374,1.10429,1420,862.7,-537356,-537587.4,19.200820389535405,63.400846804088125,59.107796558563635,NaN,NaN,50
1683527400,1.10429,1.10506,1.10426,1.10484,1202,885.05,-536154,-537313.4,20.435657308560703,67.13225545187095,60.38619702094836,NaN,NaN,50
1683529200,1.10484,1.10501,1.10438,1.10444,1868,971.3,-538022,-537579.2,21.582291590512767,62.16803666436049,61.04768319644986,NaN,NaN,50
1683531000,1.10444,1.105,1.10384,1.10494,1727,1047.25,-536295,-537320.6,21.385182072961175,65.59303767282415,61.902202763441394,NaN,NaN,50
1683532800,1.10494,1.10535,1.10431,1.10498,1809,1115.7,-534486,-536462.6,21.68259119495716,65.85932384330292,62.89234193652185,NaN,NaN,50
1683534600,1.10498,1.10538,1.1036,1.10362,2111,1194.25,-536597,-536310.8,20.584278334317283,51.317174072003496,62.387361323983065,NaN,NaN,50
1683536400,1.10362,1.1037,1.10228,1.10296,2129,1275.75,-538726,-536825.2,20.44653088057293,46.007918392082985,61.43760244099063,NaN,NaN,50
1683538200,1.10296,1.10392,1.10292,1.1036,1539,1322.25,-537187,-536658.2,19.97586492413514,51.272520758030424,60.92060120524089,NaN,NaN,50
1683540000,1.1036,1.10449,1.10354,1.1043,1283,1322.75,-535904,-536580,18.71418109589858,56.29242013902421,60.51718059760161,NaN,NaN,50
1683541800,1.1043,1.10502,1.10416,1.1048,1410,1343.75,-534494,-536581.6,17.885913989374338,59.50174736227863,60.24052337765972,NaN,NaN,50
1683543600,1.1048,1.10514,1.10452,1.10458,1476,1358.65,-535970,-536456.2,17.26264197658956,57.501099077853034,59.75508456194557,NaN,NaN,50
1683545400,1.10458,1.10502,1.10301,1.10352,2115,1398.15,-538085,-536328,17.164828743940983,48.95938804659134,58.51946454491917,NaN,NaN,50
1683547200,1.10352,1.10392,1.1032,1.10387,1919,1449.2,-536166,-536123.8,17.0740021707673,51.520192846596004,57.62895478064392,NaN,NaN,50
1683549000,1.10387,1.1041,1.10336,1.10372,1996,1489.25,-538162,-536575.4,16.73507917436792,50.35417818086133,56.92000995084063,NaN,NaN,50
1683550800,1.10372,1.10424,1.10335,1.10376,2026,1546.8,-536136,-536903.8,16.2188720519218,50.67476752963146,56.011004288379446,NaN,NaN,50
1683552600,1.10376,1.10444,1.10345,1.10434,2921,1653.2,-533215,-536352.8,15.448573864745335,55.192965652317454,55.15819787412562,NaN,NaN,50
1683554400,1.10434,1.10441,1.10246,1.10258,2955,1741,-536170,-535969.8,15.851059637179276,42.477676498921724,53.75174357659428,NaN,NaN,50
1683556200,1.10258,1.10274,1.10132,1.10158,3004,1849.65,-539174,-536571.4,17.184589521786148,37.22957098970726,51.725781670657355,NaN,NaN,50
1683558000,1.10158,1.10192,1.10116,1.10172,2278,1918.8,-536896,-536318.2,18.540216148117956,38.37744500469318,49.76279032504238,NaN,NaN,50
1683559800,1.10172,1.10234,1.10164,1.10196,1493,1934.05,-535403,-536171.6,19.154861474035737,40.38990309549016,48.982270969577144,NaN,NaN,50
1683561600,1.10196,1.10287,1.10188,1.10267,1198,1922.95,-534205,-536369.6,18.975691706389767,46.007521070682415,48.9822425894771,NaN,NaN,50
1683563400,1.10267,1.10292,1.10246,1.10274,1156,1920.65,-533049,-535745.4,18.740003954514954,46.542413066956335,48.64437775440039,NaN,NaN,50
1683565200,1.10274,1.10292,1.10232,1.10236,1213,1887.9,-534262,-534763,18.668549868142147,43.994406542654275,47.76594821180254,NaN,NaN,50
1683567000,1.10236,1.10237,1.10133,1.10156,1053,1854.2,-535315,-534446.8,19.525211853752474,39.136743370971324,46.3113050695663,NaN,NaN,50
1683568800,1.10156,1.10156,1.1005,1.10112,2153,1871.4,-537468,-534859.8,20.93588169706226,36.73432120611678,44.827963793013716,NaN,NaN,50
1683570600,1.10112,1.10112,1.10055,1.10058,1256,1828.65,-538724,-535763.6,22.245789408707065,33.977657182439216,43.757840159859995,NaN,NaN,50
1683572400,1.10058,1.10078,1.10025,1.10037,1171,1780.75,-539895,-537132.8,23.676807069301326,32.94233292501647,42.43085016546146,NaN,NaN,50
1683574200,1.10037,1.1005,1.10001,1.10017,1196,1763.6,-541091,-538498.6,25.17421675457675,31.944017283162438,41.11583867276868,NaN,NaN,50
1683576000,1.10017,1.10046,1.10002,1.10036,859,1742.4,-540232,-539482,26.564668605189645,33.99059220892836,39.92411186414703,NaN,NaN,50
1683577800,1.10036,1.10046,1.10024,1.1004,402,1692,-539830,-539954.4,27.855802466473044,34.43759198890794,38.44158517390349,NaN,NaN,50
1683579600,1.1004,1.10051,1.10022,1.10041,84,1622.4,-539746,-540158.8,28.945930522759205,34.55690560031253,37.875815824002835,NaN,NaN,50
1683581400,1.10041,1.10054,1.10033,1.10044,2256,1629.45,-537490,-539677.8,29.889112486960528,34.9394297851872,37.71223430939426,NaN,NaN,50
1683583200,1.10044,1.10048,1.10028,1.10032,416,1554.3,-537906,-539040.8,30.814441440332512,34.081294366881565,37.40536640669343,NaN,NaN,50
1683585000,1.10032,1.10034,1.10012,1.10014,405,1474.75,-538311,-538656.6,31.83558771799663,32.78072214676999,36.861853481784856,NaN,NaN,50
1683586800,1.10014,1.10024,1.09964,1.09967,395,1393.2,-538706,-538431.8,33.22909427421539,29.604002682319987,35.69017359690182,NaN,NaN,50
1683588600,1.09967,1.09982,1.09954,1.09967,457,1270,-538706,-538223.8,34.60942380163473,29.604002682319987,34.48028714085637,NaN,NaN,50
1683590400,1.09967,1.09976,1.0985,1.09873,1977,1221.1,-540683,-538862.4,36.62900004074034,24.170852826759884,33.06431901829247,NaN,NaN,50
1683592200,1.09873,1.09914,1.09861,1.099,1563,1149.05,-539120,-539105.2,38.504320834195546,28.24444343037898,32.286297593964456,NaN,NaN,50
1683594000,1.099,1.0995,1.09887,1.09925,1047,1087.5,-538073,-539057.6,39.310530227495086,31.892783138662963,31.940473446289186,NaN,NaN,50
1683595800,1.09925,1.09942,1.09872,1.09877,1081,1066.9,-539154,-539147.2,40.18399899449099,28.858858470881387,31.574844966892197,NaN,NaN,50
1683597600,1.09877,1.09906,1.09851,1.09906,981,1056.05,-538173,-539040.6,41.16769381127829,33.00546830042492,31.579354636564226,NaN,NaN,50
1683599400,1.09906,1.09928,1.09896,1.09906,971,1046.8,-538173,-538538.6,41.49538605195212,33.00546830042492,31.65517256636869,NaN,NaN,50
1683601200,1.09906,1.09912,1.09882,1.09894,815,1026.9,-538988,-538512.2,41.93612506367022,32.1073582991241,31.520655858525526,NaN,NaN,50
1683603000,1.09894,1.09942,1.09894,1.09938,755,1012,-538233,-538544.2,41.55260610657927,38.69452986001201,31.824722849318675,NaN,NaN,50
1683604800,1.09938,1.09955,1.09918,1.09927,655,937.1,-538888,-538491,40.86592074339623,37.70949483320351,32.049907794525176,NaN,NaN,50
1683606600,1.09927,1.09944,1.09884,1.09889,730,910.8,-539618,-538780,40.65186256986726,34.447142273387996,32.01474440082523,NaN,NaN,50
1683608400,1.09889,1.09925,1.09846,1.0992,1092,906.85,-538526,-538850.6,40.87432593941631,39.07756075332659,32.37162057128559,NaN,NaN,50
1683610200,1.0992,1.09944,1.09903,1.09942,1189,906.5,-537337,-538520.4,40.581580566871764,42.198009666812474,33.04428396557434,NaN,NaN,50
1683612000,1.09942,1.09993,1.09906,1.09968,1837,955.4,-535500,-537973.8,39.14737558102827,45.73546702579111,34.19653141867941,NaN,NaN,50
1683613800,1.09968,1.1001,1.09873,1.09942,2030,1036.8,-537530,-537702.2,38.26668337682117,42.9075490318955,35.14678472936338,NaN,NaN,50
1683615600,1.09942,1.10004,1.0981,1.09832,3312,1198.2,-540842,-537947,38.182753492706276,33.47653800770556,35.81147652800236,NaN,NaN,50
1683617400,1.09832,1.09839,1.09727,1.09781,2971,1233.95,-543813,-539004.4,38.85117984265929,30.165959694116964,35.948727689697925,NaN,NaN,50
1683619200,1.09781,1.09863,1.09752,1.0977,2368,1331.55,-546181,-540773.2,38.95357589847502,29.48859188386443,35.776999742926606,NaN,NaN,50
1683621000,1.0977,1.09802,1.09741,1.09789,2250,1423.8,-543931,-542459.4,39.149744268624524,32.31569082340303,36.02391633953529,NaN,NaN,50
1683622800,1.09789,1.09844,1.09778,1.09833,2041,1506.1,-541890,-543331.4,38.4331615329801,38.468363932366536,36.414123170388265,NaN,NaN,50
1683624600,1.09833,1.09842,1.09784,1.09842,1464,1556.45,-540426,-543248.2,37.76776327845313,39.67628467513155,36.890610054295884,NaN,NaN,50
1683626400,1.09842,1.09844,1.09784,1.09824,1621,1538.65,-542047,-542895,37.104887004241604,38.06674958034457,37.31628086009734,NaN,NaN,50
1683628200,1.09824,1.09829,1.09775,1.09798,1438,1532.4,-543485,-542355.8,36.607368704444816,35.80718303788234,37.11004180137379,NaN,NaN,50
1683630000,1.09798,1.09827,1.09738,1.09742,1367,1548.4,-544852,-542540,36.608425699921185,31.473792944225465,36.66463452358965,NaN,NaN,50
1683631800,1.09742,1.09742,1.09591,1.09638,2271,1607.9,-547123,-543586.6,37.89593896813775,25.340396562898135,36.01415268712609,NaN,NaN,50
1683633600,1.09638,1.09648,1.09585,1.09626,2821,1699.9,-549944,-545490.2,39.13146714762094,24.74128622595768,34.99013307802831,NaN,NaN,50
1683635400,1.09626,1.09672,1.09498,1.09501,2957,1799.2,-552901,-547661,40.795741394379746,19.554922649511724,33.37276971964968,NaN,NaN,50
1683637200,1.09501,1.09529,1.09411,1.09466,3600,1938.45,-556501,-550264.2,42.73879015314828,18.39234868838166,31.419689838406153,NaN,NaN,50
1683639000,1.09466,1.09636,1.09435,1.0962,3785,2089.95,-552716,-551837,42.574250042819514,36.3290694186041,30.949798437456767,NaN,NaN,50
1683640800,1.0962,1.09646,1.09545,1.0964,3097,2212.05,-549619,-552336.2,42.25851054562296,38.22795206431695,31.289185155786154,NaN,NaN,50
1683642600,1.0964,1.09641,1.09533,1.0956,3109,2331,-552728,-552893,42.0561560475209,33.875914539496364,31.554181930456107,NaN,NaN,50
1683644400,1.0956,1.09604,1.0954,1.09573,2522,2402.5,-550206,-552354,41.86825544214041,35.16755618616689,31.959822237763426,NaN,NaN,50
1683646200,1.09573,1.0958,1.0951,1.09528,1607,2423.4,-551813,-551416.4,41.93720829489462,32.7805556487677,31.993026868146615,NaN,NaN,50
1683648000,1.09528,1.0961,1.09493,1.09588,1719,2417.5,-550094,-550892,41.41838745536534,38.7500742941228,32.013149036843494,NaN,NaN,50
1683649800,1.09588,1.09603,1.09534,1.09554,1592,2395.6,-551686,-551305.4,40.936625247231014,36.75798656826819,31.804699172067536,NaN,NaN,50
1683651600,1.09554,1.09647,1.09542,1.09606,1654,2312.7,-550032,-550766.2,39.63728741792627,41.69485873556845,32.063849826012095,NaN,NaN,50
1683653400,1.09606,1.09647,1.0957,1.09637,1543,2241.3,-548489,-550422.8,38.43075943357185,44.477506218289626,32.683158624612624,NaN,NaN,50
1683655200,1.09637,1.09712,1.09614,1.09707,1708,2208.3,-546781,-549416.4,36.15527974050991,50.25121467771267,34.024403034147426,NaN,NaN,50
1683657000,1.09707,1.09725,1.09659,1.09666,1968,2194.2,-548749,-549147.4,33.83227667094504,47.15798862136444,35.58280246689502,NaN,NaN,50
1683658800,1.09666,1.09699,1.09654,1.09666,1568,2170.55,-548749,-548560,31.75298635009859,47.15798862136444,37.183995495138355,NaN,NaN,50
1683660600,1.09666,1.09672,1.09615,1.0963,1343,2164.5,-550092,-548572,30.41221438311966,44.3763260286432,38.95695287936203,NaN,NaN,50
1683662400,1.0963,1.09641,1.09616,1.0962,959,2131.4,-551051,-549084.4,29.167211842353513,43.606865703176965,40.75798980899027,NaN,NaN,50
1683664200,1.0962,1.09628,1.09596,1.09605,469,2082.95,-551520,-550032.2,28.315904450442765,42.41872349072812,41.19296509985627,NaN,NaN,50
1683666000,1.09605,1.09673,1.09605,1.09632,166,2022.9,-551354,-550553.2,26.636043023254846,45.307402538024895,41.69864013369255,NaN,NaN,50
1683667800,1.09632,1.09646,1.09457,1.09569,835,1951.1,-552189,-551241.2,26.93480014865473,40.23531357948579,42.152882922263224,NaN,NaN,50
1683669600,1.09569,1.09662,1.09563,1.09659,835,1851.8,-551354,-551493.6,26.924044049909746,49.01616865302026,43.142069527038466,NaN,NaN,50
1683671400,1.09659,1.09674,1.09646,1.0965,515,1729.7,-551869,-551657.2,26.693961296550032,48.252687441579994,44.24722179795363,NaN,NaN,50
1683673200,1.0965,1.0969,1.09646,1.09678,397,1569.55,-551472,-551647.6,26.182357988691486,50.81926398867574,45.10930677613597,NaN,NaN,50
1683675000,1.09678,1.09683,1.0964,1.09646,386,1399.6,-551858,-551748.4,25.784519293603136,47.89552886660656,45.90484551173158,NaN,NaN,50
1683676800,1.09646,1.09718,1.09645,1.09685,1205,1305,-550653,-551441.2,24.744569125890717,51.55374355945259,46.60905157058044,NaN,NaN,50
1683678600,1.09685,1.09722,1.09682,1.09692,1066,1202.85,-549587,-551087.8,23.703519744749848,52.20240540788027,47.16083008412263,NaN,NaN,50
1683680400,1.09692,1.09734,1.09692,1.09721,1106,1132.05,-548481,-550410.2,22.502776831944978,54.89673519417904,47.49265297815594,NaN,NaN,50
1683682200,1.09721,1.09742,1.09682,1.09714,1293,1116.35,-549774,-550070.6,21.560702670128844,54.1039448208519,47.98879270669075,NaN,NaN,50
1683684000,1.09714,1.09739,1.09704,1.09722,979,1079.35,-548795,-549458,20.685919519871007,54.90546125306885,48.54218360895536,NaN,NaN,50
1683685800,1.09722,1.0975,1.09717,1.09745,824,1040.95,-547971,-548921.6,19.622962063923495,57.21866524964981,49.45949355331298,NaN,NaN,50
1683687600,1.09745,1.09763,1.09728,1.0976,673,991.9,-547298,-548463.8,18.33927182970709,58.70638456050374,50.53803061455061,NaN,NaN,50
1683689400,1.0976,1.09775,1.0975,1.09762,537,941.6,-546761,-548119.8,17.184060236472508,58.911552652904064,51.71608984042032,NaN,NaN,50
1683691200,1.09762,1.09773,1.09746,1.09766,611,886.75,-546150,-547395,16.014289145744513,59.34660192187314,52.71888979640948,NaN,NaN,50
1683693000,1.09766,1.09772,1.0972,1.0972,619,819.3,-546769,-546989.8,15.426118250404878,52.46666164468725,53.59255751535243,NaN,NaN,50
1683694800,1.0972,1.09725,1.0966,1.09663,853,783.55,-547622,-546920,16.030820717496745,45.43748015015775,53.33693690800511,NaN,NaN,50
1683696600,1.09663,1.09674,1.09624,1.09667,1307,781.75,-546315,-546723.4,17.143786332304085,45.98438337288684,53.17491518881274,NaN,NaN,50
1683698400,1.09667,1.09726,1.09644,1.09668,1821,824.85,-544494,-546270,16.896013507816463,46.129758356636145,52.839950500809906,NaN,NaN,50
1683700200,1.09668,1.09752,1.09658,1.09696,1791,890.95,-542703,-545580.6,16.110805123842304,50.17341419744842,53.00265659587005,NaN,NaN,50
1683702000,1.09696,1.09812,1.09685,1.09793,2763,1020.8,-539940,-544214.8,15.637012070088266,61.07426645234956,53.68269394536269,NaN,NaN,50
1683703800,1.09793,1.09826,1.0963,1.09649,2692,1113.65,-542632,-543216.8,14.823668433000714,45.248116644766256,53.18595903371169,NaN,NaN,50
1683705600,1.09649,1.09649,1.09502,1.09576,3138,1228.8,-545770,-543107.8,15.703858205238738,39.64024127215043,52.096209467852496,NaN,NaN,50
1683707400,1.09576,1.09592,1.09512,1.09521,2053,1305.7,-547823,-543773.6,16.52117727945976,36.018268432842284,50.80437544013753,NaN,NaN,50
1683709200,1.09521,1.09552,1.09479,1.09549,1847,1378.2,-545976,-544428.2,17.627356032090333,39.07049370812823,49.67330632978462,NaN,NaN,50
1683711000,1.09549,1.09593,1.09528,1.09568,1715,1444.65,-544261,-545292.4,17.88167852169373,41.12300924263581,48.52361661499791,NaN,NaN,50
1683712800,1.09568,1.09607,1.0955,1.09556,1618,1465.3,-545879,-545941.8,17.864565003343678,40.20188639621079,47.20186674611984,NaN,NaN,50
1683714600,1.09556,1.0956,1.09514,1.09548,1415,1482.75,-547294,-546246.6,18.289588047254473,39.56561267568173,45.82001389060396,NaN,NaN,50
1683716400,1.09548,1.0955,1.09459,1.09493,2003,1527.6,-549297,-546541.4,19.281647229591588,35.41559896626197,44.11065653663174,NaN,NaN,50
1683718200,1.09493,1.0953,1.09466,1.09492,1857,1555.8,-551154,-547577,20.202845041761773,35.343012243087244,42.88753872223174,NaN,NaN,50
1683720000,1.09492,1.09514,1.09416,1.09464,2381,1625.9,-553535,-549431.8,21.56078425170255,33.28586596282588,42.019566280279456,NaN,NaN,50
1683721800,1.09464,1.10058,1.09464,1.10008,8791,2024.25,-544744,-549204.8,22.67521847485463,69.91920385777004,43.72919631491397,NaN,NaN,50
1683723600,1.10008,1.10064,1.09777,1.0984,5387,2259.95,-550131,-549772.2,23.739109434352596,59.122178269274926,44.65722630867389,NaN,NaN,50
1683725400,1.0984,1.09893,1.09723,1.09858,5587,2512.45,-544544,-548821.6,24.146798029349018,59.83778306195791,45.347538370424566,NaN,NaN,50
1683727200,1.09858,1.1007,1.09826,1.09872,5082,2736,-539462,-546483.2,25.39457301121759,60.41817520054962,45.30067470958171,NaN,NaN,50
1683729000,1.09872,1.0988,1.09642,1.09723,4663,2938.2,-544125,-544601.2,24.916130017961432,51.83293312856832,45.771018744139,NaN,NaN,50
1683730800,1.09723,1.098,1.0971,1.09756,3054,3048.25,-541071,-543866.6,24.471861524223574,53.41189745645255,46.75470847158915,NaN,NaN,50
1683732600,1.09756,1.09782,1.09652,1.09654,2177,3091.75,-543248,-542490,23.585723167979044,48.157128604628284,47.62176991243101,NaN,NaN,50
1683734400,1.09654,1.09736,1.0965,1.09726,1637,3082.55,-541611,-541903.4,22.746309832798435,51.764566045839494,48.52848936512468,NaN,NaN,50
1683736200,1.09726,1.09755,1.09692,1.09705,1520,3069,-543131,-542637.2,22.0974632583487,50.65737160910187,49.20951524844368,NaN,NaN,50
1683738000,1.09705,1.09728,1.09642,1.0966,2074,3034.55,-545205,-542853.2,21.044265935113966,48.2745713117396,49.786135599552885,NaN,NaN,50
1683739800,1.0966,1.09705,1.09618,1.09676,1955,2997.7,-543250,-543289,19.85239274894361,49.189713939535814,50.47357140411389,NaN,NaN,50
1683741600,1.09676,1.09748,1.09676,1.09739,1648,2923.2,-541602,-542959.8,19.094575623449135,52.735594757213676,51.71071396061044,NaN,NaN,50
1683743400,1.09739,1.09827,1.0973,1.09769,1572,2899.15,-540030,-542643.6,18.98585881846382,54.36865117684276,53.069688170164405,NaN,NaN,50
1683745200,1.09769,1.09848,1.0976,1.09838,1322,2872.9,-538708,-541759,19.03563785700087,57.96598229228277,54.83255362226846,NaN,NaN,50
1683747000,1.09838,1.0985,1.09796,1.09824,1194,2846.85,-539902,-540698.4,19.09688554463455,56.98437777872188,53.90863747376503,NaN,NaN,50
1683748800,1.09824,1.0984,1.09806,1.09828,598,2795.85,-539304,-539909.2,19.15375839743725,57.20734918645796,53.771863967849534,NaN,NaN,50
1683750600,1.09828,1.09846,1.09826,1.09834,755,2762.85,-538549,-539298.6,19.25823511078039,57.56269134999168,53.6093574169948,NaN,NaN,50
1683752400,1.09834,1.09834,1.0979,1.0983,98,2667.6,-538647,-539022,18.880294709143545,57.22155294335274,53.381027255766455,NaN,NaN,50
1683754200,1.0983,1.09834,1.09826,1.09834,673,2608.4,-537974,-538875.2,18.52935005048076,57.49284448451376,53.785306638333985,NaN,NaN,50
1683756000,1.09834,1.09858,1.09824,1.09841,307,2504.7,-537667,-538428.2,18.454696639141567,57.994882008485355,54.1126626777649,NaN,NaN,50
1683757800,1.09841,1.09865,1.09838,1.09864,285,2079.4,-537382,-538043.8,18.460100174585385,59.679921126560096,54.93571928647432,NaN,NaN,50
1683759600,1.09864,1.09874,1.09849,1.09862,268,1823.45,-537650,-537864,18.565508492712695,59.45656675896611,55.48514790884051,NaN,NaN,50
1683761400,1.09862,1.09862,1.09824,1.09828,379,1563.05,-538029,-537740.4,18.242975296318832,55.643994261292995,55.841335241139866,NaN,NaN,50
1683763200,1.09828,1.09886,1.09824,1.09862,1079,1362.9,-536950,-537535.6,18.23991882214581,58.50919359823597,56.57237969017532,NaN,NaN,50
1683765000,1.09862,1.09931,1.09852,1.09928,1260,1192.75,-535690,-537140.2,18.756147200497875,63.44540839078337,57.590643579550154,NaN,NaN,50
1683766800,1.09928,1.09982,1.0988,1.0993,1489,1114.5,-534201,-536504,19.75628119571349,63.586783177933704,58.365728466744436,NaN,NaN,50
1683768600,1.0993,1.09938,1.09842,1.09846,1604,1085.85,-535805,-536135,19.9948213323216,54.11964082941785,58.34794201335694,NaN,NaN,50
1683770400,1.09846,1.09852,1.09758,1.09763,1223,1065.15,-537028,-535934.8,18.91789947465561,46.71812096641051,57.544523347223205,NaN,NaN,50
1683772200,1.09763,1.09814,1.09752,1.09806,1377,1058,-535651,-535675,17.833727431485897,50.49546091078446,57.08102928522767,NaN,NaN,50
1683774000,1.09806,1.09819,1.09778,1.09783,823,995.45,-536474,-535831.8,16.89561138440529,48.514297275242235,56.46009700585512,NaN,NaN,50
1683775800,1.09783,1.09784,1.09736,1.09746,618,928.6,-537092,-536410,15.972283409738026,45.42658604074256,55.59323234090875,NaN,NaN,50
1683777600,1.09746,1.09748,1.09696,1.09724,701,881.25,-537793,-536807.6,15.651825448987552,43.64775584763873,54.623675405500606,NaN,NaN,50
1683779400,1.09724,1.09764,1.09714,1.09754,757,840.5,-537036,-536809.2,15.094505402373711,46.712091440872854,53.85362161666911,NaN,NaN,50
1683781200,1.09754,1.09794,1.09744,1.09785,868,817.8,-536168,-536912.6,14.100957338054808,49.75271616649474,53.26489548509836,NaN,NaN,50
1683783000,1.09785,1.09824,1.09776,1.09784,1011,808.65,-537179,-537053.6,13.460079844250208,49.654289243919465,52.5487789220526,NaN,NaN,50
1683784800,1.09784,1.0979,1.0967,1.09693,1429,850.2,-538608,-537356.8,13.573096404497905,41.590839654591754,51.272655557454435,NaN,NaN,50
1683786600,1.09693,1.09694,1.09292,1.09306,3806,1002.75,-542414,-538281,16.2525228913649,23.85157943406719,49.001768784081165,NaN,NaN,50
1683788400,1.09306,1.0936,1.09242,1.09304,4342,1214.95,-546756,-540225,18.93967868406929,23.795094975143954,46.522190311003165,NaN,NaN,50
1683790200,1.09304,1.09388,1.09276,1.09302,3299,1346.25,-550055,-543002.4,21.069699233634573,23.73456398594169,43.68570142494304,NaN,NaN,50
1683792000,1.09302,1.09366,1.09182,1.0933,4207,1541.25,-545848,-544736.2,23.440093757342854,26.551556197741363,41.04032806921502,NaN,NaN,50
1683793800,1.0933,1.09334,1.09259,1.09284,2830,1668.5,-548678,-546750.2,25.64117438650054,24.922859408898418,38.954843682035055,NaN,NaN,50
1683795600,1.09284,1.09346,1.09258,1.09294,2320,1771.1,-546358,-547539,27.5128197641675,25.98575938938575,37.473960712247575,NaN,NaN,50
1683797400,1.09294,1.0931,1.09238,1.09278,1752,1839.75,-548110,-547809.8,29.344639890109576,25.366949026870586,35.679067006253725,NaN,NaN,50
1683799200,1.09278,1.09312,1.092,1.092,2007,1886.15,-550117,-547822.2,31.222554718740437,22.54798689424817,33.82433055046844,NaN,NaN,50
1683801000,1.092,1.0926,1.09179,1.09226,1996,1922.95,-548121,-548276.8,33.06302454464934,25.51916687583845,32.40237203868957,NaN,NaN,50
1683802800,1.09226,1.09348,1.09214,1.0934,4249,2060.95,-543872,-547315.6,33.41483228396051,36.94152784943468,31.92335575310356,NaN,NaN,50
1683804600,1.0934,1.09385,1.09249,1.09316,3029,2132.2,-546901,-547424.2,33.22941781915647,35.700237071861494,31.136794726745613,NaN,NaN,50
1683806400,1.09316,1.09364,1.0926,1.09308,4253,2283.7,-551154,-548033,33.05724724469558,35.27475031005429,30.102654308428438,NaN,NaN,50
1683808200,1.09308,1.0948,1.09308,1.09329,5988,2514.25,-545166,-547042.8,31.41262475448458,37.38440537485769,29.22623403206688,NaN,NaN,50
1683810000,1.09329,1.09332,1.09126,1.09183,5253,2735.75,-550419,-547502.4,31.24561351594811,30.05087514385481,28.401950852728525,NaN,NaN,50
1683811800,1.09183,1.09203,1.0901,1.09017,5706,2990.15,-556125,-549953,31.733161506344782,24.230781781453558,28.429036734684693,NaN,NaN,50
1683813600,1.09017,1.09116,1.09002,1.09088,4502,3180.2,-551623,-550897.4,32.227169864508795,30.436462538229705,28.903420132047962,NaN,NaN,50
1683815400,1.09088,1.09212,1.09078,1.09174,4315,3358.1,-547308,-550128.2,31.619958175272956,37.15105141126669,29.861740662428314,NaN,NaN,50
1683817200,1.09174,1.092,1.09124,1.09176,3262,3477.8,-544046,-549904.2,31.056118749553953,37.30261797426127,30.62967364646545,NaN,NaN,50
1683819000,1.09176,1.09178,1.09094,1.09156,2504,3552.45,-546550,-549130.4,30.73709825445703,36.358352172847724,31.446494558176116,NaN,NaN,50
1683820800,1.09156,1.09286,1.09156,1.09272,2294,3595.7,-544256,-546756.6,29.291963442603247,45.04711811644413,32.80802018153743,NaN,NaN,50
1683822600,1.09272,1.09292,1.09236,1.09253,1841,3497.45,-546097,-545651.4,27.89050142852468,43.98779328406445,34.1380804856227,NaN,NaN,50
1683824400,1.09253,1.09258,1.09158,1.0916,2022,3381.45,-548119,-545813.6,27.205529462605593,39.136493788972906,35.3229738352459,NaN,NaN,50
1683826200,1.0916,1.09174,1.09108,1.09128,1313,3282.15,-549432,-546890.8,26.930534748112677,37.59988218530042,36.185882071636044,NaN,NaN,50
1683828000,1.09128,1.09159,1.0912,1.09151,1608,3152.2,-547824,-547145.6,26.675182513226396,39.44034944064529,36.364369328151085,NaN,NaN,50
1683829800,1.09151,1.09187,1.09141,1.09186,1541,3087.75,-546283,-547551,26.097694747547383,42.23257554044783,36.830964933050105,NaN,NaN,50
1683831600,1.09186,1.09216,1.09172,1.09194,1106,3027.05,-545177,-547367,25.211549608195526,42.88084508796891,37.37425741718687,NaN,NaN,50
1683833400,1.09194,1.0921,1.09162,1.09171,789,2978.9,-545966,-546936.4,24.48183936461585,41.440969221860854,37.66401197768709,NaN,NaN,50
1683835200,1.09171,1.09177,1.09152,1.09154,661,2911.6,-546627,-546375.4,23.901457680971884,40.362166689770326,38.40053280239534,NaN,NaN,50
1683837000,1.09154,1.0917,1.09152,1.09158,369,2830.25,-546258,-546062.2,23.362531831873916,40.752984444059486,39.58069013543862,NaN,NaN,50
1683838800,1.09158,1.09212,1.09156,1.09168,143,2624.95,-546115,-546028.6,22.260856562400193,41.78016802276291,40.390954812905285,NaN,NaN,50
1683840600,1.09168,1.09182,1.09162,1.09172,244,2485.7,-545871,-546167.4,21.237872383603165,42.211752472446705,40.75243346013242,NaN,NaN,50
1683842400,1.09172,1.09189,1.09158,1.09162,338,2289.95,-546209,-546216,20.1816357350662,41.38577048311872,41.044087210765106,NaN,NaN,50
1683844200,1.09162,1.09174,1.09147,1.09166,489,2015,-545720,-546034.6,19.35323200802874,41.87570671192797,41.43818396355655,NaN,NaN,50
1683846000,1.09166,1.09176,1.09146,1.09166,397,1772.2,-545720,-545927,18.54952048923711,41.87570671192797,41.21165457751969,NaN,NaN,50
1683847800,1.09166,1.09168,1.09114,1.09124,545,1514.15,-546265,-545957,18.270257810539476,38.007057046667754,40.78445913199135,NaN,NaN,50
1683849600,1.09124,1.09189,1.09124,1.0918,1002,1339.15,-545263,-545835.4,17.618904314978835,45.267541944188295,41.22239114307816,NaN,NaN,50
1683851400,1.0918,1.09216,1.09172,1.09216,1100,1178.4,-544163,-545426.2,16.529373418376377,49.37250251913698,42.063292595495064,NaN,NaN,50
1683853200,1.09216,1.09225,1.09176,1.09179,1468,1088.7,-545631,-545408.4,15.35804967349092,45.58808299469297,42.50241642078418,NaN,NaN,50
1683855000,1.09179,1.09243,1.09173,1.09243,1356,1031.3,-544275,-545119.4,14.572883314809657,52.38649142495203,43.22769612682019,NaN,NaN,50
1683856800,1.09243,1.09254,1.09222,1.09244,1373,985.25,-542902,-544446.8,14.039889586300127,52.48638464487876,43.9138060951709,NaN,NaN,50
1683858600,1.09244,1.09244,1.09178,1.09186,1037,945.05,-543939,-544182,13.371062926995291,46.40523760439115,44.268396693923066,NaN,NaN,50
1683860400,1.09186,1.09202,1.09152,1.09199,1028,895.35,-542911,-543931.6,13.195626882433848,47.86332063313126,44.80419340416313,NaN,NaN,50
1683862200,1.09199,1.09226,1.09176,1.09224,931,876.25,-541980,-543201.4,12.548772569911481,50.64418357783667,45.510707628004354,NaN,NaN,50
1683864000,1.09224,1.09256,1.09218,1.0924,977,844.7,-541003,-542547,11.921939686161778,52.39427236754219,46.26885793834573,NaN,NaN,50
1683865800,1.0924,1.0927,1.09232,1.09264,1085,821.9,-539918,-541950.2,11.592692491747577,54.973366326167586,47.18040178504009,NaN,NaN,50
1683867600,1.09264,1.09282,1.09218,1.09282,1108,822,-538810,-540924.4,10.994907572111957,56.86102607124356,48.285777184191865,NaN,NaN,50
1683869400,1.09282,1.09306,1.09238,1.09242,1127,838.9,-539937,-540329.6,10.894107787432617,51.676386797709725,48.985825761747705,NaN,NaN,50
1683871200,1.09242,1.09292,1.09196,1.09268,2175,914.6,-537762,-539486,10.294025941382671,54.57566864360243,49.892965899724445,NaN,NaN,50
1683873000,1.09268,1.09345,1.09248,1.0929,2179,1005.1,-535583,-538402,10.334276126969907,56.930371849974584,51.24463124281779,NaN,NaN,50
1683874800,1.0929,1.09356,1.09267,1.0929,3165,1156.2,-535583,-537535,10.551786150814955,56.93037184997458,52.07769052180252,NaN,NaN,50
1683876600,1.0929,1.09334,1.09062,1.09076,2805,1284.25,-538388,-537450.6,11.775370486624386,35.922726319430964,51.11699222182352,NaN,NaN,50
1683878400,1.09076,1.09133,1.09045,1.09109,2678,1401.25,-535710,-536605.2,13.073391403694359,39.62264592225523,50.690889573792255,NaN,NaN,50
1683880200,1.09109,1.09142,1.0908,1.09137,1845,1469.05,-533865,-535825.8,14.115810122629952,42.648591579582835,49.995325299123024,NaN,NaN,50
1683882000,1.09137,1.09174,1.0899,1.09085,2064,1552.4,-535929,-535895,15.90499010028284,38.76318479168382,49.01509673818053,NaN,NaN,50
1683883800,1.09085,1.0911,1.09028,1.0911,1954,1622.85,-533975,-535573.4,17.56637150810338,41.52153323478556,48.666260711780126,NaN,NaN,50
1683885600,1.0911,1.09148,1.09088,1.09116,1416,1643.55,-532559,-534407.6,18.391269689511734,42.19451225554352,48.26134582766672,NaN,NaN,50
1683887400,1.09116,1.09136,1.09052,1.09054,1326,1654.85,-533885,-534042.6,19.50467810399486,37.40432498214485,47.31564164226016,NaN,NaN,50
1683889200,1.09054,1.09058,1.089,1.08906,1751,1669,-535636,-534396.8,21.660021504763623,28.95420499613509,45.641351115731084,NaN,NaN,50
1683891000,1.08906,1.08966,1.08892,1.0892,2004,1701.4,-533632,-533937.4,23.709215840415222,30.552470257690217,43.897001396554124,NaN,NaN,50
1683892800,1.0892,1.08952,1.08867,1.08885,2479,1756.7,-536111,-534364.6,25.763977795217397,28.807679127437623,41.893190900567994,NaN,NaN,50
1683894600,1.08885,1.08899,1.08813,1.0887,2699,1839.8,-538810,-535614.8,27.979604476514847,28.067878656879728,40.20686889050871,NaN,NaN,50
1683896400,1.0887,1.08945,1.08832,1.08894,3068,1941.8,-535742,-535986.2,29.177398682140936,31.11598053814936,38.53117688297635,NaN,NaN,50
1683898200,1.08894,1.08918,1.08791,1.0889,3384,2064.45,-539126,-536684.2,30.560446134468215,30.881107636650796,36.670515153453216,NaN,NaN,50
1683900000,1.0889,1.08974,1.08766,1.08812,4846,2257.9,-543972,-538752.2,30.87197214493133,26.65578233888948,34.50804447408999,NaN,NaN,50
1683901800,1.08812,1.08814,1.08616,1.08624,4688,2438.05,-548660,-541262,32.1334714222738,19.669946339619287,33.347131618389156,NaN,NaN,50
1683903600,1.08624,1.0865,1.08564,1.08612,3324,2548.85,-551984,-543896.8,33.571123127684785,19.321862374921153,31.89707565072244,NaN,NaN,50
1683905400,1.08612,1.08634,1.08542,1.08558,1990,2592,-553974,-547543.2,35.01501777142846,17.795724687479733,30.12187087271508,NaN,NaN,50
1683907200,1.08558,1.0857,1.08512,1.08516,1657,2566.1,-555631,-550844.2,36.50369796300074,16.691445479733247,28.545318064718607,NaN,NaN,50
1683909000,1.08516,1.08538,1.08486,1.08518,1543,2534.3,-554088,-552867.4,38.01262287415083,16.955709710292027,26.790616384397644,NaN,NaN,50
1683910800,1.08518,1.08569,1.08504,1.08565,1618,2456.95,-552470,-553629.4,38.86184863326671,23.12698926801454,25.428650456717005,NaN,NaN,50
1683912600,1.08565,1.08565,1.08522,1.08547,1094,2371.4,-553564,-553945.4,39.65041540958861,22.439235728907207,24.35971551005718,NaN,NaN,50
1683914400,1.08547,1.08547,1.08492,1.08493,1437,2309.35,-555001,-554150.8,40.569264637831886,20.472315945757543,23.753866292173065,NaN,NaN,50
1683916200,1.08493,1.08538,1.08488,1.08532,1501,2292.15,-553500,-553724.6,41.44769079370104,25.548174034798905,23.396416561966543,NaN,NaN,50
1683918000,1.08532,1.08552,1.08514,1.08514,1310,2254.45,-554810,-553869,41.965821362374065,24.76261255394823,23.107483235288733,NaN,NaN,50
1683919800,1.08514,1.08542,1.08507,1.08516,1136,2213.55,-553674,-554109.8,42.4999308760401,25.038416983853736,22.891093115786877,NaN,NaN,50
1683921600,1.08516,1.08522,1.0848,1.08501,620,2173.75,-554294,-554255.8,43.200519840389525,24.31839076615718,22.40555098921601,NaN,NaN,50
1683923400,1.08501,1.08515,1.08488,1.08498,583,2136.6,-554877,-554231,43.85106673585684,24.168695066701773,21.926092948505364,NaN,NaN,50
1684098000,1.08498,1.08558,1.08498,1.08553,121,2055.1,-554756,-554482.2,43.424383101932825,32.386132185640264,22.335403651844704,NaN,NaN,50
1684099800,1.08553,1.0856,1.08544,1.08545,76,1958.7,-554832,-554486.6,42.98165909184233,31.8455660766262,23.205090775916627,NaN,NaN,50
1684101600,1.08545,1.08545,1.08457,1.08514,756,1872.55,-555588,-554869.4,43.382949062454365,29.771838180827928,23.95151761919568,NaN,NaN,50
1684103400,1.08514,1.08534,1.08499,1.08499,589,1767.05,-556177,-555246,43.75557546373696,28.794757403584555,24.737162813203167,NaN,NaN,50
1684105200,1.08499,1.08524,1.0848,1.08518,498,1638.55,-555679,-555406.4,44.2626762550073,31.845908921883776,25.819624487642493,NaN,NaN,50
1684107000,1.08518,1.08534,1.08497,1.0853,457,1492.2,-555222,-555499.6,44.47208255236587,33.776007509080685,27.02107433041311,NaN,NaN,50
1684108800,1.0853,1.08558,1.08498,1.08508,958,1297.8,-556180,-555769.2,44.046039056562805,31.98748747396094,27.65396705940928,NaN,NaN,50
1684110600,1.08508,1.08537,1.08482,1.08532,1305,1128.65,-554875,-555626.6,43.82896852979486,35.97073467801765,28.62050269863146,NaN,NaN,50
1684112400,1.08532,1.0861,1.08525,1.08598,1397,1032.3,-553478,-555086.8,41.950673170505105,45.43487132088579,30.40354236828347,NaN,NaN,50
1684114200,1.08598,1.08644,1.0858,1.08633,1618,1013.7,-551860,-554323,39.559558648429416,49.68235376852221,32.12741234926371,NaN,NaN,50
1684116000,1.08633,1.08634,1.08552,1.08574,1250,993.35,-553110,-553900.6,37.757476723775234,43.530838671114914,33.46799992906133,NaN,NaN,50
1684117800,1.08574,1.08586,1.08553,1.08554,1016,967,-554126,-553489.8,36.08411493659635,41.64831670711792,34.65442133786591,NaN,NaN,50
1684119600,1.08554,1.08609,1.08548,1.08606,1042,938.2,-553084,-553131.6,34.061150207068934,47.95084407070091,36.342453716761895,NaN,NaN,50
1684121400,1.08606,1.08622,1.08584,1.08599,960,931.5,-554044,-553244.8,31.922623830903284,47.211597318632144,37.988375306185496,NaN,NaN,50
1684123200,1.08599,1.0862,1.08573,1.08615,709,895.1,-553335,-553539.8,30.141394441389203,49.141619590368016,39.185195835094625,NaN,NaN,50
1684125000,1.08615,1.08636,1.08584,1.08631,547,847.4,-552788,-553475.4,28.145850613713097,51.068253501717294,40.558244936886844,NaN,NaN,50
1684126800,1.08631,1.08674,1.08618,1.08664,1045,834.15,-551743,-552998.8,26.726932390526652,54.86594488961678,42.35068113037176,NaN,NaN,50
1684128600,1.08664,1.08692,1.08644,1.08676,1307,842.7,-550436,-552469.2,25.735160455202106,56.197264042330865,44.30800303313936,NaN,NaN,50
1684130400,1.08676,1.08722,1.08652,1.08654,2052,914.3,-552488,-552158,25.324375296559293,53.10457752273532,45.826479361771604,NaN,NaN,50
1684132200,1.08654,1.08704,1.08602,1.08698,1792,974.75,-550696,-551630.2,23.84404750618038,58.074132150885475,47.5620596933291,NaN,NaN,50
1684134000,1.08698,1.08722,1.08648,1.08721,2631,1100.25,-548065,-550685.6,22.792154687088484,60.434417051135924,49.59398323455588,NaN,NaN,50
1684135800,1.08721,1.08771,1.08709,1.0874,2146,1203.75,-545919,-549520.8,22.606759580718773,62.321481088660136,51.47617940674463,NaN,NaN,50
1684137600,1.0874,1.08802,1.08713,1.0875,2208,1276.35,-543711,-548175.8,22.871742282257657,63.31324755745663,52.7532062807854,NaN,NaN,50
1684139400,1.0875,1.08783,1.0866,1.08686,1969,1345.35,-545680,-546814.2,22.00146537029913,53.590896900385346,53.03238793306134,NaN,NaN,50
1684141200,1.08686,1.08686,1.08556,1.086,2290,1434.95,-547970,-546269,21.30522420184846,43.84723762365601,53.054987858242846,NaN,NaN,50
1684143000,1.086,1.08698,1.08599,1.0869,1460,1485.1,-546510,-545958,20.457391520371356,53.396655349819554,53.894154904150106,NaN,NaN,50
1684144800,1.0869,1.0874,1.08667,1.08738,1597,1517.05,-544913,-545756.8,18.998000805434884,57.54363570431137,54.579354306550854,NaN,NaN,50
1684146600,1.08738,1.08792,1.08718,1.0878,1305,1517.05,-543608,-545736.2,18.38095470799224,60.8282236462901,55.55197047281214,NaN,NaN,50
1684148400,1.0878,1.0879,1.08736,1.08772,1368,1515.6,-544976,-545595.4,17.80798333179551,59.877989391650736,56.318854030046616,NaN,NaN,50
1684150200,1.08772,1.08806,1.08736,1.08777,2027,1536.05,-542949,-544591.2,17.50370497727661,60.29546429288466,56.977940515129994,NaN,NaN,50
1684152000,1.08777,1.08796,1.0874,1.0877,1720,1559.55,-544669,-544223,17.22116079093763,59.36417451844804,57.29924263147508,NaN,NaN,50
1684153800,1.0877,1.0891,1.08736,1.08791,4106,1714.05,-540563,-543353,18.361604465756905,61.295551335959985,57.66340600959145,NaN,NaN,50
1684155600,1.08791,1.08813,1.08739,1.08791,2419,1782.9,-540563,-542744,19.42058787808909,61.295551335959985,58.248475567678916,NaN,NaN,50
1684157400,1.08791,1.0882,1.08727,1.08794,3084,1889.1,-537479,-541244.6,20.147214434789124,61.59795262183685,58.50017702988974,NaN,NaN,50
1684159200,1.08794,1.08818,1.08676,1.08728,2946,2000.95,-540425,-540739.8,19.804357505274826,51.976565460419856,57.89604477341002,NaN,NaN,50
1684161000,1.08728,1.08768,1.08646,1.08648,3085,2127.85,-543510,-540508,18.94958600479338,43.17374455987214,56.52834930706802,NaN,NaN,50
1684162800,1.08648,1.0874,1.0864,1.08704,2220,2186.6,-541290,-540653.4,18.04935179321952,49.6074785443527,55.54936580613202,NaN,NaN,50
1684164600,1.08704,1.08753,1.08695,1.08733,1872,2214.85,-539418,-540424.4,17.42252382320866,52.600322683836424,55.47861050494996,NaN,NaN,50
1684166400,1.08733,1.0875,1.08677,1.08708,1387,2181.6,-540805,-541089.6,16.49286759915747,49.85164270664914,55.907496582306614,NaN,NaN,50
1684168200,1.08708,1.0879,1.0869,1.0879,1271,2155.55,-539534,-540911.4,16.287244172714594,57.66585324882095,56.21243928937814,NaN,NaN,50
1684170000,1.0879,1.0879,1.08754,1.08778,1198,2083.9,-540732,-540355.8,16.09630813387478,56.283678521184,56.122442347726185,NaN,NaN,50
1684171800,1.08778,1.08786,1.08747,1.08762,1082,2030.7,-541814,-540460.6,15.763417912993802,54.4110370004367,55.66407187302237,NaN,NaN,50
1684173600,1.08762,1.08782,1.08751,1.08754,950,1967.8,-542764,-541129.8,15.454305565032895,53.45339722888886,55.20517243282509,NaN,NaN,50
1684175400,1.08754,1.0877,1.08737,1.08743,897,1914.2,-543661,-541701,14.828363130069796,52.0956954321944,54.6194746570615,NaN,NaN,50
1684177200,1.08743,1.08764,1.08737,1.08756,948,1847.1,-542713,-542336.8,14.247130869032636,53.595800627968025,54.20744795059865,NaN,NaN,50
1684179000,1.08756,1.0877,1.08746,1.08752,1098,1829,-543811,-542952.6,13.845542447580861,53.045378292465266,53.618149876063306,NaN,NaN,50
1684180800,1.08752,1.08765,1.0873,1.08734,733,1785.8,-544544,-543498.6,13.0367946068834,50.53050492936601,52.84921798987802,NaN,NaN,50
1684182600,1.08734,1.08747,1.08732,1.08745,363,1738.7,-544181,-543782,12.285814469092902,52.027317551248856,52.16560119912174,NaN,NaN,50
1684184400,1.08745,1.0876,1.08736,1.08748,109,1675.75,-544072,-543864.2,11.938498326411485,52.44988378892786,52.19940965115803,NaN,NaN,50
1684186200,1.08748,1.0876,1.08739,1.08752,210,1584.9,-543862,-544094,11.615990479635881,53.043789163456694,52.90441283712835,NaN,NaN,50
1684188000,1.08752,1.0877,1.08746,1.08766,372,1517.5,-543490,-544029.8,11.60035535304403,55.15500381830251,53.300664642410474,NaN,NaN,50
1684189800,1.08766,1.08773,1.08751,1.08762,479,1336.15,-543969,-543914.8,11.672401460707933,54.402386959958186,53.429383519276314,NaN,NaN,50
1684191600,1.08762,1.08762,1.08744,1.08748,382,1234.3,-544351,-543948.8,11.472031435803713,51.74118332659811,53.56435070641552,NaN,NaN,50
1684193400,1.08748,1.08753,1.08732,1.08736,324,1096.3,-544675,-544069.4,10.836518898945407,49.50578954983588,52.98148901363088,NaN,NaN,50
1684195200,1.08736,1.088,1.08736,1.08794,911,994.55,-543764,-544049.8,11.610397722670672,58.77616812500373,53.159523985332285,NaN,NaN,50
1684197000,1.08794,1.08822,1.08776,1.0882,838,882.2,-542926,-543937,12.832100153899134,62.13241238830597,53.71105079875152,NaN,NaN,50
1684198800,1.0882,1.0882,1.08782,1.0879,1063,824.35,-543989,-543941,13.966538125754136,56.42416324784222,53.92324837153391,NaN,NaN,50
1684200600,1.0879,1.08793,1.08752,1.08776,1121,786.8,-545110,-544092.8,13.875274999782693,53.93393982126621,54.0545515421819,NaN,NaN,50
1684202400,1.08776,1.08776,1.08683,1.08762,1520,793.45,-546630,-544483.8,13.875029513460783,51.48682696680358,53.90391056638443,NaN,NaN,50
1684204200,1.08762,1.08837,1.08757,1.08836,943,777.05,-545687,-544868.4,13.383804891624429,61.444658484206386,54.5038591515088,NaN,NaN,50
1684206000,1.08836,1.08847,1.08798,1.08804,663,750.3,-546350,-545553.2,13.135872426060574,56.08367466548968,54.9005141326605,NaN,NaN,50
1684207800,1.08804,1.08838,1.08804,1.08826,566,724.5,-545784,-545912.2,12.90564942232271,58.74843512570081,55.380593959407065,NaN,NaN,50
1684209600,1.08826,1.08828,1.088,1.0881,613,707.65,-546397,-546169.6,12.579357049313447,56.083133068290344,55.64011176507581,NaN,NaN,50
1684211400,1.0881,1.08836,1.08808,1.0883,647,695.15,-545750,-545993.6,12.472418757474804,58.61086589644803,56.037760103146624,NaN,NaN,50
1684213200,1.0883,1.0883,1.08774,1.08794,767,686.1,-546517,-546159.6,11.746277960012923,52.72788596351212,55.86439454209017,NaN,NaN,50
1684215000,1.08794,1.08794,1.08702,1.08712,1406,701.5,-547923,-546474.2,12.576539219039432,42.31041017022769,55.00068191425227,NaN,NaN,50
1684216800,1.08712,1.0873,1.08629,1.08654,2709,800.3,-550632,-547443.8,14.390525883601851,36.77584367314826,53.931729081863,NaN,NaN,50
1684218600,1.08654,1.0877,1.08651,1.08764,2259,895.1,-548373,-547839,15.078775133495977,50.105971645120604,53.97459923152619,NaN,NaN,50
1684220400,1.08764,1.08834,1.0872,1.08777,3042,1041.75,-545331,-547755.2,14.40376915416941,51.409843539542535,53.448433189707536,NaN,NaN,50
1684222200,1.08777,1.08946,1.0877,1.08886,2733,1167.9,-542598,-546971.4,14.621269545827678,60.686576380503624,53.34515918915023,NaN,NaN,50
1684224000,1.08886,1.08965,1.08877,1.08956,2275,1263.05,-540323,-545451.4,15.049555010691954,65.27203065450348,53.97714971819745,NaN,NaN,50
1684225800,1.08956,1.08978,1.08896,1.08914,2164,1347.3,-542487,-543822.4,15.60320010471698,60.697483385073554,54.460259972755125,NaN,NaN,50
1684227600,1.08914,1.09048,1.08892,1.08986,2341,1445.25,-540146,-542177,16.875789533053933,65.20011754541532,55.439780728370245,NaN,NaN,50
1684229400,1.08986,1.09006,1.08937,1.08938,1678,1512.95,-541824,-541475.6,18.05747971650967,60.24492858817646,55.35408573579668,NaN,NaN,50
1684231200,1.08938,1.08958,1.08902,1.08934,1343,1534.55,-543167,-541589.4,18.45077420933685,59.83681248673969,55.62216700874311,NaN,NaN,50
1684233000,1.08934,1.08972,1.08918,1.08952,1299,1557.6,-541868,-541898.4,18.984354963948896,61.113427929111715,55.79109506612959,NaN,NaN,50
1684234800,1.08952,1.08974,1.08922,1.08962,1699,1589.4,-540169,-541434.8,19.504809779544715,61.839136565451696,56.202238173069695,NaN,NaN,50
1684236600,1.08962,1.08964,1.08852,1.0887,1738,1620.25,-541907,-541787,18.625291906839745,52.18936272382072,55.743559375024894,NaN,NaN,50
1684238400,1.0887,1.08874,1.0878,1.08806,2184,1653.45,-544091,-542240.4,17.87897257175323,46.726798295305336,55.31491025586727,NaN,NaN,50
1684240200,1.08806,1.089,1.08682,1.08817,5285,1870.55,-538806,-541368.2,18.32497303104244,47.73928040585791,55.70268670126943,NaN,NaN,50
1684242000,1.08817,1.08892,1.08744,1.08754,3695,2022.15,-542501,-541494.8,18.739116314668138,42.73032357189107,56.12800669403678,NaN,NaN,50
1684243800,1.08754,1.08891,1.08737,1.08751,4379,2212.8,-546880,-542837,19.20054211248085,42.50163605581664,55.58483986622935,NaN,NaN,50
1684245600,1.08751,1.08762,1.08598,1.08716,3729,2368.6,-550609,-544577.4,20.872333487493684,39.823820439277604,54.757266787639004,NaN,NaN,50
1684247400,1.08716,1.0873,1.08626,1.08664,3370,2504.75,-553979,-546555,22.42471119286275,36.176899503913305,53.00657558216826,NaN,NaN,50
1684249200,1.08664,1.08681,1.08555,1.08641,2849,2608.85,-556828,-550159.4,24.362881030526108,34.66479689532278,50.82034459936965,NaN,NaN,50
1684251000,1.08641,1.08663,1.0855,1.08648,2674,2672.25,-554154,-552490,26.195412983508014,35.54776053253508,49.02393582418832,NaN,NaN,50
1684252800,1.08648,1.08687,1.0864,1.08662,2036,2638.6,-552118,-553537.6,27.41540647235351,37.370763474776325,47.03612481914268,NaN,NaN,50
1684254600,1.08662,1.08722,1.0864,1.08668,1775,2614.4,-550343,-553484.4,27.873464798530158,38.17781562998799,45.459902464986364,NaN,NaN,50
1684256400,1.08668,1.08682,1.08614,1.08682,1474,2536,-548869,-552462.4,28.535634737651222,40.11687198214625,44.05133528608683,NaN,NaN,50
1684258200,1.08682,1.08712,1.08664,1.0867,1146,2456.65,-550015,-551099.8,28.57633588774932,38.988075172994115,42.47095294636414,NaN,NaN,50
1684260000,1.0867,1.08687,1.08644,1.08684,1137,2399.75,-548878,-550044.6,28.818618679147118,41.0713505063938,40.98753965643143,NaN,NaN,50
1684261800,1.08684,1.08703,1.0867,1.08678,1073,2345.2,-549951,-549611.2,28.726676245514092,40.43413259578696,40.14788036157188,NaN,NaN,50
1684263600,1.08678,1.08698,1.08672,1.08681,924,2274.35,-549027,-549348,28.64130112856914,40.92763360723137,39.733654312423745,NaN,NaN,50
1684265400,1.08681,1.08684,1.08581,1.0863,1506,2265.75,-550533,-549680.8,29.501598315964124,35.53737581023631,38.86208969845078,NaN,NaN,50
1684267200,1.0863,1.08646,1.08606,1.08621,938,2245.5,-551471,-549972,30.30044570425946,34.66961713543357,38.286324952989524,NaN,NaN,50
1684269000,1.08621,1.08632,1.08613,1.0862,606,2210.85,-552077,-550611.8,31.042232564819415,34.568613328840314,37.71968047249122,NaN,NaN,50
1684270800,1.0862,1.08648,1.0862,1.08643,110,2131.4,-551967,-551015,31.345833022642942,38.97241166800044,37.658865560257134,NaN,NaN,50
1684272600,1.08643,1.08643,1.08614,1.08625,259,2057.45,-552226,-551654.8,31.698206814697073,36.88039010005219,37.70911488855277,NaN,NaN,50
1684274400,1.08625,1.0864,1.08617,1.08628,338,1965.15,-551888,-551925.8,32.025411050175904,37.48273093656006,37.91039589149828,NaN,NaN,50
1684276200,1.08628,1.08631,1.08616,1.08625,268,1714.3,-552156,-552062.8,32.34261584192774,37.101442634043046,38.02137318446314,NaN,NaN,50
1684278000,1.08625,1.08646,1.08607,1.08645,372,1548.15,-551784,-552004.2,32.195503807817786,41.38242582297929,38.30792049504906,NaN,NaN,50
1684279800,1.08645,1.08656,1.08634,1.08654,397,1349.05,-551387,-551888.2,31.765715453846692,43.254117834709405,38.67051350967201,NaN,NaN,50
1684281600,1.08654,1.08685,1.08639,1.08682,1218,1223.5,-550169,-551476.8,30.559274010341795,48.738161777914826,39.28631992365548,NaN,NaN,50
1684283400,1.08682,1.0872,1.08668,1.08706,1240,1117,-548929,-550885,28.58329214753466,52.93659999555551,40.28264312526701,NaN,NaN,50
1684285200,1.08706,1.08712,1.08673,1.08706,1342,1041.65,-548929,-550239.6,26.748451846356602,52.93659999555551,41.13016094592142,NaN,NaN,50
1684287000,1.08706,1.08707,1.08622,1.087,1837,999.8,-550766,-550036,26.083913835318278,51.70869009078005,41.93548648127807,NaN,NaN,50
1684288800,1.087,1.08738,1.08684,1.08713,982,947.1,-549784,-549715.4,24.717545978197553,54.188193238447695,42.88266931207924,NaN,NaN,50
1684290600,1.08713,1.08736,1.08688,1.08698,2141,965.4,-551925,-550066.6,23.44877582515688,50.93827453015772,43.98273350635934,NaN,NaN,50
1684292400,1.08698,1.08714,1.08672,1.08678,873,935.35,-552798,-550840.4,22.607935778662995,46.89941565285458,44.85629054331798,NaN,NaN,50
1684294200,1.08678,1.0868,1.08647,1.08656,588,907.45,-553386,-551731.8,22.323537031355187,42.87251616009412,45.44942645983611,NaN,NaN,50
1684296000,1.08656,1.08668,1.08632,1.08661,741,887.65,-552645,-552107.6,22.34065861006439,44.048356122717976,45.81199392088736,NaN,NaN,50
1684297800,1.08661,1.08677,1.0864,1.08648,657,866.85,-553302,-552811.2,22.09117702299177,41.64810648611011,46.15254509132007,NaN,NaN,50
1684299600,1.08648,1.08653,1.08596,1.08602,944,867.85,-554246,-553275.4,22.657317025817232,34.486984224548465,45.93856318331924,NaN,NaN,50
1684301400,1.08602,1.08628,1.08525,1.08532,1673,876.2,-555919,-553899.6,24.147835594417284,26.905533359507245,45.21028394942383,NaN,NaN,50
1684303200,1.08532,1.08612,1.08502,1.08602,1898,924.2,-554021,-554026.6,25.786376108665255,40.89773133775536,45.17566291476498,NaN,NaN,50
1684305000,1.08602,1.08646,1.08518,1.08538,1758,981.8,-555779,-554653.4,26.349018000766637,34.41176103704473,44.54406600064607,NaN,NaN,50
1684306800,1.08538,1.08638,1.0839,1.08442,3297,1141.15,-559076,-555808.2,28.151213322812886,27.393889938444957,43.019475154969655,NaN,NaN,50
1684308600,1.08442,1.08464,1.08313,1.08319,3046,1280.5,-562122,-557383.4,30.339713157608944,21.378170355026725,40.765301609217595,NaN,NaN,50
1684310400,1.08319,1.0844,1.08316,1.08434,2592,1393.2,-559530,-558105.6,32.37189157563386,35.61453561324241,39.52801129619523,NaN,NaN,50
1684312200,1.08434,1.08482,1.08272,1.08292,2480,1503.8,-562010,-559703.4,34.52331650017159,28.703206444402227,37.8847624643111,NaN,NaN,50
1684314000,1.08292,1.08292,1.08206,1.08274,2456,1608,-564466,-561440.8,36.86055483870952,27.962445151078768,36.01149474378475,NaN,NaN,50
1684315800,1.08274,1.08326,1.0826,1.0831,1854,1680.85,-562612,-562148,38.24621922859532,31.75583990122763,34.64132084171832,NaN,NaN,50
1684317600,1.0831,1.08328,1.0827,1.08306,1725,1706.2,-564337,-562591,39.48665972660251,31.55699844369535,33.545433898206944,NaN,NaN,50
1684319400,1.08306,1.08318,1.08246,1.08302,1666,1727.5,-566003,-563885.6,40.799642733003864,31.34562764530527,32.72208471857917,NaN,NaN,50
1684321200,1.08302,1.08392,1.08274,1.08379,1832,1752,-564171,-564317.8,40.39056401732413,39.71637232517651,32.41265730446906,NaN,NaN,50
1684323000,1.08379,1.08417,1.0825,1.08252,2212,1770.75,-566383,-564701.2,39.529138665398136,32.64625069999832,31.769667605461077,NaN,NaN,50
1684324800,1.08252,1.08318,1.08246,1.08268,2258,1834.55,-564125,-565003.8,38.772896128747405,34.234634663104316,31.751642636786492,NaN,NaN,50
1684326600,1.08268,1.08314,1.08134,1.0824,3153,1885.15,-567278,-565592,39.10880463953403,32.777845014066,32.17109346925498,NaN,NaN,50
1684328400,1.0824,1.0839,1.08238,1.08308,3348,2008.9,-563930,-565177.4,38.08811797241049,39.50994689624315,32.07196600914697,NaN,NaN,50
1684330200,1.08308,1.08312,1.0815,1.08156,3483,2153.65,-567413,-565825.8,37.889580399744936,31.83518393307594,31.88792478743491,NaN,NaN,50
1684332000,1.08156,1.08302,1.08102,1.08297,3681,2300.65,-563732,-565295.6,38.055246153597224,42.91303853889705,32.99643540175291,NaN,NaN,50
1684333800,1.08297,1.0833,1.08197,1.08207,3396,2437.6,-567128,-565896.2,37.75415737002285,38.60082677005157,34.22662514568326,NaN,NaN,50
1684335600,1.08207,1.083,1.08178,1.08276,3095,2545.15,-564033,-565247.2,37.62640374568713,43.304635264821236,34.775917977938896,NaN,NaN,50
1684337400,1.08276,1.08363,1.08262,1.08294,2556,2589.3,-561477,-564756.6,36.50825499732523,44.49915896508178,35.90420030084458,NaN,NaN,50
1684339200,1.08294,1.08348,1.0829,1.08338,1665,2577.65,-559812,-563236.4,35.469974016703475,47.41570049545454,37.29371853972856,NaN,NaN,50
1684341000,1.08338,1.08454,1.08334,1.0842,1752,2577.35,-558060,-562102,33.048795475943756,52.43247953938596,38.770621371025584,NaN,NaN,50
1684342800,1.0842,1.08479,1.08417,1.08444,1690,2497,-556370,-559950.4,30.871406238098515,53.82113407386161,40.360916773180314,NaN,NaN,50
1684344600,1.08444,1.08492,1.08418,1.0844,1367,2413.05,-557737,-558691.2,29.004808962965097,53.54059052089477,41.94627126429385,NaN,NaN,50
1684346400,1.0844,1.08456,1.08372,1.08392,1877,2377.3,-559614,-558318.6,27.180713227450642,50.16161614668468,42.69236010868729,NaN,NaN,50
1684348200,1.08392,1.08407,1.08364,1.08376,1442,2325.4,-561056,-558567.4,25.586630845190424,49.050377031759176,43.86408341809878,NaN,NaN,50
1684350000,1.08376,1.0843,1.0837,1.08406,1322,2268.7,-559734,-558902.2,23.785389146589946,51.23189038802699,45.07817311273611,NaN,NaN,50
1684351800,1.08406,1.08418,1.08392,1.08399,1198,2235.9,-560932,-559814.6,22.112807569318075,50.68654572712314,46.357366020811625,NaN,NaN,50
1684353600,1.08399,1.08402,1.0837,1.08372,634,2181.35,-561566,-560580.4,20.882691021694207,48.540280574000924,47.00238985493718,NaN,NaN,50
1684355400,1.08372,1.0839,1.0837,1.0839,413,2118.7,-561153,-560888.2,19.74043994175776,50.05853780113415,48.304057988369905,NaN,NaN,50
1684357200,1.0839,1.0842,1.0839,1.0842,84,2031.3,-561069,-560890.8,18.482807860354264,52.57020790948849,48.99385580055501,NaN,NaN,50
1684359000,1.0842,1.08466,1.08403,1.08403,165,1928.95,-561234,-561190.8,18.01109798935402,51.00480972697396,49.87985458319232,NaN,NaN,50
1684360800,1.08403,1.08426,1.08398,1.08405,401,1836.1,-560833,-561171,17.481006081238053,51.18895855628528,50.443020532582615,NaN,NaN,50
1684362600,1.08405,1.08421,1.08383,1.08386,278,1692.35,-561111,-561080,16.705283329720384,49.293503510283756,50.78547371438275,NaN,NaN,50
1684364400,1.08386,1.08386,1.08354,1.08354,397,1544.8,-561508,-561151,15.568629694575481,46.19124540769461,50.69801263668562,NaN,NaN,50
1684366200,1.08354,1.08386,1.08349,1.08381,336,1387.45,-561172,-561171.6,14.603480004756966,49.1018848497096,50.460113015994445,NaN,NaN,50
1684368000,1.08381,1.08391,1.0835,1.0838,925,1249.65,-562097,-561344.2,13.608569823356994,48.99617424445165,50.11547302817945,NaN,NaN,50
1684369800,1.0838,1.08434,1.08374,1.08423,1241,1141.9,-560856,-561348.8,13.389593153982881,53.6200272968008,50.121147083601315,NaN,NaN,50
1684371600,1.08423,1.0848,1.0838,1.0847,1351,1054.7,-559505,-561027.6,13.913185135357766,58.0921223263819,50.687611810722544,NaN,NaN,50
1684373400,1.0847,1.0847,1.08406,1.08452,2331,1043.45,-561836,-561093.2,14.399377689491585,55.870243208873994,51.17474510908789,NaN,NaN,50
1684375200,1.08452,1.08482,1.08438,1.0845,1211,1020.75,-563047,-561468.2,15.039266485626671,55.61571093860012,51.487875148414545,NaN,NaN,50
1684377000,1.0845,1.08472,1.08438,1.08462,1000,983.15,-562047,-561458.2,15.633448939180678,56.88490369139665,51.93061500300551,NaN,NaN,50
1684378800,1.08462,1.08474,1.0841,1.08418,908,944.05,-562955,-561878,15.45733951711807,51.11339734387536,52.11440905799653,NaN,NaN,50
1684380600,1.08418,1.08422,1.08377,1.08398,704,910.9,-563659,-562708.8,14.526733553136584,48.69494235408313,52.01700938320717,NaN,NaN,50
1684382400,1.08398,1.08405,1.08353,1.08376,770,855.55,-564429,-563227.4,13.821775867289098,46.110423298019995,51.555596196673704,NaN,NaN,50
1684384200,1.08376,1.08385,1.08327,1.0833,603,813.6,-565032,-563624.4,13.675783815277406,41.187924438835054,50.85439010466378,NaN,NaN,50
1684386000,1.0833,1.08341,1.08298,1.0832,1143,804.65,-566175,-564450,14.0589900514613,40.183626671795295,50.06829497005735,NaN,NaN,50
1684387800,1.0832,1.0836,1.08269,1.08302,1380,813.75,-567555,-565370,14.885756593772898,38.370025187706396,49.28804651844468,NaN,NaN,50
1684389600,1.08302,1.08346,1.0826,1.08326,2046,884.35,-565509,-565740,15.794213808932142,42.1209434104303,48.99731066149723,NaN,NaN,50
1684391400,1.08326,1.08343,1.08234,1.0826,2021,964.75,-567530,-566360.2,17.03159083541477,35.68830795006727,48.039198025808496,NaN,NaN,50
1684393200,1.0826,1.08312,1.08192,1.0821,2415,1081.3,-569945,-567342.8,18.739457948794318,31.73435676949785,46.8062110633118,NaN,NaN,50
1684395000,1.0821,1.08267,1.08091,1.08164,2301,1188.1,-572246,-568557,21.30619597209237,28.59547361211166,45.01874294297686,NaN,NaN,50
1684396800,1.08164,1.08222,1.08129,1.0818,2553,1295.7,-569693,-568984.6,23.68959556515485,31.146519000818444,43.0940569911509,NaN,NaN,50
1684398600,1.0818,1.08207,1.08122,1.08166,2388,1401.2,-572081,-570299,25.96215151434536,30.13210631811272,41.25561864181081,NaN,NaN,50
1684400400,1.08166,1.08194,1.08074,1.0808,1904,1476.55,-573985,-571590,28.45159709546578,24.790766507952526,39.05383689676455,NaN,NaN,50
1684402200,1.0808,1.082,1.0808,1.08181,1783,1548.9,-572202,-572041.4,30.581641195215692,38.56439752761972,37.74522931363764,NaN,NaN,50
1684404000,1.08181,1.08196,1.08083,1.08086,1428,1574.05,-573630,-572318.2,32.55953928784061,32.529831885753424,36.41783178091464,NaN,NaN,50
1684405800,1.08086,1.08164,1.08056,1.08154,1398,1581.9,-572232,-572826,34.62331859660931,39.79225902182874,35.78192582861076,NaN,NaN,50
1684407600,1.08154,1.08157,1.08084,1.08111,1268,1577.75,-573500,-573109.8,36.53968509760882,37.07462489350739,35.13651165685985,NaN,NaN,50
1684409400,1.08111,1.08181,1.08098,1.0815,1728,1547.6,-571772,-572667.2,37.47909060704045,41.00970685171077,35.12378182920812,NaN,NaN,50
1684411200,1.0815,1.0818,1.08094,1.08119,1782,1576.15,-573554,-572937.6,38.397773429136855,38.92594126154603,35.03394715704746,NaN,NaN,50
1684413000,1.08119,1.08125,1.07853,1.07902,5136,1782.95,-578690,-573949.6,40.86744193191523,28.14518857220527,34.30360168451166,NaN,NaN,50
1684414800,1.07902,1.07952,1.0786,1.07874,3750,1925.05,-582440,-575991.2,43.16070554163801,27.10215851818444,33.230831335065524,NaN,NaN,50
1684416600,1.07874,1.07886,1.07752,1.0778,3537,2066.7,-585977,-578486.6,45.659866268787425,23.899985441753316,32.38880829875738,NaN,NaN,50
1684418400,1.0778,1.07866,1.07766,1.07846,3714,2213.9,-582263,-580584.8,47.98051551542616,30.14111681391394,32.275005444787105,NaN,NaN,50
1684420200,1.07846,1.07858,1.0767,1.07694,3091,2338.3,-585354,-582944.8,50.39273780436437,25.04651518970975,32.02150841461554,NaN,NaN,50
1684422000,1.07694,1.07733,1.07633,1.07729,2884,2425.35,-582470,-583700.8,52.7161450204518,28.061741736195813,31.801167181428205,NaN,NaN,50
1684423800,1.07729,1.07785,1.07698,1.07754,2228,2467.75,-580242,-583261.2,53.71892540977111,30.221023714818116,31.80751842405002,NaN,NaN,50
1684425600,1.07754,1.07812,1.07662,1.07668,2344,2482.65,-582586,-582583,54.79686744344633,27.196822181903514,31.979379543617945,NaN,NaN,50
1684427400,1.07668,1.07675,1.07628,1.07631,1537,2458.45,-584123,-582955,55.92959725949219,25.9917182475656,31.081331023614077,NaN,NaN,50
1684429200,1.07631,1.07664,1.07625,1.07662,1855,2430.45,-582268,-582337.8,56.993133639986105,28.83687379141024,30.817548302589564,NaN,NaN,50
1684431000,1.07662,1.07672,1.07632,1.07666,1663,2398.55,-580605,-581964.8,57.78794420707113,29.21501137125648,30.062030613262973,NaN,NaN,50
1684432800,1.07666,1.07684,1.0765,1.07678,948,2318.3,-579657,-581847.8,58.22714828119887,30.409685771006124,29.58596353308431,NaN,NaN,50
1684434600,1.07678,1.0769,1.0764,1.07668,1308,2264.3,-580965,-581523.6,58.69125171716457,29.955958329838467,28.796410067236287,NaN,NaN,50
1684436400,1.07668,1.07688,1.0766,1.07684,1268,2232.5,-579697,-580638.4,59.122204907704145,31.711595414290784,28.2810996495752,NaN,NaN,50
1684438200,1.07684,1.07744,1.07684,1.0774,1213,2204,-578484,-579881.6,58.06047384175068,37.606237634884515,28.956888868338005,NaN,NaN,50
1684440000,1.0774,1.07749,1.07712,1.07714,681,2166.65,-579165,-579593.6,56.95293171110292,36.05030966507455,29.5960425216873,NaN,NaN,50
1684441800,1.07714,1.07736,1.07705,1.07712,598,2126.65,-579763,-579614.8,55.99625805666686,35.92717113766996,30.45512721425277,NaN,NaN,50
1684443600,1.07712,1.07714,1.07686,1.07712,98,2068.15,-579763,-579374.4,55.30398235896005,35.92717113766996,30.868416808806774,NaN,NaN,50
1684445400,1.07712,1.07728,1.07702,1.07706,264,1994.95,-580027,-579440.4,54.272844617835126,35.50521460061691,31.61546676672871,NaN,NaN,50
1684447200,1.07706,1.0776,1.07704,1.07756,403,1926,-579624,-579668.4,52.47215926093234,41.65489517757329,32.586406298255675,NaN,NaN,50
1684449000,1.07756,1.07769,1.07756,1.07765,272,1682.8,-579352,-579705.8,50.57189597747289,42.71374789340606,33.478743739583386,NaN,NaN,50
1684450800,1.07765,1.07767,1.07748,1.07756,458,1518.2,-579810,-579715.2,48.92993292264153,41.89494856943399,34.528609910121276,NaN,NaN,50
1684452600,1.07756,1.07756,1.07737,1.07752,430,1362.85,-580240,-579810.6,47.57667006769662,41.51405197874096,35.63734803377666,NaN,NaN,50
1684454400,1.07752,1.07802,1.07725,1.0778,1470,1250.65,-578770,-579559.2,45.11433883202115,45.26542214372374,36.81081577322762,NaN,NaN,50
1684456200,1.0778,1.07784,1.07732,1.07738,1338,1163,-580108,-579656,42.82788839889392,41.01566523692627,37.65371962077546,NaN,NaN,50
1684458000,1.07738,1.0776,1.07638,1.0765,1715,1104.55,-581823,-580150.2,42.165475460046174,33.84567235538992,37.89914723394573,NaN,NaN,50
1684459800,1.0765,1.07676,1.076,1.07635,1921,1089.2,-583744,-580937,41.99145501994757,32.79335182511167,38.10181819789382,NaN,NaN,50
1684461600,1.07635,1.07648,1.07607,1.07638,1229,1033.45,-582515,-581392,41.829864611284584,33.24041940392256,38.211019911438946,NaN,NaN,50
1684463400,1.07638,1.0774,1.07635,1.07722,1498,1031.5,-581017,-581841.4,39.614382420733705,44.39423531016009,38.69587688824435,NaN,NaN,50
1684465200,1.07722,1.07725,1.07672,1.07695,1147,996.1,-582164,-582252.6,37.55714895807931,41.96713167068007,39.118507031501885,NaN,NaN,50
1684467000,1.07695,1.07716,1.0767,1.07684,822,954.05,-582986,-582485.2,35.679926362074774,40.98404862937172,39.47971256662344,NaN,NaN,50
1684468800,1.07684,1.07694,1.07632,1.07634,765,944.9,-583751,-582486.6,34.54523363009152,36.767936292917604,39.53976722056969,NaN,NaN,50
1684470600,1.07634,1.07637,1.07606,1.07637,827,920.85,-582924,-582568.4,33.87009709125993,37.18547174079099,39.65978558772499,NaN,NaN,50
1684472400,1.07637,1.07653,1.07625,1.07635,845,899.7,-583769,-583118.8,32.868365007828274,37.01001555347156,39.32800847171772,NaN,NaN,50
1684474200,1.07635,1.07712,1.07616,1.07688,1335,905.8,-582434,-583172.8,30.715789295070696,44.48539441905008,39.45455465212087,NaN,NaN,50
1684476000,1.07688,1.0792,1.0767,1.07902,2692,1006.35,-579742,-582524,30.90633025110946,63.38185983821765,40.98933402846256,NaN,NaN,50
1684477800,1.07902,1.07915,1.07802,1.07814,1834,1068.15,-581576,-582089,31.083261138859747,55.07924520151086,41.958276401517544,NaN,NaN,50
1684479600,1.07814,1.07902,1.07776,1.07786,2578,1192.15,-584154,-582335,30.785541777570387,52.713167211123455,42.4902581920461,NaN,NaN,50
1684481400,1.07786,1.07833,1.0774,1.07776,2344,1296.15,-586498,-582880.8,29.897781186867956,51.856385922336415,43.264595383861106,NaN,NaN,50
1684483200,1.07776,1.07824,1.07708,1.07813,2094,1380.7,-584404,-583274.8,28.56080118940978,54.78473185991352,44.76024249132708,NaN,NaN,50
1684485000,1.07813,1.07946,1.07809,1.07882,2025,1468.35,-582379,-583802.2,28.583959553735134,59.706798779826386,46.68263155952099,NaN,NaN,50
1684486800,1.07882,1.07954,1.07876,1.07888,1683,1529.6,-580696,-583626.2,28.675975505655472,60.11340703130068,48.60213067576228,NaN,NaN,50
1684488600,1.07888,1.08044,1.07885,1.08026,2461,1631.15,-578235,-582442.4,29.482558647294006,68.08950493902987,50.29464993496727,NaN,NaN,50
1684490400,1.08026,1.08028,1.07902,1.07978,2676,1691.45,-580911,-581325,30.231528707386936,63.344676725080085,51.82161743885298,NaN,NaN,50
1684492200,1.07978,1.07984,1.07907,1.07944,2190,1734.05,-583101,-581064.4,30.92700090604465,60.14740480569558,53.19042859430469,NaN,NaN,50
1684494000,1.07944,1.07992,1.07924,1.07962,2250,1760.8,-580851,-580758.8,31.640253360595892,61.262169024871326,54.9400166465871,NaN,NaN,50
1684495800,1.07962,1.08092,1.0796,1.08087,2522,1790.85,-578329,-580285.4,33.040146832513706,67.9639160102038,57.13847695154516,NaN,NaN,50
1684497600,1.08087,1.08158,1.0806,1.08134,2861,1872.45,-575468,-579732,34.72488076063034,70.06121084754439,59.4992766154075,NaN,NaN,50
1684499400,1.08134,1.08238,1.08053,1.08059,3589,1977,-579057,-579361.2,36.67979359519715,62.97614009446184,60.8200441636512,NaN,NaN,50
1684501200,1.08059,1.0808,1.07932,1.07948,3389,2089.1,-582446,-579230.2,36.52282913743431,54.23457505510784,60.16666667914336,NaN,NaN,50
1684503000,1.07948,1.07974,1.07892,1.07951,3624,2229.2,-578822,-578824.4,35.82785304026167,54.41872964122298,60.11948699626565,NaN,NaN,50
1684504800,1.07951,1.07962,1.07864,1.07936,2956,2338.75,-581778,-579514.2,34.808290488787236,53.26464213172702,60.15887806202306,NaN,NaN,50
1684506600,1.07936,1.07956,1.07844,1.07859,2749,2434.85,-584527,-581326,33.59408294757035,47.67521669969452,59.860223117548635,NaN,NaN,50
1684508400,1.07859,1.08266,1.07822,1.08131,6288,2707,-578239,-581162.4,34.460287157201215,62.60379738073351,60.41872779760721,NaN,NaN,50
1684510200,1.08131,1.08227,1.08088,1.0819,5890,2934.75,-572349,-579143,35.26461963757273,64.94040489191562,60.79255680561351,NaN,NaN,50
1684512000,1.0819,1.08229,1.08114,1.08139,3382,2969.25,-575731,-578524.8,36.021326360826826,61.370778650773666,60.88236906414729,NaN,NaN,50
1684513800,1.08139,1.0825,1.08114,1.08208,2092,2982.15,-573639,-576897,36.831728757112764,64.23514046412402,60.607057315939734,NaN,NaN,50
1684515600,1.08208,1.0822,1.0818,1.08215,1837,2945.1,-571802,-574352,37.5842452679497,64.52254788423346,60.691190970164975,NaN,NaN,50
1684517400,1.08215,1.08289,1.08194,1.08198,1343,2895.05,-573145,-573333.2,38.64384474901307,63.19437251157994,60.90883152058529,NaN,NaN,50
1684519200,1.08198,1.08204,1.08128,1.08139,1653,2873,-574798,-573823,38.648220829449095,58.679764475849964,60.72437405279804,NaN,NaN,50
1684521000,1.08139,1.08144,1.0808,1.08084,1461,2844.8,-576259,-573928.6,38.000079865030536,54.75291502514643,59.78073112529395,NaN,NaN,50
1684522800,1.08084,1.08094,1.0802,1.08022,1117,2816.5,-577376,-574676,36.644827369225105,50.63900546095396,58.39343074053749,NaN,NaN,50
1684524600,1.08022,1.08066,1.07978,1.08062,1406,2763.75,-575970,-575509.6,34.894822784371364,53.08798184140266,57.68713372246184,NaN,NaN,50
1684526400,1.08062,1.08076,1.08016,1.08066,663,2663.1,-575307,-575942,33.36149142358493,53.33730076072836,57.62304270143473,NaN,NaN,50
1684528200,1.08066,1.08085,1.08038,1.08062,742,2590.7,-576049,-576192.2,32.02401557785913,53.03376611333756,57.52411673515719,NaN,NaN,50
1684702800,1.08062,1.08084,1.08062,1.08079,72,2481.8,-575977,-576135.8,30.78207372111375,54.22602208663895,57.59278673193661,NaN,NaN,50
1684704600,1.08079,1.08083,1.08076,1.08077,105,2360.95,-576082,-575877,29.62884199699304,54.05217688126934,58.04828388776339,NaN,NaN,50
1684706400,1.08077,1.08182,1.08074,1.08176,475,2241.65,-575607,-575804.4,29.539291347200543,60.7585788453292,57.916482563805936,NaN,NaN,50
1684708200,1.08176,1.08199,1.08172,1.08173,322,2078.3,-575929,-575928.8,29.60400031728994,60.47054780949787,57.59720705791896,NaN,NaN,50
1684710000,1.08173,1.08244,1.08169,1.0821,561,1936.9,-575368,-575792.6,30.04225782736714,62.812072834135456,57.7001566424448,NaN,NaN,50
1684711800,1.0821,1.08226,1.08176,1.08221,564,1783.9,-574804,-575558,30.449211229581678,63.504216648646604,57.64794779848212,NaN,NaN,50
1684713600,1.08221,1.08248,1.08174,1.08187,1474,1709.8,-576278,-575597.2,31.01700018086887,59.79943701162728,57.31058273615311,NaN,NaN,50
1684715400,1.08187,1.0825,1.08168,1.08236,1144,1629.55,-575134,-575502.6,31.425549849483748,63.13716116579815,57.30649621145442,NaN,NaN,50
1684717200,1.08236,1.083,1.08236,1.08285,1724,1401.35,-573410,-574998.8,32.244432628190964,66.16267416477854,57.840989760663604,NaN,NaN,50
1684719000,1.08285,1.08285,1.08209,1.08256,1917,1202.7,-575327,-574990.6,32.4584285890294,62.87366111333863,58.42104305267734,NaN,NaN,50
1684720800,1.08256,1.08258,1.0819,1.08245,1371,1102.15,-576698,-575369.4,32.28050923101463,61.622336242159314,59.20556667990629,NaN,NaN,50
1684722600,1.08245,1.0825,1.08187,1.08228,1550,1075.05,-578248,-575763.4,32.05415831817571,59.64660452350273,59.674039728627726,NaN,NaN,50
1684724400,1.08228,1.08239,1.082,1.08226,972,1031.8,-579220,-576580.6,31.843975327682415,59.40529153288858,60.10746764092489,NaN,NaN,50
1684726200,1.08226,1.08254,1.08199,1.08209,782,1003.75,-580002,-577899,31.835069204138644,57.28385133310354,60.41104515662246,NaN,NaN,50
1684728000,1.08209,1.08238,1.08194,1.0823,730,957.6,-579272,-578688,31.704177158691948,59.22114622640918,60.767839738034624,NaN,NaN,50
1684729800,1.0823,1.08234,1.08178,1.08184,938,931.45,-580210,-579390.4,31.18349445333952,53.49764798860929,60.728230531416045,NaN,NaN,50
1684731600,1.08184,1.08197,1.08144,1.08144,1059,928.55,-581269,-579994.6,29.9041348448715,49.057691675280196,59.89245287641255,NaN,NaN,50
1684733400,1.08144,1.08156,1.081,1.08104,1404,928.45,-582673,-580685.2,27.818372242847357,45.03277068371404,58.78975451028513,NaN,NaN,50
1684735200,1.08104,1.08224,1.08072,1.08212,2465,1018.55,-580208,-580726.4,26.987255708061202,55.620072350240115,58.27604019000689,NaN,NaN,50
1684737000,1.08212,1.08244,1.08103,1.08108,1971,1080,-582179,-581307.8,26.497210868588855,46.359915477397045,57.05144724920335,NaN,NaN,50
1684738800,1.08108,1.0813,1.07955,1.08056,2875,1220.15,-585054,-582276.6,25.506972378611266,42.545765030932856,55.81904210772518,NaN,NaN,50
1684740600,1.08056,1.08117,1.07974,1.0807,2293,1329.55,-582761,-582575,24.587465209346355,43.88435786680325,54.44384187208269,NaN,NaN,50
1684742400,1.0807,1.08082,1.08012,1.08036,2472,1429.4,-585233,-583087,23.73363712360037,41.3638778319962,52.67249927688395,NaN,NaN,50
1684744200,1.08036,1.0813,1.07992,1.08104,2148,1520.7,-583085,-583662.4,22.140448673782103,47.81894873675305,51.59716267855641,NaN,NaN,50
1684746000,1.08104,1.08186,1.08083,1.08182,1924,1588.85,-581161,-583458.8,21.26184185898791,54.06556121049066,51.05739303343722,NaN,NaN,50
1684747800,1.08182,1.08236,1.08172,1.08194,1678,1644.55,-579483,-582344.6,21.067567939799424,54.95889165582808,50.722556400031884,NaN,NaN,50
1684749600,1.08194,1.08287,1.08174,1.08284,1759,1658.8,-577724,-581337.2,21.444914498486884,61.073455945640895,50.841711000942766,NaN,NaN,50
1684751400,1.08284,1.08296,1.08202,1.0822,1857,1694.45,-579581,-580206.8,21.8894290074819,55.32201596128068,50.701579902955416,NaN,NaN,50
1684753200,1.0822,1.08234,1.08156,1.0819,1795,1698,-581376,-579865,21.484654273824866,52.81141404212229,50.24374188979207,NaN,NaN,50
1684755000,1.0819,1.08222,1.08125,1.08218,2291,1716.7,-579085,-579449.8,20.601650839668704,54.86998933020499,50.34176627133461,NaN,NaN,50
1684756800,1.08218,1.08278,1.08201,1.08276,2107,1753.5,-576978,-578948.8,20.47122132231933,58.87236771959159,51.042814560214005,NaN,NaN,50
1684758600,1.08276,1.08313,1.08159,1.08193,3310,1841.5,-580288,-579461.6,19.679751513042735,51.79351500022824,51.52572486853644,NaN,NaN,50
1684760400,1.08193,1.08215,1.08086,1.0809,2549,1920.35,-582837,-580112.8,18.61002554230012,44.622948710341525,50.74021603711511,NaN,NaN,50
1684762200,1.0809,1.08188,1.0809,1.08124,3129,2037.7,-579708,-579779.2,17.616708569467693,47.22053183849407,50.80168863433634,NaN,NaN,50
1684764000,1.08124,1.08244,1.08002,1.08064,4611,2231.75,-584319,-580826,17.73332573406006,43.355599947646006,50.85953398553013,NaN,NaN,50
1684765800,1.08064,1.08154,1.07973,1.07986,3634,2366.55,-587953,-583021,18.138005590947916,38.898320555278346,50.50338846327835,NaN,NaN,50
1684767600,1.07986,1.08048,1.07962,1.08022,2510,2439.1,-585443,-584052,18.626269775123397,41.86879983963214,50.53945432096664,NaN,NaN,50
1684769400,1.08022,1.08082,1.07977,1.08051,1804,2459.1,-583639,-584212.4,18.50788947588382,44.22125991411275,50.2824765479209,NaN,NaN,50
1684771200,1.08051,1.0817,1.0803,1.08154,1788,2425.25,-581851,-584641,17.239495197841293,51.69784663011182,50.113354077893845,NaN,NaN,50
1684773000,1.08154,1.08166,1.08098,1.08098,1648,2409.1,-583499,-584477,16.061700511087512,47.935752084008016,49.61170125133526,NaN,NaN,50
1684774800,1.08098,1.08176,1.08082,1.08118,1762,2353.45,-581737,-583233.8,15.083602722288772,49.35329145653194,48.774546644970336,NaN,NaN,50
1684776600,1.08118,1.08205,1.08112,1.08182,1403,2308.95,-580334,-582212,14.253664478998154,53.69771918899568,48.65852544694998,NaN,NaN,50
1684778400,1.08182,1.08216,1.08169,1.08176,1177,2244.2,-581511,-581786.4,13.639847784727364,53.23666902076345,48.688900802567204,NaN,NaN,50
1684780200,1.08176,1.08198,1.08142,1.0819,1175,2195.55,-580336,-581483.4,12.689307057876384,54.22428687562652,48.64277919866874,NaN,NaN,50
1684782000,1.0819,1.082,1.08146,1.08158,1242,2161.45,-581578,-581099.2,11.791471391409372,51.544663082077356,48.11937172456059,NaN,NaN,50
1684783800,1.08158,1.08165,1.08104,1.08112,1304,2142.75,-582882,-581328.2,11.601765115031572,47.88162531127405,47.83995103249243,NaN,NaN,50
1684785600,1.08112,1.08138,1.08098,1.08123,965,2103.05,-581917,-581644.8,11.516618590297533,48.818306673159626,48.139619458408006,NaN,NaN,50
1684787400,1.08123,1.08138,1.0812,1.0813,461,2033.25,-581456,-581633.8,11.437553960187351,49.44102169487652,48.29822587672105,NaN,NaN,50
1684789200,1.0813,1.0816,1.0812,1.08148,118,1949.4,-581338,-581834.2,10.920338119341059,51.08895922603401,48.850608682320185,NaN,NaN,50
1684791000,1.08148,1.08152,1.08115,1.08131,509,1860.3,-581847,-581888,10.53303803807718,49.44962846523552,49.60427353303142,NaN,NaN,50
1684792800,1.08131,1.08148,1.08129,1.08142,316,1770.75,-581531,-581617.8,10.173402248332149,50.555204372662125,50.22473099967642,NaN,NaN,50
1684794600,1.08142,1.08148,1.08118,1.08128,602,1635.35,-582133,-581661,10.06560784498835,49.083831632339496,50.57205755097833,NaN,NaN,50
1684796400,1.08128,1.08132,1.08088,1.08098,939,1554.85,-583072,-581984.2,10.54997309808463,45.994659250120534,50.164687023836095,NaN,NaN,50
1684798200,1.08098,1.08112,1.08065,1.08107,513,1424.05,-582559,-582228.4,11.408807600104018,47.070887131242806,50.10291095578144,NaN,NaN,50
1684800000,1.08107,1.08206,1.08107,1.08175,1230,1255,-581329,-582124.8,11.018105160017274,54.45589243218024,50.467382454042024,NaN,NaN,50
1684801800,1.08175,1.08183,1.08112,1.08118,1006,1123.6,-582335,-582285.6,10.655310037079584,48.36428890415908,50.08642314798227,NaN,NaN,50
1684803600,1.08118,1.0812,1.08066,1.08083,1407,1068.45,-583742,-582607.4,10.352500856356059,45.03311996425267,49.5004553582315,NaN,NaN,50
1684805400,1.08083,1.08106,1.08042,1.08044,1774,1066.95,-585516,-583096.2,10.48240672299447,41.59519595951823,48.59837743565233,NaN,NaN,50
1684807200,1.08044,1.08078,1.08028,1.08066,1196,1037.35,-584320,-583448.4,10.836383236391216,44.18380930986861,48.07260216620885,NaN,NaN,50
1684809000,1.08066,1.08104,1.08054,1.08101,959,1002.9,-583361,-583854.8,10.594141219008648,48.12313919193221,48.08985315768444,NaN,NaN,50
1684810800,1.08101,1.08105,1.08053,1.08056,1260,977.8,-584621,-584312,10.369202202867692,43.83910445765182,47.73419585657673,NaN,NaN,50
1684812600,1.08056,1.08098,1.08048,1.08082,1270,971.15,-583351,-584233.8,10.260872274009587,46.78667975897286,47.54460000401219,NaN,NaN,50
1684814400,1.08082,1.08088,1.08058,1.08072,758,950.2,-584109,-583952.4,10.160280197212776,45.791218372166725,47.16618994302167,NaN,NaN,50
1684816200,1.08072,1.08108,1.0807,1.08104,915,937.2,-583194,-583727.2,9.55447425350167,49.4944109294841,47.16938869046799,NaN,NaN,50
1684818000,1.08104,1.08108,1.08032,1.08038,746,912.4,-583940,-583843,9.826423101317657,42.97379009442989,46.62785909916569,NaN,NaN,50
1684819800,1.08038,1.08076,1.08003,1.08075,1404,917.4,-582536,-583426,10.62951847079993,47.175361897853506,46.491539832416684,NaN,NaN,50
1684821600,1.08075,1.08118,1.08032,1.0807,2173,977.8,-584709,-583697.6,10.32148666474956,46.674897009604244,46.54012824380838,NaN,NaN,50
1684823400,1.0807,1.0813,1.08062,1.08092,1788,1044.15,-582921,-583460,9.76102069461224,49.22716988454612,46.69414844047291,NaN,NaN,50
1684825200,1.08092,1.08098,1.07863,1.07901,3254,1200.95,-586175,-584056.2,11.972974438616452,34.008462422000434,45.233617725460064,NaN,NaN,50
1684827000,1.07901,1.08038,1.07852,1.08036,3440,1347.5,-582735,-583815.2,14.123530599480544,46.57937836791932,45.106124115728655,NaN,NaN,50
1684828800,1.08036,1.08048,1.07892,1.08012,3091,1486.25,-585826,-584473.2,15.898727962299422,44.94038345552341,45.09950007939084,NaN,NaN,50
1684830600,1.08012,1.08082,1.0798,1.08033,2527,1582.5,-583299,-584191.2,16.811761403996837,46.70741160402467,45.464658339712734,NaN,NaN,50
1684832400,1.08033,1.08038,1.07898,1.07903,2143,1642.7,-585442,-584695.4,18.481560940784416,38.47545939786564,45.05691906028395,NaN,NaN,50
1684834200,1.07903,1.07927,1.07803,1.07813,2032,1718.65,-587474,-584955.2,20.748029288725135,34.006896458196124,44.04861600787423,NaN,NaN,50
1684836000,1.07813,1.07814,1.07698,1.07718,2234,1768.85,-589708,-586349.8,23.444006108691156,30.040815600726674,43.0630239466653,NaN,NaN,50
1684837800,1.07718,1.07796,1.07712,1.07778,1996,1818.35,-587712,-586727,25.94741315580246,35.18243148743353,42.234149070126776,NaN,NaN,50
1684839600,1.07778,1.07847,1.07752,1.07814,1882,1842.1,-585830,-587233.2,27.30233423296667,38.12098895899133,41.68627554061425,NaN,NaN,50
1684841400,1.07814,1.0784,1.07728,1.07728,2030,1854.9,-587860,-587716.8,28.72416159510645,34.13922307834615,40.589476408390105,NaN,NaN,50
1684843200,1.07728,1.07828,1.07728,1.07776,2509,1920.55,-585351,-587292.2,30.044429859950526,38.0298667848525,40.236339029134584,NaN,NaN,50
1684845000,1.07776,1.07782,1.07631,1.0764,3112,2028.2,-588463,-587043.2,31.885737471414068,32.2218548171049,39.16823138050968,NaN,NaN,50
1684846800,1.0764,1.07805,1.0763,1.07763,3517,2141.05,-584946,-586490,33.150286363742545,40.998290594293714,38.762759493701786,NaN,NaN,50
1684848600,1.07763,1.0785,1.07674,1.07821,5311,2343.1,-579635,-585251,33.49392089831796,44.638637998170935,38.43500721610356,NaN,NaN,50
1684850400,1.07821,1.07956,1.07798,1.07885,5100,2560.2,-574535,-582586,32.18986914590631,48.42038926282564,39.46443056187678,NaN,NaN,50
1684852200,1.07885,1.07908,1.07773,1.07788,3668,2697.85,-578203,-581156.4,31.222085973733538,43.56322630197795,39.24899112859526,NaN,NaN,50
1684854000,1.07788,1.0781,1.07726,1.07738,2709,2796,-580912,-579646.2,30.760369872853214,41.26536885377916,38.986490085613525,NaN,NaN,50
1684855800,1.07738,1.07792,1.07709,1.0771,2006,2826.1,-582918,-579240.6,30.4845570944212,39.99315130097453,38.50690006396708,NaN,NaN,50
1684857600,1.0771,1.07724,1.07602,1.07626,2030,2818.95,-584948,-580303.2,31.072682934728924,36.37046716457653,38.35654347587501,NaN,NaN,50
1684859400,1.07626,1.07688,1.07623,1.07668,1520,2805.55,-583428,-582081.8,31.618799786443237,39.32967749506433,38.73674212136559,NaN,NaN,50
1684861200,1.07668,1.0775,1.07644,1.07727,1428,2714.25,-582000,-582841.2,31.15482530422608,43.31765168453357,39.68508755592323,NaN,NaN,50
1684863000,1.07727,1.0779,1.07712,1.0778,1439,2614.2,-580561,-582771,30.15421596411573,46.70654907787394,40.508238812383254,NaN,NaN,50
1684864800,1.0778,1.078,1.07758,1.07772,1913,2555.3,-582474,-582682.2,29.08388069112915,46.256990016842174,41.08938174508689,NaN,NaN,50
1684866600,1.07772,1.07809,1.07754,1.07762,1802,2519.05,-584276,-582547.8,27.95761886625155,45.66530572344209,41.91267336259374,NaN,NaN,50
1684868400,1.07762,1.07765,1.07706,1.07713,1464,2485.1,-585740,-583010.2,27.4356593157291,42.77786834412795,42.251816331113424,NaN,NaN,50
1684870200,1.07713,1.07716,1.07666,1.07676,1217,2444.35,-586957,-584001.6,27.3509634233219,40.685875484601326,42.8563892359346,NaN,NaN,50
1684872000,1.07676,1.07708,1.0767,1.07701,589,2362.1,-586368,-585163,27.27231723751522,42.724027162356364,42.97965613365336,NaN,NaN,50
1684873800,1.07701,1.07715,1.07692,1.07707,358,2280.2,-586010,-585870.2,27.07195135307235,43.22823166903204,42.87891282442915,NaN,NaN,50
1684875600,1.07707,1.07742,1.07707,1.07714,1548,2263.5,-584462,-585907.4,26.39331881605425,43.849273850567954,42.55240458069646,NaN,NaN,50
1684877400,1.07714,1.07736,1.07713,1.0773,692,2196.6,-583770,-585513.4,25.7631600316803,45.321623356952806,42.67800437033752,NaN,NaN,50
1684879200,1.0773,1.07735,1.07708,1.0772,341,2088.2,-584111,-584944.2,25.247249607289422,44.535614058839,42.911593313556075,NaN,NaN,50
1684881000,1.0772,1.07732,1.07719,1.07724,171,1941.15,-583940,-584458.6,24.768189927497897,44.94690452644415,43.26543282966105,NaN,NaN,50
1684882800,1.07724,1.07738,1.07705,1.07708,432,1786.9,-584372,-584131,24.537368070403566,43.55559716790927,43.77865640132767,NaN,NaN,50
1684884600,1.07708,1.0771,1.07688,1.07694,461,1544.4,-584833,-584205.2,24.580238977095156,42.321147283014625,43.99233281475269,NaN,NaN,50
1684886400,1.07694,1.07753,1.07678,1.07743,968,1337.8,-583865,-584224.2,23.62681963145547,47.88811845979951,44.31879472727169,NaN,NaN,50
1684888200,1.07743,1.07752,1.07706,1.07724,980,1203.4,-584845,-584371,22.74150166764718,46.03282673231643,44.27067170258901,NaN,NaN,50
1684890000,1.07724,1.0774,1.07678,1.07704,1675,1151.7,-586520,-584887,22.41030480373125,44.09619677196702,44.116329327955064,NaN,NaN,50
1684891800,1.07704,1.07745,1.07688,1.07738,1203,1111.55,-585317,-585076,21.97900778401845,48.094074827023924,44.28981283535377,NaN,NaN,50
1684893600,1.07738,1.07765,1.07688,1.07762,2085,1114.3,-583232,-584755.8,21.084452891196662,50.77035689197296,44.86070487448556,NaN,NaN,50
1684895400,1.07762,1.07767,1.07721,1.07748,1152,1095.9,-584384,-584859.6,20.20406860178718,49.17747828345492,45.46724793154653,NaN,NaN,50
1684897200,1.07748,1.07798,1.07726,1.07782,1087,1078.85,-583297,-584550,18.880878713827663,53.031504605585155,46.2034963203486,NaN,NaN,50
1684899000,1.07782,1.07799,1.07774,1.07789,1064,1060.1,-582233,-583692.6,17.67554049993431,53.80815854348983,46.95920538280986,NaN,NaN,50
1684900800,1.07789,1.07804,1.07757,1.07802,889,1008.9,-581344,-582898,16.687566712094725,55.286878341534305,47.776177132164605,NaN,NaN,50
1684902600,1.07802,1.07824,1.07787,1.07801,763,956.95,-582107,-582673,15.72347924739748,55.14064923786011,48.47753612365799,NaN,NaN,50
1684904400,1.07801,1.0783,1.07791,1.07798,1060,936.75,-583167,-582429.6,14.976347106553266,54.673458489534504,49.201667868707666,NaN,NaN,50
1684906200,1.07798,1.07864,1.07788,1.07837,1463,949.05,-581704,-582111,15.064744097753046,59.479872704323256,50.23973702427046,NaN,NaN,50
1684908000,1.07837,1.07894,1.07817,1.0787,2750,1057.1,-578954,-581455.2,15.739099242395701,63.05025015654844,51.63221223774468,NaN,NaN,50
1684909800,1.0787,1.07888,1.07763,1.07778,2435,1160.95,-581389,-581464.2,14.933827975753932,49.8599725476131,52.170699756644574,NaN,NaN,50
1684911600,1.07778,1.07822,1.07718,1.07753,2996,1233.35,-584385,-581919.8,14.489995276453591,46.98356790861244,52.106089002988355,NaN,NaN,50
1684913400,1.07753,1.07858,1.07703,1.07839,3143,1355.9,-581242,-581534.8,13.593766365601507,56.31898617700388,52.84081467760889,NaN,NaN,50
1684915200,1.07839,1.07952,1.07784,1.07832,3109,1494.3,-584351,-582064.2,14.275638584668773,55.46291427728166,53.652723070845646,NaN,NaN,50
1684917000,1.07832,1.07854,1.0775,1.07776,2464,1608.95,-586815,-583636.4,14.225689828364052,49.04067446771563,53.720337330895056,NaN,NaN,50
1684918800,1.07776,1.07812,1.07748,1.07803,1942,1684.45,-584873,-584333.2,14.139590828256743,51.93076510332092,53.80322363170563,NaN,NaN,50
1684920600,1.07803,1.0782,1.07732,1.07736,1928,1757.8,-586801,-584816.4,13.73291240322389,45.096028127135355,53.511691477682795,NaN,NaN,50
1684922400,1.07736,1.07738,1.07481,1.07524,3362,1877.5,-590163,-586600.6,15.294316460421578,31.133351022701746,51.94753765033398,NaN,NaN,50
1684924200,1.07524,1.07558,1.07491,1.07516,1955,1926.25,-592118,-588154,16.744191656390857,30.74648139621,50.300274996956844,NaN,NaN,50
1684926000,1.07516,1.07701,1.0751,1.07688,2126,1948.8,-589992,-588789.4,16.04155534502662,46.219823633548074,49.65262823210069,NaN,NaN,50
1684927800,1.07688,1.0781,1.07674,1.07808,2388,2008.05,-587604,-589335.6,15.53224109536226,53.95030485491963,49.56760363331922,NaN,NaN,50
1684929600,1.07808,1.08014,1.07785,1.07913,3519,2079.75,-584085,-588792.4,16.553929664692426,59.44363907946462,49.908330818314234,NaN,NaN,50
1684931400,1.07913,1.07948,1.07858,1.07896,3199,2182.1,-587284,-588216.6,17.502640479070443,58.232431735152815,49.81922789194492,NaN,NaN,50
1684933200,1.07896,1.0794,1.07852,1.07858,2873,2271.4,-590157,-587824.4,18.31148180967574,55.5097209620462,49.280618663766184,NaN,NaN,50
1684935000,1.07858,1.07874,1.07692,1.07696,3996,2418,-594153,-588656.6,17.38297189783888,45.69977255312122,48.98346152130248,NaN,NaN,50
1684936800,1.07696,1.07773,1.07628,1.07642,3569,2552,-597722,-590680.2,16.31021542030573,42.973543900095414,48.697031234979825,NaN,NaN,50
1684938600,1.07642,1.07718,1.07582,1.07626,3315,2679.6,-601037,-594070.6,15.686563106832791,42.17081093509806,47.68644728912942,NaN,NaN,50
1684940400,1.07626,1.0765,1.07558,1.07612,2967,2774.95,-604004,-597414.6,15.299793255374603,41.44135904534485,46.68490762970536,NaN,NaN,50
1684942200,1.07612,1.07612,1.07548,1.07584,2928,2848.2,-606932,-600769.6,15.023358585313645,39.95286431772364,46.03577833327735,NaN,NaN,50
1684944000,1.07584,1.07614,1.07496,1.07521,2900,2855.7,-609832,-603905.4,15.19304820573391,36.75407247308402,44.951728859689005,NaN,NaN,50
1684945800,1.07521,1.07611,1.07518,1.07562,1874,2827.65,-607958,-605952.6,15.350617138981296,40.11445015587279,44.59590186174167,NaN,NaN,50
1684947600,1.07562,1.07642,1.07539,1.0763,2172,2786.45,-605786,-606902.4,15.123577740563126,45.30499482453088,45.6081621333009,NaN,NaN,50
1684949400,1.0763,1.07658,1.07554,1.07566,1882,2723.4,-607668,-607635.2,14.719261840950072,41.64632421379036,46.38672233455664,NaN,NaN,50
1684951200,1.07566,1.07652,1.0752,1.07624,2879,2711.9,-604789,-607206.6,14.682505337912913,45.90947893603236,46.36455485616266,NaN,NaN,50
1684953000,1.07624,1.0766,1.07498,1.07508,2031,2690.25,-606820,-606604.2,14.86414334412571,39.667623100219316,45.344363302255495,NaN,NaN,50
1684954800,1.07508,1.07563,1.07496,1.07546,1915,2688.9,-604905,-605993.6,15.053117675147037,42.42899846285567,44.12903182964057,NaN,NaN,50
1684956600,1.07546,1.07573,1.07495,1.07496,1778,2681.4,-606683,-606173,15.076156304094823,39.8448453246054,42.815632800315754,NaN,NaN,50
1684958400,1.07496,1.0754,1.07496,1.07507,854,2556,-605829,-605805.2,15.097549316689193,40.70052978251627,41.75783343034933,NaN,NaN,50
1684960200,1.07507,1.07512,1.07494,1.07494,611,2488.8,-606440,-606135.4,15.142770617028953,39.976787348706694,41.34904877289115,NaN,NaN,50
1684962000,1.07494,1.07528,1.07494,1.07523,119,2388.45,-606321,-606035.6,14.896427725200322,42.43588152637052,41.31064431762509,NaN,NaN,50
1684963800,1.07523,1.07533,1.07494,1.075,568,2297.45,-606889,-606432.4,14.575116393542913,41.00116326906678,41.227098055765715,NaN,NaN,50
1684965600,1.075,1.07526,1.07424,1.07456,653,2154.15,-607542,-606604.2,15.22962571273335,38.331257191288394,41.00494792333312,NaN,NaN,50
1684967400,1.07456,1.07568,1.07454,1.0755,1075,2047.95,-606467,-606731.8,15.061734255233613,46.366448510173974,41.46306107993671,NaN,NaN,50
1684969200,1.0755,1.0756,1.07528,1.07538,552,1931.9,-607019,-606847.6,14.905835044698149,45.55050074296569,42.09137738492826,NaN,NaN,50
1684971000,1.07538,1.07569,1.07532,1.07556,548,1759.5,-606471,-606877.6,14.58897654578111,47.05556414033516,42.58717124096129,NaN,NaN,50
1684972800,1.07556,1.0756,1.0749,1.07495,1673,1664.7,-608144,-607128.6,14.914280646758343,42.74361015815688,42.40421519336314,NaN,NaN,50
1684974600,1.07495,1.07506,1.07454,1.07506,1360,1566.95,-606784,-606977,15.690426634237895,43.74470239362616,42.5540993490657,NaN,NaN,50
1684976400,1.07506,1.07534,1.07423,1.0744,1682,1502.7,-608466,-607376.8,16.786136935630207,39.30426505935477,42.08229835787444,NaN,NaN,50
1684978200,1.0744,1.07457,1.07408,1.07438,1812,1446.9,-610278,-608028.6,17.978715206607824,39.174495022013375,42.04707492371688,NaN,NaN,50
1684980000,1.07438,1.07447,1.07401,1.0743,1258,1364.8,-611536,-609041.6,19.169505955614046,38.625144499988295,41.77537106922635,NaN,NaN,50
1684981800,1.0743,1.07462,1.07416,1.07416,948,1318.5,-612484,-609909.6,19.90082804111752,37.6306317036198,41.617212953441665,NaN,NaN,50
1684983600,1.07416,1.07425,1.0736,1.0737,1161,1267.95,-613645,-611281.8,21.26229893574243,34.488469105344606,41.173494333643696,NaN,NaN,50
1684985400,1.0737,1.07402,1.07362,1.07376,759,1211.8,-612886,-612165.8,22.5265219093227,35.24795331375448,40.83572047400425,NaN,NaN,50
1684987200,1.07376,1.07398,1.07368,1.07386,722,1103.95,-612164,-612543,23.700443241932952,36.56786168933982,40.416576199930624,NaN,NaN,50
1684989000,1.07386,1.07388,1.07329,1.07344,872,1046,-613036,-612843,25.24968841076029,33.48096415253177,39.87941912017813,NaN,NaN,50
1684990800,1.07344,1.0738,1.07338,1.07356,990,999.75,-612046,-612755.4,26.688273210385677,35.164990441110945,39.65325720945116,NaN,NaN,50
1684992600,1.07356,1.07399,1.07352,1.07398,1277,974.7,-610769,-612180.2,27.44084050160308,40.81284036043697,39.25657091304138,NaN,NaN,50
1684994400,1.07398,1.07402,1.07282,1.07344,2127,1038.35,-612896,-612182.2,28.956765759766363,36.420024896084215,38.60439406683555,NaN,NaN,50
1684996200,1.07344,1.0744,1.07298,1.07322,2211,1118.35,-615107,-612770.8,29.342058410439886,34.777694497025436,37.72740337802772,NaN,NaN,50
1684998000,1.07322,1.07332,1.07156,1.07245,3519,1288.35,-618626,-613888.8,31.009305268240954,29.725279974197633,36.797522650602055,NaN,NaN,50
1684999800,1.07245,1.07252,1.0714,1.07211,2419,1380.9,-621045,-615688.6,32.66823369489695,27.80446470116064,35.65893424399737,NaN,NaN,50
1685001600,1.07211,1.07307,1.07198,1.07284,2526,1474.55,-618519,-617238.6,33.01663736279628,37.18921071961089,35.50785893401567,NaN,NaN,50
1685003400,1.07284,1.07372,1.07222,1.0723,2533,1547.45,-621052,-618869.8,32.15094917613618,33.69948692484077,35.11678692707477,NaN,NaN,50
1685005200,1.0723,1.0734,1.07223,1.07327,2265,1633.1,-618787,-619605.8,31.3470958599518,43.88565125403993,35.49253740950703,NaN,NaN,50
1685007000,1.07327,1.07382,1.07305,1.07317,1879,1699.65,-620666,-620013.8,29.882499310504357,43.149640900217534,35.88675235212115,NaN,NaN,50
1685008800,1.07317,1.07327,1.07252,1.07294,1831,1707.55,-622497,-620304.2,29.16917149516472,41.428664826085985,36.3824806178884,NaN,NaN,50
1685010600,1.07294,1.07297,1.07222,1.07226,1647,1721.9,-624144,-621429.2,28.84031257853631,36.760513021238545,36.49052059699441,NaN,NaN,50
1685012400,1.07226,1.07292,1.07221,1.07287,1891,1732.35,-622253,-621669.4,28.54619457764359,42.96867578843286,36.94772160407248,NaN,NaN,50
1685014200,1.07287,1.07329,1.07256,1.07329,2015,1742.5,-620238,-621959.6,27.588793468063383,46.838374452754316,37.90182233980266,NaN,NaN,50
1685016000,1.07329,1.07404,1.07292,1.07322,3219,1840.55,-623457,-622517.8,25.71756381867199,46.27481233668694,38.69538104662952,NaN,NaN,50
1685017800,1.07322,1.07336,1.07146,1.07184,6303,2108.3,-629760,-623970.4,25.456934102092404,36.859147461889144,38.412974411018965,NaN,NaN,50
1685019600,1.07184,1.07254,1.07152,1.07204,4036,2252.05,-625724,-624286.4,25.214920793839934,38.80260412621287,38.583158641742436,NaN,NaN,50
1685021400,1.07204,1.07217,1.07072,1.07134,4206,2424.4,-629930,-625821.8,25.70377520307872,34.76886622058227,38.58252805056793,NaN,NaN,50
1685023200,1.07134,1.07302,1.07134,1.07242,4179,2597.25,-625751,-626924.4,24.951091913896313,44.37648253571955,39.62904251924807,NaN,NaN,50
1685025000,1.07242,1.07327,1.07236,1.07286,3960,2751.65,-621791,-626591.2,23.931851449532,47.7527567270458,41.053920521097005,NaN,NaN,50
1685026800,1.07286,1.07311,1.07216,1.07216,3130,2858.65,-624921,-625623.4,23.19249658539246,43.25453410283145,41.48715790561276,NaN,NaN,50
1685028600,1.07216,1.07248,1.07181,1.07242,2714,2930.5,-622207,-624920,22.86178903798378,45.31502411505247,42.316839133485026,NaN,NaN,50
1685030400,1.07242,1.07244,1.07152,1.07178,1994,2923.85,-624201,-623774.2,22.839277537118548,41.33614596725766,42.134731613000575,NaN,NaN,50
1685032200,1.07178,1.07208,1.07119,1.07127,1592,2892.9,-625793,-623782.6,23.13128897890157,38.43965120485557,41.79830377761758,NaN,NaN,50
1685034000,1.07127,1.0722,1.07114,1.07216,1751,2804.5,-624042,-624232.8,23.205980235504555,45.603089346112164,42.09647695761945,NaN,NaN,50
1685035800,1.07216,1.0728,1.07214,1.07278,1222,2744.65,-622820,-623812.6,22.34852895974079,49.97058271098809,43.04005336403013,NaN,NaN,50
1685037600,1.07278,1.07294,1.07218,1.07255,1647,2700.7,-624467,-624264.6,21.349104757010128,48.41754634593703,43.42925840385186,NaN,NaN,50
1685039400,1.07255,1.07262,1.0719,1.0721,1678,2657.95,-626145,-624653.4,20.762948178613286,45.441824505632404,43.32950483620029,NaN,NaN,50
1685041200,1.0721,1.07238,1.07176,1.07194,1403,2614.85,-627548,-625004.4,20.388362228131182,44.39701884462076,43.19537672962414,NaN,NaN,50
1685043000,1.07194,1.0721,1.07152,1.07208,1609,2601.35,-625939,-625383.8,20.33061074486002,45.57614904251541,43.818019699668874,NaN,NaN,50
1685044800,1.07208,1.07245,1.07208,1.07232,794,2549.5,-625145,-625848.8,19.677406559375264,47.6265679989727,44.44830283343743,NaN,NaN,50
1685046600,1.07232,1.07256,1.07229,1.0725,473,2490.8,-624672,-625889.8,18.88655003542553,49.17321749650035,45.477185067431584,NaN,NaN,50
1685048400,1.0725,1.07268,1.07244,1.07252,51,2398.8,-624621,-625585,17.9462902505208,49.35218893356001,45.832592667277325,NaN,NaN,50
1685050200,1.07252,1.07287,1.07232,1.07287,110,2303.55,-624511,-624977.6,16.74623260523987,52.50407281394142,46.17197238776987,NaN,NaN,50
1685052000,1.07287,1.0729,1.0724,1.07248,1126,2198.9,-625637,-624917.2,15.579092899227168,48.855646812982656,46.572051867066385,NaN,NaN,50
1685053800,1.07248,1.07272,1.07246,1.07262,558,1911.65,-625079,-624904,14.495320315072515,50.19361468386568,46.92052262198161,NaN,NaN,50
1685055600,1.07262,1.07274,1.07246,1.07262,335,1726.6,-625079,-624985.4,13.471218488758103,50.19361468386568,47.553198958882184,NaN,NaN,50
1685057400,1.07262,1.07262,1.07226,1.07234,540,1543.3,-625619,-625185,12.90591404558894,47.32209797993079,48.18765944281612,NaN,NaN,50
1685059200,1.07234,1.07253,1.0719,1.07241,1139,1391.3,-624480,-625178.8,13.052817907510248,48.12115517011002,48.36752128738739,NaN,NaN,50
1685061000,1.07241,1.07258,1.07194,1.07254,1545,1270.55,-622935,-624638.4,13.068703911403151,49.648686729304195,48.34452871726712,NaN,NaN,50
1685062800,1.07254,1.07322,1.07246,1.07276,1720,1200.05,-621215,-623865.6,12.5485292500941,52.21301453298886,48.61563358777082,NaN,NaN,50
1685064600,1.07276,1.07328,1.07254,1.07324,1563,1142.5,-619652,-622780.2,12.177930926998968,57.320270631400184,49.46409402532566,NaN,NaN,50
1685066400,1.07324,1.07374,1.07324,1.0736,1277,1106.65,-618375,-621331.4,12.635865127975851,60.711731688569024,50.62943065703625,NaN,NaN,50
1685068200,1.0736,1.07373,1.07323,1.07342,1243,1089.2,-619618,-620359,13.037120720118004,58.22060079227293,51.532605782018926,NaN,NaN,50
1685070000,1.07342,1.07387,1.0734,1.07382,880,1045.65,-618738,-619519.6,13.64863068920306,61.95635439986511,52.55616195351124,NaN,NaN,50
1685071800,1.07382,1.07383,1.07344,1.07374,1588,1063.95,-620326,-619341.8,14.216461374782039,60.78569091930733,53.38562434085459,NaN,NaN,50
1685073600,1.07374,1.074,1.07368,1.07384,635,1013.35,-619691,-619349.6,15.048845264507207,61.75838688595493,54.271781337454236,NaN,NaN,50
1685075400,1.07384,1.0741,1.07377,1.07399,969,977.9,-618722,-619419,15.998429251466925,63.23165755207219,55.03803739017786,NaN,NaN,50
1685077200,1.07399,1.07428,1.07365,1.074,1257,970.6,-617465,-618988.4,17.191094846276588,63.33307536681845,56.072139429737554,NaN,NaN,50
1685079000,1.074,1.07419,1.07365,1.07372,1319,956.1,-618784,-618997.6,18.298570041456987,58.469948259084774,56.66330611368178,NaN,NaN,50
1685080800,1.07372,1.07383,1.07297,1.07336,1982,1015.5,-620766,-619085.6,17.334633081754518,52.85085530543361,56.853109015222344,NaN,NaN,50
1685082600,1.07336,1.07369,1.07287,1.07296,1958,1089.75,-622724,-619692.2,16.198375759672803,47.400119669473376,56.85868199304682,NaN,NaN,50
1685084400,1.07296,1.07438,1.07254,1.07368,2765,1225.45,-619959,-619939.6,16.50326745367392,56.163911994453805,57.43316462335709,NaN,NaN,50
1685086200,1.07368,1.07446,1.07302,1.07406,2849,1362.4,-617110,-619868.6,16.920164229654077,59.95601714883525,58.16940251046645,NaN,NaN,50
1685088000,1.07406,1.07412,1.073,1.0731,2556,1433.9,-619666,-620045,17.252227166886016,48.53348521820391,57.90657898798181,NaN,NaN,50
1685089800,1.0731,1.07363,1.07287,1.07318,2244,1518.2,-617422,-619376.2,17.193786853194553,49.39864278091633,57.34074842723296,NaN,NaN,50
1685091600,1.07318,1.07369,1.07256,1.07367,2091,1606,-615331,-617897.6,16.325667507983894,54.449387792890974,56.89343814897024,NaN,NaN,50
1685093400,1.07367,1.07368,1.07311,1.07352,1708,1664.4,-617039,-617313.6,15.519556687431141,52.714763582634866,56.50016406256752,NaN,NaN,50
1685095200,1.07352,1.07352,1.07264,1.0733,1831,1699,-618870,-617665.6,15.15248220116678,50.189308106417776,55.659660755892716,NaN,NaN,50
1685097000,1.0733,1.07468,1.07326,1.07442,1879,1715.7,-616991,-617130.6,15.54167719412376,60.55086400452178,55.6428874048366,NaN,NaN,50
1685098800,1.07442,1.07484,1.07408,1.07445,1926,1726,-615065,-616659.2,16.13006221590642,60.786168160312045,55.57344321014783,NaN,NaN,50
1685100600,1.07445,1.07588,1.0744,1.07526,2030,1749.35,-613035,-616200,17.867929496921427,66.58205945209264,55.81275763157787,NaN,NaN,50
1685102400,1.07526,1.07574,1.07494,1.07556,2232,1797.1,-610803,-614952.8,19.48166340072108,68.44245413812486,56.17771325809975,NaN,NaN,50
1685104200,1.07556,1.07572,1.07292,1.0742,5923,2031.1,-616726,-614524,18.51299069350263,53.815997186836654,55.84528818151059,NaN,NaN,50
1685106000,1.0742,1.07506,1.0725,1.07318,3850,2179.6,-620576,-615241,18.076159814224628,45.89429963487623,55.34839134789935,NaN,NaN,50
1685107800,1.07318,1.0735,1.07206,1.07229,4111,2305.75,-624687,-617165.4,18.121529838568065,40.317613519267766,54.8424980514561,NaN,NaN,50
1685109600,1.07229,1.0741,1.07229,1.07304,4566,2502.3,-620121,-618582.6,17.352064105556938,46.24535668789528,54.134029815273344,NaN,NaN,50
1685111400,1.07304,1.07323,1.07021,1.07054,5104,2709.05,-625225,-621467,18.379799906563623,34.09070311515572,52.286507384296236,NaN,NaN,50
1685113200,1.07054,1.07097,1.07018,1.0703,4193,2855.85,-629418,-624005.4,19.353982024939057,33.18887676086139,51.190463923057486,NaN,NaN,50
1685115000,1.0703,1.07139,1.07026,1.07122,2732,2926.5,-626686,-625227.4,19.713078032023727,39.766736755393936,50.502470635520176,NaN,NaN,50
1685116800,1.07122,1.07202,1.07121,1.07176,2068,2930.8,-624618,-625213.6,19.287256244515703,43.2956642508336,49.70577609680179,NaN,NaN,50
1685118600,1.07176,1.0722,1.07141,1.07197,1413,2903.55,-623205,-625830.4,18.683669101313445,44.65368153980291,49.12998452231379,NaN,NaN,50
1685120400,1.07197,1.07272,1.07188,1.07217,1758,2853.2,-621447,-625074.8,17.538706384169416,45.98056998852943,48.829360371036046,NaN,NaN,50
1685122200,1.07217,1.07276,1.07214,1.07268,1255,2773.5,-620192,-623229.6,16.430954792779406,49.31736642560304,48.02696768682757,NaN,NaN,50
1685124000,1.07268,1.07301,1.07252,1.07288,1220,2706.7,-618972,-621686.8,15.398761373217805,50.60591028278718,47.29980640986151,NaN,NaN,50
1685125800,1.07288,1.07328,1.07288,1.07294,1110,2650,-617862,-620335.6,14.746381389599645,51.00831985511693,46.18739643864897,NaN,NaN,50
1685127600,1.07294,1.07314,1.07276,1.07277,680,2579.45,-618542,-619403,13.985028696042054,49.771083240086625,44.853727088789086,NaN,NaN,50
1685129400,1.07277,1.07298,1.07266,1.07297,872,2537.65,-617670,-618647.6,13.143774589623575,51.26864917693349,44.671773659510286,NaN,NaN,50
1685131200,1.07297,1.07302,1.07277,1.07287,412,2466.7,-618082,-618225.6,12.416537475298783,50.45858046716669,44.997793718959606,NaN,NaN,50
1685133000,1.07287,1.07287,1.07245,1.07252,744,2409.95,-618826,-618196.4,11.776698483550232,47.62239921802565,45.51956412601374,NaN,NaN,50
1685307600,1.07252,1.07254,1.0721,1.07247,166,2321.95,-618992,-618422.4,11.654454222327363,47.21411979355492,45.58876149070371,NaN,NaN,50
1685309400,1.07247,1.07252,1.07232,1.07234,157,2228.3,-619149,-618543.8,11.540941694048982,46.10730739720204,46.44709036799274,NaN,NaN,50
1685311200,1.07234,1.07294,1.07219,1.07242,967,2165.05,-618182,-618646.2,10.751905119827596,46.931764535406714,47.42872520903169,NaN,NaN,50
1685313000,1.07242,1.07242,1.07182,1.07194,337,1885.75,-618519,-618733.6,10.560892305559152,42.70991420668643,47.6389521698383,NaN,NaN,50
1685314800,1.07194,1.07238,1.07187,1.07229,365,1711.5,-618154,-618599.2,10.383523263738455,46.48984337933806,47.86710782187432,NaN,NaN,50
1685316600,1.07229,1.07239,1.07216,1.07217,460,1528.95,-618614,-618523.6,10.200426303101281,45.38422065406743,47.91928918717893,NaN,NaN,50
1685318400,1.07217,1.07217,1.07174,1.07192,754,1338.35,-619368,-618567.4,10.671066380223921,43.0853127703311,47.71248510016477,NaN,NaN,50
1685320200,1.07192,1.07219,1.07172,1.072,911,1128.7,-618457,-618622.4,11.108089308980661,44.06178512458267,47.33708643580617,NaN,NaN,50
1685322000,1.072,1.07312,1.07184,1.07307,1163,977.2,-617294,-618377.4,10.783161861914092,55.14621109938964,47.66139363699206,NaN,NaN,50
1685323800,1.07307,1.07322,1.07274,1.07316,1179,899.55,-616115,-617969.6,10.63246081892584,55.93711004665574,48.01345007924483,NaN,NaN,50
1685325600,1.07316,1.07348,1.07312,1.0734,944,843.35,-615171,-617281,10.881181869027582,58.060820049760935,48.60557413707871,NaN,NaN,50
1685327400,1.0734,1.07356,1.07307,1.07313,806,813,-615977,-616602.8,11.230905337108666,54.85753400543971,48.86192305340059,NaN,NaN,50
1685329200,1.07313,1.07336,1.0731,1.07312,659,758.05,-616636,-616238.6,11.55564855746967,54.73708170056738,49.16753028435778,NaN,NaN,50
1685331000,1.07312,1.07321,1.07292,1.07305,495,720.05,-617131,-616206,11.459499319806996,53.845803228103215,49.612059142220474,NaN,NaN,50
1685332800,1.07305,1.07325,1.07299,1.07315,441,681.1,-616690,-616321,11.443190675026273,54.9737388354909,50.1663176452159,NaN,NaN,50
1685334600,1.07315,1.07364,1.07304,1.07362,592,655.2,-616098,-616506.4,12.104705030715898,59.93021135528677,51.153667927936226,NaN,NaN,50
1685336400,1.07362,1.07374,1.07348,1.07369,635,652.95,-615463,-616403.6,12.881098967888697,60.625408127954,52.1317853274039,NaN,NaN,50
1685338200,1.07369,1.07386,1.0734,1.07364,872,652.95,-616335,-616343.4,13.798301000769897,59.826964405333264,53.354431770164375,NaN,NaN,50
1685340000,1.07364,1.07434,1.07362,1.07427,1101,687.4,-615234,-615964,15.356682538926734,65.91774773778087,54.74213922433887,NaN,NaN,50
1685341800,1.07427,1.07436,1.07358,1.07366,1019,701.15,-616253,-615876.6,16.689325477667012,56.919220888840215,55.56606781253693,NaN,NaN,50
1685343600,1.07366,1.07388,1.0731,1.07353,1467,766.2,-617720,-616201,16.65904096122098,55.19008810576085,56.43069462221048,NaN,NaN,50
1685345400,1.07353,1.07358,1.07246,1.07282,1467,831.7,-619187,-616945.8,15.634225843126156,46.82375231280534,56.62797799279782,NaN,NaN,50
1685347200,1.07282,1.07294,1.07154,1.07272,1514,859.05,-620701,-617819,16.066314012529144,45.771320468353,55.95834294772377,NaN,NaN,50
1685349000,1.07272,1.07286,1.07231,1.07241,1033,893.85,-621734,-619119,16.467538741260494,42.57651612778356,55.00401481066147,NaN,NaN,50
1685350800,1.07241,1.07241,1.07137,1.07154,1099,930.55,-622833,-620435,17.904496382826686,35.15940785896319,53.36819965417591,NaN,NaN,50
1685352600,1.07154,1.0719,1.07132,1.0716,1039,959.5,-621794,-621249.8,19.28765235343151,35.987626701907274,52.02034913249503,NaN,NaN,50
1685354400,1.0716,1.0718,1.07142,1.07145,796,961.6,-622590,-621930.4,20.572011468993136,34.79118365227232,50.59564212904537,NaN,NaN,50
1685356200,1.07145,1.0718,1.0712,1.07153,1001,966.1,-621589,-622108,21.99830599320894,36.013022231108266,49.321872057831456,NaN,NaN,50
1685358000,1.07153,1.0719,1.07146,1.07182,766,946.25,-620823,-621925.8,23.072835563134703,40.37448672604435,48.27906833572813,NaN,NaN,50
1685359800,1.07182,1.0719,1.07104,1.07106,923,933.45,-621746,-621708.4,24.525699639387227,33.86065700231278,46.416957310515706,NaN,NaN,50
1685361600,1.07106,1.07148,1.07102,1.07126,828,927.65,-620918,-621533.2,25.895655468400104,36.752494441256935,44.71174919003733,NaN,NaN,50
1685363400,1.07126,1.0715,1.07099,1.07149,959,935.3,-619959,-621007,27.201015359551956,40.0014039227713,43.29563772699719,NaN,NaN,50
1685365200,1.07149,1.07158,1.07088,1.07124,1185,961.6,-621144,-620918,28.539256638280957,37.732546616479674,41.28240907547568,NaN,NaN,50
1685367000,1.07124,1.0713,1.07081,1.07096,1029,988.3,-622173,-621188,29.86383286386672,35.316463539203895,39.739354979073084,NaN,NaN,50
1685368800,1.07096,1.07108,1.07062,1.07085,663,999.4,-622836,-621406,31.314499198807106,34.38496188460523,38.25327453470483,NaN,NaN,50
1685370600,1.07085,1.071,1.0706,1.07088,791,1009.35,-622045,-621631.4,32.684949658476484,34.88935790726629,37.40081779145204,NaN,NaN,50
1685372400,1.07088,1.07116,1.07082,1.07082,587,1006.95,-622632,-622166,33.38115248866768,34.32110172738382,36.58294502423996,NaN,NaN,50
1685374200,1.07082,1.07154,1.07082,1.0714,358,981.25,-622274,-622392,32.80075488232527,43.8428683775468,36.6733987563659,NaN,NaN,50
1685376000,1.0714,1.07143,1.07113,1.07126,394,945.9,-622668,-622491,32.261814247864464,42.25062469314528,37.17991424452176,NaN,NaN,50
1685377800,1.07126,1.07138,1.07122,1.07128,312,910.55,-622356,-622395,31.761369373008,42.57149147311546,37.65019029960806,NaN,NaN,50
1685379600,1.07128,1.0715,1.07124,1.07124,127,843.55,-622483,-622482.6,30.89045109092207,42.06805511326109,38.16996683253583,NaN,NaN,50
1685381400,1.07124,1.07133,1.07114,1.07118,178,779.1,-622661,-622488.4,30.306671586291365,41.279492817565185,38.54614330299704,NaN,NaN,50
1685383200,1.07118,1.0712,1.07112,1.07113,106,708.7,-622767,-622587,29.810751132885795,40.596562686416554,38.56200587159505,NaN,NaN,50
1685385000,1.07113,1.07119,1.07105,1.07108,169,665.5,-622936,-622640.6,29.51751634492893,39.885928153940284,38.99238238242559,NaN,NaN,50
1685386800,1.07108,1.07108,1.07098,1.071,136,617.35,-623072,-622783.8,29.414288866856076,38.718108335846836,39.1327833748963,NaN,NaN,50
1685388600,1.071,1.0711,1.07092,1.07092,196,575.2,-623268,-622940.8,29.465204235566205,37.53459658508094,38.956582850775554,NaN,NaN,50
1685390400,1.07092,1.07102,1.07055,1.07058,279,549.35,-623547,-623118,30.308349740373558,32.92783967884108,38.61338949808708,NaN,NaN,50
1685392200,1.07058,1.07103,1.07058,1.07091,147,506.65,-623400,-623244.6,31.044652821933454,40.553999306409914,38.987499195744654,NaN,NaN,50
1685394000,1.07091,1.07137,1.07091,1.0711,171,476.9,-623229,-623303.2,30.275146686802035,44.468929199019755,39.707782575345696,NaN,NaN,50
1685395800,1.0711,1.07116,1.07094,1.07096,162,438.85,-623391,-623367,29.560605275608566,42.26044386628175,40.234288715275376,NaN,NaN,50
1685397600,1.07096,1.07122,1.07083,1.07086,354,415.15,-623745,-623462.4,29.190347588076154,40.705386627451944,40.69030906528024,NaN,NaN,50
1685399400,1.07086,1.07115,1.07086,1.07098,328,383.6,-623417,-623436.4,28.846536878224637,43.39702974092419,40.65846344837862,NaN,NaN,50
1685401200,1.07098,1.07098,1.07078,1.07089,314,340.05,-623731,-623502.6,28.752124191045365,41.86216582926231,40.6307163866727,NaN,NaN,50
1685403000,1.07089,1.07089,1.0706,1.07068,519,314.55,-624250,-623706.8,29.138746406644568,38.44539634013567,40.33599530574558,NaN,NaN,50
1685404800,1.07068,1.07194,1.07043,1.07155,1530,357.9,-622720,-623572.6,28.11782473130896,54.87690688863735,41.25091328970102,NaN,NaN,50
1685406600,1.07155,1.07199,1.0707,1.07139,1393,388,-624113,-623646.2,27.28167569008615,52.1212979415446,42.02532794141383,NaN,NaN,50
1685408400,1.07139,1.07209,1.07138,1.07208,1462,431.75,-622651,-623493,26.73271920816663,61.17545675942908,43.49524894662901,NaN,NaN,50
1685410200,1.07208,1.07264,1.07194,1.07232,1561,491.9,-621090,-622964.8,27.280348023667973,63.743699457874854,45.19937546833862,NaN,NaN,50
1685412000,1.07232,1.07252,1.07206,1.07224,968,520.6,-622058,-622526.4,27.788860495204933,62.26514229158901,46.88130646517735,NaN,NaN,50
1685413800,1.07224,1.07233,1.07194,1.07214,893,549.65,-622951,-622572.6,27.833721313057353,60.37981257575925,48.51310760736866,NaN,NaN,50
1685415600,1.07214,1.07218,1.07072,1.07084,1155,601.05,-624106,-622571.2,26.82142650001889,42.40432968797029,49.18999975087788,NaN,NaN,50
1685417400,1.07084,1.07084,1.07012,1.07066,1251,654.7,-625357,-623112.4,26.793428564844806,40.601937088726835,49.19342387818624,NaN,NaN,50
1685419200,1.07066,1.07078,1.07036,1.07054,952,697,-626309,-624156.2,26.76743048218316,39.39960487330766,48.831329283492515,NaN,NaN,50
1685421000,1.07054,1.07088,1.07047,1.0708,944,735.75,-625365,-624817.6,26.492324807785405,43.31624043105969,48.906743323833794,NaN,NaN,50
1685422800,1.0708,1.07084,1.06836,1.06914,1679,812.9,-627044,-625636.2,28.36802036730853,29.989448669576575,48.14131918398555,NaN,NaN,50
1685424600,1.06914,1.06946,1.06812,1.06862,2134,909.8,-629178,-626650.6,30.262504238418614,27.169528012388795,46.982211917661594,NaN,NaN,50
1685426400,1.06862,1.06906,1.06848,1.06881,2323,1012,-626855,-626950.2,32.02166783302083,29.768117385490868,46.11835131453506,NaN,NaN,50
1685428200,1.06881,1.06984,1.06877,1.06945,2457,1127.5,-624398,-626568,32.04264467378407,37.816535088071596,46.07343265367334,NaN,NaN,50
1685430000,1.06945,1.06945,1.06725,1.06776,3312,1284.55,-627710,-627037,33.194536465987696,28.52167852773212,44.19091634218011,NaN,NaN,50
1685431800,1.06776,1.0691,1.0673,1.06904,2947,1423.8,-624763,-626580.8,34.26415027303392,40.45849951639016,43.357859311811936,NaN,NaN,50
1685433600,1.06904,1.07018,1.06874,1.06974,2832,1547.7,-621931,-625131.4,33.54507872781913,45.79019049993097,42.25891172184778,NaN,NaN,50
1685435400,1.06974,1.07082,1.06958,1.07046,2498,1656.2,-619433,-623647,32.04714209871668,50.682002617553216,41.32593337611052,NaN,NaN,50
1685437200,1.07046,1.07176,1.06971,1.0716,2867,1783.85,-616566,-622080.6,29.896739648763344,57.25855293576232,40.968319850694336,NaN,NaN,50
1685439000,1.0716,1.07248,1.07143,1.07195,2954,1905.6,-613612,-619261,28.57329049151433,59.06344757543342,40.874293779242485,NaN,NaN,50
1685440800,1.07195,1.0733,1.07195,1.07263,2604,1959.3,-611008,-616510,28.012109866818452,62.38674424432349,42.30160910469628,NaN,NaN,50
1685442600,1.07263,1.07359,1.07256,1.07317,2205,1999.9,-608803,-613884.4,27.709720317327637,64.82858437435489,44.03208391081255,NaN,NaN,50
1685444400,1.07317,1.07382,1.07306,1.07332,2070,2030.3,-606733,-611344.4,27.602781218296073,65.49861554181342,45.896298958562966,NaN,NaN,50
1685446200,1.07332,1.07448,1.07312,1.07441,2478,2076.15,-604255,-608882.2,27.976863941038832,69.97482702099377,47.80048371498683,NaN,NaN,50
1685448000,1.07441,1.07467,1.07334,1.0736,2818,2168.65,-607073,-607574.4,28.45418602704332,63.39283361065354,50.18643978220661,NaN,NaN,50
1685449800,1.0736,1.0738,1.07218,1.07225,3190,2283.5,-610263,-607425.4,27.443183879358163,54.23615563828288,52.11977032691333,NaN,NaN,50
1685451600,1.07225,1.07388,1.07186,1.07335,2918,2371.65,-607345,-607133.8,26.153451571289498,59.384138007291114,54.23520037132763,NaN,NaN,50
1685453400,1.07335,1.07358,1.07262,1.07301,3397,2478.95,-610742,-607935.6,24.95584299951145,57.240797641695856,55.62264769658651,NaN,NaN,50
1685455200,1.07301,1.07352,1.07204,1.07282,4208,2641.75,-614950,-610074.6,23.19628441226919,56.02390180382955,57.58709221630776,NaN,NaN,50
1685457000,1.07282,1.07409,1.07257,1.07276,3690,2779.05,-618640,-612388,22.136510741504285,55.62176407558316,58.6701825419644,NaN,NaN,50
1685458800,1.07276,1.07286,1.07198,1.07225,2880,2839.1,-621520,-614639.4,20.596547747343404,52.19240925564431,59.127483881658215,NaN,NaN,50
1685460600,1.07225,1.07266,1.07198,1.07216,1764,2820.6,-623284,-617827.2,19.1665821099083,51.58794185821726,59.192193827419935,NaN,NaN,50
1685462400,1.07216,1.0727,1.07164,1.07252,1622,2785.55,-621662,-620011.2,18.209739508526688,53.88843061504311,58.951470804511416,NaN,NaN,50
1685464200,1.07252,1.07274,1.07208,1.07208,1551,2740.25,-623213,-621663.8,17.27156831741606,50.71631423855134,58.355246994734124,NaN,NaN,50
1685466000,1.07208,1.07216,1.07142,1.07165,1391,2644.2,-624604,-622856.6,17.109704904744962,47.75764163068492,57.31031109375994,NaN,NaN,50
1685467800,1.07165,1.07196,1.07144,1.0717,1317,2562.7,-623287,-623210,16.959403164407515,48.13651766309649,56.11802061438434,NaN,NaN,50
1685469600,1.0717,1.07192,1.07142,1.07176,1399,2491.05,-621888,-622930.8,16.842075522629077,48.618077916639734,54.912267926871934,NaN,NaN,50
1685471400,1.07176,1.0721,1.0717,1.07196,1444,2438.35,-620444,-622687.2,16.45071954392279,50.27546193423577,53.505170420674936,NaN,NaN,50
1685473200,1.07196,1.07292,1.0718,1.0727,1577,2373.85,-618867,-621818,15.60935716309623,55.93860404735834,52.972725451868136,NaN,NaN,50
1685475000,1.0727,1.07304,1.0727,1.073,1383,2295.3,-617484,-620394,14.979177275596237,58.025709007472486,53.24340783538168,NaN,NaN,50
1685476800,1.073,1.07338,1.07272,1.0732,865,2208.35,-616619,-619060.4,14.816201031890447,59.4062171925153,53.24498492004056,NaN,NaN,50
1685478600,1.0732,1.07349,1.07318,1.07342,488,2122.5,-616131,-617909,14.799658570021498,60.928492333304646,53.50839168372689,NaN,NaN,50
1685480400,1.07342,1.07342,1.07274,1.07326,189,2028.45,-616320,-617084.2,14.08711722793479,59.19003431096526,53.734544005665164,NaN,NaN,50
1685482200,1.07326,1.0735,1.07322,1.07336,337,1921.4,-615983,-616507.4,13.536999765877317,59.95901117141153,54.044347369652904,NaN,NaN,50
1685484000,1.07336,1.07348,1.07311,1.07313,375,1799.25,-616358,-616282.2,12.84595648056213,57.28536903871648,54.40813021130092,NaN,NaN,50
1685485800,1.07313,1.07336,1.07313,1.07322,236,1651.55,-616122,-616182.8,12.204273429912313,58.073212186010466,54.87136380614329,NaN,NaN,50
1685487600,1.07322,1.07357,1.07316,1.0735,393,1525.3,-615729,-616102.4,11.951021767508044,60.51334599812484,55.344572047791985,NaN,NaN,50
1685489400,1.0735,1.07358,1.07306,1.07318,623,1386.6,-616352,-616108.8,11.522240236174957,56.46847442182994,55.75544063231189,NaN,NaN,50
1685491200,1.07318,1.07332,1.07274,1.07307,993,1225.85,-617345,-616381.2,10.873452628801541,55.10492349127781,56.2802464794971,NaN,NaN,50
1685493000,1.07307,1.07356,1.07288,1.07352,1320,1107.35,-616025,-616314.6,10.362287575146693,59.42173688188426,57.086333566553364,NaN,NaN,50
1685494800,1.07352,1.07355,1.07297,1.07306,1259,1026.3,-617284,-616547,9.887634311038623,53.733949857414345,57.45175299089441,NaN,NaN,50
1685496600,1.07306,1.07341,1.0712,1.07134,2405,1058.35,-619689,-617339,11.431089032067463,38.78484115459787,56.63099436377742,NaN,NaN,50
1685498400,1.07134,1.07148,1.07076,1.07082,1656,1060.05,-621345,-618337.6,13.271982314063296,35.56354156294644,55.175632757748,NaN,NaN,50
1685500200,1.07082,1.07084,1.07028,1.07047,1257,1045.35,-622602,-619389,15.381291904050295,33.544085358928584,53.426945354280576,NaN,NaN,50
1685502000,1.07047,1.07052,1.0695,1.06988,1356,1043.6,-623958,-620975.6,17.891347736822922,30.40932159471086,51.35573852586598,NaN,NaN,50
1685503800,1.06988,1.07006,1.06944,1.06979,896,1022.55,-624854,-622489.6,20.26119086871592,29.949537269505328,49.14295602130888,NaN,NaN,50
1685505600,1.06979,1.0701,1.06952,1.06988,869,996.05,-623985,-623348.8,22.37677396298454,31.071887752380462,47.13451698140996,NaN,NaN,50
1685507400,1.06988,1.07006,1.06952,1.06982,744,961.05,-624729,-624025.6,24.34124397909111,30.71853263917454,45.04591137196446,NaN,NaN,50
1685509200,1.06982,1.0699,1.06912,1.06944,1216,943,-625945,-624694.2,26.465031178480725,28.507383063366703,42.99034094515377,NaN,NaN,50
1685511000,1.06944,1.0699,1.06852,1.06975,2490,998.35,-623455,-624593.6,28.82781357885808,32.75955682388127,41.18222270500168,NaN,NaN,50
1685512800,1.06975,1.06982,1.06852,1.06859,2323,1071.25,-625778,-624778.4,31.02182580777991,26.425828868151186,38.7474000528607,NaN,NaN,50
1685514600,1.06859,1.06912,1.06793,1.06849,2534,1173.55,-628312,-625643.8,33.40468236702682,25.959866823661855,36.56821379584869,NaN,NaN,50
1685516400,1.06849,1.06849,1.0672,1.06784,3398,1334,-631710,-627040,35.96700329263821,23.107689707385916,34.282697096999264,NaN,NaN,50
1685518200,1.06784,1.06806,1.067,1.06742,2817,1458,-634527,-628756.4,38.431822560234366,21.466510165954887,31.571609474432883,NaN,NaN,50
1685520000,1.06742,1.0677,1.06658,1.06705,2738,1576.15,-637265,-631518.4,40.89140070897629,20.111387181560232,29.16999785472902,NaN,NaN,50
1685521800,1.06705,1.06714,1.06587,1.06599,2745,1701.6,-640010,-634364.8,43.424357067790496,16.832953434176332,27.602005874698907,NaN,NaN,50
1685523600,1.06599,1.06738,1.06599,1.06724,2343,1799.1,-637667,-636235.8,45.21345392237887,31.09723398859647,27.28298390510248,NaN,NaN,50
1685525400,1.06724,1.06764,1.067,1.0676,1804,1858.15,-635863,-637066.4,46.278442126339456,34.577427411279984,27.356794051699012,NaN,NaN,50
1685527200,1.0676,1.06764,1.06676,1.06722,1564,1886.7,-637427,-637646.4,47.401083328959444,32.69993007854258,27.520408943401275,NaN,NaN,50
1685529000,1.06722,1.06789,1.06722,1.06763,1701,1905.75,-635726,-637338.6,47.8646215799227,36.694006953728085,28.002156777988613,NaN,NaN,50
1685530800,1.06763,1.06828,1.06748,1.06822,1692,1927.4,-634034,-636143.4,47.44276898853705,42.02597115306852,28.784591306609183,NaN,NaN,50
1685532600,1.06822,1.06872,1.06788,1.06798,2073,1910.8,-636107,-635831.4,46.178063511938596,40.53053243252718,29.4854484347058,NaN,NaN,50
1685534400,1.06798,1.06875,1.06792,1.06825,2024,1929.2,-634083,-635475.4,44.94548048394208,42.988361042829105,30.5198040046674,NaN,NaN,50
1685536200,1.06825,1.0687,1.06798,1.06808,2277,1980.2,-636360,-635262,43.80093910080245,41.816502759277554,31.166728714338557,NaN,NaN,50
1685538000,1.06808,1.06874,1.06784,1.06858,2408,2032.8,-633952,-634907.2,42.90508791855826,46.44097949402917,32.5963823304727,NaN,NaN,50
1685539800,1.06858,1.07054,1.06855,1.06916,4213,2198.65,-629739,-634048.2,40.54077550560333,51.27853324759954,34.4048585036111,NaN,NaN,50
1685541600,1.06916,1.0692,1.0658,1.06642,6706,2490.5,-636445,-634115.8,39.60989300543787,35.133935465520636,35.26387605776359,NaN,NaN,50
1685543400,1.06642,1.0685,1.06575,1.06614,5890,2747.8,-642335,-635766.2,38.779727011754176,33.95736545126583,36.15608000671437,NaN,NaN,50
1685545200,1.06614,1.06642,1.0651,1.06556,4476,2910.8,-646811,-637856.4,38.44452529361773,31.596938184715924,36.976476506939775,NaN,NaN,50
1685547000,1.06556,1.06674,1.06522,1.06528,2916,2932.1,-649727,-641011.4,37.721664352353926,30.494895282756076,37.952329496124044,NaN,NaN,50
1685548800,1.06528,1.06543,1.064,1.06454,2833,2957.6,-652560,-645575.6,37.818300599909904,27.741077508614268,37.71260403326817,NaN,NaN,50
1685550600,1.06454,1.0647,1.06352,1.06381,2373,2949.55,-654933,-649273.2,38.16806266508333,25.31266864101582,37.05083554967787,NaN,NaN,50
1685552400,1.06381,1.06492,1.06356,1.06484,2053,2882.3,-652880,-651382.2,38.20080697265431,34.08084299462462,37.149472186540876,NaN,NaN,50
1685554200,1.06484,1.067,1.0648,1.06633,3120,2897.45,-649760,-651972,35.99517549983837,44.27291113722681,37.69082248536222,NaN,NaN,50
1685556000,1.06633,1.06758,1.0663,1.06752,2165,2868.8,-647595,-651545.6,33.46026096307982,50.81383391752485,38.31852696853766,NaN,NaN,50
1685557800,1.06752,1.068,1.06714,1.0674,2176,2840.35,-649771,-650987.8,31.37283437955139,50.17428637007814,39.0073665355056,NaN,NaN,50
1685559600,1.0674,1.06767,1.06705,1.06732,1752,2810.8,-651523,-650305.8,29.354306142418913,49.724963246672445,39.488552407208694,NaN,NaN,50
1685561400,1.06732,1.06892,1.06722,1.06863,2148,2828,-649375,-649604.8,28.440270883430024,56.581684945456374,40.54320827765004,NaN,NaN,50
1685563200,1.06863,1.06923,1.06858,1.06902,1390,2819.3,-647985,-649249.8,27.8045176111677,58.40066729448811,41.397471691968526,NaN,NaN,50
1685565000,1.06902,1.06912,1.06879,1.06888,666,2767.55,-648651,-649461,27.214175286924114,57.4698937614189,41.83971172866991,NaN,NaN,50
1685566800,1.06888,1.06902,1.06848,1.06848,212,2693.55,-648863,-649279.4,26.326198052468254,54.783364614618534,43.24324238217691,NaN,NaN,50
1685568600,1.06848,1.06887,1.06848,1.06874,379,2608.85,-648484,-648671.6,25.50164776333067,56.21609252021523,44.83315145853044,NaN,NaN,50
1685570400,1.06874,1.06907,1.06874,1.06896,460,2530.65,-648024,-648401.4,24.912003904301187,57.44480997362332,46.67942801488097,NaN,NaN,50
1685572200,1.06896,1.06946,1.06893,1.06932,684,2451,-647340,-648272.4,24.702862621577598,59.45016426812739,48.747661513836064,NaN,NaN,50
1685574000,1.06932,1.06974,1.06927,1.06959,728,2367,-646612,-647864.6,24.744858848914213,60.93695755170835,51.11879580262849,NaN,NaN,50
1685575800,1.06959,1.06959,1.06928,1.06934,768,2194.75,-647380,-647568,24.783855345726778,58.78760247266802,53.50986250488937,NaN,NaN,50
1685577600,1.06934,1.06952,1.06902,1.06934,1197,1919.3,-647380,-647347.2,24.429393490844177,58.78760247266802,55.27463103903533,NaN,NaN,50
1685579400,1.06934,1.06934,1.06854,1.06865,1403,1694.95,-648783,-647499,23.4167559579752,52.8236489807491,55.88539802785835,NaN,NaN,50
1685581200,1.06865,1.06898,1.06832,1.06875,1679,1555.1,-647104,-647451.8,22.17779810558457,53.55898492533533,56.08148024270196,NaN,NaN,50
1685583000,1.06875,1.06935,1.06802,1.06916,2401,1529.35,-644703,-647070,21.45854661212771,56.54936324112039,56.536842876347826,NaN,NaN,50
1685584800,1.06916,1.0694,1.06882,1.06886,1537,1464.55,-646240,-646842,20.84884674895509,53.818630755488364,56.82924769840611,NaN,NaN,50
1685586600,1.06886,1.0692,1.06886,1.06906,1344,1413.1,-644896,-646345.2,20.282696876009084,55.36605754530886,56.742417169824144,NaN,NaN,50
1685588400,1.06906,1.06936,1.06892,1.06901,1289,1374.9,-646185,-645825.6,19.96378080371759,54.87105062123783,56.49030169316341,NaN,NaN,50
1685590200,1.06901,1.06912,1.06854,1.06871,927,1265.25,-647112,-645827.2,19.01928859407517,51.874265731758385,56.09061397675909,NaN,NaN,50
1685592000,1.06871,1.06915,1.06838,1.06908,969,1205.45,-646143,-646115.2,17.88060820180179,55.129193271901734,56.115316023707884,NaN,NaN,50
1685593800,1.06908,1.06916,1.06814,1.06816,911,1142.2,-647054,-646278,16.770306321375106,46.67587516042343,55.433871926579904,NaN,NaN,50
1685595600,1.06816,1.06846,1.06786,1.06819,1242,1116.7,-645812,-646461.2,16.17117559848145,46.961473145366824,54.68506215313301,NaN,NaN,50
1685597400,1.06819,1.06827,1.0676,1.06772,1511,1084.85,-647323,-646688.8,15.996349994143749,43.06956012870733,53.51501900031729,NaN,NaN,50
1685599200,1.06772,1.06831,1.06733,1.06798,2040,1117.35,-645283,-646323,16.211205575599898,45.748090736858074,52.4300999421137,NaN,NaN,50
1685601000,1.06798,1.06855,1.06745,1.06843,2032,1185.65,-643251,-645744.6,15.940236611272002,50.12214060350767,51.81113838003081,NaN,NaN,50
1685602800,1.06843,1.06866,1.0672,1.06725,3244,1337.25,-646495,-645632.8,16.054339703497618,40.826749207171716,50.52822028963822,NaN,NaN,50
1685604600,1.06725,1.06752,1.06618,1.06704,2672,1451.9,-649167,-646303.8,17.364055924950453,39.42543185245577,49.57120478047441,NaN,NaN,50
1685606400,1.06704,1.06766,1.06646,1.06747,2422,1550,-646745,-646188.2,18.298745089916473,43.68759089268297,48.86610520671353,NaN,NaN,50
1685608200,1.06747,1.06871,1.06718,1.06867,1932,1612.4,-644813,-646094.2,17.382443655686135,53.517066076204685,48.64951255207669,NaN,NaN,50
1685610000,1.06867,1.06948,1.06828,1.06907,1945,1673.25,-642868,-646017.6,16.739699382690286,56.25793895912922,48.82374885233675,NaN,NaN,50
1685611800,1.06907,1.07098,1.06886,1.0709,2184,1744.05,-640684,-644855.4,17.556646714400884,66.10500266930465,49.590816361193596,NaN,NaN,50
1685613600,1.0709,1.07124,1.07008,1.07043,2251,1796.75,-642935,-643609,18.514111597001598,62.23027925648116,50.11647554942526,NaN,NaN,50
1685615400,1.07043,1.07148,1.07043,1.0709,2083,1830.75,-640852,-642430.4,19.586165611431806,64.47287564955424,51.01637625783925,NaN,NaN,50
1685617200,1.0709,1.07158,1.07087,1.07088,2012,1847.4,-642864,-642040.6,20.65940916249574,64.29792276423834,51.67128550729187,NaN,NaN,50
1685619000,1.07088,1.07146,1.0705,1.0706,2017,1828.2,-644881,-642443.2,21.06697870252398,61.770723563151584,52.7494889646296,NaN,NaN,50
1685620800,1.0706,1.07074,1.06846,1.0693,4248,1963.75,-649129,-644132.2,20.086387655596376,51.62520350283284,53.08261256159146,NaN,NaN,50
1685622600,1.0693,1.07116,1.06912,1.07081,5034,2148.25,-644095,-644364.2,18.747749417603245,59.86998618590782,54.28264299424863,NaN,NaN,50
1685624400,1.07081,1.07134,1.0703,1.07125,3356,2251.6,-640739,-644341.6,17.49438203151412,61.907319151900154,55.436873595323064,NaN,NaN,50
1685626200,1.07125,1.07312,1.07118,1.07288,4655,2438,-636084,-642985.6,17.820105152595154,68.32316716593238,56.73694692121055,NaN,NaN,50
1685628000,1.07288,1.0742,1.0721,1.0726,5981,2688.6,-642065,-642422.4,18.797359720045453,66.25868815127009,58.553513988646145,NaN,NaN,50
1685629800,1.0726,1.07365,1.07216,1.07314,4289,2857.5,-637776,-640151.8,19.704810389820732,68.2511537944411,60.612494127359376,NaN,NaN,50
1685631600,1.07314,1.07408,1.0728,1.07372,3110,2950.9,-634666,-638266,20.806757465234146,70.28108248289641,62.512029240946056,NaN,NaN,50
1685633400,1.07372,1.07539,1.07359,1.07506,2970,3023.85,-631696,-636457.4,22.516332783635864,74.35989806626802,64.00080295452202,NaN,NaN,50
1685635200,1.07506,1.07538,1.07478,1.07538,2210,3032.35,-629486,-635137.8,24.103795579294605,75.2340480864615,65.35623932076003,NaN,NaN,50
1685637000,1.07538,1.07641,1.07534,1.076,2000,3030.75,-627486,-632222,26.047571992144853,76.8788091543512,66.12579692683478,NaN,NaN,50
1685638800,1.076,1.07617,1.07558,1.07608,1620,2949.55,-625866,-629840,27.852507232648655,77.09023178311153,67.18722210730837,NaN,NaN,50
1685640600,1.07608,1.07645,1.07574,1.07642,1297,2880.8,-624569,-627820.6,29.65426462306113,78.01053216561172,68.15419757274107,NaN,NaN,50
1685642400,1.07642,1.07677,1.07626,1.07676,1458,2832.6,-623111,-626103.6,31.470137029004842,78.92236548980792,69.19880062456745,NaN,NaN,50
1685644200,1.07676,1.07685,1.07614,1.07618,1329,2802.45,-624440,-625094.4,32.96892044042245,73.3357325791281,70.02487269713721,NaN,NaN,50
1685646000,1.07618,1.0763,1.07598,1.07604,1300,2770.2,-625740,-624745.2,34.10240838594265,72.01068429142435,71.48097846775089,NaN,NaN,50
1685647800,1.07604,1.07624,1.07568,1.07624,1350,2728.5,-624390,-624450,34.66911691872207,72.76766971971699,72.40224157730869,NaN,NaN,50
1685649600,1.07624,1.07636,1.07588,1.07598,613,2646.6,-625003,-624536.8,35.27527323425811,70.11293327915001,72.98835687211225,NaN,NaN,50
1685651400,1.07598,1.07626,1.07596,1.07622,408,2562.85,-624595,-624833.6,35.83813267011301,71.15889877817438,73.19090913012953,NaN,NaN,50
1685653200,1.07622,1.07643,1.07588,1.07604,177,2471.1,-624772,-624900,36.48561341315041,69.20274350160143,73.40119879801034,NaN,NaN,50
1685655000,1.07604,1.0762,1.07594,1.07597,553,2397.9,-625325,-624817,37.08684553168515,68.41508817157312,73.41290839637692,NaN,NaN,50
1685656800,1.07597,1.07644,1.07593,1.07636,750,2223,-624575,-624854,37.83373449580267,70.4341713477291,73.42384331529354,NaN,NaN,50
1685658600,1.07636,1.07654,1.0762,1.07654,269,1984.75,-624306,-624714.6,38.60615148285242,71.34465624309527,73.20846889935262,NaN,NaN,50
1685660400,1.07654,1.07654,1.07602,1.07602,445,1839.2,-624751,-624745.8,38.90710638817735,65.10694155674696,72.48510414723016,NaN,NaN,50
1685662200,1.07602,1.07618,1.07596,1.07604,379,1625.4,-624372,-624665.8,39.04497901933393,65.23284700414087,71.65324970792942,NaN,NaN,50
1685664000,1.07604,1.07644,1.07582,1.07602,1075,1380.1,-625447,-624690.2,39.43006121459595,64.98034074350903,70.78825749081497,NaN,NaN,50
1685665800,1.07602,1.07638,1.0759,1.07619,981,1214.7,-624466,-624668.4,39.787637538767825,66.17873381336007,69.9431290370827,NaN,NaN,50
1685667600,1.07619,1.07643,1.07588,1.07616,998,1109.1,-625464,-624900,40.17279645539709,65.75112409046847,69.00232607998703,NaN,NaN,50
1685669400,1.07616,1.07668,1.07594,1.07616,1481,1034.65,-625464,-625042.6,40.79369277439336,65.75112409046847,68.46056833079705,NaN,NaN,50
1685671200,1.07616,1.07661,1.07608,1.07652,1052,976.75,-624412,-625050.6,41.370239356318464,68.5768465107696,68.21529420360743,NaN,NaN,50
1685673000,1.07652,1.07672,1.07639,1.07655,1092,931.35,-623320,-624625.2,42.026751503274205,68.80780427150967,67.93244667159261,NaN,NaN,50
1685674800,1.07655,1.07692,1.07642,1.0768,954,898.05,-622366,-624205.2,42.85172727142708,70.7379536637532,67.97709098477856,NaN,NaN,50
1685676600,1.0768,1.07688,1.07634,1.0768,943,880.35,-622366,-623585.6,43.33697367449611,70.7379536637532,67.94702347660562,NaN,NaN,50
1685678400,1.0768,1.07686,1.07661,1.0768,767,845.8,-622366,-622966,43.78755962020305,70.7379536637532,68.05668134533074,NaN,NaN,50
1685680200,1.0768,1.07686,1.0762,1.07632,1081,833.4,-623447,-622773,42.7944182851879,61.59758080958034,67.56971653375983,NaN,NaN,50
1685682000,1.07632,1.07676,1.0762,1.07642,813,809.05,-622634,-622635.8,41.87221561695956,62.679518145900126,67.01581273362919,NaN,NaN,50
1685683800,1.07642,1.07722,1.07642,1.07712,1158,799.45,-621476,-622457.8,41.75027866880011,69.21733143768122,66.86386096181388,NaN,NaN,50
1685685600,1.07712,1.0779,1.077,1.07705,1642,850.9,-623118,-622608.2,42.445927879601925,67.93568593045171,67.06591413136422,NaN,NaN,50
1685687400,1.07705,1.07746,1.07662,1.07709,1704,915.7,-621414,-622417.8,41.985458272497524,68.29693024333467,67.28477721987807,NaN,NaN,50
1685689200,1.07709,1.0775,1.07677,1.07741,2543,1034,-618871,-621502.6,41.61026134230398,71.10186963257593,67.72202928338285,NaN,NaN,50
1685691000,1.07741,1.0776,1.076,1.0762,2254,1119.05,-621125,-621200.8,39.3871918586299,52.26995851584029,66.72854533356,NaN,NaN,50
1685692800,1.0762,1.0768,1.07602,1.07662,1917,1177.4,-619208,-620747.2,37.32291305236111,56.56981227364614,66.07273734664413,NaN,NaN,50
1685694600,1.07662,1.07772,1.07662,1.07743,1768,1252.35,-617440,-619611.6,36.749397003131534,63.41499975400005,65.90587132261068,NaN,NaN,50
1685696400,1.07743,1.0777,1.0764,1.07644,2162,1338.2,-619602,-619249.2,35.74281647547418,52.51945995217227,64.75891513985373,NaN,NaN,50
1685698200,1.07644,1.07704,1.07603,1.07672,1763,1407.4,-617839,-619042.8,34.06292378235997,54.88063019683177,63.76411699166244,NaN,NaN,50
1685700000,1.07672,1.07727,1.07664,1.07694,1371,1422.2,-616468,-618111.4,32.84079267835474,56.70252603679494,62.76158644687971,NaN,NaN,50
1685701800,1.07694,1.07749,1.07656,1.07674,1446,1445.45,-617914,-617852.6,32.01784041267522,54.54618762456108,61.60503172979456,NaN,NaN,50
1685703600,1.07674,1.07694,1.07628,1.07668,1595,1475.3,-619509,-618266.4,30.671166151400342,53.884151783808534,60.401188738369946,NaN,NaN,50
1685705400,1.07668,1.07683,1.07576,1.07576,1525,1477.5,-621034,-618552.8,28.49796966346723,44.887795664023436,59.20763265654444,NaN,NaN,50
1685707200,1.07576,1.07654,1.07576,1.07637,2270,1538.4,-618764,-618737.8,26.48000149610077,50.75817806193646,58.35610836483276,NaN,NaN,50
1685709000,1.07637,1.07675,1.07352,1.07474,8183,1892.95,-626947,-620833.6,27.255911140313817,38.849857999456894,56.1870031192453,NaN,NaN,50
1685710800,1.07474,1.07684,1.07458,1.07672,3979,2044.2,-622968,-621844.4,27.821043183645997,53.210026661515215,55.135170314321265,NaN,NaN,50
1685712600,1.07672,1.0771,1.07405,1.07424,4800,2237.05,-627768,-623496.2,28.76844536638154,40.409748835840595,53.14322878521454,NaN,NaN,50
1685714400,1.07424,1.07498,1.07236,1.07284,4703,2433.85,-632471,-625783.6,30.652335706084997,35.25396265866431,50.58266400136371,NaN,NaN,50
1685716200,1.07284,1.07344,1.07213,1.07235,3955,2577.55,-636426,-629316,32.509931060078344,33.636364924330664,49.2516930305416,NaN,NaN,50
1685718000,1.07235,1.07298,1.07216,1.07293,2778,2675.8,-633648,-630656.2,34.23484103164359,37.303464715231286,47.87552534779768,NaN,NaN,50
1685719800,1.07293,1.07297,1.07174,1.07232,2113,2723.55,-635761,-633214.8,36.04329370406023,35.10629271333859,45.853474844893285,NaN,NaN,50
1685721600,1.07232,1.07237,1.07104,1.07134,1869,2734.9,-637630,-635187.2,38.031810833358435,31.859634313361866,44.37777301354969,NaN,NaN,50
1685723400,1.07134,1.07169,1.07086,1.07102,1497,2724.55,-639127,-636518.4,39.95255893840217,30.85616933041392,42.661740094519836,NaN,NaN,50
1685725200,1.07102,1.07158,1.07076,1.07154,1554,2675.1,-637573,-636747.8,41.77853468980581,34.46820119691287,41.07357403452826,NaN,NaN,50
1685727000,1.07154,1.07159,1.07074,1.07102,1120,2618.4,-638693,-637756.8,43.48303371034125,32.63237523883821,39.50830172126234,NaN,NaN,50
1685728800,1.07102,1.07115,1.07057,1.07114,1395,2592.3,-637298,-638064.2,45.14478526106379,33.51244247272962,38.05317962761386,NaN,NaN,50
1685730600,1.07114,1.07154,1.071,1.07124,1154,2561.6,-636144,-637767,45.81037181868503,34.28289604027711,37.29568679734626,NaN,NaN,50
1685732400,1.07124,1.07144,1.07097,1.071,919,2499.45,-637063,-637354.2,46.44814685611561,33.28596934534713,36.047671889018446,NaN,NaN,50
1685734200,1.071,1.07109,1.07065,1.0708,1125,2467.55,-638188,-637477.2,47.25096354429187,32.43940107256324,35.589782108526045,NaN,NaN,50
1685736000,1.0708,1.07087,1.07052,1.07054,537,2425.85,-638725,-637483.6,48.08018372145776,31.324062066418776,34.026498923162016,NaN,NaN,50
1685737800,1.07054,1.07079,1.07054,1.07078,548,2380.95,-638177,-637659.4,48.85017388596894,33.59374721017366,33.5396416641858,NaN,NaN,50
1685912400,1.07078,1.071,1.07074,1.07097,84,2305.4,-638093,-638049.2,49.00516957057216,35.41357097148733,33.55104225795888,NaN,NaN,50
1685914200,1.07097,1.071,1.07078,1.07084,111,2234.7,-638204,-638277.4,49.149094134846564,34.712628631941044,33.62791823707391,NaN,NaN,50
1685916000,1.07084,1.07086,1.07042,1.07068,694,2155.9,-638898,-638419.4,49.59533969292032,33.82523818446879,33.37947348487659,NaN,NaN,50
1685917800,1.07068,1.07068,1.07012,1.07012,404,1766.95,-639302,-638534.8,50.246218718455026,30.8524146244757,33.07562504995781,NaN,NaN,50
1685919600,1.07012,1.07018,1.06974,1.06979,852,1610.6,-640154,-638930.2,51.12181466271954,29.22253064947222,32.887260502537124,NaN,NaN,50
1685921400,1.06979,1.06982,1.06938,1.06968,869,1414.05,-641023,-639516.2,52.16457389990329,28.67866713779567,32.73172463163582,NaN,NaN,50
1685923200,1.06968,1.06972,1.06903,1.06917,1194,1238.6,-642217,-640318.8,53.33460919671486,26.24027958815094,32.144015945295685,NaN,NaN,50
1685925000,1.06917,1.06958,1.06903,1.06937,1203,1101,-641014,-640742,54.42107054375417,28.797018897650275,31.870061920925117,NaN,NaN,50
1685926800,1.06937,1.06982,1.0691,1.06934,1583,1041.25,-642597,-641401,54.68953759413008,28.636670122805853,31.521792467359138,NaN,NaN,50
1685928600,1.06934,1.07016,1.06922,1.07014,1703,1020.75,-640894,-641549,53.969660753039314,38.47503461539682,31.821230937010544,NaN,NaN,50
1685930400,1.07014,1.07047,1.0699,1.07006,1249,989.75,-642143,-641773,52.49878994899273,37.91216082938169,32.15167318587016,NaN,NaN,50
1685932200,1.07006,1.07014,1.06986,1.07004,892,959.5,-643035,-641936.6,51.1838016686108,37.763420745024725,32.53196030533169,NaN,NaN,50
1685934000,1.07004,1.07025,1.06993,1.06998,737,918.65,-643772,-642488.2,49.66910879603891,37.29075234485406,32.95815246807707,NaN,NaN,50
1685935800,1.06998,1.07042,1.06998,1.07027,768,901.05,-643004,-642569.6,47.81188593554339,41.126388055784744,33.496198242763576,NaN,NaN,50
1685937600,1.07027,1.07034,1.06966,1.06994,913,876.95,-643917,-643174.2,46.57582307396497,38.25867119179219,33.699419687071064,NaN,NaN,50
1685939400,1.06994,1.07002,1.06968,1.07,706,854.55,-643211,-643387.8,45.42805041678502,39.09028985623638,34.01210977452073,NaN,NaN,50
1685941200,1.07,1.07,1.0694,1.06958,1046,860.9,-644257,-643632.2,44.77596014321801,35.486991967357085,34.13080647329846,NaN,NaN,50
1685943000,1.06958,1.07038,1.06952,1.07014,1177,863.5,-643080,-643493.8,43.11332320153277,43.027796958271374,35.000476639998155,NaN,NaN,50
1685944800,1.07014,1.07014,1.0692,1.06936,1953,934.3,-645033,-643899.6,42.07210236061684,36.609051498856275,35.528085272097016,NaN,NaN,50
1685946600,1.06936,1.06956,1.06894,1.06938,1687,991.25,-643346,-643785.4,41.476528457134755,36.8691052150804,36.113116563331644,NaN,NaN,50
1685948400,1.06938,1.06982,1.06834,1.0688,3036,1138.85,-646382,-644419.6,41.64809896953324,32.68188678595466,36.57323136317477,NaN,NaN,50
1685950200,1.0688,1.06994,1.06862,1.06898,2337,1250.15,-644045,-644377.2,41.47937058969518,35.14364147989143,37.02656154762057,NaN,NaN,50
1685952000,1.06898,1.0697,1.06854,1.06894,1901,1310.5,-645946,-644950.4,41.41985223215316,34.83874840962808,37.46956713953644,NaN,NaN,50
1685953800,1.06894,1.06978,1.06866,1.06961,1608,1370.7,-644338,-644811.4,41.12791277422839,43.65625860807683,37.83965456758501,NaN,NaN,50
1685955600,1.06961,1.06966,1.06901,1.06934,1651,1410.65,-645989,-645340,40.85682613472682,41.234710255700904,38.076979526607815,NaN,NaN,50
1685957400,1.06934,1.06992,1.06911,1.06924,1680,1451.2,-647669,-645597.4,39.80508534526837,40.34217202423494,38.2611760465514,NaN,NaN,50
1685959200,1.06924,1.06935,1.0687,1.06876,1472,1465.1,-649141,-646616.6,39.47033060379418,36.28253315292866,38.189160389985304,NaN,NaN,50
1685961000,1.06876,1.06949,1.06868,1.0693,1313,1470.6,-647828,-646993,38.7462248776104,43.20662768368482,38.337748934835304,NaN,NaN,50
1685962800,1.0693,1.0695,1.06876,1.06876,1237,1453.3,-649065,-647938.4,38.04351269292949,38.67999197141894,38.36784327623722,NaN,NaN,50
1685964600,1.06876,1.0694,1.0685,1.06896,1486,1442.45,-647579,-648256.4,37.81848257277302,41.13961848998967,38.51422389293388,NaN,NaN,50
1685966400,1.06896,1.06918,1.06842,1.06844,1903,1475.15,-649482,-648619,37.735733345063416,36.98569254149685,38.62127393394386,NaN,NaN,50
1685968200,1.06844,1.06844,1.06746,1.06791,2291,1545.1,-651773,-649145.4,38.83362600566805,33.2955595568781,37.926114119558626,NaN,NaN,50
1685970000,1.06791,1.0686,1.06779,1.06846,2108,1613.65,-649665,-649512.8,39.36612533040322,39.987076048742,38.1674015874076,NaN,NaN,50
1685971800,1.06846,1.06914,1.06797,1.06809,2748,1712.65,-652413,-650182.4,38.40502102203588,37.277855006888295,38.196598001108164,NaN,NaN,50
1685973600,1.06809,1.07224,1.06809,1.07178,6991,2016.55,-645422,-649751,37.97249363994563,63.695516793328466,40.41185728734916,NaN,NaN,50
1685975400,1.07178,1.07205,1.07054,1.07109,4007,2181.6,-649429,-649740.4,37.570861070861824,58.71547000190515,42.09555932463585,NaN,NaN,50
1685977200,1.07109,1.07148,1.07075,1.07128,2376,2248.1,-647053,-648796.4,37.19791654242687,59.65097643997074,43.86786132680318,NaN,NaN,50
1685979000,1.07128,1.07207,1.07032,1.07207,1806,2279.55,-645247,-647912.8,37.330436633648425,63.36786733373615,45.27583337863599,NaN,NaN,50
1685980800,1.07207,1.07214,1.07126,1.07132,1587,2261.25,-646834,-646797,37.50791932317816,57.91348773592984,46.46717462722377,NaN,NaN,50
1685982600,1.07132,1.07142,1.071,1.07116,1011,2227.45,-647845,-647281.6,37.197066816040156,56.79044839878319,47.64205151112007,NaN,NaN,50
1685984400,1.07116,1.07141,1.07081,1.07083,1111,2131.2,-648956,-647187,36.564792877111664,54.44538306481828,48.939397933397906,NaN,NaN,50
1685986200,1.07083,1.07131,1.07074,1.07129,951,2061.9,-648005,-647377.4,35.848127020293326,57.10439923730551,49.93209590151367,NaN,NaN,50
1685988000,1.07129,1.07152,1.07109,1.07144,1046,2019.15,-646959,-647719.8,35.41178599502715,57.96600259657078,51.30966808902451,NaN,NaN,50
1685989800,1.07144,1.07172,1.07113,1.07138,1666,2022.05,-648625,-648078,35.22172706068968,57.46875681655697,52.47603511235075,NaN,NaN,50
1685991600,1.07138,1.07154,1.07113,1.07148,1296,2004.3,-647329,-647974.8,35.04524376451918,58.11367327901597,53.98517659360211,NaN,NaN,50
1685993400,1.07148,1.07176,1.07118,1.07125,1299,1985.25,-648628,-647909.2,35.13041535333536,56.01002246804961,55.60763823011437,NaN,NaN,50
1685995200,1.07125,1.07134,1.07111,1.07112,585,1940.9,-649213,-648150.8,35.03963669672206,54.8024981642978,56.66588266693979,NaN,NaN,50
1685997000,1.07112,1.0713,1.07097,1.07119,420,1896.25,-648793,-648517.6,34.608887920305584,55.360567512138864,57.957504988743395,NaN,NaN,50
1685998800,1.07119,1.0717,1.07119,1.07126,169,1842.85,-648624,-648517.4,34.71754585373585,55.94635523739315,57.403993449033734,NaN,NaN,50
1686000600,1.07126,1.07134,1.07118,1.07128,245,1780.8,-648379,-648727.4,34.7922537525117,56.123517023405384,57.218853950569454,NaN,NaN,50
1686002400,1.07128,1.07148,1.07096,1.07112,550,1713.15,-648929,-648787.6,34.279942316689784,54.24413251348141,56.83265081296308,NaN,NaN,50
1686004200,1.07112,1.0714,1.07112,1.07136,489,1623.05,-648440,-648633,33.80422455485515,56.592220041478264,56.34867600637323,NaN,NaN,50
1686006000,1.07136,1.07142,1.07076,1.07082,763,1555.8,-649203,-648715,32.43084320030847,50.333419317088456,55.80724254788456,NaN,NaN,50
1686007800,1.07082,1.07122,1.0708,1.07114,444,1440.6,-648759,-648742,31.155560513943705,53.60773727606744,55.579906039119145,NaN,NaN,50
1686009600,1.07114,1.07146,1.071,1.07136,717,1126.9,-648042,-648674.6,30.418212828528045,55.76678612969365,55.674291972324525,NaN,NaN,50
1686011400,1.07136,1.0717,1.07136,1.07163,634,958.25,-647408,-648370.4,30.14690646590541,58.32989623469537,55.76182747213809,NaN,NaN,50
1686013200,1.07163,1.0717,1.07145,1.07152,925,885.7,-648333,-648349,29.89497912918439,56.883722787612044,55.684521771498176,NaN,NaN,50
1686015000,1.07152,1.07165,1.07129,1.07157,1108,850.8,-647225,-647953.4,29.17720937307585,57.40072616239892,55.679662439058326,NaN,NaN,50
1686016800,1.07157,1.07248,1.07156,1.07196,1301,836.5,-645924,-647386.4,29.82806055361899,61.298847120437365,55.90717485630271,NaN,NaN,50
1686018600,1.07196,1.07204,1.07163,1.07184,1163,844.1,-647087,-647195.4,30.432422364123333,59.49485817863758,56.156091692773266,NaN,NaN,50
1686020400,1.07184,1.07194,1.07168,1.0718,879,832.5,-647966,-647307,30.993615473877366,58.87290107826887,56.446834758056916,NaN,NaN,50
1686022200,1.0718,1.0718,1.07144,1.0716,659,817.9,-648625,-647365.4,30.756870447856272,55.735516794826076,56.473616849677434,NaN,NaN,50
1686024000,1.0716,1.07211,1.07151,1.07198,757,803.45,-647868,-647494,31.03518127611172,60.0876110012992,56.76942083281358,NaN,NaN,50
1686025800,1.07198,1.07242,1.07183,1.07235,2047,822.5,-645821,-647473.4,31.7327414167356,63.817876566346406,57.319017943023646,NaN,NaN,50
1686027600,1.07235,1.07315,1.07235,1.07252,1226,819,-644595,-646975,33.19499658280212,65.41715692011272,58.11709111492588,NaN,NaN,50
1686029400,1.07252,1.07292,1.07227,1.0725,1275,817.8,-645870,-646555.8,34.31114526412505,65.05285399057352,58.721422111289826,NaN,NaN,50
1686031200,1.0725,1.07311,1.07214,1.0727,2138,895.45,-643732,-645577.2,35.544222721948415,67.03015413630746,59.91404602694833,NaN,NaN,50
1686033000,1.0727,1.07329,1.07228,1.07242,2201,984.5,-645933,-645190.2,36.869187590742534,61.76159223887482,60.49646423857744,NaN,NaN,50
1686034800,1.07242,1.07274,1.071,1.07126,3443,1148.2,-649376,-645901.2,34.96352649634512,45.7264177647858,59.77929506965544,NaN,NaN,50
1686036600,1.07126,1.07164,1.07072,1.07146,3317,1301.8,-646059,-646194,32.69893227452844,48.222467560578814,59.057335878647116,NaN,NaN,50
1686038400,1.07146,1.07151,1.06951,1.07016,3434,1446,-649493,-646918.6,31.800606783835363,36.478808335755886,57.59984198922882,NaN,NaN,50
1686040200,1.07016,1.07036,1.06968,1.06992,2126,1527.85,-651619,-648496,30.96644739962036,34.79414637463792,55.985086290103034,NaN,NaN,50
1686042000,1.06992,1.07012,1.06933,1.06946,1850,1582.2,-653469,-650003.2,30.59467807832989,31.766069590970673,53.87560218085542,NaN,NaN,50
1686043800,1.06946,1.0698,1.06894,1.06922,1811,1650.55,-655280,-651184,30.663619980391722,30.28515961848848,51.78919514084477,NaN,NaN,50
1686045600,1.06922,1.06928,1.06824,1.06857,1998,1714.6,-657278,-653427.8,31.368850233320327,26.66011033391402,49.488281516247994,NaN,NaN,50
1686047400,1.06857,1.06996,1.06852,1.06978,2181,1791.95,-655097,-654548.6,30.812459459571283,40.853069593496514,48.425249573295886,NaN,NaN,50
1686049200,1.06978,1.07003,1.06876,1.06914,1727,1832.05,-656824,-655589.6,30.179293254286293,36.796840117313984,46.76162308158265,NaN,NaN,50
1686051000,1.06914,1.06958,1.06764,1.06769,2062,1879.75,-658886,-656673,30.624426643798703,29.621033293908624,44.31899141926567,NaN,NaN,50
1686052800,1.06769,1.06839,1.06728,1.06744,2371,1933.25,-661257,-657868.4,31.311542582231933,28.585963263724906,41.68819187238082,NaN,NaN,50
1686054600,1.06744,1.06752,1.0667,1.06708,2739,2012.05,-663996,-659212,32.35369925559911,27.1165269440057,38.978454226197414,NaN,NaN,50
1686056400,1.06708,1.06814,1.06698,1.06792,2318,2084,-661678,-660528.2,32.29715910972431,35.45390305075216,36.72300772008631,NaN,NaN,50
1686058200,1.06792,1.06828,1.06692,1.06726,3360,2219.05,-665038,-662171,32.02530487844808,32.325025660570944,34.62039582163604,NaN,NaN,50
1686060000,1.06726,1.06846,1.0671,1.0678,2916,2327,-662122,-662818.2,31.48552604352708,37.20777961280015,34.01192166792278,NaN,NaN,50
1686061800,1.0678,1.06912,1.06736,1.06909,2948,2372.05,-659174,-662401.6,30.00611966023092,47.038353133328044,33.92734206597629,NaN,NaN,50
1686063600,1.06909,1.06922,1.06847,1.06922,2850,2453.25,-656324,-660867.2,28.492841078804865,47.92317498430841,34.74479682658719,NaN,NaN,50
1686065400,1.06922,1.06969,1.06899,1.06944,1894,2484.2,-654430,-659417.6,26.464612329414734,49.46195592888028,35.79249750903307,NaN,NaN,50
1686067200,1.06944,1.06979,1.06893,1.06894,1658,2460.2,-656088,-657627.6,24.712781410494134,46.12607307888901,36.81821204388438,NaN,NaN,50
1686069000,1.06894,1.06902,1.06873,1.06886,1209,2410.6,-657297,-656662.6,23.08710545111733,45.59619883561244,37.91185770225037,NaN,NaN,50
1686070800,1.06886,1.06886,1.06823,1.06854,1230,2299.95,-658527,-656533.2,22.230377228394573,43.446272766528786,39.11086930458,NaN,NaN,50
1686072600,1.06854,1.06871,1.06844,1.0686,708,2169.5,-657819,-656832.2,21.434843878723438,43.97964049359961,39.33419579744451,NaN,NaN,50
1686074400,1.0686,1.06926,1.06849,1.06918,949,2045.25,-656870,-657320.2,19.954797009412598,48.98803972731792,40.20499576958765,NaN,NaN,50
1686076200,1.06918,1.06964,1.06903,1.0694,891,1983.5,-655979,-657298.4,19.100186351153475,50.78536502769076,41.71673375057208,NaN,NaN,50
1686078000,1.0694,1.06962,1.0692,1.06952,862,1934.1,-655117,-656862.4,18.306619311341436,51.78328461174669,43.37368527543078,NaN,NaN,50
1686079800,1.06952,1.06956,1.06904,1.06919,992,1893.15,-656109,-656378.8,17.30323315835417,48.849815100026575,44.92606300086084,NaN,NaN,50
1686081600,1.06919,1.06933,1.06902,1.06924,491,1817.8,-655618,-655938.6,16.337041938279125,49.31828750411181,45.91637617610082,NaN,NaN,50
1686083400,1.06924,1.06931,1.06913,1.06922,413,1729.4,-656031,-655770.8,15.439864376780868,49.12447606268299,47.116336919108825,NaN,NaN,50
1686085200,1.06922,1.0695,1.06922,1.06945,133,1649.7,-655898,-655754.6,14.940324104994792,51.485630213214826,48.13618339056701,NaN,NaN,50
1686087000,1.06945,1.06958,1.06943,1.06946,101,1551.65,-655797,-655890.6,14.617273458345972,51.59082639159263,48.46136005187162,NaN,NaN,50
1686088800,1.06946,1.06954,1.06937,1.06946,281,1447.15,-655797,-655828.2,14.182479705087728,51.59082639159263,48.723335152391925,NaN,NaN,50
1686090600,1.06946,1.06951,1.0694,1.0695,209,1320.65,-655588,-655822.2,13.778742648490788,52.07292936703228,48.909833255117064,NaN,NaN,50
1686092400,1.0695,1.06956,1.06924,1.06942,367,1223.1,-655955,-655807,13.014596777483359,50.97942196069908,49.25650103238922,NaN,NaN,50
1686094200,1.06942,1.06992,1.0694,1.06988,494,1079.8,-655461,-655719.6,13.055944372593595,56.620323925177516,50.04393853878672,NaN,NaN,50
1686096000,1.06988,1.0704,1.06975,1.0701,1202,994.1,-654259,-655412,13.926072482497062,59.047493631446,51.158311457709374,NaN,NaN,50
1686097800,1.0701,1.07044,1.0698,1.07005,1004,896.9,-655263,-655305.2,14.797860655556677,58.24979246419473,52.1776080270376,NaN,NaN,50
1686099600,1.07005,1.07012,1.06971,1.06997,1327,820.75,-656590,-655505.6,15.353857410128816,56.92470598750175,52.74451275990787,NaN,NaN,50
1686101400,1.06997,1.07016,1.06929,1.06965,1506,801.35,-658096,-655933.8,14.785305658403042,51.844330790882644,52.82015317156443,NaN,NaN,50
1686103200,1.06965,1.06968,1.06888,1.0693,1167,776.8,-659263,-656694.2,14.085079674478823,46.912724519643525,52.47225602212849,NaN,NaN,50
1686105000,1.0693,1.06946,1.06912,1.0693,999,766.3,-659263,-657695,13.43486983226348,46.91272451964353,52.333892409243994,NaN,NaN,50
1686106800,1.0693,1.06936,1.06896,1.0691,1196,764.6,-660459,-658734.2,13.167546489545268,44.13071021895184,51.96335117458971,NaN,NaN,50
1686108600,1.0691,1.06937,1.06906,1.06928,743,766.35,-659716,-659359.4,12.893262102496585,47.16738314394019,51.823558823250934,NaN,NaN,50
1686110400,1.06928,1.06957,1.06923,1.0694,492,743.5,-659224,-659585,12.116623416149062,49.1516283548538,51.65684440479657,NaN,NaN,50
1686112200,1.0694,1.0694,1.06894,1.06906,780,737.95,-660004,-659733.2,12.05686767795979,44.09809223279802,51.12164910773981,NaN,NaN,50
1686114000,1.06906,1.06906,1.06833,1.06851,1033,746.5,-661037,-660088,13.118819767995893,37.39939306817032,50.10797529892393,NaN,NaN,50
1686115800,1.06851,1.06886,1.06841,1.06852,1126,753.2,-659911,-659978.4,14.104918137315131,37.58503726684878,49.073125863196545,NaN,NaN,50
1686117600,1.06852,1.06862,1.0675,1.06782,1614,809.35,-661525,-660340.2,16.24075159743098,30.71788248356168,47.62587304340101,NaN,NaN,50
1686119400,1.06782,1.06792,1.06728,1.06767,1924,884.9,-663449,-661185.2,18.453477242146363,29.47510022704175,45.68692849353418,NaN,NaN,50
1686121200,1.06767,1.06818,1.06684,1.06763,2447,1000.6,-665896,-662363.6,20.92276988226141,29.136571419861795,43.55043404984959,NaN,NaN,50
1686123000,1.06763,1.06865,1.06762,1.06843,1769,1084,-664127,-662981.6,21.98817908808155,43.189935608051826,42.474729988696524,NaN,NaN,50
1686124800,1.06843,1.06892,1.06792,1.06861,1647,1152.3,-662480,-663495.4,22.347159188170977,45.794692260765885,41.679729008215396,NaN,NaN,50
1686126600,1.06861,1.06935,1.06842,1.06932,1587,1221.2,-660893,-663369,21.770989636757985,54.631013210783124,41.878777752493995,NaN,NaN,50
1686128400,1.06932,1.06977,1.06901,1.06945,1846,1295.15,-659047,-662488.6,20.457302654466005,56.04393512195552,42.53100708123056,NaN,NaN,50
1686130200,1.06945,1.06978,1.0692,1.06964,1463,1343.6,-657584,-660826.2,19.219433149279723,58.09788551712497,43.32994715247924,NaN,NaN,50
1686132000,1.06964,1.07091,1.06964,1.07076,1754,1371.2,-655830,-659166.8,19.3097142022307,67.68391894136869,45.01231920408044,NaN,NaN,50
1686133800,1.07076,1.07188,1.07049,1.07149,2261,1434.05,-653569,-657384.6,20.385666941683564,72.1552412826748,46.79716621399006,NaN,NaN,50
1686135600,1.07149,1.07209,1.0713,1.07187,2284,1481.9,-651285,-655463,21.568201932849842,74.1595421528627,48.58344577099069,NaN,NaN,50
1686137400,1.07187,1.07231,1.0714,1.07155,1787,1495.95,-653072,-654268,22.856717124749796,69.61516489940838,50.40609381860572,NaN,NaN,50
1686139200,1.07155,1.0718,1.07074,1.07084,2260,1550.6,-655332,-653817.6,22.854708020660873,60.7239625360926,52.07213449488588,NaN,NaN,50
1686141000,1.07084,1.07182,1.07052,1.07162,2192,1610.25,-653140,-653279.6,22.489978481658344,65.87969610742826,54.09318155492728,NaN,NaN,50
1686142800,1.07162,1.0723,1.07141,1.0717,2400,1670.45,-650740,-652713.8,22.671672759255774,66.36734143467851,56.639571480007056,NaN,NaN,50
1686144600,1.0717,1.07387,1.07152,1.07372,3523,1809.45,-647217,-651900.2,24.113740691543125,75.77998557435248,59.94706329052924,NaN,NaN,50
1686146400,1.07372,1.07398,1.0713,1.07152,5758,2072.75,-652975,-651880.8,25.09930259905196,57.05244660909049,61.94105437547415,NaN,NaN,50
1686148200,1.07152,1.07186,1.0703,1.07078,4260,2246.75,-657235,-652261.4,24.58619130141966,52.364755431506865,62.59639864857808,NaN,NaN,50
1686150000,1.07078,1.07084,1.07017,1.07052,2788,2334.5,-660023,-653638,23.942165617258865,50.78585832774323,62.952910510505035,NaN,NaN,50
1686151800,1.07052,1.07106,1.06952,1.07013,2488,2402.6,-662511,-655992.2,22.54538574010639,48.42712223256762,62.509775440632495,NaN,NaN,50
1686153600,1.07013,1.07067,1.0701,1.07024,1871,2415.45,-660640,-658676.8,21.248375854179095,49.14456407039635,62.01696322266398,NaN,NaN,50
1686155400,1.07024,1.07047,1.06927,1.06932,1972,2417.85,-662612,-660604.2,20.351788981143823,43.672477172908216,60.986576912362786,NaN,NaN,50
1686157200,1.06932,1.0695,1.06912,1.06936,1583,2374.65,-661029,-661363,19.674541904529377,43.96462096328245,59.292341342499476,NaN,NaN,50
1686159000,1.06936,1.06996,1.0691,1.06988,1425,2357.45,-659604,-661279.2,18.468284410468883,47.75798044063615,57.549679853782436,NaN,NaN,50
1686160800,1.06988,1.07018,1.06974,1.07008,1208,2335.5,-658396,-660456.2,17.215776662106254,49.182876228003366,55.765632287721054,NaN,NaN,50
1686162600,1.07008,1.07034,1.06988,1.07024,1257,2319,-657139,-659756,16.247790462374248,50.34958036764744,54.38951910688098,NaN,NaN,50
1686164400,1.07024,1.07054,1.07014,1.07018,1094,2281.4,-658233,-658880.2,15.595148683690319,49.88703503564252,53.61545285684883,NaN,NaN,50
1686166200,1.07018,1.07026,1.06936,1.06938,1439,2280.2,-659672,-658608.8,14.972800861577523,44.07327395721215,52.05785127469054,NaN,NaN,50
1686168000,1.06938,1.07,1.06938,1.06976,861,2235.55,-658811,-658450.2,14.394906455329929,47.219714402143715,50.69016362950948,NaN,NaN,50
1686169800,1.06976,1.06996,1.06972,1.06985,456,2145.3,-658355,-658442,13.858290220957162,47.9663827369167,48.703477712549784,NaN,NaN,50
1686171600,1.06985,1.06994,1.0696,1.0699,256,2043.9,-658099,-658634,13.52287997658662,48.4030914507878,48.08566662981387,NaN,NaN,50
1686173400,1.0699,1.06993,1.06985,1.06993,151,1962.1,-657948,-658577,13.211427606813972,48.68139491762651,47.82256945025099,NaN,NaN,50
1686175200,1.06993,1.07016,1.06988,1.07006,357,1866.95,-657591,-658160.8,12.519694197006443,49.941422975616774,47.76225263938482,NaN,NaN,50
1686177000,1.07006,1.07013,1.06977,1.06994,1127,1813.7,-658718,-658142.2,12.055846428903493,48.75150780295865,47.78542303726989,NaN,NaN,50
1686178800,1.06994,1.07009,1.06968,1.06976,424,1714.9,-659142,-658299.6,11.774898412998237,46.94467739407331,47.62828827467538,NaN,NaN,50
1686180600,1.06976,1.07073,1.06974,1.0707,640,1570.75,-658502,-658380.2,11.480693488290699,56.09581856622308,48.5156698027693,NaN,NaN,50
1686182400,1.0707,1.071,1.07062,1.07072,909,1328.3,-657593,-658309.2,11.61763299499007,56.26865129720525,49.39452911233521,NaN,NaN,50
1686184200,1.07072,1.07099,1.07066,1.07086,977,1164.15,-656616,-658114.2,11.744791108353771,57.529012963249315,50.092460006807585,NaN,NaN,50
1686186000,1.07086,1.07101,1.07052,1.07058,1084,1078.95,-657700,-657910.6,11.570916499131547,54.166618093752845,50.448441568646835,NaN,NaN,50
1686187800,1.07058,1.07099,1.0703,1.07088,1369,1023,-656331,-657348.4,10.96058097975949,57.062285153488496,50.9279204819212,NaN,NaN,50
1686189600,1.07088,1.07116,1.07072,1.07096,1072,983.05,-655259,-656699.8,10.710096454340265,57.827441330784715,51.49509236014564,NaN,NaN,50
1686191400,1.07096,1.07101,1.07066,1.07068,967,932.8,-656226,-656426.4,10.346579281022054,54.18774644056772,52.21755468038533,NaN,NaN,50
1686193200,1.07068,1.07106,1.0706,1.07104,867,897,-655359,-656175,9.872937201843731,57.86017131858157,52.977587317273745,NaN,NaN,50
1686195000,1.07104,1.0711,1.07076,1.07084,883,869.9,-656242,-655883.4,9.52105706480091,55.21216963486694,53.49514352427019,NaN,NaN,50
1686196800,1.07084,1.07104,1.07056,1.07102,887,853.85,-655355,-655688.2,8.97047910378827,57.11445919964734,54.11738407776016,NaN,NaN,50
1686198600,1.07102,1.07137,1.07076,1.07116,880,835,-654475,-655531.4,8.947084104419243,58.58774071293449,54.82498020599644,NaN,NaN,50
1686200400,1.07116,1.07164,1.07109,1.07162,1062,833.4,-653413,-654968.8,9.46684512984179,63.076185508542515,55.76317752977685,NaN,NaN,50
1686202200,1.07162,1.07174,1.07092,1.07103,1170,819.95,-654583,-654813.6,9.50726288592676,54.862773879540036,56.19969653524695,NaN,NaN,50
1686204000,1.07103,1.0713,1.07076,1.07082,1374,845.6,-655957,-654756.6,9.142186516688257,52.25461075423491,56.57897748954421,NaN,NaN,50
1686205800,1.07082,1.07192,1.07082,1.07113,1811,913.35,-654146,-654514.8,10.005881636087775,55.609470699900314,56.54423835623543,NaN,NaN,50
1686207600,1.07113,1.07125,1.0701,1.0702,2521,1026.6,-656667,-654953.2,9.337535046963847,45.321047241612376,55.76226663797879,NaN,NaN,50
1686209400,1.0702,1.07132,1.07016,1.07132,2083,1123.2,-654584,-655187.4,8.757555771376436,55.90227400310297,55.646070997968344,NaN,NaN,50
1686211200,1.07132,1.07193,1.07099,1.07186,1735,1192.1,-652849,-654840.6,9.265107687494368,59.928615456926295,56.057642238195015,NaN,NaN,50
1686213000,1.07186,1.073,1.07152,1.07268,2199,1245.7,-650650,-653779.2,11.051290320333019,65.13450573063733,56.63422942227707,NaN,NaN,50
1686214800,1.07268,1.07339,1.0721,1.07289,2147,1331.85,-648503,-652650.6,13.081199680483714,66.34053539762999,57.242307569908874,NaN,NaN,50
1686216600,1.07289,1.07315,1.07234,1.07288,1573,1378.5,-650076,-651332.4,14.966115514909356,66.22306273411237,58.101973019447776,NaN,NaN,50
1686218400,1.07288,1.07331,1.07268,1.07271,1246,1395.35,-651322,-650680,16.873191600262512,64.14362950869238,58.55079146159856,NaN,NaN,50
1686220200,1.07271,1.0733,1.07262,1.073,1213,1407.15,-650109,-650132,18.49798768572657,66.09922532215062,59.32843829640452,NaN,NaN,50
1686222000,1.073,1.07368,1.07239,1.07362,1789,1442.4,-648320,-649666,20.393268808564137,69.88127887839813,60.240353987743866,NaN,NaN,50
1686223800,1.07362,1.07394,1.07302,1.07358,1713,1459.6,-650033,-649972,22.396402790203958,69.3437787883772,61.00864242170406,NaN,NaN,50
1686225600,1.07358,1.07426,1.07334,1.07385,2495,1530.75,-647538,-649464.4,24.535924750047585,70.96707206305369,61.57227717559772,NaN,NaN,50
1686227400,1.07385,1.07591,1.07384,1.07468,5297,1747.25,-642241,-647648.2,27.531597092884024,75.29739371312716,63.0318928779968,NaN,NaN,50
1686229200,1.07468,1.07567,1.0742,1.0752,3029,1855.35,-639212,-645468.8,30.31329283980357,77.555995190662,64.83913462345588,NaN,NaN,50
1686231000,1.0752,1.07692,1.075,1.07656,4569,2039.65,-634643,-642733.4,33.39111421228404,82.15222017495222,66.73504530024529,NaN,NaN,50
1686232800,1.07656,1.07748,1.07618,1.07742,3417,2166.15,-631226,-638972,36.421320826223855,84.33661339400797,69.52187145398784,NaN,NaN,50
1686234600,1.07742,1.0776,1.07668,1.07694,3335,2288.9,-634561,-636376.6,39.27048560501354,78.55749346087252,71.14010141525709,NaN,NaN,50
1686236400,1.07694,1.07783,1.07672,1.0778,2618,2366.7,-631943,-634317,41.98480892883195,81.0614876085368,72.64959228322928,NaN,NaN,50
1686238200,1.0778,1.07834,1.07751,1.07788,2324,2424.4,-629619,-632398.4,44.648680273807855,81.28047983038547,73.802876147497,NaN,NaN,50
1686240000,1.07788,1.07872,1.07772,1.07864,1915,2451.45,-627704,-631010.6,47.22025086659874,83.26076087145556,75.01146368134168,NaN,NaN,50
1686241800,1.07864,1.07864,1.07824,1.07848,1561,2438.95,-629265,-630618.4,49.60813784561884,81.31060035819041,76.0891449402044,NaN,NaN,50
1686243600,1.07848,1.07858,1.07796,1.07817,1459,2385.85,-630724,-629851,51.134595852253675,77.52197878751686,77.04474131726329,NaN,NaN,50
1686245400,1.07817,1.07834,1.07778,1.07782,1091,2336.25,-631815,-629825.4,52.11551717152688,73.36557782990889,77.56376649638888,NaN,NaN,50
1686247200,1.07782,1.07822,1.07778,1.07817,967,2297.85,-630848,-630071.2,53.026372682280574,74.81950145708072,77.9164966805805,NaN,NaN,50
1686249000,1.07817,1.07826,1.07783,1.07792,1216,2248.7,-632064,-630943.2,53.895072087879335,71.80437275195467,78.0922533922646,NaN,NaN,50
1686250800,1.07792,1.07796,1.07737,1.07748,1032,2192.95,-633096,-631709.4,53.503403932555685,66.70903415384373,77.78810782732103,NaN,NaN,50
1686252600,1.07748,1.078,1.07738,1.07792,989,2163.75,-632107,-631986,53.17442730330598,69.07251175273785,77.34347340157895,NaN,NaN,50
1686254400,1.07792,1.07824,1.0779,1.0781,666,2134.75,-631441,-631911.2,53.078399416867384,70.01050300617767,76.80450967411578,NaN,NaN,50
1686256200,1.0781,1.07828,1.07804,1.07828,411,2094.65,-631030,-631947.6,53.024305915907114,70.95903051788862,76.00499612718265,NaN,NaN,50
1686258000,1.07828,1.07838,1.0781,1.07831,117,2011.05,-630913,-631717.4,53.06505007531095,71.1229636749194,75.06116400439062,NaN,NaN,50
1686259800,1.07831,1.07848,1.07816,1.07822,226,1936.7,-631139,-631326,53.195572253276815,69.84910146531895,74.43913600470822,NaN,NaN,50
1686261600,1.07822,1.07836,1.07818,1.07831,352,1829.55,-630787,-631062,53.31677141853083,70.41966031901369,73.679005484028,NaN,NaN,50
1686263400,1.07831,1.07842,1.07823,1.07838,274,1578.4,-630513,-630876.4,53.49081119811546,70.88120505471569,72.93620014290872,NaN,NaN,50
1686265200,1.07838,1.07849,1.07828,1.07828,381,1446,-630894,-630849.2,53.7264361280487,69.21960534668857,71.93326046256821,NaN,NaN,50
1686267000,1.07828,1.07854,1.07818,1.07818,471,1241.1,-631365,-630939.6,53.55575550833762,67.51516681641861,70.94787235244165,NaN,NaN,50
1686268800,1.07818,1.07851,1.07818,1.07836,1195,1130,-630170,-630745.8,53.397266361463046,68.9950923230571,70.33880903355167,NaN,NaN,50
1686270600,1.07836,1.07852,1.07815,1.07822,1063,1016.4,-631233,-630835,53.12086446974212,66.45906653527024,69.84548679822034,NaN,NaN,50
1686272400,1.07822,1.07842,1.07806,1.07821,1345,952.75,-632578,-631248,52.46701518658373,66.27168786842846,69.23492868474517,NaN,NaN,50
1686274200,1.07821,1.07852,1.07796,1.07808,1526,912.85,-634104,-631890,51.85986942365094,63.75511797271603,68.65998191479956,NaN,NaN,50
1686276000,1.07808,1.07812,1.07772,1.0778,1070,870.6,-635174,-632651.8,50.23537634054483,58.59411262319299,68.08034466261022,NaN,NaN,50
1686277800,1.0778,1.07799,1.07757,1.07768,1034,844.25,-636208,-633859.4,48.12818623958731,56.48378002924339,67.18114953950347,NaN,NaN,50
1686279600,1.07768,1.078,1.07766,1.07798,841,813.35,-635367,-634686.2,46.197776463281905,60.33040126402801,66.4897137007785,NaN,NaN,50
1686281400,1.07798,1.07802,1.07773,1.07778,851,801.35,-636218,-635414.2,44.46100804317081,56.73012812671886,65.47336352998066,NaN,NaN,50
1686283200,1.07778,1.07786,1.07746,1.07763,718,788.9,-636936,-635980.6,41.75353705954163,54.121483753676806,64.25897210703475,NaN,NaN,50
1686285000,1.07763,1.07772,1.07753,1.07753,584,757.3,-637520,-636449.8,39.2394568604574,52.39183411842631,63.01202443939956,NaN,NaN,50
1686286800,1.07753,1.07798,1.07752,1.07776,770,744.2,-636750,-636558.2,37.72687814866566,55.884016599038794,61.973764173687066,NaN,NaN,50
1686288600,1.07776,1.0784,1.07772,1.0778,1226,756.05,-635524,-636589.6,37.3549162919461,56.48188064446648,60.94524100152641,NaN,NaN,50
1686290400,1.0778,1.0782,1.07725,1.07767,1570,801.25,-637094,-636764.8,35.34981575043357,53.924133034011476,59.85270726490661,NaN,NaN,50
1686292200,1.07767,1.07824,1.0776,1.07788,1619,861.65,-635475,-636472.6,33.59042190733037,57.28886358533047,59.12225703411461,NaN,NaN,50
1686294000,1.07788,1.07798,1.07687,1.0773,2663,988.95,-638138,-636596.2,32.30089214715225,47.06590557044921,57.55588655178547,NaN,NaN,50
1686295800,1.0773,1.07778,1.07674,1.07756,2151,1085.2,-635987,-636443.6,31.365909426017836,51.264303370553804,56.47054632573429,NaN,NaN,50
1686297600,1.07756,1.0776,1.07621,1.07644,2208,1178,-638195,-636977.8,31.42309382482868,37.475539144661596,54.41367855975094,NaN,NaN,50
1686299400,1.07644,1.07664,1.07594,1.07635,2009,1264.75,-640204,-637599.8,31.86799583051191,36.623078566420666,52.475675745015565,NaN,NaN,50
1686301200,1.07635,1.07684,1.0761,1.07632,1641,1327.75,-641845,-638873.8,31.685310261461215,36.326450115798934,50.885128423058845,NaN,NaN,50
1686303000,1.07632,1.07654,1.07582,1.07586,1552,1381.8,-643397,-639925.6,31.93836631350871,32.04109719275455,49.13922250616679,NaN,NaN,50
1686304800,1.07586,1.0762,1.07567,1.0761,1648,1404.45,-641749,-641078,32.38649904113763,36.2656002414127,47.420308147408555,NaN,NaN,50
1686306600,1.0761,1.07628,1.07571,1.07614,1552,1428.9,-640197,-641478.4,32.548120893750855,36.968863358223274,46.00878923537315,NaN,NaN,50
1686308400,1.07614,1.07708,1.07602,1.07684,1689,1446.1,-638508,-641139.2,30.608280308243064,47.81990724283513,45.55867662745589,NaN,NaN,50
1686310200,1.07684,1.07818,1.07676,1.07732,1990,1469.3,-636518,-640073.8,29.869512508543846,53.705301027360605,45.652495692379766,NaN,NaN,50
1686312000,1.07732,1.07841,1.07732,1.07756,2552,1543.4,-633966,-638187.6,29.479483631003987,56.35593960979619,45.68620447886244,NaN,NaN,50
1686313800,1.07756,1.07841,1.07634,1.07671,3717,1677.55,-637683,-637374.4,27.406294161636502,46.254837187691486,44.95570137480708,NaN,NaN,50
1686315600,1.07671,1.07704,1.07614,1.07685,2524,1761.7,-635159,-636366.8,25.707528407895726,47.91087384087924,44.52618286101192,NaN,NaN,50
1686317400,1.07685,1.07752,1.07666,1.07709,3881,1913.2,-631278,-634920.8,24.315375813998568,50.71448481954712,44.05658437774168,NaN,NaN,50
1686319200,1.07709,1.07734,1.07665,1.07692,2718,2013.2,-633996,-634416.4,23.006531522516635,48.714391208104885,44.17433335185994,NaN,NaN,50
1686321000,1.07692,1.07696,1.07538,1.07568,3708,2169.4,-637704,-635164,22.640821794096546,37.1923510586857,43.169193901012214,NaN,NaN,50
1686322800,1.07568,1.07597,1.07522,1.07538,2395,2250.65,-640099,-635647.2,22.475190757435406,35.03341944198519,42.99475677939248,NaN,NaN,50
1686324600,1.07538,1.07546,1.07465,1.07481,2083,2293.5,-642182,-637051.8,22.902827291131857,31.31410006043218,42.61554402896473,NaN,NaN,50
1686326400,1.07481,1.07524,1.07472,1.07498,1635,2296.75,-640547,-638905.6,23.299918358135706,33.578980247029875,42.4192961811955,NaN,NaN,50
1686328200,1.07498,1.07504,1.07435,1.07482,1293,2280.45,-641840,-640474.4,24.033581701418395,32.49299692946276,42.451574733817516,NaN,NaN,50
1686330000,1.07482,1.07519,1.07462,1.07496,1103,2202.45,-640737,-641081,24.42634915040865,34.48945235054347,42.32470702732686,NaN,NaN,50
1686331800,1.07496,1.07524,1.07463,1.07486,785,2134.15,-641522,-641365.6,24.691710629463827,33.722294811044804,42.09280927395697,NaN,NaN,50
1686333600,1.07486,1.07508,1.07473,1.0748,792,2063.35,-642314,-641392,24.93811771715792,33.244486367166374,41.051707782837774,NaN,NaN,50
1686335400,1.0748,1.075,1.0746,1.07498,1039,2014.85,-641275,-641537.6,25.327906152335682,36.16655827256412,39.79894044320945,NaN,NaN,50
1686337200,1.07498,1.0751,1.07474,1.07476,657,1965.65,-641932,-641556,25.45398869448285,34.19632327167652,38.21611070477234,NaN,NaN,50
1686339000,1.07476,1.07484,1.0743,1.07443,1117,1943.9,-643049,-642018.4,26.129008360970126,31.43042007616225,37.15722376823453,NaN,NaN,50
1686340800,1.07443,1.07492,1.0744,1.07488,663,1894.65,-642386,-642191.2,26.557818289888342,38.71036141384435,36.50004430916062,NaN,NaN,50
1686342600,1.07488,1.07501,1.07468,1.07496,613,1847.7,-641773,-642083,26.7267570725884,39.93133571295998,35.729819372975825,NaN,NaN,50
1686517200,1.07496,1.07504,1.07461,1.07469,193,1772.9,-641966,-642221.2,26.984858365552398,37.23525867418766,34.90988133483888,NaN,NaN,50
1686519000,1.07469,1.07494,1.07457,1.07468,206,1683.7,-642172,-642269.2,27.28483680556957,37.135252741789024,34.90580288363198,NaN,NaN,50
1686520800,1.07468,1.07508,1.07452,1.07472,537,1582.95,-641635,-641986.4,27.153975584339644,37.85425042901405,35.1072908112769,NaN,NaN,50
1686522600,1.07472,1.07472,1.07432,1.0745,371,1415.65,-642006,-641910.4,27.36784610330017,35.452568982070886,35.40289573425109,NaN,NaN,50
1686524400,1.0745,1.07492,1.0744,1.07481,411,1310,-641595,-641874.8,26.97592370906977,41.12126203035569,35.94163014734579,NaN,NaN,50
1686526200,1.07481,1.07516,1.07481,1.075,554,1143.65,-641041,-641689.8,25.951557171869705,44.347281281839265,36.788364743944115,NaN,NaN,50
1686528000,1.075,1.07505,1.07448,1.07459,779,1046.7,-641820,-641619.4,25.63057255290055,39.338406599555746,37.134718618873556,NaN,NaN,50
1686529800,1.07459,1.07484,1.07444,1.07454,746,898.6,-642566,-641805.6,25.405510707487682,38.763409093197836,37.494798210455926,NaN,NaN,50
1686531600,1.07454,1.07461,1.07423,1.07423,940,825.85,-643506,-642105.6,25.5759473590182,35.31669236754064,37.642812924768364,NaN,NaN,50
1686533400,1.07423,1.07446,1.07362,1.07369,1344,788.9,-644850,-642756.6,26.64463758944036,30.26794825990811,37.22148363815008,NaN,NaN,50
1686535200,1.07369,1.07387,1.07354,1.07364,965,755.4,-645815,-643711.4,27.740304770345936,29.842545667705537,36.910499523580725,NaN,NaN,50
1686537000,1.07364,1.07388,1.07331,1.07386,1019,741.7,-644796,-644306.6,29.04794156798814,34.223089024260915,37.109975877016346,NaN,NaN,50
1686538800,1.07386,1.07401,1.07364,1.07378,775,725.3,-645571,-644907.6,29.835635925977606,33.406254774467016,36.73111111706083,NaN,NaN,50
1686540600,1.07378,1.07416,1.07378,1.0741,693,720.7,-644878,-645182,30.083296956769583,39.61480086974748,36.708501485402785,NaN,NaN,50
1686542400,1.0741,1.07444,1.07391,1.0742,793,720.75,-644085,-645029,29.46977400964664,41.4517826591058,37.00968177003979,NaN,NaN,50
1686544200,1.0742,1.07424,1.07399,1.0741,631,700.35,-644716,-644809.2,28.90007413017533,40.13685350373632,37.2240818244646,NaN,NaN,50
1686546000,1.0741,1.07459,1.07405,1.07444,818,708.4,-643898,-644629.6,27.383415477509754,46.36644189508138,37.83209550061226,NaN,NaN,50
1686547800,1.07444,1.07506,1.07442,1.07492,1032,704.15,-642866,-644088.6,25.966686297781006,53.69290479637425,39.134976630205365,NaN,NaN,50
1686549600,1.07492,1.0754,1.07492,1.0753,1244,733.2,-641622,-643437.4,25.306099688011397,58.52336295121536,40.3779838388382,NaN,NaN,50
1686551400,1.0753,1.07531,1.07456,1.07492,1273,766.2,-642895,-643199.4,23.845640704815082,52.612946372013056,40.96838848813633,NaN,NaN,50
1686553200,1.07492,1.07539,1.07443,1.07534,2343,873.7,-640552,-642366.6,22.204806608301332,57.69804764610904,42.27979142003299,NaN,NaN,50
1686555000,1.07534,1.07724,1.07504,1.07696,2152,971,-638400,-641267,23.28745456468888,70.74045740152924,44.56386629919952,NaN,NaN,50
1686556800,1.07696,1.07795,1.07679,1.07768,2616,1074.95,-635784,-639850.6,24.883569140987426,74.5030547513617,47.36289218375817,NaN,NaN,50
1686558600,1.07768,1.07842,1.07746,1.07772,2244,1168.6,-633540,-638234.2,26.69978498786255,74.69772160996902,50.53644742304823,NaN,NaN,50
1686560400,1.07772,1.07802,1.07746,1.078,1729,1234.5,-631811,-636017.4,28.386271131389456,76.07475054860761,53.8387477716841,NaN,NaN,50
1686562200,1.078,1.07902,1.07778,1.07854,2216,1317.6,-629595,-633826,30.573847457993747,78.50444927303279,57.001702075167806,NaN,NaN,50
1686564000,1.07854,1.07876,1.07782,1.07801,2102,1383.75,-631697,-632485.4,32.60516833269773,70.89460243826052,59.67944119401019,NaN,NaN,50
1686565800,1.07801,1.07832,1.07676,1.07728,2191,1456,-633888,-632106.2,32.47933056353,61.98245985388371,61.2771311214485,NaN,NaN,50
1686567600,1.07728,1.07758,1.07664,1.07682,1698,1493.9,-635586,-632515.4,32.16490105515402,57.110490996168195,62.395610288381526,NaN,NaN,50
1686569400,1.07682,1.07727,1.07614,1.0763,2023,1527.85,-637609,-633675,31.080287859662597,52.12286195530752,63.251753749208035,NaN,NaN,50
1686571200,1.0763,1.07715,1.07626,1.07646,2284,1593.8,-635325,-634821,30.073147035277703,53.469398787958184,63.75910781298495,NaN,NaN,50
1686573000,1.07646,1.07688,1.07607,1.07662,2108,1648.25,-633217,-635125,28.830620745107264,54.83729970227376,63.840850306263484,NaN,NaN,50
1686574800,1.07662,1.07716,1.07646,1.07667,2161,1717.55,-631056,-634558.6,28.0208472224036,55.27974032768424,63.60916297601126,NaN,NaN,50
1686576600,1.07667,1.07672,1.07431,1.07531,3884,1877.1,-634940,-634429.4,27.39845717887545,42.95357474658362,62.91920785990916,NaN,NaN,50
1686578400,1.07531,1.07617,1.075,1.0751,3416,2008.25,-638356,-634578.8,26.82052356702788,41.417845767623696,61.75633629716021,NaN,NaN,50
1686580200,1.0751,1.07567,1.07452,1.07472,3128,2133.1,-641484,-635810.6,26.71624432767507,38.72010173117145,59.469168034991796,NaN,NaN,50
1686582000,1.07472,1.07569,1.07445,1.07546,2721,2228.25,-638763,-636919.8,26.681493084507004,46.08483436288415,57.43929515010054,NaN,NaN,50
1686583800,1.07546,1.07552,1.07448,1.07461,1899,2271.6,-640662,-638841,26.6492240729938,40.120318347974525,54.96948063138665,NaN,NaN,50
1686585600,1.07461,1.07508,1.07438,1.07444,1515,2285.15,-642177,-640288.4,26.718991885462074,39.03225178639854,52.323587862657426,NaN,NaN,50
1686587400,1.07444,1.07518,1.0744,1.07486,1427,2292.85,-640750,-640767.2,26.601674889398268,43.13540819086284,49.79722778535957,NaN,NaN,50
1686589200,1.07486,1.07522,1.07456,1.07472,1578,2254.6,-642328,-640936,26.41651684411736,42.11787680196396,47.74174738276697,NaN,NaN,50
1686591000,1.07472,1.07542,1.0745,1.07536,1189,2206.45,-641139,-641411.2,25.855538339068318,48.14041498346665,46.75302989202289,NaN,NaN,50
1686592800,1.07536,1.07561,1.07504,1.07512,1332,2142.25,-642471,-641773,24.97045165695248,46.19914903809413,45.97364832358903,NaN,NaN,50
1686594600,1.07512,1.07592,1.07504,1.0756,1132,2086.65,-641339,-641605.4,23.579230429024825,50.498548693521585,45.85762594774718,NaN,NaN,50
1686596400,1.0756,1.07606,1.0756,1.076,1286,2064.5,-640053,-641466,22.038433707532732,53.81107947245912,45.88203171092581,NaN,NaN,50
1686598200,1.076,1.07634,1.07594,1.076,1295,2018.45,-640053,-641011,20.804864214717398,53.811079472459134,45.808730265939055,NaN,NaN,50
1686600000,1.076,1.07605,1.07579,1.07596,560,1941.35,-640613,-640905.8,19.38318368683049,53.3966739228417,45.674225522736016,NaN,NaN,50
1686601800,1.07596,1.07602,1.07579,1.0758,474,1855.5,-641087,-640629,18.06305176807836,51.682166980182835,46.297696396564525,NaN,NaN,50
1686603600,1.0758,1.0758,1.07554,1.07562,104,1775.8,-641191,-640599.4,17.188422900121832,49.74695411165078,46.892632706852176,NaN,NaN,50
1686605400,1.07562,1.07582,1.0756,1.07578,215,1685.4,-640976,-640784,16.33314858368175,51.48590811883574,47.804476020256764,NaN,NaN,50
1686607200,1.07578,1.07604,1.07576,1.07595,417,1592.05,-640559,-640885.2,15.269755125124842,53.33365760853332,48.32224910923171,NaN,NaN,50
1686609000,1.07595,1.07614,1.07592,1.07602,379,1505.6,-640180,-640798.6,14.493895886164502,54.10872437667683,49.321420968424725,NaN,NaN,50
1686610800,1.07602,1.07644,1.07594,1.07618,516,1423.35,-639664,-640514,14.377787033421713,55.9112034199863,50.527060370823854,NaN,NaN,50
1686612600,1.07618,1.0764,1.07617,1.07622,536,1255.95,-639128,-640101.4,14.26997167016055,56.37254717262128,51.472570298092315,NaN,NaN,50
1686614400,1.07622,1.0767,1.0762,1.07652,857,1128,-638271,-639560.4,14.74923412419825,59.77244584630976,52.73361094411701,NaN,NaN,50
1686616200,1.07652,1.07656,1.07596,1.07606,863,1014.75,-639134,-639275.4,14.552659619852745,52.957605069731,53.07769595027876,NaN,NaN,50
1686618000,1.07606,1.07658,1.07594,1.07648,1204,938.9,-637930,-638825.4,14.370126151531922,57.69973958747498,53.89916670380596,NaN,NaN,50
1686619800,1.07648,1.07684,1.0764,1.07677,1396,913.75,-636534,-638199.4,14.736981815309521,60.649382155060025,54.624226236772984,NaN,NaN,50
1686621600,1.07677,1.07732,1.0766,1.07714,1052,890.6,-635482,-637470.2,15.911535797555226,64.08995465805269,55.35843160717253,NaN,NaN,50
1686623400,1.07714,1.07757,1.07699,1.07744,726,855.55,-634756,-636767.2,17.37200332049713,66.63706425184358,56.274573377128554,NaN,NaN,50
1686625200,1.07744,1.0779,1.07742,1.07782,930,823.15,-633826,-635705.6,19.16733445613372,69.58035302026482,57.43055045551593,NaN,NaN,50
1686627000,1.07782,1.078,1.07775,1.07791,1137,820.55,-632689,-634657.4,20.959946594345983,70.24977876429766,58.75680844009556,NaN,NaN,50
1686628800,1.07791,1.07792,1.07762,1.07781,728,790.35,-633417,-634034,22.201670972071096,68.44739471004158,60.09255419712348,NaN,NaN,50
1686630600,1.07781,1.07832,1.0778,1.07822,697,768.6,-632720,-633481.6,23.881846445190995,71.65809623818566,61.53342477707704,NaN,NaN,50
1686632400,1.07822,1.07943,1.07815,1.0794,1636,786.1,-631084,-632747.2,26.463426792400895,78.45360719590748,63.3277068904609,NaN,NaN,50
1686634200,1.0794,1.07962,1.07826,1.07828,1850,813.85,-632934,-632568.8,28.99286451171158,63.01072742851379,63.9635642513064,NaN,NaN,50
1686636000,1.07828,1.07974,1.07816,1.07941,2847,928.2,-630087,-632048.4,31.424796991747012,69.52794501801455,64.93618865116564,NaN,NaN,50
1686637800,1.07941,1.0798,1.07912,1.07928,2004,1004.7,-632091,-631783.2,33.725733095421084,68.04263487969266,65.76976634452788,NaN,NaN,50
1686639600,1.07928,1.08042,1.07926,1.07964,2562,1127.6,-629529,-631145,36.25859785164736,69.95666896269384,66.49721085284104,NaN,NaN,50
1686641400,1.07964,1.08075,1.07958,1.07997,2781,1255.9,-626748,-630277.8,38.787554657366016,71.6338327767135,67.83122711762549,NaN,NaN,50
1686643200,1.07997,1.08034,1.0794,1.08022,2120,1341.05,-624628,-628616.6,40.58274380723664,72.8694848243765,68.91478034883275,NaN,NaN,50
1686645000,1.08022,1.08082,1.07991,1.08074,1920,1418.1,-622708,-627140.8,42.5452745741187,75.2814272852567,69.95992642956108,NaN,NaN,50
1686646800,1.08074,1.08108,1.0801,1.08041,2126,1498.6,-624834,-625689.4,44.510694160248995,70.96945788778895,70.45131951739938,NaN,NaN,50
1686648600,1.08041,1.08099,1.08006,1.08057,1668,1555.2,-623166,-624416.8,46.21082293838731,71.81247331450797,70.82099159330399,NaN,NaN,50
1686650400,1.08057,1.0807,1.07977,1.07992,1790,1601.85,-624956,-624058.4,46.896060583564754,63.7174712275418,70.40221432239518,NaN,NaN,50
1686652200,1.07992,1.08018,1.07952,1.07987,1311,1624.25,-626267,-624386.2,46.81408547111932,63.12797602250399,69.89351412655279,NaN,NaN,50
1686654000,1.07987,1.0799,1.07932,1.07965,1650,1646.55,-627917,-625428,46.189582334172854,60.47674534647666,69.3241820291553,NaN,NaN,50
1686655800,1.07965,1.0798,1.0792,1.07942,1732,1663.35,-629649,-626391,45.285060676774904,57.746262995719206,68.3304796546934,NaN,NaN,50
1686657600,1.07942,1.07966,1.07906,1.07924,2610,1741.25,-632259,-628209.6,44.066374298695095,55.62943784650734,66.70018184402196,NaN,NaN,50
1686659400,1.07924,1.08237,1.07838,1.08142,8123,2111.1,-624136,-628045.6,45.2567992825842,69.9815995946802,67.19810128446241,NaN,NaN,50
1686661200,1.08142,1.0818,1.07922,1.08032,4565,2292.85,-628701,-628532.4,46.362193910481224,59.51983419797121,66.48323622588788,NaN,NaN,50
1686663000,1.08032,1.08152,1.07931,1.0794,4900,2481,-633601,-629669.2,47.38863177924274,52.456636279631795,65.36995061159783,NaN,NaN,50
1686664800,1.0794,1.07975,1.07784,1.07945,4733,2681.25,-628868,-629513,45.64605003431981,52.78457329697829,64.143372349761,NaN,NaN,50
1686666600,1.07945,1.08078,1.07905,1.0802,3510,2821.9,-625358,-628132.8,44.8558149192418,57.51805666057135,63.13510262717942,NaN,NaN,50
1686668400,1.0802,1.0809,1.07926,1.07945,3317,2905.95,-628675,-629040.6,44.20862733275698,51.91325929569646,61.63822937513084,NaN,NaN,50
1686670200,1.07945,1.0795,1.07862,1.07912,2652,2946.05,-631327,-629565.8,42.67447266711065,49.62203481719393,59.805415627412074,NaN,NaN,50
1686672000,1.07912,1.07986,1.07902,1.07963,1976,2902.5,-629351,-628715.8,41.553850828001785,53.06939319212035,58.52683957772147,NaN,NaN,50
1686673800,1.07963,1.08037,1.07951,1.08024,1653,2884.95,-627698,-628481.8,40.91749316675336,56.87093842592022,57.45958708567948,NaN,NaN,50
1686675600,1.08024,1.08045,1.07962,1.07967,1567,2835.2,-629265,-629263.2,40.388767516711965,52.58454694299742,56.66437820821203,NaN,NaN,50
1686677400,1.07967,1.0797,1.07869,1.0789,1557,2774,-630822,-629692.6,38.56966864999842,47.38847964670689,55.54012846708367,NaN,NaN,50
1686679200,1.0789,1.07909,1.07856,1.0786,1717,2753.85,-632539,-629935,36.71194804113082,45.50195743279867,54.47050075896381,NaN,NaN,50
1686681000,1.0786,1.07905,1.0783,1.07902,1716,2743.65,-630823,-630229.4,34.646390673434105,48.58776172345495,53.81632209665922,NaN,NaN,50
1686682800,1.07902,1.07906,1.07847,1.07882,1628,2718.75,-632451,-631180,32.7399069916751,47.21672611515904,53.21541411584864,NaN,NaN,50
1686684600,1.07882,1.07959,1.07882,1.07918,1298,2700.25,-631153,-631557.6,31.567047939466704,49.95418016481551,51.78488415657258,NaN,NaN,50
1686686400,1.07918,1.07932,1.07908,1.07916,653,2643.4,-631806,-631754.4,30.47796453384462,49.799658614081764,51.090585900580486,NaN,NaN,50
1686688200,1.07916,1.07933,1.07906,1.07933,288,2592.25,-631518,-631550.2,29.43376067312985,51.18195513012485,50.999537247044266,NaN,NaN,50
1686690000,1.07933,1.0796,1.07905,1.07914,169,2518.2,-631687,-631723,28.791415774913503,49.540078225878915,50.7677875991086,NaN,NaN,50
1686691800,1.07914,1.07924,1.07893,1.07902,410,2452.1,-632097,-631652.2,27.976425675374074,48.48224126079125,50.122372213410024,NaN,NaN,50
1686693600,1.07902,1.07921,1.07883,1.07894,712,2357.2,-632809,-631983.4,27.032776762685902,47.75020811825098,49.82501141502106,NaN,NaN,50
1686695400,1.07894,1.07922,1.07894,1.07917,347,1968.4,-632462,-632114.6,26.171109581545537,50.083734288880414,49.857989948712955,NaN,NaN,50
1686697200,1.07917,1.07922,1.07892,1.07892,327,1756.5,-632789,-632368.8,25.32885420186052,47.5955022325243,49.466997737313235,NaN,NaN,50
1686699000,1.07892,1.07896,1.07882,1.07896,342,1528.6,-632447,-632520.8,24.327107288120388,48.040302924879846,48.83623805866749,NaN,NaN,50
1686700800,1.07896,1.07931,1.07858,1.07922,979,1340.9,-631468,-632395,23.979852039995684,50.95434279689942,48.719794905374776,NaN,NaN,50
1686702600,1.07922,1.07926,1.07894,1.07902,977,1214.25,-632445,-632322.2,23.6574007381656,48.692152257755204,48.81291437759251,NaN,NaN,50
1686704400,1.07902,1.07934,1.07882,1.07908,1056,1101.2,-631389,-632107.6,23.056792192285027,49.41767775479098,49.09260868630624,NaN,NaN,50
1686706200,1.07908,1.07952,1.07902,1.07939,1370,1037.1,-630019,-631553.6,22.82562453227712,53.107200325048424,49.41542572927721,NaN,NaN,50
1686708000,1.07939,1.07958,1.07904,1.07953,922,984.4,-629097,-630883.6,22.719758935547933,54.71373082932787,49.950926066003554,NaN,NaN,50
1686709800,1.07953,1.07962,1.07937,1.07959,884,945.95,-628213,-630232.6,22.697046300464592,55.418657359334915,50.34124586561207,NaN,NaN,50
1686711600,1.07959,1.07961,1.07914,1.0792,698,902.5,-628911,-629525.8,22.003564403720514,49.97344703823298,50.35365932448003,NaN,NaN,50
1686713400,1.0792,1.0792,1.07887,1.079,717,860.5,-629628,-629173.6,20.644474637794268,47.401282067480196,50.08361124857684,NaN,NaN,50
1686715200,1.079,1.07902,1.07847,1.0787,738,811.55,-630366,-629243,19.868341059039167,43.76264284807403,49.67093729301934,NaN,NaN,50
1686717000,1.0787,1.0792,1.07869,1.07898,592,755.35,-629774,-629378.4,18.703617320270233,47.790894729658426,49.62155539793843,NaN,NaN,50
1686718800,1.07898,1.07906,1.07818,1.07818,732,710.55,-630506,-629837,18.63694437580003,39.16007786857733,49.00797466581888,NaN,NaN,50
1686720600,1.07818,1.07874,1.0774,1.07762,1632,727.25,-632138,-630482.4,19.72198264609944,34.467616408465105,47.89253767436064,NaN,NaN,50
1686722400,1.07762,1.07858,1.07762,1.07858,1627,775.95,-630511,-630659,20.729518182806036,46.33860786524443,47.802759505269215,NaN,NaN,50
1686724200,1.07858,1.07878,1.07838,1.07854,1338,828.45,-631849,-630955.6,21.14045983016462,45.964986582587485,47.654522623676904,NaN,NaN,50
1686726000,1.07854,1.07949,1.07854,1.07936,2126,926.3,-629723,-630945.4,19.955193268475703,54.129984145349525,47.88135414856621,NaN,NaN,50
1686727800,1.07936,1.07968,1.07892,1.07896,1844,998,-631567,-631157.6,18.560529057792568,50.14914056818137,47.98542474216807,NaN,NaN,50
1686729600,1.07896,1.07967,1.0786,1.07964,1718,1048.3,-629849,-630699.8,17.774201737903777,56.06456305052455,48.46020226329191,NaN,NaN,50
1686731400,1.07964,1.08048,1.07952,1.08021,1340,1097.95,-628509,-630299.4,17.333185071282674,60.31549994074293,48.97508080727009,NaN,NaN,50
1686733200,1.08021,1.08045,1.07964,1.08038,1619,1162.55,-626890,-629307.6,16.923669595134502,61.51157543166669,49.460641136008576,NaN,NaN,50
1686735000,1.08038,1.08102,1.08027,1.08046,1504,1220.65,-625386,-628440.2,17.344616685825308,62.09061752627212,49.937209719361235,NaN,NaN,50
1686736800,1.08046,1.08088,1.08022,1.0807,1349,1239.15,-624037,-626934.2,17.631585980367223,63.84781469405773,50.92823598049158,NaN,NaN,50
1686738600,1.0807,1.08098,1.08034,1.08066,1482,1264.4,-625519,-626068.2,18.03779244806242,63.32100348574594,52.065358938939134,NaN,NaN,50
1686740400,1.08066,1.08077,1.08046,1.08058,1440,1283.6,-626959,-625758.2,18.4149841680651,62.21534460388099,53.383409064353906,NaN,NaN,50
1686742200,1.08058,1.08076,1.08018,1.08034,1524,1291.3,-628483,-626076.8,18.106833249885632,58.89301224330614,54.17641745818589,NaN,NaN,50
1686744000,1.08034,1.08198,1.08034,1.0818,2181,1354.25,-626302,-626260,19.41388357662089,69.54681375702204,56.3468985930748,NaN,NaN,50
1686745800,1.0818,1.08332,1.08153,1.08312,3936,1506.85,-622366,-625925.8,21.69492039508627,75.68306959563472,59.29085953501548,NaN,NaN,50
1686747600,1.08312,1.08396,1.08272,1.08367,2916,1617.75,-619450,-624712,24.18773399370247,77.69939578689002,61.53091581513302,NaN,NaN,50
1686749400,1.08367,1.08452,1.08351,1.08448,3565,1760.15,-615885,-622497.2,26.788452030083526,80.29128989216764,63.98279462296017,NaN,NaN,50
1686751200,1.08448,1.08488,1.08414,1.08474,2752,1860.85,-613133,-619427.2,29.3723319158768,81.05253539652642,65.90583399804424,NaN,NaN,50
1686753000,1.08474,1.08564,1.08467,1.08558,2691,1965.8,-610442,-616255.2,32.08930702376557,83.29717714369677,68.27355089629533,NaN,NaN,50
1686754800,1.08558,1.08558,1.08485,1.08505,2254,2041.9,-612696,-614321.2,34.61221248109085,77.09157250771406,69.77548014323744,NaN,NaN,50
1686756600,1.08505,1.08582,1.08482,1.0858,1710,2045.8,-610986,-612628.4,37.05296827521905,79.42726627185615,71.14060630974554,NaN,NaN,50
1686758400,1.0858,1.08626,1.08553,1.08621,1424,2035.65,-609562,-611363.8,39.490591768751166,80.59220756025665,72.50350860464482,NaN,NaN,50
1686760200,1.08621,1.08644,1.0859,1.08624,1553,2046.4,-608009,-610339,41.821456456485336,80.67842134711765,73.83120887756236,NaN,NaN,50
1686762000,1.08624,1.0863,1.08566,1.08568,1376,2008.9,-609385,-610127.6,43.434125286637915,74.06445655369711,74.56096901039373,NaN,NaN,50
1686763800,1.08568,1.08583,1.08524,1.0855,1715,2002.45,-611100,-609808.4,44.01594664137507,72.0206916528599,75.18237530804473,NaN,NaN,50
1686765600,1.0855,1.0855,1.08014,1.08108,9208,2376.95,-620308,-611672.8,42.65402332628827,41.63722512595455,73.71250963105,NaN,NaN,50
1686767400,1.08108,1.08454,1.0807,1.08342,9016,2760.75,-611292,-612018.8,41.38938024799337,52.95312481530375,73.28823195762126,NaN,NaN,50
1686769200,1.08342,1.0844,1.08236,1.08238,5257,2942.65,-616549,-613726.8,40.21506881814812,48.45630376723863,71.78176695835101,NaN,NaN,50
1686771000,1.08238,1.08296,1.08208,1.08268,3240,3029.45,-613309,-614511.6,39.30401620090382,49.78111403323557,69.9316272753225,NaN,NaN,50
1686772800,1.08268,1.0835,1.08249,1.08344,998,3011.9,-612311,-614753.8,37.86643322606257,53.071818439693686,68.1725146076656,NaN,NaN,50
1686774600,1.08344,1.08355,1.08305,1.08316,811,2978.35,-613122,-613316.6,36.47673119623876,51.72698624655264,66.13220720440741,NaN,NaN,50
1686776400,1.08316,1.08342,1.08275,1.08297,175,2915.1,-613297,-613717.6,35.41903973196171,50.78654206219547,63.97035053766948,NaN,NaN,50
1686778200,1.08297,1.08328,1.08293,1.08324,338,2855.8,-612959,-612999.6,34.43689765799016,52.11876241074725,61.74332091388737,NaN,NaN,50
1686780000,1.08324,1.08346,1.0831,1.08342,377,2765.6,-612582,-612854.2,33.28992102879913,53.031595580314416,60.024751133358826,NaN,NaN,50
1686781800,1.08342,1.08353,1.08316,1.08324,295,2583.55,-612877,-612967.4,32.130190895084255,51.96470665050565,58.06313973183379,NaN,NaN,50
1686783600,1.08324,1.08386,1.08319,1.08385,627,2469.1,-612250,-612793,30.603562347762924,55.250320054415035,56.25300490998796,NaN,NaN,50
1686785400,1.08385,1.08429,1.08385,1.08428,741,2327.9,-611509,-612435.4,28.63073736271134,57.45926217396716,54.59449354047721,NaN,NaN,50
1686787200,1.08428,1.08445,1.08382,1.08399,838,2232.2,-612347,-612313,26.597609118905762,55.47055367734059,53.26635762073746,NaN,NaN,50
1686789000,1.08399,1.08415,1.08371,1.08382,1016,2148.45,-613363,-612469.2,24.851258875761236,54.28445138786254,51.99948331609479,NaN,NaN,50
1686790800,1.08382,1.08382,1.082,1.08221,2054,2138.45,-615417,-612977.2,24.97303303480985,44.56548796661993,52.208644947570896,NaN,NaN,50
1686792600,1.08221,1.08242,1.08102,1.0811,1915,2148.7,-617332,-613993.6,25.78596961278368,39.33645372995647,51.2360255843318,NaN,NaN,50
1686794400,1.0811,1.08158,1.08085,1.0812,1606,2157.8,-615726,-614837,26.651385134510836,40.019258201049645,50.63337947246116,NaN,NaN,50
1686796200,1.0812,1.08152,1.08096,1.08134,1153,2137.8,-614573,-615282.2,27.454985261828906,41.02014504511149,50.007595973309435,NaN,NaN,50
1686798000,1.08134,1.08158,1.08108,1.08114,917,2114.85,-615490,-615707.6,28.104109231663276,39.99343341545211,49.07342561443504,NaN,NaN,50
1686799800,1.08114,1.08144,1.08108,1.08134,778,2068,-614712,-615566.6,28.706867203652337,41.568443815653936,48.347815440799415,NaN,NaN,50
1686801600,1.08134,1.08145,1.081,1.08124,759,1645.55,-615471,-615194.4,29.334610919002557,40.9891376947088,47.64800084312179,NaN,NaN,50
1686803400,1.08124,1.08152,1.08115,1.08116,764,1232.95,-616235,-615296.2,29.780534085585046,40.50283746958607,46.81829191875314,NaN,NaN,50
1686805200,1.08116,1.08156,1.08058,1.08142,1400,1040.1,-614835,-615348.6,30.696093599219765,42.87492398119968,46.092815375959226,NaN,NaN,50
1686807000,1.08142,1.08236,1.08142,1.08185,1854,970.8,-612981,-614846.8,30.105748993393146,46.66238077525022,45.71407781344099,NaN,NaN,50
1686808800,1.08185,1.08207,1.0813,1.08134,2265,1034.15,-615246,-614953.6,29.68132417121212,43.01928577882389,44.84043250804162,NaN,NaN,50
1686810600,1.08134,1.08138,1.08038,1.08106,1759,1081.55,-617005,-615260.4,30.13061261820341,41.12109101940607,43.67342028271583,NaN,NaN,50
1686812400,1.08106,1.0814,1.08058,1.08132,2338,1189.7,-614667,-614946.8,30.512535437473538,43.60929015987407,42.82618717432537,NaN,NaN,50
1686814200,1.08132,1.0829,1.08114,1.08271,2015,1273.55,-612652,-614510.2,28.672344105013586,54.64451799427416,42.85190621764048,NaN,NaN,50
1686816000,1.08271,1.08304,1.08246,1.0826,1760,1342.7,-614412,-614796.4,26.796824327736076,53.74812261307368,43.50780869238718,NaN,NaN,50
1686817800,1.0826,1.08372,1.08258,1.08328,1447,1400.3,-612965,-614340.2,25.47410012247483,58.30188479836761,44.86248234013083,NaN,NaN,50
1686819600,1.08328,1.0845,1.08313,1.08437,1967,1467.3,-610998,-613138.8,24.994354846593463,64.35932540947665,46.6010585693042,NaN,NaN,50
1686821400,1.08437,1.08477,1.08396,1.08476,1741,1517.3,-609257,-612056.8,24.785929090515083,66.24856803541071,48.403088782896994,NaN,NaN,50
1686823200,1.08476,1.08488,1.08344,1.08392,1867,1568.75,-611124,-611751.2,23.911312048870727,58.99493010791359,49.760338546644256,NaN,NaN,50
1686825000,1.08392,1.08454,1.08384,1.08423,1490,1592.45,-609634,-610795.6,23.09916765305811,60.704886431304594,51.12722730490501,NaN,NaN,50
1686826800,1.08423,1.08434,1.08322,1.08338,1703,1574.9,-611337,-610470,21.561436437890137,54.04939384360138,52.060102744111624,NaN,NaN,50
1686828600,1.08338,1.08338,1.08178,1.0818,2163,1587.3,-613500,-610970.4,21.33128719654412,44.32195872594871,52.33289711956609,NaN,NaN,50
1686830400,1.0818,1.08516,1.08146,1.08494,4192,1716.6,-609308,-610980.6,20.246932379548706,59.80449866981334,53.542152454467065,NaN,NaN,50
1686832200,1.08494,1.08812,1.08432,1.08643,6465,1982.2,-602843,-609324.4,21.052635199445497,64.80567537671548,54.83810206885744,NaN,NaN,50
1686834000,1.08643,1.08939,1.08585,1.08866,5059,2189.3,-597784,-606954.4,22.343986804763347,70.68455445344156,56.814192688472986,NaN,NaN,50
1686835800,1.08866,1.09008,1.08768,1.08991,4425,2371.65,-593359,-603358.8,23.808387207127975,73.36981206550333,59.117672763194214,NaN,NaN,50
1686837600,1.08991,1.09202,1.08991,1.0918,3847,2526.05,-589512,-598561.2,25.804814555234408,76.82620488840078,61.49030952951755,NaN,NaN,50
1686839400,1.0918,1.09214,1.09079,1.09106,3940,2684.85,-593452,-595390,27.694066865817668,72.83988006299636,62.78997824871199,NaN,NaN,50
1686841200,1.09106,1.09284,1.09098,1.09281,3116,2770.65,-590336,-592888.6,29.65527510611155,76.01005719576771,64.38011643319014,NaN,NaN,50
1686843000,1.09281,1.09358,1.09266,1.09328,1978,2776.85,-588358,-591003.4,31.683362479731343,76.79349770939932,65.70094592683526,NaN,NaN,50
1686844800,1.09328,1.09451,1.09322,1.09428,1890,2758.1,-586468,-589625.2,33.807534350992924,78.4090997397935,66.7045012361436,NaN,NaN,50
1686846600,1.09428,1.09452,1.09378,1.09438,1837,2762,-584631,-588649,35.78254305457276,78.56977026465216,67.58458710966084,NaN,NaN,50
1686848400,1.09438,1.09452,1.09396,1.09444,1395,2714.85,-583236,-586605.8,37.61647970789689,78.67232245977631,68.9901151347939,NaN,NaN,50
1686850200,1.09444,1.09502,1.09426,1.0943,1350,2681.6,-584586,-585455.8,39.460328101593426,77.73754033747441,70.20673327094887,NaN,NaN,50
1686852000,1.0943,1.09464,1.09416,1.09446,1311,2659.15,-583275,-584439.2,41.0451869119386,78.0584132734216,71.92166323022175,NaN,NaN,50
1686853800,1.09446,1.09512,1.0944,1.09504,1318,2652.7,-581957,-583537,42.66300695543839,79.2272316084193,74.41489700754109,NaN,NaN,50
1686855600,1.09504,1.09527,1.09473,1.09488,1637,2636.2,-583594,-583329.6,44.21101267496412,77.99295910126506,75.71407275264478,NaN,NaN,50
1686857400,1.09488,1.09494,1.09452,1.09478,1668,2632.55,-585262,-583734.8,45.3443511968521,77.18362756860773,76.59821219492278,NaN,NaN,50
1686859200,1.09478,1.09492,1.09473,1.0948,546,2566.5,-584716,-583760.8,46.39673696717666,77.23450940254375,77.06606611985866,NaN,NaN,50
1686861000,1.0948,1.09481,1.09452,1.09455,498,2516.9,-585214,-584148.6,47.04043108012372,74.98350375185852,77.18132981174118,NaN,NaN,50
1686862800,1.09455,1.09456,1.09424,1.09434,102,2436.85,-585316,-584820.4,47.191904072244135,73.0573408109709,76.9121252347819,NaN,NaN,50
1686864600,1.09434,1.09438,1.09422,1.0943,140,2335.7,-585456,-585192.8,47.29971266539273,72.67439782889481,76.90030507520324,NaN,NaN,50
1686866400,1.0943,1.0948,1.0943,1.09462,524,2152.3,-584932,-585126.8,47.638631573735466,73.85507801511496,76.74637799087088,NaN,NaN,50
1686868200,1.09462,1.09496,1.09454,1.09491,705,1864.3,-584227,-585029,48.04254522615473,74.91297738430852,76.61205511050726,NaN,NaN,50
1686870000,1.09491,1.09514,1.09472,1.09474,585,1640.6,-584812,-584948.6,48.51964723173551,73.04704766230964,76.22905139068698,NaN,NaN,50
1686871800,1.09474,1.09488,1.09452,1.09455,574,1448.05,-585386,-584962.6,48.57248309970444,70.9208600627767,75.68270066198158,NaN,NaN,50
1686873600,1.09455,1.09508,1.09452,1.09462,983,1304.85,-584403,-584752,48.75430137591577,71.25284842089903,75.1527382306332,NaN,NaN,50
1686875400,1.09462,1.09468,1.094,1.0942,1170,1166.35,-585573,-584880.2,47.919047455634086,66.35767174797223,74.33989047424018,NaN,NaN,50
1686877200,1.0942,1.09464,1.094,1.09422,1187,1069.9,-584386,-584912,47.14345452965823,66.4757827015431,73.512559719106,NaN,NaN,50
1686879000,1.09422,1.09484,1.094,1.09434,1217,1031.85,-583169,-584583.4,46.60236936690277,67.2194125235741,72.65485835590277,NaN,NaN,50
1686880800,1.09434,1.09458,1.09422,1.0943,1219,998.3,-584388,-584383.8,46.09993314434412,66.68839137051086,71.84738923227748,NaN,NaN,50
1686882600,1.0943,1.09438,1.09356,1.09364,1857,999.3,-586245,-584752.2,44.314425239714275,58.47941913735499,70.51137434433085,NaN,NaN,50
1686884400,1.09364,1.09424,1.09364,1.09421,1120,985.55,-585125,-584662.6,42.656453613986564,62.74465223156781,69.476384546404,NaN,NaN,50
1686886200,1.09421,1.09424,1.09381,1.09382,842,960.15,-585967,-584978.8,41.11690853295368,58.32953444128034,68.28681530993414,NaN,NaN,50
1686888000,1.09382,1.09426,1.09366,1.09424,671,928.15,-585296,-585404.2,39.37422652150118,61.473611920466475,67.45940610346953,NaN,NaN,50
1686889800,1.09424,1.09431,1.09387,1.09388,686,896.55,-585982,-585723,37.83232377070785,57.47093063469361,66.37344416102658,NaN,NaN,50
1686891600,1.09388,1.09426,1.09376,1.09411,839,856.65,-585143,-585502.6,36.15241675492392,59.29451247532668,65.33340376532742,NaN,NaN,50
1686893400,1.09411,1.09452,1.09394,1.09398,1202,833.35,-586345,-585746.6,35.01990476771882,57.78629344037735,64.11006919790377,NaN,NaN,50
1686895200,1.09398,1.0958,1.09393,1.09564,2354,923.75,-583991,-585351.4,35.506529692582,68.72557252316041,63.80139240225025,NaN,NaN,50
1686897000,1.09564,1.09625,1.09458,1.09472,2210,1009.35,-586201,-585532.4,36.34397983945652,59.51978417548548,62.98702983887231,NaN,NaN,50
1686898800,1.09472,1.09522,1.09339,1.0941,2514,1129.95,-588715,-586079,34.923196591700375,54.24625972688291,61.772273503585446,NaN,NaN,50
1686900600,1.0941,1.09468,1.09364,1.09428,2175,1231.7,-586540,-586358.4,33.60389786164109,55.47954821542026,60.995264679831735,NaN,NaN,50
1686902400,1.09428,1.09528,1.09382,1.09487,2167,1313.85,-584373,-585964,33.02885934035252,59.347568898329364,60.486106551030744,NaN,NaN,50
1686904200,1.09487,1.09536,1.09453,1.09505,2156,1386.4,-582217,-585609.2,32.57678436721168,60.475798540797385,60.00441983797527,NaN,NaN,50
1686906000,1.09505,1.09513,1.09398,1.09466,1755,1444.9,-583972,-585163.4,31.230759205679743,56.797738513731346,59.29794463391959,NaN,NaN,50
1686907800,1.09466,1.09496,1.09447,1.09494,1413,1486.85,-582559,-583932.2,29.98087869854294,58.73802270230219,59.316416317130106,NaN,NaN,50
1686909600,1.09494,1.09494,1.09434,1.09444,1381,1506.75,-583940,-583412.2,28.5985753514632,54.068229305115196,58.696671822383486,NaN,NaN,50
1686911400,1.09444,1.09499,1.0943,1.09444,1161,1506.3,-583940,-583325.6,27.386360515866958,54.068229305115196,58.392292884085975,NaN,NaN,50
1686913200,1.09444,1.09586,1.09444,1.09575,1927,1543.3,-582013,-583284.8,27.3538710276598,63.00518925985731,58.50169126547104,NaN,NaN,50
1686915000,1.09575,1.0966,1.09558,1.09604,2060,1585.45,-579953,-582481,28.038266286718354,64.64516283688843,59.01413642277067,NaN,NaN,50
1686916800,1.09604,1.09708,1.09594,1.09651,2554,1652.2,-577399,-581449,29.066985228198998,67.18417027912622,59.57768340875634,NaN,NaN,50
1686918600,1.09651,1.09668,1.09475,1.0951,2733,1696,-580132,-580687.4,28.099224493419445,54.531823397171635,59.345221262813084,NaN,NaN,50
1686920400,1.0951,1.09562,1.09424,1.09534,2877,1783.85,-577255,-579350.4,26.538552414506782,56.04904582082711,58.43975506978928,NaN,NaN,50
1686922200,1.09534,1.09584,1.0947,1.09534,3509,1917.2,-577255,-578398.8,25.32998569774227,56.04904582082711,58.191845187313675,NaN,NaN,50
1686924000,1.09534,1.09672,1.09315,1.09362,5839,2175.6,-583094,-579027,24.5110940420079,43.87915807195638,57.4513379262475,NaN,NaN,50
1686925800,1.09362,1.09393,1.09178,1.09253,4739,2378.25,-587833,-581113.8,24.7928065742125,38.21614051106115,56.218237375936134,NaN,NaN,50
1686927600,1.09253,1.0932,1.09231,1.09286,3354,2504,-584479,-581983.2,25.054396782688197,40.71094367210433,54.88704985977721,NaN,NaN,50
1686929400,1.09286,1.0931,1.09216,1.09242,2481,2567.95,-586960,-583924.2,25.40490247465177,38.47984884692563,53.31591059592922,NaN,NaN,50
1686931200,1.09242,1.09292,1.09242,1.09289,1799,2540.2,-585161,-585505.4,25.730372045760802,42.1282559692955,52.2680904141838,NaN,NaN,50
1686933000,1.09289,1.0934,1.09274,1.09339,1432,2501.3,-583729,-585632.4,25.359782053754625,45.81006581185445,51.34466492200897,NaN,NaN,50
1686934800,1.09339,1.09394,1.09322,1.09379,1332,2442.2,-582397,-584545.2,24.320635476466947,48.62594059000054,50.955930013786485,NaN,NaN,50
1686936600,1.09379,1.09398,1.09352,1.09394,1096,2388.25,-581301,-583909.6,23.305071507945293,49.68187064786968,50.6426186811261,NaN,NaN,50
1686938400,1.09394,1.09426,1.09386,1.0941,1222,2341,-580079,-582533.4,22.000180203628705,50.842502386882515,49.77385533305647,NaN,NaN,50
1686940200,1.0941,1.09456,1.09374,1.09446,1438,2305.1,-578641,-581229.4,20.447227709080387,53.44450714067771,48.97380849761286,NaN,NaN,50
1686942000,1.09446,1.09446,1.09384,1.09414,1234,2279.05,-579875,-580458.6,19.00520039271409,50.86707497116872,47.8083016899016,NaN,NaN,50
1686943800,1.09414,1.09434,1.09347,1.09352,1419,2279.35,-581294,-580238,18.110884660093188,46.21649060183741,47.21434934737773,NaN,NaN,50
1686945600,1.09352,1.09394,1.09348,1.09365,782,2249.4,-580512,-580080.2,17.28044862265949,47.30437235013555,46.589729813756904,NaN,NaN,50
1686947400,1.09365,1.09425,1.0936,1.09416,708,2226.75,-579804,-580025.2,16.049552903616203,51.45301760952674,46.26144208437831,NaN,NaN,50
1687122000,1.09416,1.09422,1.09361,1.09384,63,2133.55,-579867,-580270.4,14.906578307361723,48.85407323728934,46.61679316761638,NaN,NaN,50
1687123800,1.09384,1.09419,1.09334,1.09408,397,2050.4,-579470,-580189.4,14.255408226696794,50.85890045694496,47.519847449465225,NaN,NaN,50
1687125600,1.09408,1.09435,1.09373,1.09404,755,1960.45,-580225,-579975.6,13.379454443984084,50.503578957319036,48.21932139840913,NaN,NaN,50
1687127400,1.09404,1.09432,1.09394,1.0943,440,1845.8,-579785,-579830.2,12.566068788607994,52.81133679278805,49.242999108827874,NaN,NaN,50
1687129200,1.0943,1.09432,1.094,1.094,638,1733.85,-580423,-579954,11.810782108615914,49.91921376476727,49.79949609421872,NaN,NaN,50
1687131000,1.094,1.0941,1.09388,1.09398,594,1588.1,-581017,-580184,11.337220891722152,49.723713844102235,50.079042382236416,NaN,NaN,50
1687132800,1.09398,1.09463,1.09397,1.09419,965,1344.4,-580052,-580300.4,11.164221362125259,51.855762653428805,50.309743958195575,NaN,NaN,50
1687134600,1.09419,1.09423,1.09348,1.09368,1000,1157.45,-581052,-580465.8,10.645842404471558,46.6786479598829,50.09522805191081,NaN,NaN,50
1687136400,1.09368,1.09406,1.09336,1.09363,1071,1043.3,-582123,-580933.4,10.371184025553937,46.1917480769841,49.7630313154895,NaN,NaN,50
1687138200,1.09363,1.09394,1.09348,1.09368,1482,993.35,-580641,-580977,10.116144102273287,46.789476104033334,49.28767195572919,NaN,NaN,50
1687140000,1.09368,1.09404,1.09363,1.09402,886,947.7,-579755,-580724.6,9.663577970629246,50.79242713327357,49.28233996730811,NaN,NaN,50
1687141800,1.09402,1.09408,1.09363,1.09364,929,922.55,-580684,-580851,9.154117615878473,46.57520141039891,49.30796216791964,NaN,NaN,50
1687143600,1.09364,1.09369,1.0934,1.09364,813,896.6,-580684,-580777.4,9.163938655039804,46.57520141039891,49.25587852936702,NaN,NaN,50
1687145400,1.09364,1.09381,1.09342,1.09369,1089,896.25,-579595,-580271.8,8.880235504685299,47.243635385684165,48.95520837052112,NaN,NaN,50
1687147200,1.09369,1.09371,1.09332,1.09352,849,877.6,-580444,-580232.4,8.837336687041288,45.17411879374311,48.692354481696384,NaN,NaN,50
1687149000,1.09352,1.09354,1.09322,1.09347,939,852.65,-581383,-580558,9.019486475668073,44.55590788067955,48.242140726248856,NaN,NaN,50
1687150800,1.09347,1.09372,1.09318,1.09366,1023,842.1,-580360,-580493.2,8.69825680192626,47.496299469713314,48.02733504856274,NaN,NaN,50
1687152600,1.09366,1.09414,1.09358,1.09402,1354,838.85,-579006,-580157.6,8.755137496631626,52.62313939428923,48.0138923772414,NaN,NaN,50
1687154400,1.09402,1.09403,1.09276,1.09286,1812,890.35,-580818,-580402.2,9.171791636373479,39.30490242784595,47.25572728174701,NaN,NaN,50
1687156200,1.09286,1.09338,1.09286,1.09295,1384,924.15,-579434,-580200.2,9.558684766133771,40.56181402754435,46.601305866278594,NaN,NaN,50
1687158000,1.09295,1.09322,1.0926,1.0928,2186,1030.3,-581620,-580247.6,10.374458963324482,39.10818942952255,45.690764921713864,NaN,NaN,50
1687159800,1.0928,1.09376,1.09252,1.09294,2216,1121.25,-579404,-580056.4,9.893029693849067,41.22531521914086,45.301241154517996,NaN,NaN,50
1687161600,1.09294,1.09388,1.09291,1.09371,1882,1177.6,-577522,-579759.6,9.200426135863237,51.26224082965895,45.66341920828048,NaN,NaN,50
1687163400,1.09371,1.09372,1.0927,1.09296,1696,1240.4,-579218,-579439.6,8.976752640015597,43.47467147860421,45.42664744932126,NaN,NaN,50
1687165200,1.09296,1.09297,1.0924,1.09268,1400,1278.5,-580618,-579676.4,9.325990538603863,40.972167745260435,44.725200350177474,NaN,NaN,50
1687167000,1.09268,1.09268,1.091,1.09107,1791,1338.35,-582409,-579834.2,11.461366578456929,30.205579114859987,43.55594161478184,NaN,NaN,50
1687168800,1.09107,1.09168,1.09072,1.09162,1547,1367.45,-580862,-580125.8,13.703056727395872,36.35810923367054,42.826149316444095,NaN,NaN,50
1687170600,1.09162,1.09198,1.0915,1.09198,1143,1374.6,-579719,-580565.2,15.127876440285037,40.0813373580783,42.31455660018653,NaN,NaN,50
1687172400,1.09198,1.09222,1.0917,1.09212,1188,1380.45,-578531,-580427.8,15.949342898358537,41.51430520111774,42.05314134357043,NaN,NaN,50
1687174200,1.09212,1.09274,1.09201,1.09214,1437,1378.2,-577094,-579723,15.7243662290773,41.7287007073368,41.85119797404595,NaN,NaN,50
1687176000,1.09214,1.09295,1.09195,1.09254,1555,1411.65,-575539,-578349,15.150134093274184,45.99284601437767,41.743808441521985,NaN,NaN,50
1687177800,1.09254,1.09262,1.09206,1.09261,1509,1440.65,-574030,-576982.6,14.61691853859986,46.727533814403564,41.32269375724443,NaN,NaN,50
1687179600,1.09261,1.09262,1.0917,1.09226,1569,1478.45,-575599,-576158.6,14.667059021291754,43.53835931242652,41.62508353471447,NaN,NaN,50
1687181400,1.09226,1.09236,1.09171,1.09184,1515,1499.75,-577114,-575875.2,14.713618040934225,40.00949901584916,41.58563246245053,NaN,NaN,50
1687183200,1.09184,1.092,1.09124,1.09193,1654,1540,-575460,-575548.4,15.429917545907482,41.110974104113836,41.72868851063562,NaN,NaN,50
1687185000,1.09193,1.09263,1.09171,1.09229,2105,1598.3,-573355,-575111.6,14.861900239981226,45.42728230307444,42.02882901663088,NaN,NaN,50
1687186800,1.09229,1.0929,1.09219,1.09275,1499,1622.1,-571856,-574676.8,13.873520547284196,50.4271862486986,41.969182260847994,NaN,NaN,50
1687188600,1.09275,1.09284,1.09212,1.09218,796,1594.2,-572652,-574087.4,13.072298925058659,44.93356557640936,42.07338898211979,NaN,NaN,50
1687190400,1.09218,1.09263,1.09182,1.09214,718,1539.5,-573370,-573338.6,12.819990214731805,44.56664363744212,42.330137260132766,NaN,NaN,50
1687192200,1.09214,1.09216,1.09158,1.09162,717,1506.15,-574087,-573064,12.95674740650434,39.99439381215599,43.029338309939625,NaN,NaN,50
1687194000,1.09162,1.09184,1.09158,1.09183,288,1411.25,-573799,-573152.8,13.08373622743598,42.55742877064272,43.47214684829478,NaN,NaN,50
1687195800,1.09183,1.09193,1.09173,1.09176,230,1311.95,-574029,-573587.4,13.001967102018241,41.91475137455229,43.603104992328646,NaN,NaN,50
1687197600,1.09176,1.0921,1.09172,1.09182,264,1231.05,-573765,-573810,12.548449780645129,42.71331446634635,43.688748511273545,NaN,NaN,50
1687199400,1.09182,1.09199,1.09162,1.09194,217,1157.1,-573548,-573845.6,12.321001531878647,44.36086384233989,43.87676016377377,NaN,NaN,50
1687201200,1.09194,1.09201,1.09189,1.09197,443,1109.25,-573105,-573649.2,12.061231272001216,44.78836768460726,43.7907259973616,NaN,NaN,50
1687203000,1.09197,1.09209,1.09182,1.09184,247,1032.05,-573352,-573559.8,11.61752272637254,43.23800925521137,43.54147424313358,NaN,NaN,50
1687204800,1.09184,1.09206,1.09174,1.092,311,970.25,-573041,-573362.2,11.389255000608548,45.72803446590739,43.697879611239365,NaN,NaN,50
1687206600,1.092,1.09228,1.092,1.0921,278,927,-572763,-573161.8,10.597544605584536,47.28453358698877,44.21752493774933,NaN,NaN,50
1687208400,1.0921,1.09248,1.0921,1.09237,196,877.4,-572567,-572965.6,10.30800865660252,51.3421819388684,44.948325497374654,NaN,NaN,50
1687210200,1.09237,1.09242,1.09206,1.09229,359,823.5,-572926,-572929.8,9.928847524051152,50.11139258304852,45.28290480308709,NaN,NaN,50
1687212000,1.09229,1.09262,1.09222,1.09252,492,770.35,-572434,-572746.2,10.068031283890443,53.558377083745796,45.50656129130475,NaN,NaN,50
1687213800,1.09252,1.09264,1.09228,1.0923,410,715.4,-572844,-572706.8,10.245968689196836,49.99972834664902,45.86843006060758,NaN,NaN,50
1687215600,1.0923,1.0924,1.09192,1.09194,440,658.95,-573284,-572811,9.665496907770162,44.758881784122686,45.882161356799045,NaN,NaN,50
1687217400,1.09194,1.09248,1.0919,1.09236,333,599.85,-572951,-572887.8,9.044474411827755,51.18722127206863,46.681649032507096,NaN,NaN,50
1687219200,1.09236,1.09262,1.0917,1.09188,1172,575.75,-574123,-573127.2,8.872449096519508,44.77448250636681,46.84001001363025,NaN,NaN,50
1687221000,1.09188,1.09206,1.0917,1.09204,1226,531.8,-572897,-573219.8,8.712711303733279,47.15121566242217,47.21404317704952,NaN,NaN,50
1687222800,1.09204,1.09224,1.09158,1.09172,1249,519.3,-574146,-573480.2,8.17168804985581,43.15131382930029,47.24532884583194,NaN,NaN,50
1687224600,1.09172,1.09188,1.0911,1.09134,1729,565.95,-575875,-573998.4,8.757371912342636,38.928144947632575,46.85727749620999,NaN,NaN,50
1687226400,1.09134,1.09184,1.09106,1.0918,1649,612.5,-574226,-574253.4,9.392610781011978,45.838410617511954,46.93228056284604,NaN,NaN,50
1687228200,1.0918,1.09238,1.09172,1.09224,1583,655.8,-572643,-573957.4,8.990027937368868,51.49225961619072,47.521869874344574,NaN,NaN,50
1687230000,1.09224,1.09239,1.09196,1.09208,1047,693.75,-573690,-574116,8.641056714205261,49.469956178200974,47.789149996651254,NaN,NaN,50
1687231800,1.09208,1.09234,1.0919,1.09198,827,723.6,-574517,-574190.2,8.14725406836452,48.19592690252909,47.85424951918985,NaN,NaN,50
1687233600,1.09198,1.09204,1.09163,1.0919,840,752.4,-575357,-574086.6,8.16570585553197,47.1497810615275,47.55479231366549,NaN,NaN,50
1687235400,1.0919,1.0919,1.09129,1.09138,1005,791.8,-576362,-574513.8,8.961462014024848,40.930664070315444,46.89902599132741,NaN,NaN,50
1687237200,1.09138,1.09178,1.09118,1.09177,1567,848,-574795,-574944.2,9.929861799468382,46.617774585445744,46.40326867002027,NaN,NaN,50
1687239000,1.09177,1.09262,1.09164,1.09262,1156,893.45,-573639,-574934,9.770704270681026,56.457480829085526,46.86453670448002,NaN,NaN,50
1687240800,1.09262,1.09324,1.09208,1.09323,1935,974.65,-571704,-574371.4,10.703626146901382,61.8869213741522,48.087968103767835,NaN,NaN,50
1687242600,1.09323,1.09324,1.09197,1.09217,1805,1051,-573509,-574001.8,11.303459459165836,50.17802839319995,48.01588289813436,NaN,NaN,50
1687244400,1.09217,1.09352,1.09152,1.09332,2828,1182.6,-570681,-572865.6,10.856539141580722,59.197487990740036,49.04609757558959,NaN,NaN,50
1687246200,1.09332,1.09462,1.09328,1.09439,2602,1294.75,-568079,-571522.4,12.049099407811525,65.46249045619749,50.354045775144975,NaN,NaN,50
1687248000,1.09439,1.09448,1.0936,1.09402,2206,1380.45,-570285,-570851.6,13.156476797882984,61.921857169401505,51.694798870866485,NaN,NaN,50
1687249800,1.09402,1.09406,1.09318,1.0938,2344,1477.15,-572629,-571036.6,13.319339152947338,59.84908495024347,53.18915172819584,NaN,NaN,50
1687251600,1.0938,1.09401,1.09262,1.09298,2228,1566.55,-574857,-571306.2,12.480932784132898,52.760027813162566,53.683552956456595,NaN,NaN,50
1687253400,1.09298,1.09328,1.09228,1.09252,1718,1635.8,-576575,-572485,12.004436488627805,49.23673399400381,53.522443983443246,NaN,NaN,50
1687255200,1.09252,1.09338,1.09248,1.09306,1557,1655.05,-575018,-573872.8,11.39170740116036,53.18871644316666,53.78806971665508,NaN,NaN,50
1687257000,1.09306,1.09344,1.09272,1.09282,1704,1678.95,-576722,-575160.2,10.716746795373759,51.27798959343869,54.00821705172006,NaN,NaN,50
1687258800,1.09282,1.09322,1.09256,1.09271,1653,1699.15,-578375,-576309.4,10.367180046856802,50.38459565635935,54.23927523706518,NaN,NaN,50
1687260600,1.09271,1.0931,1.0922,1.09288,2039,1714.65,-576336,-576605.2,10.631194475531638,51.78275078751797,55.01442428829393,NaN,NaN,50
1687262400,1.09288,1.09358,1.09276,1.09278,2488,1756.6,-578824,-577055,9.966955128119888,50.87456377658231,55.3184806590894,NaN,NaN,50
1687264200,1.09278,1.09278,1.09121,1.09194,3081,1831.5,-581905,-578432.4,11.320856903139182,43.90828828237192,54.42210976289557,NaN,NaN,50
1687266000,1.09194,1.09202,1.09063,1.0914,2701,1914.2,-584606,-580009.2,13.092202177998818,40.10629257783082,52.866350563158335,NaN,NaN,50
1687267800,1.0914,1.09246,1.09109,1.09167,4022,2073.95,-580584,-580451,13.994070709301395,42.77444018858969,52.3375228342576,NaN,NaN,50
1687269600,1.09167,1.09208,1.09,1.0902,3921,2228,-584505,-582084.8,15.729992577247742,33.91576906025642,50.531685767794485,NaN,NaN,50
1687271400,1.0902,1.09057,1.08922,1.09016,4075,2381.5,-588580,-584036,17.850679749092933,33.71117853361952,48.26373491618177,NaN,NaN,50
1687273200,1.09016,1.09098,1.09006,1.09048,3262,2466.25,-585318,-584718.6,19.182781085355742,36.98605692416794,46.48260632723652,NaN,NaN,50
1687275000,1.09048,1.09082,1.08996,1.08998,2357,2526.3,-587675,-585332.4,20.491647904477144,34.147373909880685,44.646769824353456,NaN,NaN,50
1687276800,1.08998,1.09084,1.08956,1.09081,2022,2530.65,-585653,-586346.2,21.992410589522514,42.092591032869045,43.88481005433249,NaN,NaN,50
1687278600,1.09081,1.09162,1.0908,1.0915,1706,2525.7,-583947,-586234.6,22.189590072806894,47.73775328502498,43.77774000369114,NaN,NaN,50
1687280400,1.0915,1.09172,1.09122,1.09158,1682,2468.4,-582265,-584971.6,22.22939780761046,48.366247899622735,43.43327796486658,NaN,NaN,50
1687282200,1.09158,1.09168,1.09122,1.09157,1038,2390.2,-583303,-584568.6,22.266362132785197,48.288076464142755,43.21971274134544,NaN,NaN,50
1687284000,1.09157,1.09166,1.09116,1.09158,1153,2337.55,-582150,-583463.6,22.361746825740898,48.377928061987284,43.07637934174743,NaN,NaN,50
1687285800,1.09158,1.09176,1.09124,1.09171,1323,2286.5,-580827,-582498.4,22.278383984269347,49.60384363634358,42.92074311666355,NaN,NaN,50
1687287600,1.09171,1.09176,1.09098,1.09112,1094,2229.8,-581921,-582093.2,22.492042859134457,44.4451168691082,42.461496908986824,NaN,NaN,50
1687289400,1.09112,1.09162,1.09112,1.09128,1085,2198.15,-580836,-581807.4,22.690440385794915,46.08271694624143,42.61681324212036,NaN,NaN,50
1687291200,1.09128,1.09174,1.09122,1.09172,710,2155.8,-580126,-581172,22.633674229796068,50.41166629297738,43.35291136463083,NaN,NaN,50
1687293000,1.09172,1.0918,1.0916,1.09179,453,2093.25,-579673,-580676.6,22.456497662460066,51.08453562163685,43.946489609848484,NaN,NaN,50
1687294800,1.09179,1.09198,1.09164,1.09198,121,2016.65,-579552,-580421.6,21.913104640578275,52.95067822957319,45.306125979085394,NaN,NaN,50
1687296600,1.09198,1.09218,1.09174,1.0918,241,1926.75,-579793,-579996,20.996929665388745,50.96691171907547,46.538678349475106,NaN,NaN,50
1687298400,1.0918,1.09206,1.09176,1.09188,389,1821.8,-579404,-579709.6,20.14619575985561,51.83066916761503,47.59900779543561,NaN,NaN,50
1687300200,1.09188,1.09205,1.09182,1.09198,461,1690.8,-578943,-579473,19.35622856186055,52.94647698567168,48.941800872277824,NaN,NaN,50
1687302000,1.09198,1.09224,1.09194,1.09213,323,1571.9,-578620,-579262.4,18.184884387766896,54.64367527458145,49.838306889543,NaN,NaN,50
1687303800,1.09213,1.09215,1.09184,1.092,588,1400.2,-579208,-579193.6,17.311144472219432,52.86401399128207,50.204468368561365,NaN,NaN,50
1687305600,1.092,1.09201,1.09154,1.09163,1165,1262.4,-580373,-579309.6,17.108925469365925,48.06582945343857,50.18300990811964,NaN,NaN,50
1687307400,1.09163,1.09192,1.09146,1.0916,1320,1124.65,-581693,-579767.4,17.076177175105332,47.687884041624926,50.14013902079694,NaN,NaN,50
1687309200,1.0916,1.0917,1.09118,1.09136,1336,1028.35,-583029,-580584.6,17.565548295354255,44.662305413875735,49.87473740307469,NaN,NaN,50
1687311000,1.09136,1.0917,1.09122,1.09141,1287,974.85,-581742,-581209,18.0199643355854,45.43895747111169,49.57724553412955,NaN,NaN,50
1687312800,1.09141,1.09211,1.09122,1.09186,1595,953.5,-580147,-581396.8,17.298947228564103,51.972154190943655,50.114891057117795,NaN,NaN,50
1687314600,1.09186,1.09188,1.09118,1.09126,1276,932,-581423,-581606.8,16.717458452817656,44.347268001361115,49.99093041819778,NaN,NaN,50
1687316400,1.09126,1.09162,1.09125,1.09138,1263,911.05,-580160,-581300.2,16.177504589624526,46.05198691899283,49.67952474862745,NaN,NaN,50
1687318200,1.09138,1.0916,1.0913,1.0915,1115,914.9,-579045,-580503.4,15.676118859516622,47.77477283605606,49.443113121085965,NaN,NaN,50
1687320000,1.0915,1.09188,1.0914,1.09185,977,906.1,-578068,-579768.6,14.71906405552601,52.53572872795067,49.413473870970066,NaN,NaN,50
1687321800,1.09185,1.09196,1.09152,1.09162,1009,890.4,-579077,-579554.6,14.048343546472875,49.35181408373026,49.29810975415969,NaN,NaN,50
1687323600,1.09162,1.09176,1.09128,1.09143,1027,887.05,-580104,-579290.8,13.353724017864607,46.82708806296952,48.94071110382787,NaN,NaN,50
1687325400,1.09143,1.09143,1.09103,1.09123,1188,892.2,-581292,-579517.2,13.34579429244391,44.260319242736145,48.32027126504676,NaN,NaN,50
1687327200,1.09123,1.09158,1.09058,1.09138,3686,1041,-577606,-579229.4,14.286865061212836,46.62344112460363,47.7473973971912,NaN,NaN,50
1687329000,1.09138,1.09169,1.09074,1.09103,2380,1137.35,-579986,-579613,14.810712013231612,42.13471438482202,46.98101885387262,NaN,NaN,50
1687330800,1.09103,1.09161,1.09092,1.0916,2908,1276.7,-577078,-579213.2,15.297141325820476,50.49398372065467,47.154458444388055,NaN,NaN,50
1687332600,1.0916,1.09199,1.0913,1.0913,2398,1384.55,-579476,-579087.6,14.581922802914443,46.67241581663838,47.08192499974616,NaN,NaN,50
1687334400,1.0913,1.093,1.09094,1.09274,2902,1510.2,-576574,-578144,15.251374694120088,61.66864421914408,48.29666348583675,NaN,NaN,50
1687336200,1.09274,1.09339,1.09224,1.0925,2454,1609.85,-579028,-578428.4,16.43535221348236,58.70556773480665,49.24427850467212,NaN,NaN,50
1687338000,1.0925,1.09279,1.09167,1.09279,2228,1705.1,-576800,-577791.2,16.21539199768073,61.135546434259275,49.89880652205181,NaN,NaN,50
1687339800,1.09279,1.09298,1.09165,1.09167,1899,1770.65,-578699,-578115.4,16.307524724480604,49.11487518353299,50.23934989220693,NaN,NaN,50
1687341600,1.09167,1.0925,1.09136,1.09224,1913,1808.05,-576786,-577577.4,15.780597945365905,54.06504124968663,50.81171091582792,NaN,NaN,50
1687343400,1.09224,1.0926,1.09174,1.09184,1731,1828.6,-578517,-577966,15.462933919018788,50.36245141048169,50.996545099715476,NaN,NaN,50
1687345200,1.09184,1.09212,1.09164,1.09184,1683,1845.95,-578517,-577863.8,14.948249958243027,50.36245141048169,50.84131100561054,NaN,NaN,50
1687347000,1.09184,1.09269,1.09177,1.09245,2106,1886.9,-576411,-577786,15.42054110108156,55.7251718861999,51.29655084864409,NaN,NaN,50
1687348800,1.09245,1.09248,1.09113,1.09144,2497,1932,-578908,-577827.8,14.563799833753297,46.724138716525935,51.28919732389812,NaN,NaN,50
1687350600,1.09144,1.09258,1.09082,1.09252,3909,2063.65,-574999,-577470.4,13.812173682798637,55.079619370789615,52.06200447590194,NaN,NaN,50
1687352400,1.09252,1.09256,1.09153,1.09206,2859,2143.45,-577858,-577338.6,13.114235114055022,51.383202953283444,52.40198746366479,NaN,NaN,50
1687354200,1.09206,1.09309,1.09105,1.09266,4382,2306.8,-573476,-576330.4,12.819498770039958,55.571431587727496,53.36175297815804,NaN,NaN,50
1687356000,1.09266,1.09447,1.0923,1.09447,3802,2448.05,-569674,-574983,14.235323278013883,65.28665008105125,54.41837200390064,NaN,NaN,50
1687357800,1.09447,1.09641,1.09442,1.09547,5487,2671.95,-564187,-572038.8,16.908551726083804,69.28309487044572,56.033420507744026,NaN,NaN,50
1687359600,1.09547,1.09553,1.09434,1.09503,3873,2814.25,-568060,-570651,19.256679688221052,65.69904762941474,56.32130646562051,NaN,NaN,50
1687361400,1.09503,1.09564,1.09486,1.09508,2623,2886,-565437,-568166.8,21.501677622483612,65.91482899365181,56.83625369839516,NaN,NaN,50
1687363200,1.09508,1.0964,1.09497,1.09628,2287,2816.05,-563150,-566101.6,24.002510236048387,70.68178559089611,57.518127923869216,NaN,NaN,50
1687365000,1.09628,1.09738,1.09622,1.09706,1809,2787.5,-561341,-564435,26.76253594206694,73.29604866381904,59.2453546010325,NaN,NaN,50
1687366800,1.09706,1.09752,1.09672,1.09734,2173,2750.75,-559168,-563431.2,29.38205217627507,74.18589884146583,60.68255871473102,NaN,NaN,50
1687368600,1.09734,1.09794,1.09728,1.09774,1783,2720,-557385,-561296.2,31.982059232269627,75.44474443891804,62.47415107390504,NaN,NaN,50
1687370400,1.09774,1.09894,1.09762,1.09894,1663,2658.05,-555722,-559353.2,34.741692312320545,78.78689251954756,64.50446829598118,NaN,NaN,50
1687372200,1.09894,1.09901,1.09834,1.09847,1813,2626,-557535,-558230.2,37.32632816883948,74.50935964410377,65.84619599297432,NaN,NaN,50
1687374000,1.09847,1.09895,1.09816,1.09858,1304,2579.8,-556231,-557208.2,39.380127477645146,74.85346938798236,67.85543389807835,NaN,NaN,50
1687375800,1.09858,1.09881,1.09838,1.0988,1259,2547.8,-554972,-556369,41.28722683582183,75.56396538503682,69.31860147052457,NaN,NaN,50
1687377600,1.0988,1.09908,1.09851,1.09897,818,2493.05,-554154,-555722.8,43.17201216352287,76.12531336492931,71.08589507135642,NaN,NaN,50
1687379400,1.09897,1.099,1.0986,1.09866,589,2435.95,-554743,-555527,44.92216996781669,72.83933383624034,72.31931666053592,NaN,NaN,50
1687381200,1.09866,1.09869,1.09844,1.0985,807,2392.15,-555550,-555130,46.172454604769165,71.13267054968863,72.73688955115287,NaN,NaN,50
1687383000,1.0985,1.09858,1.09838,1.09856,298,2301.75,-555252,-554934.2,47.18861544115545,71.40326215926987,72.88833007178316,NaN,NaN,50
1687384800,1.09856,1.09894,1.0984,1.09888,377,2195.75,-554875,-554914.8,48.34331084293463,72.86420644854637,73.40012713029257,NaN,NaN,50
1687386600,1.09888,1.09909,1.09886,1.09906,406,2020.6,-554469,-554977.8,49.5003491928053,73.67878014852063,73.95469506992605,NaN,NaN,50
1687388400,1.09906,1.09924,1.09898,1.09914,431,1899.2,-554038,-554836.8,50.660147356683815,74.0516013351857,74.19539619451815,NaN,NaN,50
1687390200,1.09914,1.09922,1.09908,1.09916,561,1708.15,-553477,-554422.2,51.73710279457101,74.15017861059407,74.25640547643067,NaN,NaN,50
1687392000,1.09916,1.09922,1.09872,1.09888,1102,1573.15,-554579,-554287.6,51.72133047653118,70.13317284777962,73.96692504831023,NaN,NaN,50
1687393800,1.09888,1.09907,1.09866,1.09884,975,1347.55,-555554,-554423.4,51.54253375124721,69.55348288755023,73.54612065178394,NaN,NaN,50
1687395600,1.09884,1.09937,1.09871,1.09928,940,1200.9,-554614,-554452.4,51.650383020686554,72.26878728243534,73.08054170627592,NaN,NaN,50
1687397400,1.09928,1.09951,1.09924,1.09938,915,1115.5,-553699,-554384.6,51.873124054487576,72.86117220385441,72.9628140319724,NaN,NaN,50
1687399200,1.09938,1.09938,1.09884,1.09918,931,1047.7,-554630,-554615.2,50.96215199305465,69.65630354337017,72.5915879002144,NaN,NaN,50
1687401000,1.09918,1.09936,1.09908,1.09934,852,999.85,-553778,-554455,50.11624936458122,70.76421121181997,72.2487483164132,NaN,NaN,50
1687402800,1.09934,1.09946,1.09912,1.09919,688,925.6,-554466,-554237.4,49.45462528466557,68.24836944502299,71.68610946499132,NaN,NaN,50
1687404600,1.09919,1.09942,1.09916,1.0993,685,870.7,-553781,-554070.8,48.84026006760102,69.1155230091046,71.42012297733876,NaN,NaN,50
1687406400,1.0993,1.0994,1.09887,1.09891,870,831.05,-554651,-554261.2,47.390252643009696,62.58896291201539,70.8098581460764,NaN,NaN,50
1687408200,1.09891,1.09894,1.09866,1.09871,967,788.75,-555618,-554458.8,45.457835843697666,59.48669938148191,69.9586750905201,NaN,NaN,50
1687410000,1.09871,1.09885,1.0985,1.09884,1150,781.05,-554468,-554596.8,43.235728229407286,60.84521252045222,69.10017552422767,NaN,NaN,50
1687411800,1.09884,1.09905,1.09849,1.09858,1190,777.6,-555658,-554835.2,41.55643416089024,56.746741891453766,67.89074422015146,NaN,NaN,50
1687413600,1.09858,1.09906,1.09817,1.09844,1514,812.4,-557172,-555513.4,39.16229078737105,54.613525091211905,66.50231020272477,NaN,NaN,50
1687415400,1.09844,1.09878,1.09808,1.09828,1585,862.2,-558757,-556334.6,36.71754433724657,52.19846242390221,64.93433047510392,NaN,NaN,50
1687417200,1.09828,1.09928,1.09798,1.09911,2565,950.1,-556192,-556449.4,35.44302981175784,61.66806462319014,64.32967988763325,NaN,NaN,50
1687419000,1.09911,1.10001,1.09857,1.09944,3341,1102.25,-552851,-556126,35.34516002303557,64.66524248045172,63.98051985855478,NaN,NaN,50
1687420800,1.09944,1.10037,1.09922,1.09934,2735,1220.15,-555586,-556111.6,35.68041828923847,63.056262150968486,63.3224823491643,NaN,NaN,50
1687422600,1.09934,1.09941,1.09875,1.0993,2114,1305.55,-557700,-556217.2,34.86271198482657,62.3875755701212,62.574368303897636,NaN,NaN,50
1687424400,1.0993,1.10026,1.09922,1.09976,1816,1374.8,-555884,-555642.6,35.0787212054415,66.7539143392626,62.367054789318516,NaN,NaN,50
1687426200,1.09976,1.1004,1.09974,1.1002,1647,1429.1,-554237,-555251.6,35.41672792964044,70.30491096669766,62.33424762895264,NaN,NaN,50
1687428000,1.1002,1.10083,1.10004,1.10072,1782,1463.1,-552455,-555172.4,36.13013989876971,73.85856046219331,62.73497555875052,NaN,NaN,50
1687429800,1.10072,1.10074,1.10006,1.10046,1629,1495.8,-554084,-554872,36.79259387010404,69.38735159803201,62.754391886531046,NaN,NaN,50
1687431600,1.10046,1.1012,1.10004,1.10006,4893,1693.45,-558977,-555127.4,37.81088666682806,63.06228439369305,62.788200563793744,NaN,NaN,50
1687433400,1.10006,1.10012,1.0988,1.09892,2684,1781.9,-561661,-556282.8,36.265869382154804,49.27593576836948,62.05886030571428,NaN,NaN,50
1687435200,1.09892,1.09942,1.09846,1.09916,2663,1868.5,-558998,-557235,34.30164391804822,51.671321990021234,61.4035824106835,NaN,NaN,50
1687437000,1.09916,1.1002,1.09802,1.09826,4102,2031,-563100,-559364,33.36520379334818,43.39532378918967,60.4499096890932,NaN,NaN,50
1687438800,1.09826,1.09839,1.09682,1.09776,3969,2195.05,-567069,-561961,31.061934152505184,39.60056340815402,59.3775552831605,NaN,NaN,50
1687440600,1.09776,1.09852,1.09738,1.09812,4054,2363.5,-563015,-562768.6,28.915134528255354,43.43586693336174,58.75165560526475,NaN,NaN,50
1687442400,1.09812,1.09892,1.09764,1.09776,3752,2507.6,-566767,-563789.8,27.382242712520128,40.65568738788932,57.25077151702897,NaN,NaN,50
1687444200,1.09776,1.09785,1.09584,1.09592,4052,2661.85,-570819,-566154,26.73536981999724,30.06389244084093,54.779246514199635,NaN,NaN,50
1687446000,1.09592,1.09668,1.09523,1.09528,3459,2777.3,-574278,-568389.6,26.604394007959158,27.3908794637356,52.23171917939728,NaN,NaN,50
1687447800,1.09528,1.09644,1.09522,1.09527,2660,2850.8,-576938,-570363.4,26.490387339499634,27.34996119200997,49.729032438103616,NaN,NaN,50
1687449600,1.09527,1.09568,1.09485,1.0954,2018,2876,-574920,-572744.4,26.671254735581325,28.838245786487562,47.02077039861969,NaN,NaN,50
1687451400,1.0954,1.0957,1.09512,1.09546,1599,2876.7,-573321,-574055.2,26.810575204763776,29.555527303048066,44.11010013693043,NaN,NaN,50
1687453200,1.09546,1.09552,1.095,1.09526,1673,2832.1,-574994,-574890.2,27.040265699087584,28.523458602029365,40.87187857549014,NaN,NaN,50
1687455000,1.09526,1.09582,1.09514,1.09573,1493,2739.7,-573501,-574734.8,26.78628267208133,34.32719903427065,38.36758196379291,NaN,NaN,50
1687456800,1.09573,1.09604,1.09537,1.09564,1356,2670.75,-574857,-574318.6,26.213378345391515,33.76187129494134,36.27469531388208,NaN,NaN,50
1687458600,1.09564,1.09591,1.09511,1.09591,1200,2625.05,-573657,-574066,25.950517512319554,37.10815092202124,35.4055678248572,NaN,NaN,50
1687460400,1.09591,1.09617,1.09557,1.09562,1263,2597.4,-574920,-574385.8,25.29006200627108,35.05945165960884,34.219005658399176,NaN,NaN,50
1687462200,1.09562,1.09593,1.09544,1.09582,1382,2584.15,-573538,-574094.6,24.82538197909511,37.61738461103414,33.806295717102344,NaN,NaN,50
1687464000,1.09582,1.09586,1.09532,1.09538,721,2531.1,-574259,-574246.2,24.53443528553474,34.40652456741576,33.4352929427639,NaN,NaN,50
1687465800,1.09538,1.09558,1.09534,1.09558,573,2478.3,-573686,-574012,24.26427049865725,37.037267128175024,32.978250099536275,NaN,NaN,50
1687467600,1.09558,1.09594,1.09558,1.09568,424,2254.85,-573262,-573933,23.34289153327826,38.36826328707926,32.814862663764124,NaN,NaN,50
1687469400,1.09568,1.09585,1.09552,1.09563,612,2151.25,-573874,-573723.8,22.574448286075345,37.93644153905764,33.37718759935103,NaN,NaN,50
1687471200,1.09563,1.09563,1.09536,1.09546,371,2036.65,-574245,-573865.2,22.09826911895698,36.434979025625005,34.02319471091456,NaN,NaN,50
1687473000,1.09546,1.0955,1.09528,1.09534,365,1849.8,-574610,-573935.4,21.776594452469126,35.370787872720825,34.5961109023939,NaN,NaN,50
1687474800,1.09534,1.09568,1.09534,1.09548,624,1682.55,-573986,-573995.4,21.088542340851294,37.65854302028194,35.22613213337922,NaN,NaN,50
1687476600,1.09548,1.09577,1.09544,1.09555,852,1522.45,-573134,-573969.8,20.254571480536264,38.82458000820916,35.888207326605006,NaN,NaN,50
1687478400,1.09555,1.0958,1.0954,1.09544,1140,1391.85,-574274,-574049.8,19.554718680778,37.63337137118869,36.53891538154496,NaN,NaN,50
1687480200,1.09544,1.09587,1.09528,1.09553,1281,1253.3,-572993,-573799.4,19.134386383931517,39.27503011092252,36.89233188702009,NaN,NaN,50
1687482000,1.09553,1.09562,1.09528,1.09534,1413,1151,-574406,-573758.6,18.744077822574067,37.05734109688224,37.12772258715872,NaN,NaN,50
1687483800,1.09534,1.09534,1.09458,1.09468,1757,1105.85,-576163,-574194,19.586294497941353,30.59475777460368,36.66248021948605,NaN,NaN,50
1687485600,1.09468,1.09468,1.09377,1.09391,1630,1086.45,-577793,-575125.8,21.33977742378484,25.09596582916086,35.950802660168335,NaN,NaN,50
1687487400,1.09391,1.0941,1.09322,1.09386,1161,1064.55,-578954,-576061.8,23.46774326237619,24.78446176078957,35.03416531372229,NaN,NaN,50
1687489200,1.09386,1.09406,1.0938,1.09392,871,1024.45,-578083,-577079.8,25.443711541068154,25.971930437535477,34.43169430444513,NaN,NaN,50
1687491000,1.09392,1.09395,1.09348,1.09358,1039,1001.75,-579122,-578023,27.550529535305913,23.68957051765028,33.478287403693365,NaN,NaN,50
1687492800,1.09358,1.0937,1.09316,1.09332,1025,985.2,-580147,-578819.8,29.75603966225836,22.09085379817155,32.31561529734281,NaN,NaN,50
1687494600,1.09332,1.09344,1.09288,1.09332,1346,992.5,-580147,-579290.6,32.0059101754934,22.09085379817155,31.183787601565232,NaN,NaN,50
1687496400,1.09332,1.09341,1.09274,1.09274,1478,1003.25,-581625,-579824.8,34.192819284060235,18.80716702570426,29.924658172999468,NaN,NaN,50
1687498200,1.09274,1.09334,1.09273,1.09326,1307,999.5,-580318,-580271.8,36.230754143894536,28.99738757638096,29.469415294689473,NaN,NaN,50
1687500000,1.09326,1.09334,1.09234,1.09263,2004,1063.65,-582322,-580911.8,38.39515252225977,24.917144402246294,28.559315393401214,NaN,NaN,50
1687501800,1.09263,1.09264,1.09203,1.09232,1831,1126.55,-584153,-581713,40.597207880630556,23.188129566579804,27.442426076141977,NaN,NaN,50
1687503600,1.09232,1.09261,1.08765,1.08795,4776,1344.15,-588929,-583469.4,43.85169919214768,11.29239935999695,25.560928075342563,NaN,NaN,50
1687505400,1.08795,1.08795,1.08536,1.0869,5669,1597,-594598,-586064,47.1075741812998,9.96905754412478,23.4676443205713,NaN,NaN,50
1687507200,1.0869,1.08746,1.08604,1.08697,3217,1739.3,-591381,-588276.6,50.13088667122678,10.720217375232536,21.58642119759632,NaN,NaN,50
1687509000,1.08697,1.08698,1.08486,1.08491,3092,1875.65,-594473,-590706.8,53.03172488093306,8.478366955032513,20.00667899619838,NaN,NaN,50
1687510800,1.08491,1.08546,1.08444,1.08532,2565,1972.7,-591908,-592257.8,55.75533033342255,12.404682950702934,19.10015879059424,NaN,NaN,50
1687512600,1.08532,1.08622,1.085,1.08608,2109,2035.55,-589799,-592431.8,57.17626078909927,19.314571128576006,18.709452316864702,NaN,NaN,50
1687514400,1.08608,1.08676,1.08608,1.08659,1608,2058.95,-588191,-591150.4,57.762139906217335,23.666166165574595,18.544754868867496,NaN,NaN,50
1687516200,1.08659,1.08724,1.0863,1.08682,1782,2084,-586409,-590156,57.680062191416795,25.61459013941348,18.682256270422013,NaN,NaN,50
1687518000,1.08682,1.08738,1.08662,1.08704,1759,2101.3,-584650,-588191.4,57.42065835827267,27.520323616840614,19.070075543184085,NaN,NaN,50
1687519800,1.08704,1.08793,1.08704,1.08763,2027,2114.8,-582623,-586334.4,56.46683936121539,32.513804191349536,19.814571999839654,NaN,NaN,50
1687521600,1.08763,1.08958,1.08762,1.08939,2727,2169.65,-579896,-584353.8,53.79990270336562,44.743504072611856,21.6671675031902,NaN,NaN,50
1687523400,1.08939,1.08956,1.08808,1.08874,3535,2288.35,-583431,-583401.8,51.32346152107654,41.735413266482176,22.57702648105457,NaN,NaN,50
1687525200,1.08874,1.09004,1.08862,1.08973,3222,2405.9,-580209,-582161.8,48.554386816355105,47.522267372503464,24.191678121787223,NaN,NaN,50
1687527000,1.08973,1.09027,1.08832,1.08833,4832,2595.55,-585041,-582240,46.2067649065332,41.27859264965589,25.48385405629266,NaN,NaN,50
1687528800,1.08833,1.08988,1.08808,1.08931,4165,2752.55,-580876,-581890.6,44.20706300280641,46.57044143273621,28.003714204345464,NaN,NaN,50
1687530600,1.08931,1.08946,1.0879,1.08826,3628,2866.65,-584504,-582812.2,42.48807997149528,42.18405214853209,30.30478524751741,NaN,NaN,50
1687532400,1.08826,1.08866,1.0879,1.08816,2775,2931.5,-587279,-583581.8,40.891881442420654,41.7804390968686,32.523372513348555,NaN,NaN,50
1687534200,1.08816,1.08924,1.08806,1.08864,2247,2978.5,-585032,-584546.4,38.71415400375725,44.52420082799668,35.098074932845996,NaN,NaN,50
1687536000,1.08864,1.08895,1.08828,1.08882,1791,2967.85,-583241,-584186.4,36.69197852499836,45.56031829988086,37.46633460064442,NaN,NaN,50
1687537800,1.08882,1.08898,1.08856,1.08858,1405,2946.55,-584646,-584940.4,34.77608739119508,44.370386524450026,39.256035700349706,NaN,NaN,50
1687539600,1.08858,1.08944,1.08858,1.08921,1328,2774.15,-583318,-584703.2,32.416410279765685,48.19527417488845,41.00811484387213,NaN,NaN,50
1687541400,1.08921,1.08964,1.0892,1.08948,1510,2566.2,-581808,-583609,30.21994848104962,49.78866498205087,42.73483447548909,NaN,NaN,50
1687543200,1.08948,1.08951,1.08909,1.0892,1367,2473.7,-583175,-583237.6,28.083601655283996,48.13520126163549,44.20732573583158,NaN,NaN,50
1687545000,1.0892,1.08928,1.08886,1.0892,1326,2385.4,-583175,-583224.4,26.398571976126682,48.13520126163549,45.323139812280566,NaN,NaN,50
1687546800,1.0892,1.08945,1.08892,1.08906,1356,2324.95,-584531,-583201.4,24.59271830332153,47.22574384888985,45.50044265344328,NaN,NaN,50
1687548600,1.08906,1.08931,1.08872,1.08911,1276,2283.3,-583255,-583188.8,23.193647846210965,47.60647972921542,45.91980454363851,NaN,NaN,50
1687550400,1.08911,1.08941,1.08904,1.08933,775,2241.65,-582480,-583323.2,21.738962663705458,49.33836163967084,46.0495255627219,NaN,NaN,50
1687552200,1.08933,1.08966,1.08932,1.0896,645,2184.8,-581835,-583055.2,20.372587705027517,51.4590400928122,46.77670038009021,NaN,NaN,50
1687726800,1.0896,1.09058,1.0896,1.09026,458,2119.75,-581377,-582695.6,20.30911339855347,56.27707214061341,47.470031144938574,NaN,NaN,50
1687728600,1.09026,1.09026,1.09008,1.09012,66,2021.7,-581443,-582078,20.250172971113287,55.029331433321744,48.38755109385213,NaN,NaN,50
1687730400,1.09012,1.09067,1.08976,1.09039,722,1921.45,-580721,-581571.2,20.668136934426173,57.00899268321986,49.47530492144865,NaN,NaN,50
1687732200,1.09039,1.09073,1.09024,1.09068,1100,1799.7,-579621,-580999.4,21.123745006253927,59.09199044783633,50.51586132286577,NaN,NaN,50
1687734000,1.09068,1.09068,1.09032,1.09048,583,1667.75,-580204,-580673.2,21.5468096443797,57.03939767836441,51.335795564186014,NaN,NaN,50
1687735800,1.09048,1.09066,1.09046,1.09063,685,1460.4,-579519,-580301.6,21.939655379782202,58.21179243048803,52.3244674146173,NaN,NaN,50
1687737600,1.09063,1.09086,1.0899,1.09054,1851,1344.7,-581370,-580287,21.12718830782583,57.20309944955911,52.967883505665206,NaN,NaN,50
1687739400,1.09054,1.09095,1.09034,1.09052,1462,1236.4,-582832,-580709.2,20.51303892164312,56.96686538667675,53.480612105995625,NaN,NaN,50
1687741200,1.09052,1.09072,1.09018,1.09059,1873,1191.3,-580959,-580976.8,19.618459850580535,57.62645003029174,54.15855844661393,NaN,NaN,50
1687743000,1.09059,1.09098,1.09035,1.0904,1781,1168,-582740,-581484,19.22121729968395,55.155322133248205,54.659995651729126,NaN,NaN,50
1687744800,1.0904,1.09092,1.09033,1.09092,1505,1153.7,-581235,-581827.2,18.808081796168054,60.1872042576647,55.585814252355895,NaN,NaN,50
1687746600,1.09092,1.09092,1.09046,1.09049,1272,1147.05,-582507,-582054.6,18.424455971474725,54.719426173518194,56.09388185552039,NaN,NaN,50
1687748400,1.09049,1.09095,1.09039,1.09091,1120,1136.65,-581387,-581765.6,17.893375930773445,58.668982605993726,56.76035478168631,NaN,NaN,50
1687750200,1.09091,1.09092,1.0905,1.09062,778,1100.05,-582165,-582006.8,17.400230178693686,55.09554444027986,57.02010509221971,NaN,NaN,50
1687752000,1.09062,1.09083,1.0903,1.09037,830,1073.2,-582995,-582057.8,16.413240601453666,52.14683253927072,56.72508797783809,NaN,NaN,50
1687753800,1.09037,1.0904,1.08998,1.09026,779,1045.85,-583774,-582565.6,15.748026815390817,50.85708505969178,56.42707037972167,NaN,NaN,50
1687755600,1.09026,1.09081,1.09024,1.09065,827,1019.4,-582947,-582653.6,15.06900561625402,55.09746007354989,56.29053233617382,NaN,NaN,50
1687757400,1.09065,1.091,1.09054,1.0907,1242,1017.7,-581705,-582717.2,14.830472770907047,55.62610129141733,56.042968825001026,NaN,NaN,50
1687759200,1.0907,1.09111,1.0902,1.09024,1925,1075.2,-583630,-583010.2,13.800024136820738,49.815427602453035,55.52697096243593,NaN,NaN,50
1687761000,1.09024,1.09064,1.08977,1.09033,1832,1134.55,-581798,-582770.8,13.655434409916841,50.89619533449925,55.004428312722446,NaN,NaN,50
1687762800,1.09033,1.09086,1.08978,1.09034,2873,1255.3,-578925,-581801,13.02096124536121,51.022407653867546,54.56295032731591,NaN,NaN,50
1687764600,1.09034,1.09058,1.08956,1.09023,2952,1399.6,-581877,-581587,12.861735160167969,49.51476405984484,54.03065737539934,NaN,NaN,50
1687766400,1.09023,1.09035,1.08874,1.08932,3193,1523.15,-585070,-582260,14.00337171215194,39.196278443627534,52.714216547780474,NaN,NaN,50
1687768200,1.08932,1.08932,1.08877,1.08919,2203,1578.3,-587273,-582988.6,15.063462796137056,37.978670018378644,51.48731282528979,NaN,NaN,50
1687770000,1.08919,1.08973,1.08908,1.08956,1698,1634.05,-585575,-583744,15.081270979616319,43.37064060362785,50.286129707144305,NaN,NaN,50
1687771800,1.08956,1.09012,1.08941,1.08967,1783,1688.95,-583792,-584717.4,14.297735855981006,44.90419991739234,49.585042117421025,NaN,NaN,50
1687773600,1.08967,1.09074,1.08941,1.09058,1540,1673.4,-582252,-584792.4,14.043129144254543,55.61314505353127,49.36676800653085,NaN,NaN,50
1687775400,1.09058,1.0907,1.09032,1.09044,1842,1692.4,-584094,-584597.2,13.806708626222827,53.878095968065956,49.279807401372715,NaN,NaN,50
1687777200,1.09044,1.09078,1.09032,1.09052,1385,1668,-582709,-583684.4,13.720386555078973,54.74691462668425,49.46552755047369,NaN,NaN,50
1687779000,1.09052,1.09181,1.09043,1.09178,1727,1665.3,-580982,-582765.8,15.042473033645662,65.70468029176362,50.52607006705024,NaN,NaN,50
1687780800,1.09178,1.09201,1.09142,1.09198,1866,1683.35,-579116,-581830.6,16.48728816689538,67.06781415050864,51.38109535826159,NaN,NaN,50
1687782600,1.09198,1.09202,1.09143,1.09174,1527,1696.1,-580643,-581508.8,17.840044133461568,63.791163772291696,51.96431410689547,NaN,NaN,50
1687784400,1.09174,1.09202,1.09136,1.0914,1781,1729.15,-582424,-581174.8,18.923583286974914,59.3662204610907,52.64651359679816,NaN,NaN,50
1687786200,1.0914,1.09166,1.0908,1.09128,2962,1838.35,-585386,-581710.2,18.663894851989816,57.84121429342717,53.142586379578724,NaN,NaN,50
1687788000,1.09128,1.09162,1.0908,1.09102,2889,1941.3,-588275,-583168.8,18.42275559093223,54.57032727424207,53.396009209605474,NaN,NaN,50
1687789800,1.09102,1.09153,1.09028,1.09082,3233,2064,-591508,-585647.2,17.16552901393474,52.12834015349993,53.58269321629512,NaN,NaN,50
1687791600,1.09082,1.09149,1.09054,1.09134,2151,2130.2,-589357,-587390,15.998104335294222,57.458689861982435,54.887151174749036,NaN,NaN,50
1687793400,1.09134,1.09178,1.09086,1.09094,2049,2170.55,-591406,-589186.4,15.445855461639871,52.60629367367007,55.93198143584129,NaN,NaN,50
1687795200,1.09094,1.09096,1.09024,1.09024,1556,2152.1,-592962,-590701.6,14.891722334215723,45.383269823129154,56.07574066580566,NaN,NaN,50
1687797000,1.09024,1.091,1.09,1.09088,1345,2127.75,-591617,-591370,14.758792504453208,51.88763171046498,56.57455722245371,NaN,NaN,50
1687798800,1.09088,1.09132,1.09064,1.09126,1098,2039,-590519,-591172.2,14.015881050434592,55.29211663661827,56.55162662124563,NaN,NaN,50
1687800600,1.09126,1.09132,1.09098,1.091,1062,1944.5,-591581,-591617,13.326034700274448,52.55206407689793,56.456910057590775,NaN,NaN,50
1687802400,1.091,1.09137,1.09086,1.09134,948,1832.25,-590633,-591462.4,12.906071333129104,55.647381520712045,56.5212291214499,NaN,NaN,50
1687804200,1.09134,1.09154,1.0912,1.09149,1160,1780.1,-589473,-590764.6,12.155749014845444,56.98074269357975,55.89809072157963,NaN,NaN,50
1687806000,1.09149,1.09152,1.09062,1.09066,1078,1749.1,-590551,-590551.4,12.484737417249878,48.323857611436736,54.559236683074495,NaN,NaN,50
1687807800,1.09066,1.09072,1.09042,1.09062,1315,1725.7,-591866,-590820.8,13.098255363073145,47.94580629419421,53.427425434638955,NaN,NaN,50
1687809600,1.09062,1.09086,1.09052,1.09053,545,1675.95,-592411,-590986.8,13.342891452306969,47.053833975249944,52.54796925707891,NaN,NaN,50
1687811400,1.09053,1.09064,1.0904,1.0905,418,1604.75,-592829,-591426,13.769994934013551,46.74168026636961,51.755145398003364,NaN,NaN,50
1687813200,1.0905,1.09096,1.0905,1.09088,188,1544.9,-592641,-592059.6,13.417933480817979,51.161297201568544,51.51164324995526,NaN,NaN,50
1687815000,1.09088,1.09098,1.09062,1.09073,186,1467.85,-592827,-592514.8,13.045325282590031,49.417987413034446,51.31804662563629,NaN,NaN,50
1687816800,1.09073,1.09122,1.09069,1.09097,409,1395,-592418,-592625.2,12.153736734238892,52.22313268474941,50.94407825583394,NaN,NaN,50
1687818600,1.09097,1.09116,1.09092,1.0911,358,1336.55,-592060,-592555,11.325833082198548,53.720287455880616,51.02364924027756,NaN,NaN,50
1687820400,1.0911,1.09112,1.09076,1.09093,315,1263.25,-592375,-592464.2,10.924671997091192,51.449780647334144,51.45697144200648,NaN,NaN,50
1687822200,1.09093,1.09108,1.09084,1.09098,622,1146.25,-591753,-592286.6,10.552165275205791,52.091146778696746,51.47150823259445,NaN,NaN,50
1687824000,1.09098,1.09102,1.09068,1.09087,1026,1053.1,-592779,-592277,10.587644881282209,50.5102563756089,51.12994678537951,NaN,NaN,50
1687825800,1.09087,1.09114,1.0902,1.09046,1123,947.6,-593902,-592573.8,11.603200531069126,45.02533223296902,50.59232308224173,NaN,NaN,50
1687827600,1.09046,1.09108,1.09038,1.09098,1659,923,-592243,-592610.4,12.546216491585549,52.12593942468695,50.340791503954215,NaN,NaN,50
1687829400,1.09098,1.09352,1.09084,1.0924,2492,945.15,-589751,-592085.6,14.12982021138031,65.30467004052922,50.935357743022045,NaN,NaN,50
1687831200,1.0924,1.09242,1.09177,1.09206,1508,942.75,-591259,-591986.8,15.600309379761157,60.976437188883374,51.83911342712537,NaN,NaN,50
1687833000,1.09206,1.09244,1.09194,1.0923,1251,938.05,-590008,-591432.6,16.986809338878732,62.848251008905024,52.90357376389043,NaN,NaN,50
1687834800,1.0923,1.09284,1.09216,1.09274,1416,953.95,-588592,-590370.6,18.685541666389877,66.06224432223826,54.26131736010388,NaN,NaN,50
1687836600,1.09274,1.09292,1.09256,1.09268,1172,959.45,-589764,-589874.8,20.342157141720076,65.23350173961524,55.58216175105,NaN,NaN,50
1687838400,1.09268,1.09288,1.0926,1.09272,1052,964.65,-588712,-589667,21.88044294024098,65.5438338450884,56.6094857970157,NaN,NaN,50
1687840200,1.09272,1.09274,1.09231,1.09232,925,952.9,-589637,-589342.6,22.569286964690946,59.795778202000456,57.35075656765613,NaN,NaN,50
1687842000,1.09232,1.09273,1.0923,1.09268,1120,955,-588517,-589044.4,23.183536977218044,62.945400250656526,58.116632822363776,NaN,NaN,50
1687843800,1.09268,1.0927,1.09174,1.09178,1391,958.8,-589908,-589307.6,22.440813509418554,51.9815999516337,57.99244085777472,NaN,NaN,50
1687845600,1.09178,1.09276,1.09162,1.09266,1858,1024.45,-588050,-588964.8,21.49875073532971,59.423684096773535,58.56200538987753,NaN,NaN,50
1687847400,1.09266,1.09336,1.09248,1.09311,2312,1119.15,-585738,-588370,21.55962420832091,62.614519367761154,59.31367486052498,NaN,NaN,50
1687849200,1.09311,1.09415,1.09294,1.09364,2418,1230.65,-583320,-587106.6,22.558475559211864,66.00523844313224,60.42045929391951,NaN,NaN,50
1687851000,1.09364,1.09416,1.09308,1.09395,2087,1325.7,-581233,-585649.8,23.496618985853743,67.8423825069901,62.050248599206725,NaN,NaN,50
1687852800,1.09395,1.09439,1.09368,1.09404,2776,1444.05,-578457,-583359.6,24.616420782061965,68.37670545507525,63.21101760137732,NaN,NaN,50
1687854600,1.09404,1.09414,1.09347,1.09396,2096,1530.95,-580553,-581860.2,25.15381383129942,67.30615557412747,63.3539808537772,NaN,NaN,50
1687856400,1.09396,1.09396,1.09262,1.09298,2094,1619.9,-582647,-581242,23.94885216298393,55.78410059319311,62.983099668370755,NaN,NaN,50
1687858200,1.09298,1.09448,1.09296,1.0941,1884,1683,-580763,-580730.6,23.52631921653132,63.47887564203495,63.0281442850229,NaN,NaN,50
1687860000,1.0941,1.09457,1.09385,1.09417,1705,1716.95,-579058,-580295.6,23.24771180302754,63.901708581111905,62.87382030351387,NaN,NaN,50
1687861800,1.09417,1.09528,1.09406,1.09516,1639,1742.75,-577419,-580088,23.80233233857331,69.31300021931024,63.165213052063514,NaN,NaN,50
1687863600,1.09516,1.09524,1.09454,1.09454,1594,1739.5,-579013,-579780,24.317337121580103,62.94881206371437,62.97985435339394,NaN,NaN,50
1687865400,1.09454,1.09486,1.09428,1.09446,1649,1697.35,-580662,-579383,24.264462142136374,62.15577627141588,63.14842564406647,NaN,NaN,50
1687867200,1.09446,1.09589,1.09444,1.09559,2227,1733.3,-578435,-578917.4,25.279424718093065,68.24180738659236,63.52674043949046,NaN,NaN,50
1687869000,1.09559,1.09722,1.09452,1.09653,4199,1880.7,-574236,-577953,27.159093770291147,72.24100125457944,64.97384053255801,NaN,NaN,50
1687870800,1.09653,1.09729,1.09616,1.09718,2959,1957.85,-571277,-576724.6,28.94579409294229,74.6209230604971,66.05935760139542,NaN,NaN,50
1687872600,1.09718,1.09766,1.0963,1.0966,4096,2104.05,-575373,-575996.6,30.82233618124809,68.94108050818363,66.5112548257113,NaN,NaN,50
1687874400,1.0966,1.09688,1.09424,1.09596,5115,2307.2,-580488,-575961.8,29.502189184982537,63.222551086198,66.31249144307314,NaN,NaN,50
1687876200,1.09596,1.09647,1.09474,1.0949,4158,2468.85,-584646,-577204,28.276338402735956,55.07427660365307,65.40048387854907,NaN,NaN,50
1687878000,1.0949,1.09592,1.09458,1.0955,2949,2560.3,-581697,-578696.2,26.943225363074593,58.346725345431125,64.6840567278602,NaN,NaN,50
1687879800,1.0955,1.0963,1.09544,1.096,2426,2612.05,-579271,-580295,26.082815980788283,60.9025422048806,64.226655772914,NaN,NaN,50
1687881600,1.096,1.09656,1.09593,1.0961,1844,2611.35,-577427,-580705.8,25.53492979480344,61.412508885917696,64.62868493668005,NaN,NaN,50
1687883400,1.0961,1.09618,1.09572,1.09589,1458,2568.65,-578885,-580385.2,24.732856901592008,59.65285011280744,64.35539739887807,NaN,NaN,50
1687885200,1.09589,1.09602,1.0955,1.09596,1661,2530.8,-577224,-578900.8,23.680652728346416,60.06362481688253,64.08124855857598,NaN,NaN,50
1687887000,1.09596,1.0964,1.09594,1.0962,1278,2490.35,-575946,-577750.6,23.124376595722072,61.510499732140715,63.52392709520672,NaN,NaN,50
1687888800,1.0962,1.09626,1.09582,1.09595,1339,2418.5,-577285,-577353.4,22.427578384265566,59.108219480058324,63.24959905351701,NaN,NaN,50
1687890600,1.09595,1.09614,1.09584,1.09598,1016,2364.5,-576269,-577121.8,21.780551473627384,59.31356723515134,63.04658412235525,NaN,NaN,50
1687892400,1.09598,1.09624,1.09594,1.0962,1189,2319.25,-575080,-576360.8,21.30728155264486,60.865592582479564,62.519711636347196,NaN,NaN,50
1687894200,1.0962,1.0964,1.09615,1.09626,1285,2289.3,-573795,-575675,21.07566782241515,61.29918586942923,61.73815339455075,NaN,NaN,50
1687896000,1.09626,1.09634,1.09602,1.09602,681,2238.1,-574476,-575381,20.614894120086298,58.506803829594574,60.58714487805771,NaN,NaN,50
1687897800,1.09602,1.09611,1.09597,1.09608,409,2176.6,-574067,-574737.4,20.08940529994219,59.00952568384503,59.877748104890664,NaN,NaN,50
1687899600,1.09608,1.09612,1.09592,1.09604,208,2107.3,-574275,-574338.6,19.498884797464097,58.5006577912044,59.54047001239112,NaN,NaN,50
1687901400,1.09604,1.0963,1.09594,1.09609,271,2038.4,-574004,-574123.4,19.245627739281744,58.97687638457411,59.81922713959977,NaN,NaN,50
1687903200,1.09609,1.09627,1.09602,1.09609,344,1944.25,-574004,-574165.2,19.010460470969555,58.97687638457411,59.86423792810998,NaN,NaN,50
1687905000,1.09609,1.09614,1.09564,1.09573,332,1750.9,-574336,-574137.2,17.939800577890264,53.81974025241302,59.35832350293372,NaN,NaN,50
1687906800,1.09573,1.09586,1.09554,1.09556,434,1624.65,-574770,-574277.8,16.73507217676957,51.52832420083715,58.65231031114225,NaN,NaN,50
1687908600,1.09556,1.0958,1.09548,1.09575,792,1459.45,-573978,-574218.4,15.592836026269016,53.89117226991009,58.240761893792445,NaN,NaN,50
1687910400,1.09575,1.09614,1.09556,1.09594,1415,1274.45,-572563,-573930.2,15.137462741684987,56.19100241425684,57.96414600789061,NaN,NaN,50
1687912200,1.09594,1.09596,1.09528,1.09548,1380,1135.55,-573943,-573918,14.085655794674127,49.724479233611085,57.12228740085278,NaN,NaN,50
1687914000,1.09548,1.09563,1.09494,1.0954,1619,1069.05,-575562,-574163.2,13.734152475718957,48.67534765409224,56.37708227042663,NaN,NaN,50
1687915800,1.0954,1.09552,1.09462,1.09463,2396,1067.55,-577958,-574800.8,13.979682804711993,39.94044553130936,54.99328786300935,NaN,NaN,50
1687917600,1.09463,1.09476,1.09422,1.09442,1502,1050.45,-579460,-575897.2,14.835242948970725,37.94073132608104,53.355797773266595,NaN,NaN,50
1687919400,1.09442,1.09508,1.09436,1.09491,1233,1039.2,-578227,-577030,14.876333933224048,44.87591388546035,52.18270691726882,NaN,NaN,50
1687921200,1.09491,1.09546,1.09486,1.09518,1013,1006.8,-577214,-577684.2,14.11711901082462,48.304065361978175,51.45393988386765,NaN,NaN,50
1687923000,1.09518,1.09536,1.09498,1.0951,706,978.2,-577920,-578155.8,13.412133725739436,47.36417014465392,50.62212877392542,NaN,NaN,50
1687924800,1.0951,1.09536,1.09488,1.09494,983,960.4,-578903,-578344.8,12.953622102500919,45.459014541933676,49.690582827548944,NaN,NaN,50
1687926600,1.09494,1.09507,1.09464,1.09487,1046,961.9,-579949,-578442.6,12.986243405566613,44.613522020579026,48.664628944406445,NaN,NaN,50
1687928400,1.09487,1.09522,1.09468,1.09518,1000,952.45,-578949,-578587,12.65702188792057,49.126180198992394,47.961007788293465,NaN,NaN,50
1687930200,1.09518,1.09548,1.09502,1.09534,1128,944.6,-577821,-578708.4,11.759072268420875,51.33027637518476,47.78318893992002,NaN,NaN,50
1687932000,1.09534,1.09549,1.0944,1.09449,1820,1001.55,-579641,-579052.6,12.097165901565864,41.134391983250026,47.04076521009237,NaN,NaN,50
1687933800,1.09449,1.0948,1.09361,1.09381,2063,1084.25,-581704,-579612.8,13.507989153765765,35.123679246593056,45.70022999414115,NaN,NaN,50
1687935600,1.09381,1.09514,1.09381,1.09494,2368,1192.25,-579336,-579490.2,14.078395099933319,48.57216399810118,45.15602725013003,NaN,NaN,50
1687937400,1.09494,1.0957,1.09476,1.09528,2290,1293.2,-577046,-579109.6,13.546962865312345,51.809122514827784,45.30493034164551,NaN,NaN,50
1687939200,1.09528,1.09579,1.09489,1.09499,3043,1428.15,-580089,-579563.2,12.895635109708461,48.977475936183396,45.32651093322345,NaN,NaN,50
1687941000,1.09499,1.09606,1.09454,1.0953,2419,1532.5,-577670,-579169,12.836007538152359,51.997726651189026,46.18774529892914,NaN,NaN,50
1687942800,1.0953,1.0959,1.09444,1.09502,2277,1624.65,-579947,-578817.6,12.931287468656672,49.16676669292755,46.989604967989614,NaN,NaN,50
1687944600,1.09502,1.09534,1.09448,1.09477,1899,1680,-581846,-579319.6,13.01976168983925,46.720929712892726,47.12139181280621,NaN,NaN,50
1687946400,1.09477,1.09606,1.09454,1.09589,1885,1703.5,-579961,-579902.6,12.43832576199306,57.033147879610254,47.74489770692278,NaN,NaN,50
1687948200,1.09589,1.09623,1.09536,1.09544,1672,1718.1,-581633,-580211.4,12.174946306071487,52.62583737667451,48.12073108063854,NaN,NaN,50
1687950000,1.09544,1.09557,1.09468,1.09518,1896,1731.95,-583529,-581383.2,11.838966825751926,50.211515588584234,48.46019544111358,NaN,NaN,50
1687951800,1.09518,1.09528,1.09378,1.09404,2163,1720.3,-585692,-582532.2,12.68582037037718,41.27108886176184,48.22145021548378,NaN,NaN,50
1687953600,1.09404,1.09448,1.09284,1.09305,2951,1792.75,-588643,-583891.6,14.37001731857066,35.379625560916736,47.23955345562123,NaN,NaN,50
1687955400,1.09305,1.09334,1.09261,1.09278,2935,1877.85,-591578,-586215,16.12330318346469,33.95596460453112,45.998531186288815,NaN,NaN,50
1687957200,1.09278,1.09342,1.09237,1.09339,2793,1966.85,-588785,-587645.4,17.946215910910166,39.84539108074918,45.90645969325305,NaN,NaN,50
1687959000,1.09339,1.09444,1.09242,1.09347,5489,2206,-583296,-587598.8,17.921815677016774,40.59359079959648,46.29716766132473,NaN,NaN,50
1687960800,1.09347,1.09368,1.0915,1.09154,4178,2365.75,-587474,-587955.2,18.732076307455518,30.679568602972594,45.01912513310126,NaN,NaN,50
1687962600,1.09154,1.09202,1.08968,1.08988,4657,2546.3,-592131,-588652.8,20.654911529484835,25.019661432408768,43.10559219864275,NaN,NaN,50
1687964400,1.08988,1.09172,1.08981,1.09148,3875,2690.05,-588256,-587988.4,22.44040137851206,37.07035212268195,42.255083354821224,NaN,NaN,50
1687966200,1.09148,1.09148,1.09021,1.09036,2435,2755.4,-590691,-588369.6,24.098356238323053,33.06438225051549,40.90270161191597,NaN,NaN,50
1687968000,1.09036,1.09185,1.09032,1.09168,1947,2761.75,-588744,-589459.2,25.059924115559763,41.13781020480372,40.32920471990713,NaN,NaN,50
1687969800,1.09168,1.09168,1.09102,1.09109,1776,2747.4,-590520,-590068.4,25.952808572993845,38.88048006338742,39.76917260208533,NaN,NaN,50
1687971600,1.09109,1.09178,1.09099,1.09164,2016,2729.8,-588504,-589343,26.613746294805086,42.07158382748921,38.70048945550525,NaN,NaN,50
1687973400,1.09164,1.0917,1.09132,1.0915,1465,2688.55,-589969,-589685.6,27.227474179344096,41.477936976045996,37.90421085546035,NaN,NaN,50
1687975200,1.0915,1.09227,1.0915,1.0921,1275,2600.15,-588694,-589286.2,26.81574585890117,45.05615077942154,37.53597051194873,NaN,NaN,50
1687977000,1.0921,1.0924,1.09202,1.09224,1184,2538.4,-587510,-589039.4,26.22210884797146,45.88754191617846,37.86571715869278,NaN,NaN,50
1687978800,1.09224,1.09225,1.09176,1.09176,1151,2482.1,-588661,-588667.6,25.961030698528255,43.45943254511594,38.44284622899272,NaN,NaN,50
1687980600,1.09176,1.0919,1.09139,1.0916,1253,2449.8,-589914,-588949.6,26.111127578709674,42.64931334922777,39.06379971075676,NaN,NaN,50
1687982400,1.0916,1.0917,1.0912,1.0912,858,2398.45,-590772,-589110.2,26.444554678577408,40.611168484450886,39.11849809673545,NaN,NaN,50
1687984200,1.0912,1.09135,1.09113,1.09128,433,2336.5,-590339,-589439.2,26.82715635016562,41.21622391739772,39.16297189086412,NaN,NaN,50
1687986000,1.09128,1.09162,1.09128,1.0915,112,2247.3,-590227,-589982.6,26.63848661883389,42.937915646027754,40.038568108225206,NaN,NaN,50
1687987800,1.0915,1.0915,1.09134,1.0914,153,2146.8,-590380,-590326.4,26.463293296883002,42.33101362583019,41.27509326489816,NaN,NaN,50
1687989600,1.0914,1.09154,1.0914,1.0915,340,2016.25,-590040,-590351.6,26.21342072546135,43.195670396904845,41.71261599877123,NaN,NaN,50
1687991400,1.0915,1.09152,1.09138,1.0914,243,1881.65,-590283,-590253.8,26.010366946882023,42.50928208033965,42.38725170090152,NaN,NaN,50
1687993200,1.0914,1.09168,1.0914,1.09162,425,1763.25,-589858,-590157.6,25.439439140693647,44.59514077385803,42.6342038844054,NaN,NaN,50
1687995000,1.09162,1.09189,1.09152,1.09152,535,1515.55,-590393,-590190.8,24.422145827555926,43.81694080820807,42.98680822332117,NaN,NaN,50
1687996800,1.09152,1.09163,1.09048,1.0905,1212,1367.25,-591605,-590435.8,24.971899932714066,36.7688897767096,42.6080443625512,NaN,NaN,50
1687998600,1.0905,1.09074,1.09012,1.0907,1090,1188.9,-590515,-590530.8,25.87384016250472,38.84603154658594,42.420051117589765,NaN,NaN,50
1688000400,1.0907,1.09147,1.09059,1.09128,1574,1073.85,-588941,-590262.4,25.23825828279292,44.536229835049674,42.38291390727749,NaN,NaN,50
1688002200,1.09128,1.09144,1.09062,1.09065,1874,1045.8,-590815,-590453.8,24.64807510877482,40.16459945524034,41.974132302924765,NaN,NaN,50
1688004000,1.09065,1.09067,1.08934,1.08984,1680,1032.45,-592495,-590874.2,25.485326841875217,35.35888755448579,41.39552194645118,NaN,NaN,50
1688005800,1.08984,1.08993,1.08931,1.08934,1261,1006.7,-593756,-591304.4,26.289415205986177,32.75367037032865,40.68869030510125,NaN,NaN,50
1688007600,1.08934,1.08958,1.08919,1.08942,1004,956.1,-592752,-591751.8,27.14734473739967,33.59669392573073,40.187656408049804,NaN,NaN,50
1688009400,1.08942,1.08942,1.08905,1.0893,902,927.95,-593654,-592694.4,28.076266059131832,32.9298310069546,39.595771200161,NaN,NaN,50
1688011200,1.0893,1.08934,1.089,1.08907,1078,918.1,-594732,-593477.8,28.98761983843268,31.63377915266298,38.78833287920638,NaN,NaN,50
1688013000,1.08907,1.08917,1.08808,1.08854,1233,920.55,-595965,-594171.8,30.613273129984602,28.818998972897504,37.823188975425474,NaN,NaN,50
1688014800,1.08854,1.08889,1.08842,1.08882,1320,929,-594645,-594349.6,32.12280832928282,32.24886251682641,37.04127412684845,NaN,NaN,50
1688016600,1.08882,1.08947,1.08846,1.08942,1627,947.7,-593018,-594402.8,32.236603034795685,39.028655388030046,36.792657934540614,NaN,NaN,50
1688018400,1.08942,1.08984,1.08898,1.08923,2258,1017.7,-595276,-594727.2,31.621443020413466,37.74071147200798,36.30305584155132,NaN,NaN,50
1688020200,1.08923,1.09002,1.08902,1.08975,2285,1110.3,-592991,-594379,30.71435693522826,43.259467507933536,36.26323632010314,NaN,NaN,50
1688022000,1.08975,1.09206,1.08975,1.09163,3332,1271.3,-589659,-593117.8,29.86202274861172,57.81764609229005,37.766718914073174,NaN,NaN,50
1688023800,1.09163,1.09198,1.09128,1.09167,2591,1393.2,-587068,-591602.4,29.070569575324935,58.064185045705216,39.139444164010264,NaN,NaN,50
1688025600,1.09167,1.09219,1.09112,1.09136,2679,1510.15,-589747,-590948.2,28.547227831910554,55.36355501787896,39.91282453421235,NaN,NaN,50
1688027400,1.09136,1.09206,1.09106,1.09144,1930,1594.5,-587817,-589456.4,27.964765782539004,55.93317018162733,41.03915101466856,NaN,NaN,50
1688029200,1.09144,1.0917,1.09116,1.09152,1407,1643.6,-586410,-588140.2,27.42390816526542,56.530563875375364,42.551413609017814,NaN,NaN,50
1688031000,1.09152,1.09194,1.09128,1.09167,1567,1695.2,-584843,-587177,27.200083352401027,57.688781873984745,44.33249300213611,NaN,NaN,50
1688032800,1.09167,1.09263,1.09164,1.09232,1650,1717.1,-583193,-586402,27.704103550839953,62.367972144997246,46.38758430351229,NaN,NaN,50
1688034600,1.09232,1.09278,1.09202,1.09278,1524,1738.8,-581669,-584786.4,28.31251376829612,65.29319507981904,48.69925316585975,NaN,NaN,50
1688036400,1.09278,1.09347,1.09259,1.0934,1509,1735.55,-580160,-583255,29.46511972423637,68.81208900576742,51.35484672679578,NaN,NaN,50
1688038200,1.0934,1.09398,1.09318,1.09387,1560,1719.85,-578600,-581693,30.9048825954234,71.19622894431215,54.38179172475397,NaN,NaN,50
1688040000,1.09387,1.09414,1.09339,1.0935,2075,1739.6,-580675,-580859.4,32.35156180667634,66.86292288585284,56.854224608255855,NaN,NaN,50
1688041800,1.0935,1.0935,1.08734,1.0881,6872,2020.15,-587547,-581730.2,32.36787897868776,34.17268059092251,56.50736926560531,NaN,NaN,50
1688043600,1.0881,1.08854,1.0867,1.08714,4805,2210.2,-592352,-583866.8,32.668910745434815,31.24776154637236,56.04358712805992,NaN,NaN,50
1688045400,1.08714,1.08748,1.08603,1.0869,4230,2376.6,-596582,-587151.2,33.232591934878066,30.543905156728187,55.13533267440239,NaN,NaN,50
1688047200,1.0869,1.0894,1.0869,1.08914,5027,2574.05,-591555,-589742.2,32.12761572723551,43.36611693025047,54.10308059139957,NaN,NaN,50
1688049000,1.08914,1.0892,1.08788,1.08896,4340,2729.4,-595895,-592786.2,31.10156639156742,42.68420397612897,53.004510515001265,NaN,NaN,50
1688050800,1.08896,1.08968,1.08833,1.08874,3282,2827.5,-599177,-595112.2,29.771010461105067,41.81867125130232,52.03701881738865,NaN,NaN,50
1688052600,1.08874,1.08874,1.08788,1.08804,2364,2864.35,-601541,-596950,28.8066900101213,39.10177636603703,50.834776401989345,NaN,NaN,50
1688054400,1.08804,1.08837,1.08764,1.0879,1802,2841.55,-603343,-598302.2,28.056634324574752,38.56216793400135,49.551319549034055,NaN,NaN,50
1688056200,1.0879,1.08796,1.08688,1.08708,1943,2824.45,-605286,-601048.4,27.806868159431332,35.474248610028525,47.964567173037175,NaN,NaN,50
1688058000,1.08708,1.08744,1.08683,1.08739,1717,2743.7,-603569,-602583.2,27.604011639764575,37.51146595409242,46.18910244511541,NaN,NaN,50
1688059800,1.08739,1.08752,1.08712,1.08724,1385,2683.4,-604954,-603738.6,27.33343721343494,36.904316361959076,44.1613253938397,NaN,NaN,50
1688061600,1.08724,1.08726,1.08692,1.0872,1706,2634.75,-606660,-604762.4,27.213854080223708,36.73357126587091,41.8700026981328,NaN,NaN,50
1688063400,1.0872,1.08726,1.08657,1.0867,1625,2619.5,-608285,-605750.8,27.334386317475275,34.579852895098085,39.25454726604608,NaN,NaN,50
1688065200,1.0867,1.08712,1.08666,1.08706,1218,2610.05,-607067,-606107,27.446309109208872,37.42461823113723,37.151811219280674,NaN,NaN,50
1688067000,1.08706,1.08721,1.0867,1.08692,1311,2597.25,-608378,-607068.8,27.43202809627973,36.75525085694023,37.33628052399623,NaN,NaN,50
1688068800,1.08692,1.08696,1.0865,1.08652,732,2551.35,-609110,-607900,27.573676750605138,34.83800805496928,37.592726703181725,NaN,NaN,50
1688070600,1.08652,1.08674,1.08639,1.08644,583,2504.3,-609693,-608506.6,27.7926821875286,34.4509522066885,37.871801492464606,NaN,NaN,50
1688072400,1.08644,1.0867,1.08644,1.08656,139,2435.8,-609554,-608760.4,27.996044378957528,35.60663169165211,37.317552546850436,NaN,NaN,50
1688074200,1.08656,1.08663,1.0864,1.08645,84,2362,-609638,-609274.6,28.220868149060944,34.99750969682381,36.7685029554715,NaN,NaN,50
1688076000,1.08645,1.0867,1.08624,1.0867,628,2289.65,-609010,-609401,28.57886046438653,37.60980193874979,36.46786943314631,NaN,NaN,50
1688077800,1.0867,1.0867,1.08651,1.08657,257,1958.9,-609267,-609432.4,28.911281900046,36.78202107685056,36.30217262677586,NaN,NaN,50
1688079600,1.08657,1.08672,1.08647,1.08662,333,1735.3,-608934,-609280.6,29.261547425544094,37.353137951991414,36.21581334234657,NaN,NaN,50
1688081400,1.08662,1.08682,1.08645,1.08674,503,1548.95,-608431,-609056,29.367533406437325,38.78254391281305,36.45212014968833,NaN,NaN,50
1688083200,1.08674,1.08688,1.08636,1.0865,1187,1356.95,-609618,-609052,29.57354138759448,36.965890343479266,36.413150463215956,NaN,NaN,50
1688085000,1.0865,1.0874,1.08635,1.08722,1289,1204.4,-608329,-608915.8,28.638789369844307,45.25132629492701,37.00936545842796,NaN,NaN,50
1688086800,1.08722,1.08754,1.0869,1.08702,1528,1116.7,-609857,-609033.8,27.492843431283394,43.539326793576514,37.49549085326407,NaN,NaN,50
1688088600,1.08702,1.08704,1.08602,1.08616,1808,1088.9,-611665,-609580,27.580190028668234,37.04854999182189,37.671826360172915,NaN,NaN,50
1688090400,1.08616,1.08685,1.08612,1.08679,1685,1083.05,-609980,-609889.8,27.661297583382726,43.67311657508642,38.118147670455,NaN,NaN,50
1688092200,1.08679,1.08716,1.08665,1.08666,1212,1046.5,-611192,-610204.6,27.092386879070634,42.67515386573619,38.540997885368995,NaN,NaN,50
1688094000,1.08666,1.08692,1.08658,1.0868,1184,1019.85,-610008,-610540.4,26.66021266260552,44.15512358426058,39.20650613746123,NaN,NaN,50
1688095800,1.0868,1.08752,1.08679,1.08716,1086,1004.9,-608922,-610353.4,25.100898989653007,47.88129393058386,40.165816260596614,NaN,NaN,50
1688097600,1.08716,1.08738,1.08711,1.08726,705,954.85,-608217,-609663.8,23.652964864768535,48.90122781134085,41.11543026914581,NaN,NaN,50
1688099400,1.08726,1.08729,1.0868,1.087,889,918.05,-609106,-609489,22.813499030423003,46.36090820548444,41.927101591192994,NaN,NaN,50
1688101200,1.087,1.08727,1.0867,1.08724,1001,907.2,-608105,-608871.6,22.192323392604965,48.994844401182554,42.740318909938196,NaN,NaN,50
1688103000,1.08724,1.08756,1.0868,1.08698,1392,911.25,-609497,-608769.4,21.021680826745413,46.34007180150995,43.42303681884244,NaN,NaN,50
1688104800,1.08698,1.08698,1.08568,1.0859,1988,974.05,-611485,-609282,21.49928249977823,37.29917921033368,43.419182623009746,NaN,NaN,50
1688106600,1.0859,1.08662,1.08584,1.08642,2257,1057.75,-609228,-609484.2,21.942769767594417,43.05942153276644,43.72467388157785,NaN,NaN,50
1688108400,1.08642,1.08694,1.08556,1.08678,2695,1185.55,-606533,-608969.6,21.701964655034846,46.70949183920626,44.420645416986915,NaN,NaN,50
1688110200,1.08678,1.08694,1.08534,1.08565,2348,1298.75,-608881,-609124.8,21.770947932711962,38.39060939980463,43.93059421019246,NaN,NaN,50
1688112000,1.08565,1.08568,1.08418,1.08437,2472,1390.95,-611353,-609496,23.062271948218793,31.538593325267954,43.07339896245613,NaN,NaN,50
1688113800,1.08437,1.08441,1.08354,1.0839,2404,1498.3,-613757,-609950.4,24.76240002448023,29.45942252133692,42.531318428850064,NaN,NaN,50
1688115600,1.0839,1.08449,1.0836,1.08438,2120,1587.65,-611637,-610432.2,26.178954258993752,34.22828785950965,41.85668780630886,NaN,NaN,50
1688117400,1.08438,1.08495,1.08422,1.08456,1706,1647.8,-609931,-611111.8,26.592188034631057,35.97625425354384,41.37819497686655,NaN,NaN,50
1688119200,1.08456,1.08472,1.0841,1.08424,1717,1674.3,-611648,-611665.2,27.092301397783476,34.234373301749116,40.66956995668716,NaN,NaN,50
1688121000,1.08424,1.08539,1.08418,1.08534,1508,1685.25,-610140,-611422.6,26.355439338804988,44.230400752131835,40.40879187251202,NaN,NaN,50
1688122800,1.08534,1.0855,1.08492,1.08511,1620,1689.85,-611760,-611023.2,25.489598116019636,42.76669427924898,39.97061090593403,NaN,NaN,50
1688124600,1.08511,1.08593,1.08506,1.08536,1754,1687.15,-610006,-610697,24.000496785830663,44.901080731428436,39.866337514930024,NaN,NaN,50
1688126400,1.08536,1.08762,1.08532,1.08718,2729,1739.35,-607277,-610166.2,23.91439168447482,57.36615319846017,40.464288143307,NaN,NaN,50
1688128200,1.08718,1.08978,1.08718,1.08972,4965,1927,-602312,-608299,25.29687137103858,68.18406488015493,42.024573363210216,NaN,NaN,50
1688130000,1.08972,1.09098,1.08964,1.09068,3997,2067.65,-598315,-605934,27.13549182955843,71.16237925084319,44.44337336610375,NaN,NaN,50
1688131800,1.09068,1.09169,1.08966,1.09146,4575,2242.1,-593740,-602330,29.12344275706608,73.34562396825548,46.606673540067256,NaN,NaN,50
1688133600,1.09146,1.09318,1.09132,1.09238,4925,2453.1,-588815,-598091.8,31.4632285477083,75.6839935352126,48.6762808040677,NaN,NaN,50
1688135400,1.09238,1.09287,1.09087,1.09104,5415,2679.4,-594230,-595482.4,33.08597912882555,66.52901412176715,50.686166855636465,NaN,NaN,50
1688137200,1.09104,1.09188,1.09066,1.0914,3888,2823.75,-590342,-593088.4,34.33574277551133,67.66080181125078,53.26632460463524,NaN,NaN,50
1688139000,1.0914,1.09195,1.0911,1.09192,2333,2870.8,-588009,-591027.2,35.52556998899565,69.2768267455645,56.11042490636578,NaN,NaN,50
1688140800,1.09192,1.09226,1.09128,1.09134,2441,2893.45,-590450,-590369.2,36.76385147026947,65.35398986873508,58.33368933559617,NaN,NaN,50
1688142600,1.09134,1.09186,1.09121,1.09184,1805,2870.85,-588645,-590335.2,37.813396312097254,67.08436852012107,60.55569749749454,NaN,NaN,50
1688144400,1.09184,1.0923,1.09168,1.09168,1786,2825.4,-590431,-589575.4,38.99093630311649,65.9492725253111,62.82104744203468,NaN,NaN,50
1688146200,1.09168,1.0917,1.09098,1.09118,1352,2775.6,-591783,-589863.6,39.0797963759106,62.39619977276448,64.11860451493702,NaN,NaN,50
1688148000,1.09118,1.0916,1.09118,1.09138,1263,2715.15,-590520,-590365.8,39.162309300647976,63.24911634239253,65.58163466230441,NaN,NaN,50
1688149800,1.09138,1.0915,1.09105,1.09114,1435,2666.7,-591955,-590666.8,39.04606725530195,61.44797288596807,66.76355553048582,NaN,NaN,50
1688151600,1.09114,1.09148,1.09103,1.09122,1111,2616.25,-590844,-591106.6,38.906889753210585,61.83808321657414,67.08297910320825,NaN,NaN,50
1688153400,1.09122,1.09146,1.09094,1.0913,1650,2613.45,-589194,-590859.2,38.62903865282751,62.249467782965986,66.65907931055189,NaN,NaN,50
1688155200,1.0913,1.09132,1.09082,1.09092,918,2573.5,-590112,-590525,38.16535883394678,58.99619762721877,65.79006633743586,NaN,NaN,50
1688157000,1.09092,1.09112,1.0908,1.0911,639,2530.05,-589473,-590315.6,37.69880799841915,60.06096717523286,64.8411622807914,NaN,NaN,50
1688331600,1.0911,1.09131,1.0909,1.09104,97,2453.9,-589570,-589838.6,37.44893931702627,59.506267857374205,63.68561044666008,NaN,NaN,50
1688333400,1.09104,1.09104,1.09084,1.09084,30,2367.7,-589600,-589589.8,37.09605863608272,57.59673726205227,63.04759067096616,NaN,NaN,50
1688335200,1.09084,1.09135,1.09076,1.09114,542,2258.35,-589058,-589562.6,37.08441093828777,59.68646969157305,62.477995519560615,NaN,NaN,50
1688337000,1.09114,1.09122,1.09088,1.09095,499,2035.05,-589557,-589451.6,37.07359521890674,57.745466146358964,61.654326905331644,NaN,NaN,50
1688338800,1.09095,1.09102,1.09084,1.09086,315,1850.95,-589872,-589531.4,36.96853267339935,56.803150393559875,61.04355265710484,NaN,NaN,50
1688340600,1.09086,1.09104,1.09066,1.09074,611,1652.75,-590483,-589714,36.435472609143815,55.50263475262034,60.216285959426216,NaN,NaN,50
1688342400,1.09074,1.09098,1.09054,1.09076,1279,1470.45,-589204,-589634.8,35.6512163923479,55.68474310323337,59.48310528642067,NaN,NaN,50
1688344200,1.09076,1.09078,1.09006,1.09016,1168,1258.1,-590372,-589897.6,33.85915555743883,49.18185332757987,58.53922339747891,NaN,NaN,50
1688346000,1.09016,1.09072,1.09012,1.0906,1302,1128.8,-589070,-589800.2,32.195099067880406,53.47289120420179,57.840921601893854,NaN,NaN,50
1688347800,1.0906,1.09178,1.0906,1.09092,1809,1102.6,-587261,-589278,32.139400134374824,56.35904678758834,57.477426880581014,NaN,NaN,50
1688349600,1.09092,1.09107,1.09067,1.09084,1272,1044.15,-588533,-588888,32.087679696119636,55.43326459977934,57.019939836524244,NaN,NaN,50
1688351400,1.09084,1.09098,1.09064,1.09076,1111,1009.45,-589644,-588976,31.968361890978574,54.469691253295885,56.464241512976386,NaN,NaN,50
1688353200,1.09076,1.09096,1.09065,1.09076,1026,971.45,-589644,-588830.4,31.85756678620474,54.469691253295885,56.14091962912475,NaN,NaN,50
1688355000,1.09076,1.09138,1.09072,1.09128,917,949.7,-588727,-588761.8,32.30030549582054,59.74466702352587,56.118326761145674,NaN,NaN,50
1688356800,1.09128,1.09166,1.09126,1.0916,742,923.65,-587985,-588906.6,33.03466718149928,62.61510002721777,56.34038620184879,NaN,NaN,50
1688358600,1.0916,1.09183,1.0914,1.09176,955,899.65,-587030,-588606,33.90355571022252,63.99743140341099,56.797578640517266,NaN,NaN,50
1688360400,1.09176,1.09176,1.09142,1.09158,1022,895.2,-588052,-588287.6,34.71038077260838,61.253434642652216,56.90950470845149,NaN,NaN,50
1688362200,1.09158,1.09183,1.09032,1.09034,1139,869.65,-589191,-588197,32.81577345519771,46.47123331805881,56.10420236357292,NaN,NaN,50
1688364000,1.09034,1.09069,1.08884,1.08929,2484,947.95,-591675,-588786.6,31.97144284238556,38.088987504884884,54.767476442953274,NaN,NaN,50
1688365800,1.08929,1.08948,1.08882,1.08902,1885,1010.25,-593560,-589901.6,31.209486725678648,36.276954265490346,53.39421355101541,NaN,NaN,50
1688367600,1.08902,1.08908,1.08792,1.08806,2614,1136.1,-596174,-591730.4,31.397410272398858,30.686944878023624,51.608656534929004,NaN,NaN,50
1688369400,1.08806,1.08836,1.08704,1.08754,2587,1263.95,-598761,-593872.2,32.25074137452387,28.15607066839347,50.10681491641569,NaN,NaN,50
1688371200,1.08754,1.08882,1.08732,1.08876,2180,1345.85,-596581,-595350.2,32.27710567233156,40.54529946750627,49.18341550665173,NaN,NaN,50
1688373000,1.08876,1.08892,1.08836,1.08864,1908,1416.3,-598489,-596713,32.138525138475025,39.81795646903667,48.00190905532661,NaN,NaN,50
1688374800,1.08864,1.08915,1.08862,1.08882,1848,1492.95,-596641,-597329.2,31.629136514126817,41.51282242620643,47.00759175721426,NaN,NaN,50
1688376600,1.08882,1.08919,1.08761,1.08901,1841,1554.45,-594800,-597054.4,32.02417277306663,43.32712392129146,46.21169409064252,NaN,NaN,50
1688378400,1.08901,1.08928,1.08815,1.08856,1441,1562.55,-596241,-596550.4,32.240971867553796,40.15038106413,45.18888621998781,NaN,NaN,50
1688380200,1.08856,1.08961,1.08856,1.08922,1530,1580.65,-594711,-596176.4,31.89222805846514,46.36207789336827,44.232986996405124,NaN,NaN,50
1688382000,1.08922,1.0905,1.08874,1.0895,2124,1621.75,-592587,-594996,30.275923251077497,48.79036119529829,43.245505651268026,NaN,NaN,50
1688383800,1.0895,1.08996,1.08924,1.08992,1975,1630.05,-590612,-593790.2,28.77506878707469,52.28017452596901,42.40855873145074,NaN,NaN,50
1688385600,1.08992,1.09034,1.08938,1.09006,2268,1679.85,-588344,-592499,26.86843216468328,53.419679910880006,41.84900482203843,NaN,NaN,50
1688387400,1.09006,1.09103,1.08978,1.09088,2212,1734.9,-586132,-590477.2,25.630986378168362,59.517265139919395,42.78086423788562,NaN,NaN,50
1688389200,1.09088,1.09149,1.09044,1.09134,2412,1804.2,-583720,-588279,24.97031299428303,62.4841384261641,44.523375017976996,NaN,NaN,50
1688391000,1.09134,1.09206,1.09072,1.09134,3338,1925.25,-583720,-586505.6,24.9040895538323,62.4841384261641,46.39531674373941,NaN,NaN,50
1688392800,1.09134,1.09341,1.0909,1.09097,5333,2154.8,-589053,-586193.8,25.87035444689883,58.485685410822455,48.38094106751076,NaN,NaN,50
1688394600,1.09097,1.0911,1.09028,1.09068,3416,2277.85,-592469,-587018.8,25.920551980958546,55.488548822719274,50.33326093567689,NaN,NaN,50
1688396400,1.09068,1.09142,1.0902,1.09142,2673,2360.4,-589796,-587751.6,26.20554338845698,60.9830544698431,51.793100578700944,NaN,NaN,50
1688398200,1.09142,1.0923,1.09043,1.09181,2307,2418.8,-587489,-588505.4,27.06411472916221,63.537633227425886,53.48736320430017,NaN,NaN,50
1688400000,1.09181,1.09214,1.09136,1.09168,1543,2371.75,-589032,-589567.8,27.86135954553135,62.078579683412215,54.956345865529165,NaN,NaN,50
1688401800,1.09168,1.092,1.09142,1.09158,1269,2340.95,-590301,-589817.4,28.60165830358841,60.91969755342596,56.21295826782449,NaN,NaN,50
1688403600,1.09158,1.09166,1.09116,1.09146,853,2252.9,-591154,-589554.4,28.874972746608048,59.484643413142535,57.59397700703966,NaN,NaN,50
1688405400,1.09146,1.09147,1.09084,1.09084,493,2148.2,-591647,-589924.6,28.630605383782754,52.591445020230786,58.038931801815565,NaN,NaN,50
1688407200,1.09084,1.09128,1.09084,1.09122,353,2056.85,-591294,-590685.6,28.40369283258783,55.959972449345926,58.55104689139039,NaN,NaN,50
1688409000,1.09122,1.09122,1.09098,1.09118,597,1991.3,-591891,-591257.4,28.192988320763973,55.51283825818897,58.781951443691824,NaN,NaN,50
1688410800,1.09118,1.09119,1.09102,1.09106,561,1926.95,-592452,-591687.6,27.997334131213254,54.11585609888056,58.83167831426329,NaN,NaN,50
1688412600,1.09106,1.09118,1.09094,1.09094,258,1847.8,-592710,-591998.8,27.659726096281524,52.68796996405542,58.343871515987296,NaN,NaN,50
1688414400,1.09094,1.09123,1.0909,1.09122,262,1788.85,-592448,-592159,27.409680004257726,55.62982744622041,57.85427787456274,NaN,NaN,50
1688416200,1.09122,1.09146,1.09118,1.09144,247,1724.7,-592201,-592340.4,27.471312812297306,57.8476227130911,57.52309818077181,NaN,NaN,50
1688418000,1.09144,1.09144,1.09108,1.09128,81,1622.55,-592282,-592418.6,27.301622354466453,55.66830611499855,57.32185680249868,NaN,NaN,50
1688419800,1.09128,1.09141,1.09116,1.09117,117,1529.65,-592399,-592408,27.144052643623517,54.15769604022201,57.22679588946316,NaN,NaN,50
1688421600,1.09117,1.09154,1.09117,1.09138,276,1430.05,-592123,-592290.6,27.190330354440462,56.580088980734445,56.91229835452683,NaN,NaN,50
1688423400,1.09138,1.09143,1.09123,1.09126,175,1328.2,-592298,-592260.6,27.233302514484762,54.79815850828919,56.28805016030278,NaN,NaN,50
1688425200,1.09126,1.0915,1.09123,1.09137,294,1222.3,-592004,-592221.2,27.38659852312904,56.16111730801211,55.86537427634563,NaN,NaN,50
1688427000,1.09137,1.09143,1.09122,1.09129,256,1068.2,-592260,-592216.8,27.49779272893863,54.86540910869644,55.4329251017221,NaN,NaN,50
1688428800,1.09129,1.09137,1.09096,1.09107,761,839.6,-593021,-592341.2,26.806701291546155,51.356408152268706,54.85233686880253,NaN,NaN,50
1688430600,1.09107,1.09132,1.09088,1.09098,756,706.6,-593777,-592672,25.93114283182561,49.94901225358993,54.66359167118532,NaN,NaN,50
1688432400,1.09098,1.09165,1.0909,1.09143,802,613.05,-592975,-592807.4,25.788710745356585,56.384961198360195,54.69394801040063,NaN,NaN,50
1688434200,1.09143,1.09143,1.09083,1.09108,1024,548.9,-593999,-593206.4,25.439710974638068,50.90245786178848,54.364635124943455,NaN,NaN,50
1688436000,1.09108,1.09114,1.09036,1.09036,719,507.7,-594718,-593698,23.81674891351755,41.880913311180294,53.490710640107714,NaN,NaN,50
1688437800,1.09036,1.09058,1.09026,1.09058,599,474.2,-594119,-593917.6,22.165823308486708,45.083632176948676,52.947543655314384,NaN,NaN,50
1688439600,1.09058,1.09066,1.09042,1.09056,641,463.6,-594760,-594114.2,20.732975809406124,44.84171082050242,52.17696389633453,NaN,NaN,50
1688441400,1.09056,1.09092,1.09045,1.09045,542,466.05,-595302,-594579.6,20.024563533784463,43.46038462017172,51.14930403255456,NaN,NaN,50
1688443200,1.09045,1.09056,1.09034,1.09048,670,481.9,-594632,-594706.2,19.058402814925827,43.96733864931641,50.3135206421487,NaN,NaN,50
1688445000,1.09048,1.09048,1.09006,1.09007,1290,516.55,-595922,-594947,17.96688247643015,38.84156176099531,49.219511050775374,NaN,NaN,50
1688446800,1.09007,1.09012,1.08942,1.08942,921,534.55,-596843,-595491.8,18.272401436649925,32.39384188101461,47.491921972223956,NaN,NaN,50
1688448600,1.08942,1.08996,1.08942,1.08954,801,561.7,-596042,-595748.2,18.55609761399686,34.5538055610439,46.04589676170643,NaN,NaN,50
1688450400,1.08954,1.09074,1.08954,1.09074,1314,614.3,-594728,-595633.4,17.505016921012004,51.307395459958265,45.6992023439883,NaN,NaN,50
1688452200,1.09074,1.09148,1.09074,1.09148,1515,677.7,-593213,-595349.6,17.75842098800611,58.38252459099478,45.95042487843818,NaN,NaN,50
1688454000,1.09148,1.09148,1.09079,1.09082,1860,766.65,-595073,-595179.8,17.993724764500634,51.23240930155765,45.9415678176731,NaN,NaN,50
1688455800,1.09082,1.09092,1.08962,1.0903,1741,847.85,-596814,-595174,17.341357085645974,46.40978106426831,45.68876558986442,NaN,NaN,50
1688457600,1.0903,1.09046,1.08972,1.08982,1575,912.8,-598389,-595643.4,16.735587098138073,42.438575404182146,44.69259517599455,NaN,NaN,50
1688459400,1.08982,1.09028,1.0892,1.08956,1615,984.8,-600004,-596698.6,16.908593435245308,40.42096932793903,43.943917423576735,NaN,NaN,50
1688461200,1.08956,1.09031,1.08944,1.09022,1472,1043.7,-598532,-597762.4,17.009913144755107,47.27362297659623,44.329110971106445,NaN,NaN,50
1688463000,1.09022,1.0903,1.08969,1.08984,1391,1100.45,-599923,-598732.4,17.103995732157063,44.12666597813701,44.2607562426199,NaN,NaN,50
1688464800,1.08984,1.09016,1.08955,1.09004,1192,1122,-598731,-599115.8,17.403446338401256,46.15819312310456,44.354790692805764,NaN,NaN,50
1688466600,1.09004,1.09038,1.08955,1.0896,980,1133.2,-599711,-599380.2,17.179355397225212,42.49730236365735,44.285999103054735,NaN,NaN,50
1688468400,1.0896,1.08982,1.08898,1.08958,1309,1158.55,-601020,-599583.4,17.823736728876042,42.332949038064285,44.1692569879653,NaN,NaN,50
1688470200,1.08958,1.09022,1.08953,1.08984,1067,1160.7,-599953,-599867.6,17.56403651332654,45.29486843518229,44.630207464692944,NaN,NaN,50
1688472000,1.08984,1.09002,1.08938,1.08986,1404,1194.95,-598549,-599592.8,17.54978680152642,45.52664575817688,45.56826488449025,NaN,NaN,50
1688473800,1.08986,1.09012,1.08966,1.09008,1234,1226.7,-597315,-599309.6,17.319521912201157,48.13001840840271,46.53799437358731,NaN,NaN,50
1688475600,1.09008,1.09013,1.0896,1.08994,1403,1264.8,-598718,-599111,17.206390390273718,46.60364039849381,46.202011869196994,NaN,NaN,50
1688477400,1.08994,1.0901,1.08966,1.08998,1241,1299.75,-597477,-598402.4,17.101339691341096,47.119649117647015,45.397520763957864,NaN,NaN,50
1688479200,1.08998,1.0907,1.08988,1.09062,1215,1327,-596262,-597664.2,16.080519753472316,54.66804256931994,45.64292314022659,NaN,NaN,50
1688481000,1.09062,1.09076,1.08984,1.0902,1269,1325.95,-597531,-597460.6,15.250381694806963,49.65839808767033,45.87496721332674,NaN,NaN,50
1688482800,1.0902,1.09027,1.08972,1.08996,1272,1343.5,-598803,-597758.2,14.216529326447533,47.00753385865018,46.20132138864589,NaN,NaN,50
1688484600,1.08996,1.09016,1.08965,1.09011,744,1340.65,-598059,-597626.4,13.301549089882773,48.845523765283794,46.80307527702765,NaN,NaN,50
1688486400,1.09011,1.09013,1.08926,1.08934,852,1317.55,-598911,-597913.2,13.262031637947194,40.98672211146251,46.354010929518104,NaN,NaN,50
1688488200,1.08934,1.08956,1.0892,1.08945,714,1277.5,-598197,-598300.2,13.341894689584185,42.41216221462617,46.23154637498162,NaN,NaN,50
1688490000,1.08945,1.08972,1.08935,1.08958,306,1199.8,-597891,-598372.2,12.999614878394885,44.12973563880652,46.08665655467462,NaN,NaN,50
1688491800,1.08958,1.08966,1.08931,1.0894,297,1127.6,-598188,-598249.2,12.770211534461376,42.250711322829,46.06904290890117,NaN,NaN,50
1688493600,1.0894,1.08962,1.08936,1.08946,204,1059.05,-597984,-598234.2,12.557194143665976,43.12011843089663,46.125269294103475,NaN,NaN,50
1688495400,1.08946,1.08949,1.0887,1.08873,298,993.2,-598282,-598108.4,13.685197307957184,36.01575235353491,45.46247528827151,NaN,NaN,50
1688497200,1.08873,1.08878,1.08844,1.08848,518,945.5,-598800,-598229,15.143499624121432,33.95264945854754,44.63576126686943,NaN,NaN,50
1688499000,1.08848,1.0886,1.08809,1.08836,465,899.2,-599265,-598503.8,16.988349159944363,32.976188737988025,43.5533448618398,NaN,NaN,50
1688500800,1.08836,1.08838,1.08802,1.08826,282,853.7,-599547,-598775.6,18.79401794145897,32.146494327570366,42.52069157105956,NaN,NaN,50
1688502600,1.08826,1.08827,1.08768,1.0878,452,827.3,-599999,-599178.6,20.895604339305823,28.583788173143887,41.196701503595044,NaN,NaN,50
1688504400,1.0878,1.08838,1.0878,1.08812,198,771.75,-599801,-599482.4,22.48018531148612,34.05874179720411,39.724608591301056,NaN,NaN,50
1688506200,1.08812,1.08815,1.08787,1.08793,331,734.95,-600132,-599748.8,23.951581928510677,32.46720444149972,38.49666618800317,NaN,NaN,50
1688508000,1.08793,1.08802,1.08774,1.08792,423,685.9,-600555,-600006.8,25.50224258446205,32.38143838238,37.45194508255529,NaN,NaN,50
1688509800,1.08792,1.08818,1.0879,1.08806,337,641.05,-600218,-600141,26.352260399595746,34.97136762251358,36.46093392950027,NaN,NaN,50
1688511600,1.08806,1.08818,1.08796,1.08812,387,590.25,-599831,-600107.4,27.14156265650561,36.10096625939558,36.11195136863835,NaN,NaN,50
1688513400,1.08812,1.08832,1.08809,1.08824,454,550.9,-599377,-600022.6,27.340537605339865,38.40546461150711,35.82575868270128,NaN,NaN,50
1688515200,1.08824,1.08873,1.08824,1.0887,938,537.05,-598439,-599684,26.166134013917443,46.38743265539916,35.98702275531504,NaN,NaN,50
1688517000,1.0887,1.0891,1.08857,1.08867,912,519.2,-599351,-599443.2,24.505615642940658,45.96904258768336,36.252617845661774,NaN,NaN,50
1688518800,1.08867,1.08872,1.0881,1.08846,1206,515.9,-600557,-599511,23.61727184563416,43.04245966641287,36.2470707910558,NaN,NaN,50
1688520600,1.08846,1.08852,1.08763,1.0877,1380,547.7,-601937,-599932.2,23.64385272101793,34.48563578603451,36.137776750520054,NaN,NaN,50
1688522400,1.0877,1.08781,1.0875,1.08756,873,548.75,-602810,-600618.8,23.879270962095834,33.177194330535556,36.08238709851919,NaN,NaN,50
1688524200,1.08756,1.08784,1.08755,1.08782,855,555.8,-601955,-601322,24.011246176512874,37.89028293914049,36.43339382717294,NaN,NaN,50
1688526000,1.08782,1.08794,1.08753,1.08766,893,585.15,-602848,-602021.4,23.83600833288395,36.19828357858002,36.7228073451022,NaN,NaN,50
1688527800,1.08766,1.0879,1.08766,1.08776,721,606.35,-602127,-602335.4,23.673287478085665,38.05997802028109,37.39967804846915,NaN,NaN,50
1688529600,1.08776,1.08776,1.08756,1.08767,655,628.9,-602782,-602504.4,23.72968394676383,37.0131876436705,37.61070989464532,NaN,NaN,50
1688531400,1.08767,1.08769,1.08752,1.08758,574,642.7,-603356,-602613.6,23.866772728050357,35.948418015347116,37.85936800706299,NaN,NaN,50
1688533200,1.08758,1.08758,1.08678,1.08738,1164,675,-604520,-603126.6,25.2595707443012,33.632962416486976,37.94876258092778,NaN,NaN,50
1688535000,1.08738,1.08841,1.08734,1.08814,962,699.85,-603558,-603268.6,24.264154928125386,47.47729538476038,38.84204313537397,NaN,NaN,50
1688536800,1.08814,1.08846,1.08732,1.08745,1644,767.95,-605202,-603883.6,23.22619249859889,39.43435996376812,39.080142685686305,NaN,NaN,50
1688538600,1.08745,1.0889,1.08716,1.08827,2101,850.4,-603101,-603947.4,21.8069829022478,50.22586008959106,39.92445664840658,NaN,NaN,50
1688540400,1.08827,1.0908,1.08824,1.08994,3102,995.6,-599999,-603276,22.952185488286887,64.2115918132483,41.19761087396723,NaN,NaN,50
1688542200,1.08994,1.0902,1.08859,1.08868,2852,1121.65,-602851,-602942.2,24.015587889608895,52.27647929825933,41.6481420675798,NaN,NaN,50
1688544000,1.08868,1.08868,1.08664,1.0881,3533,1277.15,-606384,-603507.4,22.53231923746852,47.86603197219178,41.99268294656401,NaN,NaN,50
1688545800,1.0881,1.08944,1.08774,1.08881,2577,1389.15,-603807,-603228.4,21.510870624340317,53.084117973454845,43.32114595995118,NaN,NaN,50
1688547600,1.08881,1.08929,1.08754,1.08896,2332,1486.4,-601475,-602903.2,20.32618460692059,54.1287153904412,44.81768317851587,NaN,NaN,50
1688549400,1.08896,1.08958,1.08872,1.08943,1629,1545.15,-599846,-602872.6,19.535360328963275,57.334244908417666,46.20653760489281,NaN,NaN,50
1688551200,1.08943,1.0895,1.08842,1.0885,1666,1581.55,-601512,-602604.8,18.42424255130586,49.903093348018444,47.18545258842413,NaN,NaN,50
1688553000,1.0885,1.08878,1.08774,1.08782,1648,1618.35,-603160,-601960,17.607000856750375,45.28167627145185,47.701288177793465,NaN,NaN,50
1688554800,1.08782,1.08822,1.0878,1.08799,1517,1633.9,-601643,-601527.2,16.84813356894885,46.61277341050265,48.38697287542433,NaN,NaN,50
1688556600,1.08799,1.08824,1.08754,1.08792,1847,1657.25,-603490,-601930.2,16.440219806806002,46.11531594150503,49.1131798701499,NaN,NaN,50
1688558400,1.08792,1.0889,1.08757,1.08877,2325,1729.85,-601165,-602194,15.334188239496955,52.71442433358523,50.47614143565692,NaN,NaN,50
1688560200,1.08877,1.09022,1.08864,1.08942,2551,1814.65,-598614,-601614.4,15.650389167640352,57.04651412717907,51.1596570601154,NaN,NaN,50
1688562000,1.08942,1.09014,1.08926,1.08956,2788,1909.4,-595826,-600147.6,15.944004315202081,57.940301645285565,52.48151003736665,NaN,NaN,50
1688563800,1.08956,1.08992,1.08857,1.08916,3273,2037,-599099,-599638.8,15.333637141888609,54.45386920683928,52.78351068859866,NaN,NaN,50
1688565600,1.08916,1.08952,1.08782,1.08804,3983,2203.4,-603082,-599557.2,14.536889682899021,46.09093410800768,51.489177995367186,NaN,NaN,50
1688567400,1.08804,1.08831,1.0867,1.08738,3682,2358.8,-606764,-600677,14.808336838628094,41.99770428205418,50.754979779923964,NaN,NaN,50
1688569200,1.08738,1.08772,1.08682,1.08736,2803,2440.75,-609567,-602867.6,15.060394911805092,41.87634022577214,50.3271446551797,NaN,NaN,50
1688571000,1.08736,1.08766,1.08649,1.08672,2063,2495.8,-611630,-606028.4,15.574805635430547,38.08372635078045,49.25568811070296,NaN,NaN,50
1688572800,1.08672,1.08672,1.08606,1.0864,1693,2498.25,-613323,-608873.2,16.403315519860268,36.31286284908695,47.983127214891944,NaN,NaN,50
1688574600,1.0864,1.08651,1.0859,1.08608,1493,2467.85,-614816,-611220,17.301099066724696,34.58117321316587,46.35790780808825,NaN,NaN,50
1688576400,1.08608,1.0864,1.0859,1.08602,1564,2390.95,-616380,-613143.2,18.13475521738452,34.25135601819481,45.2399265702437,NaN,NaN,50
1688578200,1.08602,1.0861,1.08583,1.086,1262,2311.45,-617642,-614758.2,18.971645011907476,34.13448941792656,44.44369893784904,NaN,NaN,50
1688580000,1.086,1.08656,1.0853,1.08546,2100,2239.8,-619742,-616380.6,20.20798897267338,31.053619800489628,43.33233082284811,NaN,NaN,50
1688581800,1.08546,1.08575,1.0851,1.08536,1864,2204.15,-621606,-618037.2,21.519456375745925,30.504540192577437,42.21727541221042,NaN,NaN,50
1688583600,1.08536,1.08557,1.08526,1.08537,1397,2157.4,-620209,-619115.8,22.737247535741865,30.63662048184868,40.64028942280066,NaN,NaN,50
1688585400,1.08537,1.08569,1.08536,1.08552,1334,2142.65,-618875,-619614.8,23.62676554735825,32.702737521632486,38.9014482366902,NaN,NaN,50
1688587200,1.08552,1.08558,1.0853,1.08548,677,2093.2,-619552,-619996.8,24.51272578236052,32.42536529816802,37.07895278332466,NaN,NaN,50
1688589000,1.08548,1.08548,1.08533,1.08534,488,2035.2,-620040,-620056.4,25.335403143434053,31.420865776030325,35.43373825255259,NaN,NaN,50
1688590800,1.08534,1.08574,1.08534,1.08564,225,1970.6,-619815,-619698.2,25.50530960720018,35.99645264092153,34.71270386204644,NaN,NaN,50
1688592600,1.08564,1.08576,1.08541,1.08569,310,1893.75,-619505,-619557.4,25.617113190309066,36.75384749560029,34.33814266301402,NaN,NaN,50
1688594400,1.08569,1.08572,1.08558,1.08566,337,1794.35,-619842,-619750.8,25.72093080319589,36.474947240562955,33.95232887835622,NaN,NaN,50
1688596200,1.08566,1.08572,1.08528,1.0853,322,1682.9,-620164,-619873.2,26.237164893182058,33.217489172150906,33.60474050845411,NaN,NaN,50
1688598000,1.0853,1.08564,1.08521,1.08562,397,1563.35,-619767,-619818.6,26.811593740895095,38.47709453670866,33.75932848614137,NaN,NaN,50
1688599800,1.08562,1.08562,1.08536,1.08554,227,1411.05,-619994,-619854.4,27.34499195662863,37.678171530709044,33.98054265168016,NaN,NaN,50
1688601600,1.08554,1.08562,1.08507,1.08532,1118,1267.8,-621112,-620175.8,28.249020999586694,35.495476570299346,34.06940840540192,NaN,NaN,50
1688603400,1.08532,1.08548,1.08464,1.0849,1047,1136.05,-622159,-620639.2,29.611587999522847,31.717855936294214,33.89679172814247,NaN,NaN,50
1688605200,1.0849,1.08496,1.08428,1.0844,1248,1058.3,-623407,-621287.8,31.249849717280725,27.909768110819215,33.67223089316601,NaN,NaN,50
1688607000,1.0844,1.08508,1.08436,1.08501,1774,1043.85,-621633,-621661,32.39663003445296,37.732046522743175,34.1884813453207,NaN,NaN,50
1688608800,1.08501,1.08533,1.08492,1.08528,966,1007.5,-620667,-621795.6,32.70830338459233,41.5294899474599,34.96654345000722,NaN,NaN,50
1688610600,1.08528,1.08537,1.0846,1.08472,1093,987.5,-621760,-621925.2,33.403415704029406,36.55062371063838,35.24139246350764,NaN,NaN,50
1688612400,1.08472,1.08472,1.0843,1.08434,912,954.9,-622672,-622027.8,34.390696268631736,33.60636695927769,35.32574972501548,NaN,NaN,50
1688614200,1.08434,1.08458,1.08399,1.08402,1174,950.5,-623846,-622115.6,35.62668145813203,31.318489497208333,35.31843713367105,NaN,NaN,50
1688616000,1.08402,1.08414,1.0834,1.08341,1287,909.85,-625133,-622815.6,37.28469166141949,27.478199608009774,34.709990488463056,NaN,NaN,50
1688617800,1.08341,1.08437,1.08338,1.08433,1114,872.35,-624019,-623486,38.16099892921478,39.52291926635462,34.90778132923122,NaN,NaN,50
1688619600,1.08433,1.08469,1.08418,1.08446,1235,864.25,-622784,-623690.8,38.11437011759241,41.013719121559014,35.231979320730936,NaN,NaN,50
1688621400,1.08446,1.08564,1.08421,1.08553,1383,866.7,-621401,-623436.6,36.05985812719029,51.591114041763625,36.54438109713185,NaN,NaN,50
1688623200,1.08553,1.08678,1.08532,1.08659,2612,963.45,-618789,-622425.2,34.450613028422964,59.364948535065295,38.03637066844304,NaN,NaN,50
1688625000,1.08659,1.08693,1.08614,1.08672,1870,1032.55,-616919,-620782.4,33.13417464510729,60.208901609972074,39.64570853124754,NaN,NaN,50
1688626800,1.08672,1.08753,1.08572,1.08678,3411,1191.85,-613508,-618680.2,32.57375511297721,60.615471968381435,41.43999391682484,NaN,NaN,50
1688628600,1.08678,1.08686,1.08523,1.08558,2679,1310.3,-616187,-617360.8,31.26161819997546,49.68188777466107,42.72313904813676,NaN,NaN,50
1688630400,1.08558,1.08608,1.08472,1.08528,2507,1418.8,-618694,-616819.4,29.30724862417951,47.38093663672052,44.113936799986845,NaN,NaN,50
1688632200,1.08528,1.08656,1.08455,1.08641,2726,1539,-615968,-616255.2,28.067581996032537,55.70291088211944,45.39756996851372,NaN,NaN,50
1688634000,1.08641,1.08687,1.08601,1.0862,1886,1613.45,-617854,-616442.2,27.26276390648797,53.993866972364046,46.28788261314973,NaN,NaN,50
1688635800,1.0862,1.08682,1.08606,1.08617,1759,1690.05,-619613,-617663.2,26.515432823339445,53.74020155421924,47.51570960197694,NaN,NaN,50
1688637600,1.08617,1.08882,1.08614,1.0887,2273,1747.8,-617340,-617893.8,27.555520946308597,67.57517707733257,49.942053181838,NaN,NaN,50
1688639400,1.0887,1.08902,1.08834,1.08868,2746,1832.75,-620086,-618172.2,28.64954161689545,67.40356348823566,52.519558466911384,NaN,NaN,50
1688641200,1.08868,1.08952,1.08834,1.08946,2237,1882.2,-617849,-618548.4,29.97474826954127,70.54529095735886,55.595779277579176,NaN,NaN,50
1688643000,1.08946,1.0898,1.08899,1.08954,2441,1915.55,-615408,-618059.2,31.370168457888877,70.85555697534798,57.83382482822156,NaN,NaN,50
1688644800,1.08954,1.09006,1.0861,1.08798,5790,2156.75,-621198,-618376.2,29.173500652886748,58.02092505412441,59.048625251976226,NaN,NaN,50
1688646600,1.08798,1.08815,1.08584,1.0874,6481,2426.15,-627679,-620444,27.266338689316022,54.09742069468852,59.22764715575658,NaN,NaN,50
1688648400,1.0874,1.08878,1.08674,1.08861,3955,2578.3,-623724,-621171.6,25.68514585807457,60.15144461569518,59.283825447230136,NaN,NaN,50
1688650200,1.08861,1.08878,1.08691,1.08834,4755,2757.35,-628479,-623297.6,24.216895371921797,58.30359982326429,59.14773246246529,NaN,NaN,50
1688652000,1.08834,1.08834,1.08422,1.08453,6434,3014.7,-634913,-627198.6,24.13837181470161,39.74783668929033,57.65718708538736,NaN,NaN,50
1688653800,1.08453,1.08745,1.08336,1.08682,5268,3222.4,-629645,-628888,24.53045977199367,50.03988997661845,57.68275867124146,NaN,NaN,50
1688655600,1.08682,1.08704,1.08588,1.08606,3342,3327.75,-632987,-629949.6,24.89454144662201,47.160686905249314,57.66702654756495,NaN,NaN,50
1688657400,1.08606,1.08782,1.08584,1.08726,2918,3404.5,-630069,-631218.6,24.475372427447482,51.86966996028973,57.39322362457711,NaN,NaN,50
1688659200,1.08726,1.0886,1.0871,1.08716,2476,3397.7,-632545,-632031.8,23.397955790714978,51.458115531561724,57.21209852166266,NaN,NaN,50
1688661000,1.08716,1.0877,1.08708,1.08726,1637,3386.05,-630908,-631230.8,22.4119313942959,51.86937882112022,57.0784683264413,NaN,NaN,50
1688662800,1.08726,1.08804,1.08724,1.08793,1571,3294.05,-629337,-631169.2,21.189255307341444,54.6421573886983,56.154681205824566,NaN,NaN,50
1688664600,1.08793,1.08823,1.08752,1.0882,1441,3232.15,-627896,-630151,19.880452795245557,55.74851422451487,55.32217768698737,NaN,NaN,50
1688666400,1.0882,1.08826,1.08774,1.0878,1414,3177.5,-629310,-629999.2,18.636433704715703,53.660291710940875,54.11610631224323,NaN,NaN,50
1688668200,1.0878,1.08858,1.08777,1.08808,1279,3105.15,-628031,-629096.4,17.44356457881757,54.93287453671845,52.978771852341126,NaN,NaN,50
1688670000,1.08808,1.0886,1.08808,1.08849,1026,3062.15,-627005,-628315.8,16.356089476981506,56.80352059646905,52.891814391080025,NaN,NaN,50
1688671800,1.08849,1.0889,1.08821,1.08883,1302,3039.3,-625703,-627589,15.657015273825317,58.34753798173248,53.195394197297446,NaN,NaN,50
1688673600,1.08883,1.08886,1.08853,1.08884,568,2954.05,-625135,-627036.8,15.007874942323141,58.39464209821581,53.06990830319178,NaN,NaN,50
1688675400,1.08884,1.08924,1.08879,1.08921,634,2848.45,-624501,-626075,14.814502067809682,60.18859919157277,53.20455111521382,NaN,NaN,50
1688677200,1.08921,1.08921,1.08871,1.08891,124,2742.8,-624625,-625393.8,14.524906240744134,58.00471162669134,54.508613610742465,NaN,NaN,50
1688679000,1.08891,1.08896,1.08889,1.08894,37,2622.6,-624588,-624910.4,14.255995829897556,58.16817015530292,55.08920505207707,NaN,NaN,50
1688680800,1.08894,1.0891,1.08894,1.089,399,2353.05,-624189,-624607.6,14.178952613225462,58.515948758214186,55.9002951844317,NaN,NaN,50
1688682600,1.089,1.08914,1.089,1.08914,293,2043.65,-623896,-624359.8,14.158672187020285,59.36485414192022,56.43566548311959,NaN,NaN,50
1688684400,1.08914,1.08949,1.0891,1.08928,489,1870.35,-623407,-624141,14.584257773210227,60.2410431301775,57.0630174544493,NaN,NaN,50
1688686200,1.08928,1.08932,1.08896,1.08896,531,1659.15,-623938,-624003.6,14.72044460369414,57.20480982425742,57.4441196689591,NaN,NaN,50
1688688000,1.08896,1.08912,1.0886,1.08861,1150,1394.95,-625088,-624103.6,14.204986211955244,53.99904621367961,57.39818315645776,NaN,NaN,50
1688689800,1.08861,1.0888,1.08824,1.08852,1212,1192.15,-626300,-624525.8,13.243370456652382,53.17385191473388,57.21427870575912,NaN,NaN,50
1688691600,1.08852,1.08914,1.08848,1.08878,1370,1093.55,-624930,-624732.6,12.765173837550883,55.299063962278666,57.33133386656896,NaN,NaN,50
1688693400,1.08878,1.08888,1.08864,1.0887,1698,1032.55,-626628,-625376.8,12.321134119813777,54.47975017202885,57.2989678405197,NaN,NaN,50
1688695200,1.0887,1.08886,1.08844,1.08844,1411,979.3,-628039,-626197,11.550728214178982,51.7939155180546,56.94113890634724,NaN,NaN,50
1688697000,1.08844,1.08866,1.08835,1.08861,876,941.25,-627163,-626612,10.777682416547526,53.41119829883948,56.58854321471203,NaN,NaN,50
1688698800,1.08861,1.08916,1.08861,1.08904,954,910.4,-626209,-626593.8,10.802543274960843,57.31233132527061,56.5112353023588,NaN,NaN,50
1688700600,1.08904,1.08906,1.08866,1.08878,1072,891.95,-627281,-627064,10.82562835777321,54.34893438171591,56.09411638736902,NaN,NaN,50
1688702400,1.08878,1.08924,1.08856,1.08924,636,853.05,-626645,-627067.4,11.144365804779351,58.443002660562996,56.125422889788425,NaN,NaN,50
1688704200,1.08924,1.08954,1.0891,1.08912,687,823.45,-627332,-626926,11.909523999548552,57.006725175403744,56.042462534081345,NaN,NaN,50
1688706000,1.08912,1.08963,1.08903,1.08925,1134,828.85,-626198,-626733,12.756440506917263,58.20505502970891,56.02025583918811,NaN,NaN,50
1688707800,1.08925,1.08939,1.08865,1.08874,1214,824.45,-627412,-626973.6,12.658711367143033,52.0730768710446,55.499414605554136,NaN,NaN,50
1688709600,1.08874,1.09004,1.08873,1.0892,1826,887.35,-625586,-626634.6,13.552637966531389,56.52224990193318,55.233786517822395,NaN,NaN,50
1688711400,1.0892,1.08948,1.08812,1.08831,1952,953.25,-627538,-626813.2,13.167935287141594,47.36130508418495,54.530679036388655,NaN,NaN,50
1688713200,1.08831,1.0891,1.08773,1.08816,2953,1094.7,-630491,-627445,12.304961789286132,46.00786558232385,53.95988041986324,NaN,NaN,50
1688715000,1.08816,1.0888,1.08716,1.08762,2927,1239.2,-633418,-628889,12.342040521089784,41.41903192843104,53.12025042084161,NaN,NaN,50
1688716800,1.08762,1.08808,1.0867,1.0878,2313,1334.9,-631105,-629627.6,12.958623860484323,43.44397372729395,52.27345826119984,NaN,NaN,50
1688718600,1.0878,1.0881,1.08734,1.0878,2055,1423,-631105,-630731.4,13.493504411411426,43.44397372729396,51.48518851514735,NaN,NaN,50
1688720400,1.0878,1.08852,1.08732,1.08737,2102,1503.65,-633207,-631865.2,13.218256850959834,39.647047418751235,50.61755507948283,NaN,NaN,50
1688722200,1.08737,1.08888,1.087,1.08804,2309,1592.55,-630898,-631946.6,12.363668260343994,47.36602572438916,50.18575703845066,NaN,NaN,50
1688724000,1.08804,1.08832,1.08779,1.08831,1950,1632.55,-628948,-631052.6,11.570121711915002,50.13386369862488,49.67300935083311,NaN,NaN,50
1688725800,1.08831,1.08964,1.0883,1.08924,1690,1656.45,-627258,-630283.2,12.429165530773354,58.27326985863308,49.95331902775576,NaN,NaN,50
1688727600,1.08924,1.08935,1.08888,1.08913,1679,1671.9,-628937,-629849.6,13.226849076856109,57.086370614088615,49.856416738721876,NaN,NaN,50
1688729400,1.08913,1.08972,1.08876,1.08876,1837,1678.85,-630774,-629363,14.370801894166854,53.163939353171266,49.58193203713385,NaN,NaN,50
1688731200,1.08876,1.0893,1.08746,1.08864,2696,1743.1,-633470,-629877.4,13.4159760415211,51.917977124531795,49.13285504390691,NaN,NaN,50
1688733000,1.08864,1.09316,1.08864,1.09117,9603,2179.45,-623867,-628861.2,15.437767673889793,68.6173784279011,50.31459086939666,NaN,NaN,50
1688734800,1.09117,1.09136,1.08953,1.09078,5406,2402.05,-629273,-629264.2,17.31514561823215,64.87681958172757,50.91134584652483,NaN,NaN,50
1688736600,1.09078,1.0925,1.09052,1.09164,6280,2662.45,-622993,-628075.4,19.572461632634006,68.90255809676586,52.45000677599489,NaN,NaN,50
1688738400,1.09164,1.09299,1.09097,1.09293,3929,2827.1,-619064,-625733.4,21.865823652752976,73.76079173865838,54.4323586443045,NaN,NaN,50
1688740200,1.09293,1.09541,1.09279,1.0949,4364,3010.95,-614700,-621979.4,24.766243294203715,79.12436901780401,57.12559700783113,NaN,NaN,50
1688742000,1.0949,1.09526,1.09446,1.09492,3202,3114.35,-611498,-619505.6,27.45949010412226,79.17091930569038,59.67752169200231,NaN,NaN,50
1688743800,1.09492,1.09635,1.09491,1.09631,2249,3166.1,-609249,-615500.8,30.24043060926377,82.15004821132645,62.442241298004625,NaN,NaN,50
1688745600,1.09631,1.09684,1.0963,1.09678,1885,3169.05,-607364,-612375,32.9383075854241,83.03368629804345,65.54128693223979,NaN,NaN,50
1688747400,1.09678,1.09728,1.09658,1.09719,2007,3171.8,-605357,-609633.6,35.545130237596155,83.78765596235932,68.14283194923765,NaN,NaN,50
1688749200,1.09719,1.09733,1.09664,1.09718,1316,3089.95,-606673,-608028.2,37.977573324500796,83.68996809944095,70.53969654929594,NaN,NaN,50
1688751000,1.09718,1.09733,1.09668,1.09675,1172,3002.2,-607845,-607297.6,40.23627047662654,79.40299656876068,72.04896274287648,NaN,NaN,50
1688752800,1.09675,1.09697,1.09658,1.09688,1257,2949.4,-606588,-606765.4,42.183368216882045,79.74087269832413,73.66714146317902,NaN,NaN,50
1688754600,1.09688,1.09704,1.09661,1.09673,1261,2909.7,-607849,-606862.4,44.012896180368564,78.14791783341363,75.4517113546249,NaN,NaN,50
1688756400,1.09673,1.09693,1.09656,1.09682,1318,2870.5,-606531,-607097.2,45.62693739173741,78.42638965163358,77.34516939227503,NaN,NaN,50
1688758200,1.09682,1.09698,1.09633,1.09668,1486,2829.35,-608017,-607366,46.72267242348296,76.78713250744117,77.92872325509931,NaN,NaN,50
1688760000,1.09668,1.09695,1.09659,1.09666,665,2765.1,-608682,-607533.4,47.74014066724669,76.54100188595888,78.761879133973,NaN,NaN,50
1688761800,1.09666,1.09706,1.09651,1.09688,562,2708.7,-608120,-607839.8,48.7363376551783,77.39918252970878,79.36878087918319,NaN,NaN,50
1688936400,1.09688,1.09688,1.09594,1.0968,112,2630.35,-608232,-607916.4,48.58395524183061,76.30603164073891,79.5505837293318,NaN,NaN,50
1688938200,1.0968,1.0968,1.09654,1.09659,96,2543.3,-608328,-608275.8,48.44245728657918,73.37639278232972,79.14001399822651,NaN,NaN,50
1688940000,1.09659,1.09698,1.0965,1.0969,715,2444.25,-607613,-608195,48.43707619394676,74.9079008754097,78.83551268177789,NaN,NaN,50
1688941800,1.0969,1.0969,1.09664,1.09664,570,1992.6,-608183,-608095.2,48.432079465073805,71.20810175487476,78.05394507774562,NaN,NaN,50
1688943600,1.09664,1.09665,1.09628,1.0963,542,1749.4,-608725,-608216.2,47.6731173062615,66.57719273231106,76.87848125162188,NaN,NaN,50
1688945400,1.0963,1.09682,1.09624,1.0967,566,1463.7,-608159,-608201.6,47.123552573620124,69.12144173420722,75.83089452103958,NaN,NaN,50
1688947200,1.0967,1.0969,1.0957,1.09589,1477,1341.1,-609636,-608463.2,45.545965598242525,59.28046897033413,74.08735886896054,NaN,NaN,50
1688949000,1.09589,1.0966,1.0958,1.09644,1366,1191.2,-608270,-608594.6,44.08106340682047,63.12000261349644,72.92428787215594,NaN,NaN,50
1688950800,1.09644,1.09695,1.09638,1.09678,1757,1118.95,-606513,-608260.6,43.118521629057845,65.29834814498271,71.89267897548869,NaN,NaN,50
1688952600,1.09678,1.09682,1.0957,1.09606,2074,1110.2,-608587,-608233,40.9698979515461,57.54669177259165,70.42116282828712,NaN,NaN,50
1688954400,1.09606,1.09634,1.0958,1.09581,1536,1092.75,-610123,-608625.8,38.97474739385663,55.100772060660944,68.7550472860748,NaN,NaN,50
1688956200,1.09581,1.09614,1.09564,1.09606,1439,1064.35,-608684,-608435.4,36.83623416043453,57.06597810752375,67.34639340036641,NaN,NaN,50
1688958000,1.09606,1.09622,1.09546,1.09551,1307,1063.9,-609991,-608779.6,34.530129370354565,51.70427194221534,65.5723412615276,NaN,NaN,50
1688959800,1.09551,1.09564,1.09528,1.09559,1190,1064.8,-608801,-609237.2,32.07198300808908,52.40476081188189,63.787025424539955,NaN,NaN,50
1688961600,1.09559,1.09579,1.09542,1.09573,998,1051.85,-607803,-609080.4,30.051044992402005,53.67114880678743,62.17024807925771,NaN,NaN,50
1688963400,1.09573,1.0958,1.09528,1.09531,1176,1047.6,-608979,-608851.6,27.910949758054166,49.42265237074135,60.45926662128711,NaN,NaN,50
1688965200,1.09531,1.09564,1.09522,1.09523,1071,1035.25,-610050,-609124.8,26.026305724900496,48.632973405202534,58.58248608770088,NaN,NaN,50
1688967000,1.09523,1.09552,1.0946,1.09463,1743,1048.1,-611793,-609485.2,25.347377189938094,43.07410117977643,56.572914618051,NaN,NaN,50
1688968800,1.09463,1.09542,1.09451,1.09526,2150,1122.35,-609643,-609653.6,24.85558758906079,49.58963087604171,55.35951734260318,NaN,NaN,50
1688970600,1.09526,1.09549,1.0949,1.09505,1812,1184.85,-611455,-610384,24.23727826869136,47.63255727413089,53.82459702402631,NaN,NaN,50
1688972400,1.09505,1.09656,1.09494,1.09503,2607,1309.6,-614062,-611400.6,23.334637828769324,47.440530756171384,52.978887151586115,NaN,NaN,50
1688974200,1.09503,1.09556,1.09484,1.09545,2065,1408.05,-611997,-611790,22.309041492543795,51.832093182758776,52.17260790653342,NaN,NaN,50
1688976000,1.09545,1.09605,1.0953,1.09582,1916,1468.1,-610081,-611447.6,22.07435477328464,55.36989209150156,51.46343247414192,NaN,NaN,50
1688977800,1.09582,1.09658,1.09537,1.09648,1754,1527.3,-608327,-611184.4,22.51538330901889,60.88824608354137,51.70211492492403,NaN,NaN,50
1688979600,1.09648,1.09733,1.09624,1.09718,1593,1579.85,-606734,-610240.2,23.68308127470384,65.72835717863936,52.46122814763678,NaN,NaN,50
1688981400,1.09718,1.09722,1.0961,1.09619,1959,1649.5,-608693,-609166.4,24.480921752679468,55.30446174407525,52.33540555024759,NaN,NaN,50
1688983200,1.09619,1.09653,1.0959,1.09598,1631,1657.2,-610324,-608831.8,24.812013275563203,53.37093207928141,52.454452702895175,NaN,NaN,50
1688985000,1.09598,1.09603,1.09546,1.09594,1546,1666.2,-611870,-609189.6,24.275043078214868,52.9909025304953,52.49631996851041,NaN,NaN,50
1688986800,1.09594,1.09622,1.09533,1.0958,1641,1660.4,-613511,-610226.4,24.0176880128063,51.605856221248175,52.34879906954332,NaN,NaN,50
1688988600,1.0958,1.0961,1.09538,1.09539,1649,1639.15,-615160,-611911.6,23.77871545206977,47.67577735726586,52.2240222828665,NaN,NaN,50
1688990400,1.09539,1.09582,1.09482,1.09519,2193,1672,-617353,-613643.6,22.5009452882897,45.841796783270006,52.02465252415704,NaN,NaN,50
1688992200,1.09519,1.0952,1.09436,1.0947,2744,1737.25,-620097,-615598.2,21.212510161383253,41.617771249989815,51.9206289577437,NaN,NaN,50
1688994000,1.0947,1.09608,1.0947,1.096,2657,1804.75,-617440,-616712.2,20.629533146160544,53.784737047160995,52.22027939853793,NaN,NaN,50
1688995800,1.096,1.09713,1.09534,1.0967,3805,1935.5,-613635,-616737,21.18901218398603,58.767606753885964,53.01564007566329,NaN,NaN,50
1688997600,1.0967,1.09804,1.09667,1.09747,3286,2049.9,-610349,-615774.8,22.433857119040653,63.437503834404694,54.15828100982282,NaN,NaN,50
1688999400,1.09747,1.098,1.09665,1.09748,3087,2145.45,-607262,-613756.6,23.556630847968915,63.495328239316365,54.991369228148365,NaN,NaN,50
1689001200,1.09748,1.0984,1.09748,1.09835,2784,2231.1,-604478,-610632.8,24.896378555231422,68.20639297575192,55.90826214845197,NaN,NaN,50
1689003000,1.09835,1.09928,1.09824,1.099,1985,2243.2,-602493,-607643.4,26.7068616675971,71.19717335146217,56.644614096160595,NaN,NaN,50
1689004800,1.099,1.09904,1.09826,1.09882,1699,2220.65,-604192,-605754.8,28.388024557650944,69.25434001386078,56.896470012962126,NaN,NaN,50
1689006600,1.09882,1.09914,1.09871,1.09894,1470,2203.55,-602722,-604229.4,30.012347359096264,69.84511739817724,57.93508827396941,NaN,NaN,50
1689008400,1.09894,1.09926,1.09874,1.09922,1664,2156.4,-601058,-602988.6,31.599117634958183,71.23404713056527,59.211025063346824,NaN,NaN,50
1689010200,1.09922,1.09968,1.09919,1.09952,1296,2117.95,-599762,-602045.4,33.33908823260299,72.68569313719114,60.617795820967956,NaN,NaN,50
1689012000,1.09952,1.09968,1.09913,1.09963,1288,2086.55,-598474,-601241.6,34.8224961153698,73.2193464914889,62.16161655455658,NaN,NaN,50
1689013800,1.09963,1.09994,1.09942,1.09991,1357,2066.7,-597117,-599826.6,36.37205944355301,74.58073499183024,64.08339924273976,NaN,NaN,50
1689015600,1.09991,1.10005,1.09964,1.09986,1097,2041.9,-598214,-598925,37.8835048952935,73.8586983903062,66.08460650038519,NaN,NaN,50
1689017400,1.09986,1.10002,1.09966,1.0998,1235,2005.7,-599449,-598603.2,39.28698995762396,72.9460567003313,68.32234117540959,NaN,NaN,50
1689019200,1.0998,1.10004,1.0997,1.09998,723,1960.3,-598726,-598396,40.60509687585162,73.98462412606925,69.76519025247445,NaN,NaN,50
1689021000,1.09998,1.10016,1.09993,1.10012,348,1900.4,-598378,-598376.8,41.921734585469714,74.7950805144733,70.91000980680212,NaN,NaN,50
1689022800,1.10012,1.10018,1.10012,1.10013,74,1822.05,-598304,-598614.2,43.160362708082815,74.85533675282494,71.725569300975,NaN,NaN,50
1689024600,1.10013,1.10013,1.09966,1.10004,104,1744.8,-598408,-598653,42.950777705695984,73.16014644471585,72.41591345850354,NaN,NaN,50
1689026400,1.10004,1.10016,1.09996,1.10004,447,1657.5,-598408,-598444.8,42.79170741868849,73.16014644471585,72.76975299200096,NaN,NaN,50
1689028200,1.10004,1.1003,1.10004,1.10015,321,1536.35,-598087,-598317,42.81403140845346,73.99492883919508,72.96959266969615,NaN,NaN,50
1689030000,1.10015,1.10044,1.10014,1.10041,295,1418.25,-597792,-598199.8,43.00323280241064,75.90270240399579,73.44447569756294,NaN,NaN,50
1689031800,1.10041,1.1006,1.10025,1.10053,531,1254.55,-597261,-597991.2,43.36802580208407,76.7504676020967,73.93771499784292,NaN,NaN,50
1689033600,1.10053,1.10088,1.10015,1.10074,1213,1150.9,-596048,-597519.2,44.01743088337345,78.19611961734988,74.4350058897561,NaN,NaN,50
1689035400,1.10074,1.10076,1.10041,1.10068,1188,1055.95,-597236,-597284.8,44.620449887427874,76.72813725633843,74.72375189826661,NaN,NaN,50
1689037200,1.10068,1.1012,1.10065,1.10116,1275,980.5,-595961,-596859.6,45.63038712773853,79.96805140466401,75.20580224920771,NaN,NaN,50
1689039000,1.10116,1.10132,1.10058,1.10096,1640,963.25,-597601,-596821.4,46.67854196388035,75.26612981543997,75.25475902232267,NaN,NaN,50
1689040800,1.10096,1.1012,1.10062,1.10108,1261,941.35,-596340,-596637.2,47.651828597440606,76.17143034921845,75.41995416224498,NaN,NaN,50
1689042600,1.10108,1.10202,1.10103,1.1019,1806,958.15,-594534,-596334.4,49.204693165404194,81.22774813789961,76.01150355064271,NaN,NaN,50
1689044400,1.1019,1.10194,1.10138,1.10145,1353,942.6,-595887,-596064.6,50.6466388356561,72.17636889409748,75.88234246264473,NaN,NaN,50
1689046200,1.10145,1.10178,1.10121,1.10176,1071,931.35,-594816,-595835.6,51.35434498290902,74.30089562566573,75.84704354201563,NaN,NaN,50
1689048000,1.10176,1.10182,1.10152,1.1017,852,909.55,-595668,-595449,52.04826220319955,73.13687933420836,75.72429658354301,NaN,NaN,50
1689049800,1.1017,1.10203,1.10159,1.102,1203,901.85,-594465,-595074,52.88365340921188,75.22667577066302,75.87190582111066,NaN,NaN,50
1689051600,1.102,1.10223,1.10168,1.10178,1224,908.2,-595689,-595305,53.82983949557796,70.87244874167442,75.70849884232199,NaN,NaN,50
1689053400,1.10178,1.10201,1.10061,1.10072,1803,936.6,-597492,-595626,51.44557235381281,54.50319074073999,74.31623183528949,NaN,NaN,50
1689055200,1.10072,1.10274,1.10072,1.10234,2898,1045.35,-594594,-595581.6,50.18660513280373,67.03467995015397,73.682801660015,NaN,NaN,50
1689057000,1.10234,1.10239,1.1015,1.10214,2142,1135.05,-596736,-595795.2,49.01756414186673,64.6665733022754,72.81966635288491,NaN,NaN,50
1689058800,1.10214,1.1023,1.10096,1.10141,2630,1262.85,-599366,-596775.4,46.72747441827161,56.78181261065669,71.29007299526396,NaN,NaN,50
1689060600,1.10141,1.10162,1.10076,1.10082,2201,1367.7,-601567,-597951,44.20115536500845,51.33393820486751,69.4762016344446,NaN,NaN,50
1689062400,1.10082,1.1014,1.10074,1.10122,1765,1433.6,-599802,-598413,41.814502305219534,54.51984066545871,67.65847229592995,NaN,NaN,50
1689064200,1.10122,1.10156,1.10022,1.10028,1953,1515.2,-601755,-599845.2,39.050677598129504,46.77101924888797,65.62310725546196,NaN,NaN,50
1689066000,1.10028,1.10078,1.09972,1.10034,1845,1592.7,-599910,-600480,37.28038375453603,47.28602833716145,63.55986425460075,NaN,NaN,50
1689067800,1.10034,1.10087,1.10019,1.10064,2024,1667.35,-597886,-600184,35.45848893529476,49.89633153544876,61.32190592585425,NaN,NaN,50
1689069600,1.10064,1.10107,1.10053,1.10072,1337,1673.55,-596549,-599180.4,33.370601448394446,50.59884672691988,59.780654342484425,NaN,NaN,50
1689071400,1.10072,1.10128,1.1004,1.10061,1573,1692.8,-598122,-598844.4,31.028759087480456,49.56967081843737,58.01413828482526,NaN,NaN,50
1689073200,1.10061,1.10064,1.09999,1.10006,1323,1695.2,-599445,-598382.4,29.56766521855928,44.676576703051,55.98125952545688,NaN,NaN,50
1689075000,1.10006,1.10007,1.0983,1.0984,1771,1701.75,-601216,-598643.6,30.181130455552697,33.82419452395216,53.0239394364061,NaN,NaN,50
1689076800,1.0984,1.09904,1.09828,1.09846,2130,1745.2,-599086,-598883.6,30.76807344543496,34.444042520424276,50.42191042060251,NaN,NaN,50
1689078600,1.09846,1.09863,1.09769,1.0982,2332,1771.5,-601418,-599857.4,31.799888272543242,33.001506990600404,48.88607586702111,NaN,NaN,50
1689080400,1.0982,1.09906,1.09795,1.09898,2519,1829.8,-598899,-600012.8,31.929296688933334,40.9864218208389,47.025486000641465,NaN,NaN,50
1689082200,1.09898,1.09939,1.098,1.09872,3032,1927.85,-601931,-600510,31.458311902532472,39.30485221017535,45.21393449406289,NaN,NaN,50
1689084000,1.09872,1.09922,1.09784,1.09899,2673,2018.9,-599258,-600118.4,31.188052705393726,41.967543976441725,44.15577244876182,NaN,NaN,50
1689085800,1.09899,1.09936,1.0984,1.09902,2674,2092.45,-596584,-599618,30.67559133984366,42.27058835158866,43.50839031638476,NaN,NaN,50
1689087600,1.09902,1.09946,1.09868,1.09914,2079,2135.2,-594505,-598235.4,30.008560716908683,43.540624325492786,42.72416057781577,NaN,NaN,50
1689089400,1.09914,1.09932,1.09863,1.09918,1454,2117.75,-593051,-597065.8,29.453720524266835,43.98301104465985,42.52501713465663,NaN,NaN,50
1689091200,1.09918,1.09966,1.0991,1.09946,1209,2033.3,-591842,-595048,28.2609847598021,47.107254325529894,42.51224756239723,NaN,NaN,50
1689093000,1.09946,1.10033,1.09934,1.10026,1326,1992.5,-590516,-593299.6,26.46998242818171,54.854634930584474,42.86641209062121,NaN,NaN,50
1689094800,1.10026,1.10093,1.10022,1.1007,1167,1919.35,-589349,-591852.6,25.63669808215972,58.458651227733796,43.42782669782219,NaN,NaN,50
1689096600,1.1007,1.10079,1.10033,1.10068,759,1847.25,-590108,-590973.2,24.862934046567872,58.23109405504711,44.046499786151465,NaN,NaN,50
1689098400,1.10068,1.10078,1.09984,1.09986,737,1795.85,-590845,-590532,23.307573249657505,49.690574420133146,44.40464248022876,NaN,NaN,50
1689100200,1.09986,1.10014,1.09976,1.09992,875,1741.95,-589970,-590157.6,21.73351366386733,50.265365942226,45.57901186724832,NaN,NaN,50
1689102000,1.09992,1.10044,1.09992,1.10036,892,1694.3,-589078,-589870,20.740538821635603,54.381487784317535,47.00311510038356,NaN,NaN,50
1689103800,1.10036,1.10074,1.10031,1.10061,1121,1649.15,-587957,-589591.6,20.25818457653428,56.58029994251032,48.687314596948546,NaN,NaN,50
1689105600,1.10061,1.10074,1.1005,1.10058,485,1606.55,-588442,-589258.4,19.810284206083054,56.230047323919706,49.77614499002574,NaN,NaN,50
1689107400,1.10058,1.10088,1.10056,1.10087,529,1554.35,-587913,-588672,19.608707951213013,58.87995735076014,51.1743667857818,NaN,NaN,50
1689109200,1.10087,1.1009,1.10034,1.10083,108,1493.6,-588021,-588282.2,18.95569277000791,58.35517274448563,52.34491169778494,NaN,NaN,50
1689111000,1.10083,1.10091,1.10068,1.10073,450,1427.55,-588471,-588160.8,18.36672581361987,56.9876977157816,53.396133795227286,NaN,NaN,50
1689112800,1.10073,1.101,1.10073,1.101,322,1337.15,-588149,-588199.2,17.983733188296675,59.73150669643048,54.55262539315141,NaN,NaN,50
1689114600,1.101,1.10124,1.10096,1.10122,356,1238.35,-587793,-588069.4,18.055182749696574,61.86610402464758,55.82998917743625,NaN,NaN,50
1689116400,1.10122,1.10133,1.10112,1.10116,445,1134.65,-588238,-588134.4,18.277813358158195,60.917670016275395,56.81644744106093,NaN,NaN,50
1689118200,1.10116,1.10146,1.10116,1.10138,596,1012.85,-587642,-588058.6,18.71154882036413,63.14849593909741,57.40886608452614,NaN,NaN,50
1689120000,1.10138,1.10203,1.1012,1.10201,1564,957.4,-586078,-587580,19.978476114245275,68.66449825898147,58.13785515818669,NaN,NaN,50
1689121800,1.10201,1.10217,1.10169,1.10188,1869,917.15,-587947,-587539.6,21.339139450212073,66.45406079383508,58.725209925242964,NaN,NaN,50
1689123600,1.10188,1.10318,1.10186,1.10262,1876,907,-586071,-587195.2,23.646653593467686,71.98298775368347,60.3175251633537,NaN,NaN,50
1689125400,1.10262,1.10292,1.10224,1.10272,1669,917.75,-584402,-586428,25.78934529791933,72.63925654908147,61.915660206700515,NaN,NaN,50
1689127200,1.10272,1.10338,1.10253,1.10314,1939,954.25,-582463,-585392.2,28.151134741359723,75.26037703710247,63.407009439042305,NaN,NaN,50
1689129000,1.10314,1.10328,1.10279,1.10314,1375,956.7,-582463,-584669.2,30.344224938840092,75.26037703710247,64.7413006600846,NaN,NaN,50
1689130800,1.10314,1.10316,1.10271,1.10274,1292,962.95,-583755,-583830.8,32.129143029393276,68.05886244897951,65.5862160261603,NaN,NaN,50
1689132600,1.10274,1.10314,1.10266,1.10297,1038,976.9,-582717,-583160,33.623459092452556,69.84559964945812,66.36947619035301,NaN,NaN,50
1689134400,1.10297,1.1034,1.10294,1.10323,969,988.5,-581748,-582629.2,35.26612115310081,71.76815875042561,67.32754661934872,NaN,NaN,50
1689136200,1.10323,1.10369,1.10322,1.10364,966,993.05,-580782,-582293,37.05084623747764,74.52629840273121,68.5803038112737,NaN,NaN,50
1689138000,1.10364,1.10364,1.10302,1.10322,1431,1020,-582213,-582243,38.03804393940207,67.27552608101327,69.11916233874389,NaN,NaN,50
1689139800,1.10322,1.10325,1.10254,1.1026,1579,1042.9,-583792,-582250.4,37.53854945039074,58.26393256377034,68.86186437725267,NaN,NaN,50
1689141600,1.1026,1.10356,1.1026,1.10306,1699,1103.6,-582093,-582125.6,37.4872072966382,62.298978090215904,68.960529239677,NaN,NaN,50
1689143400,1.10306,1.10316,1.10206,1.1023,1984,1176.35,-584077,-582591.4,36.11266854964022,53.155246049873206,68.24672567616098,NaN,NaN,50
1689145200,1.1023,1.103,1.10218,1.10277,2349,1288.4,-581728,-582780.6,34.83631114171352,57.32652756103133,67.4368706263074,NaN,NaN,50
1689147000,1.10277,1.10292,1.10225,1.10275,1950,1363.4,-583678,-583073.6,33.6511221200673,57.093550901513815,66.76826277685588,NaN,NaN,50
1689148800,1.10275,1.10306,1.10228,1.10244,1705,1432.55,-585383,-583391.8,32.7965140210486,53.46649011096573,65.44565580237604,NaN,NaN,50
1689150600,1.10244,1.10275,1.10216,1.10223,1445,1487,-586828,-584338.8,31.6777132325289,51.09830024631745,63.90701606646432,NaN,NaN,50
1689152400,1.10223,1.10272,1.10184,1.10265,1482,1538.85,-585346,-584592.6,29.827001342726227,55.35723160258252,62.485362821141464,NaN,NaN,50
1689154200,1.10265,1.10281,1.10211,1.10249,1240,1571.05,-586586,-585564.2,28.30065044610408,53.44755467372997,60.92730408090056,NaN,NaN,50
1689156000,1.10249,1.10254,1.10214,1.10248,1364,1561.05,-587950,-586418.6,26.883324613526373,53.323740363044045,59.874795360476604,NaN,NaN,50
1689157800,1.10248,1.10254,1.10186,1.10222,1116,1523.4,-589066,-587155.2,25.082450402664563,50.075653317827225,58.462656336788676,NaN,NaN,50
1689159600,1.10222,1.10228,1.10172,1.10196,1627,1510.95,-590693,-587928.2,23.746498148981683,46.99299851589151,56.69300203432196,NaN,NaN,50
1689161400,1.10196,1.10248,1.101375,1.1015,1864,1520.7,-592557,-589370.4,23.25989724516288,42.0597385027864,54.37396204146876,NaN,NaN,50
1689163200,1.1015,1.10272,1.10149,1.10229,2540,1550.75,-590017,-590056.6,22.15753490132703,51.480229334558274,53.24572655957911,NaN,NaN,50
1689165000,1.10229,1.1072,1.10229,1.10582,8832,1923.6,-581185,-588703.6,24.71578988843689,72.77830983877311,54.282467793507884,NaN,NaN,50
1689166800,1.10582,1.10844,1.10564,1.10824,4835,2100.75,-576350,-586160.4,27.55331706973081,79.44099348642554,55.50689746466572,NaN,NaN,50
1689168600,1.10824,1.11007,1.10818,1.10979,5208,2309.25,-571142,-582250.2,30.642540546098225,82.41052535428753,57.59656027212388,NaN,NaN,50
1689170400,1.10979,1.11066,1.10889,1.10998,4954,2508.5,-566188,-576976.4,33.64705807354543,82.73963635095423,59.41178232854695,NaN,NaN,50
1689172200,1.10998,1.112345,1.10986,1.11204,3784,2649.4,-562404,-571453.8,36.762567579767705,85.83437260345019,61.464698164399536,NaN,NaN,50
1689174000,1.11204,1.11254,1.11108,1.11254,3065,2731.1,-559339,-567084.6,39.688653603260796,86.46854267231919,63.82198763306764,NaN,NaN,50
1689175800,1.11254,1.11254,1.11163,1.11222,2481,2776.2,-561820,-564178.6,42.40573348221867,83.88036032269636,66.16356335280899,NaN,NaN,50
1689177600,1.11222,1.11308,1.11206,1.11306,2417,2812.1,-559403,-561830.8,45.02651209618266,85.13792457563092,68.29075570802674,NaN,NaN,50
1689179400,1.11306,1.11335,1.11264,1.11321,2244,2825.1,-557159,-560025,47.507922090491334,85.35760114769909,70.57004474188167,NaN,NaN,50
1689181200,1.11321,1.11328,1.11247,1.11264,2051,2810.2,-559210,-559386.2,49.539109986254715,80.48894823795432,72.5104167329467,NaN,NaN,50
1689183000,1.11264,1.11302,1.11249,1.11298,1344,2779.9,-557866,-559091.6,51.425213032320706,81.17856543038974,74.73205331241545,NaN,NaN,50
1689184800,1.11298,1.11335,1.11278,1.11329,1428,2766.05,-556438,-558015.2,53.255075413586205,81.80985838053063,77.21897187417538,NaN,NaN,50
1689186600,1.11329,1.11401,1.11329,1.11383,1436,2765.6,-555002,-557135,55.10110024343622,82.88664610980105,80.13517956039071,NaN,NaN,50
1689188400,1.11383,1.11384,1.11334,1.11356,1461,2764.55,-556463,-556995.8,56.81526615686837,80.32625548971552,82.1956100000448,NaN,NaN,50
1689190200,1.11356,1.11405,1.11351,1.1137,1147,2759.9,-555316,-556217,58.45475506469996,80.65985872795069,82.7585777778432,NaN,NaN,50
1689192000,1.1137,1.11381,1.11332,1.11357,930,2738.2,-556246,-555893,59.58895413636681,79.31493333326637,82.74957348118896,NaN,NaN,50
1689193800,1.11357,1.11361,1.11307,1.11316,648,2714.8,-556894,-555984.2,60.130622272957325,75.06387647854687,82.2248128472075,NaN,NaN,50
1689195600,1.11316,1.11347,1.11308,1.1134,184,2642.65,-556710,-556325.8,60.6335998283628,75.87886548189898,81.73475778513213,NaN,NaN,50
1689197400,1.1134,1.11342,1.11281,1.11295,325,2565.7,-557035,-556440.2,60.51633547022932,71.18128136620977,80.68810841104353,NaN,NaN,50
1689199200,1.11295,1.11362,1.11295,1.11352,684,2472.9,-556351,-556647.2,60.51749276118947,73.42550333479964,79.75646274407784,NaN,NaN,50
1689201000,1.11352,1.11372,1.11341,1.11354,478,2055.2,-555873,-556572.6,60.574465754971044,73.50347197063755,79.01525643321649,NaN,NaN,50
1689202800,1.11354,1.11378,1.11343,1.11357,521,1839.5,-555352,-556264.2,60.66232416282335,73.62845939894558,78.19315177773898,NaN,NaN,50
1689204600,1.11357,1.114085,1.11353,1.11408,685,1613.35,-554667,-555855.6,60.920605433679334,75.72485304528873,77.50509834185252,NaN,NaN,50
1689206400,1.11408,1.11452,1.11395,1.11404,1347,1433,-556014,-555651.4,61.39129391848961,75.21979189982927,77.12873003198645,NaN,NaN,50
1689208200,1.11404,1.1144,1.11379,1.11384,1336,1310.6,-557350,-555851.2,61.414387844740126,72.6120250706193,76.51683429200284,NaN,NaN,50
1689210000,1.11384,1.11429,1.11364,1.1141,1491,1231.9,-555859,-555848.4,61.04595727753287,73.87979722611051,75.9504013524014,NaN,NaN,50
1689211800,1.1141,1.11457,1.11395,1.11451,1754,1195.55,-554105,-555599,60.90237577192179,75.78345412525871,75.44303049636267,NaN,NaN,50
1689213600,1.11451,1.11454,1.11394,1.11438,1411,1145.25,-555516,-555768.8,60.74135655033936,73.94329610934267,74.98710482633602,NaN,NaN,50
1689215400,1.11438,1.11478,1.11397,1.11462,1262,1096.15,-554254,-555416.8,60.76691912635803,75.14328447809444,74.59306380848916,NaN,NaN,50
1689217200,1.11462,1.11488,1.1145,1.11468,1086,1047.9,-553168,-554580.4,60.86264602834961,75.44770528962614,74.31683323394343,NaN,NaN,50
1689219000,1.11468,1.11489,1.11424,1.11457,1113,1036.35,-554281,-554264.8,60.1683576149027,73.66644883807729,74.21701697390988,NaN,NaN,50
1689220800,1.11457,1.11467,1.11442,1.11462,1020,1015.95,-553261,-554096,59.52366123098772,73.96730680578123,74.0804770684729,NaN,NaN,50
1689222600,1.11462,1.11486,1.11407,1.1141,1046,996.45,-554307,-553854.2,57.89388674219966,65.57624952480307,73.68011765122957,NaN,NaN,50
1689224400,1.1141,1.11434,1.11394,1.11396,1409,993.85,-555716,-554146.6,56.02119519780715,63.48802090188929,72.97029747745026,NaN,NaN,50
1689226200,1.11396,1.11433,1.11299,1.11312,2005,1036.75,-557721,-555057.2,52.17013766524635,52.653811656968216,71.48103602647389,NaN,NaN,50
1689228000,1.11312,1.11476,1.11309,1.11472,2883,1134.4,-554838,-555168.6,49.28405224118528,64.93006350271719,70.85972203388614,NaN,NaN,50
1689229800,1.11472,1.11501,1.114,1.11486,2620,1233,-552218,-554960,46.970801912886394,65.76648464579566,70.14841000535093,NaN,NaN,50
1689231600,1.11486,1.11578,1.11368,1.1141,2792,1363.4,-555010,-555100.6,45.78298760704865,57.7186925613274,68.89833148117222,NaN,NaN,50
1689233400,1.1141,1.1156,1.11363,1.11554,2672,1480.75,-552338,-554425,44.57587757244724,66.16663422793621,68.43794642098057,NaN,NaN,50
1689235200,1.11554,1.1165,1.11503,1.11634,2251,1559.1,-550087,-552898.2,44.360162773370135,69.77923618681446,68.145049203888,NaN,NaN,50
1689237000,1.11634,1.11702,1.11596,1.1161,2535,1661.95,-552622,-552455,44.57651642495794,67.45233554697728,67.54996930543932,NaN,NaN,50
1689238800,1.1161,1.1168,1.11551,1.11656,2076,1739.7,-550546,-552120.6,43.88148752628159,69.54834755090083,67.23604440840776,NaN,NaN,50
1689240600,1.11656,1.11746,1.11624,1.1173,1886,1799.75,-548660,-550850.6,43.78753559946321,72.60473249999106,67.05471926711466,NaN,NaN,50
1689242400,1.1173,1.11736,1.11596,1.1165,1868,1825.8,-550528,-550488.6,43.177331903151654,65.00831151811354,66.30904828343519,NaN,NaN,50
1689244200,1.1165,1.11716,1.11596,1.11714,1752,1846.6,-548776,-550226.4,42.61071418514807,67.90166363043969,65.89727791146109,NaN,NaN,50
1689246000,1.11714,1.11744,1.11696,1.11706,1494,1846.75,-550270,-549756,42.34456931757946,67.15417582887903,65.41062569882521,NaN,NaN,50
1689247800,1.11706,1.1178,1.11684,1.11744,1928,1855.45,-548342,-549315.2,42.41266404960453,68.90519089467267,65.64840722524447,NaN,NaN,50
1689249600,1.11744,1.11856,1.11744,1.11793,3279,1948.85,-545063,-548595.8,43.04705002562957,71.04846850937268,66.18843919720757,NaN,NaN,50
1689251400,1.11793,1.11906,1.11616,1.11798,6839,2227.7,-538224,-546135,41.43499702701704,71.26611093200253,67.5178891454243,NaN,NaN,50
1689253200,1.11798,1.11852,1.11763,1.118,4250,2385.9,-533974,-543174.6,39.93809067116255,71.358859452906,67.97708885615208,NaN,NaN,50
1689255000,1.118,1.11952,1.118,1.11942,4035,2532,-529939,-539108.4,39.43304884958966,77.02838946246897,68.7815106287716,NaN,NaN,50
1689256800,1.11942,1.11946,1.11812,1.11812,3532,2657.6,-533471,-536134.2,38.9640814438434,64.45013751460286,69.26232812543414,NaN,NaN,50
1689258600,1.11812,1.11962,1.11807,1.1196,3217,2766.15,-530254,-533172.4,38.66334480838223,70.38014733298402,69.56329334722325,NaN,NaN,50
1689260400,1.1196,1.11966,1.11858,1.11912,2629,2827.15,-532883,-532104.2,38.41907974222342,66.50544034480623,69.32945078707982,NaN,NaN,50
1689262200,1.11912,1.11948,1.118735,1.11929,1755,2814.65,-531128,-531535,38.19226218079023,67.19429941098343,69.31101963450882,NaN,NaN,50
1689264000,1.11929,1.12063,1.11919,1.12051,1827,2761.85,-529301,-531407.4,38.90774004748393,71.69352249488846,69.46424641622222,NaN,NaN,50
1689265800,1.12051,1.12092,1.1202,1.12058,1488,2705.25,-527813,-530275.8,39.76288575528968,71.93138831194547,69.4161504027904,NaN,NaN,50
1689267600,1.12058,1.12085,1.12022,1.12066,1478,2639.55,-526335,-529492,40.556949626823595,72.21871447623761,69.93117918551354,NaN,NaN,50
1689269400,1.12066,1.12186,1.12066,1.12157,1381,2575,-524954,-527906.2,41.89913718586789,75.31425548315892,70.46065003213634,NaN,NaN,50
1689271200,1.12157,1.12178,1.1213,1.12162,1486,2536.75,-523468,-526374.2,43.145454204980446,75.47594793568265,71.05506232547947,NaN,NaN,50
1689273000,1.12162,1.12228,1.12148,1.12224,1528,2486.4,-521940,-524902,44.564264678807625,77.44848682687012,71.66529774920785,NaN,NaN,50
1689274800,1.12224,1.12275,1.12195,1.12237,1466,2455.9,-520474,-523434.2,46.10249666706969,77.85076677688768,72.1511761968875,NaN,NaN,50
1689276600,1.12237,1.12269,1.12232,1.12264,1399,2431.55,-519075,-521982.2,47.530854941884456,78.70058392896365,72.68220998238472,NaN,NaN,50
1689278400,1.12264,1.1228,1.12242,1.1226,709,2373.6,-519784,-520948.2,48.91088621013286,78.22176060901657,73.1724172078212,NaN,NaN,50
1689280200,1.1226,1.12266,1.12251,1.12264,507,2311.35,-519277,-520110,50.19234381636352,78.3635254452475,73.26778406373394,NaN,NaN,50
1689282000,1.12264,1.12264,1.12142,1.12244,170,2245.15,-519447,-519611.4,48.96181308587488,75.70982036050103,74.07204712415523,NaN,NaN,50
1689283800,1.12244,1.12262,1.12214,1.12252,760,2186.75,-518687,-519254,47.819177407564,76.05906081821077,74.47768380167143,NaN,NaN,50
1689285600,1.12252,1.12298,1.1224,1.1226,780,2061.8,-517907,-519020.4,47.103763316443064,76.42410604556972,75.18615992315453,NaN,NaN,50
1689287400,1.1226,1.1227,1.1224,1.12247,575,1748.6,-518482,-518760,46.43945023183077,74.43784051663658,75.70355571641548,NaN,NaN,50
1689289200,1.12247,1.1227,1.12233,1.12261,640,1568.1,-517842,-518473,45.66493942503975,75.18579750946652,75.95300393174249,NaN,NaN,50
1689291000,1.12261,1.1228,1.12217,1.12234,868,1409.75,-518710,-518325.6,44.57839073976963,70.87841448039376,75.87779151520307,NaN,NaN,50
1689292800,1.12234,1.12248,1.12135,1.12141,2263,1346.3,-520973,-518782.8,41.95647094031606,58.45589081398289,74.89473268218488,NaN,NaN,50
1689294600,1.12141,1.12238,1.12141,1.12228,1732,1272.05,-519241,-519049.6,39.52183112653775,64.69048973772462,74.13589227179672,NaN,NaN,50
1689296400,1.12228,1.123,1.12223,1.12298,2059,1243.55,-517182,-518789.6,38.128338522577806,68.75363245385186,73.65572688023737,NaN,NaN,50
1689298200,1.12298,1.12338,1.12268,1.1233,2617,1286.65,-514565,-518134.2,37.291595323935965,70.4288646232607,73.15432529426528,NaN,NaN,50
1689300000,1.1233,1.12386,1.12325,1.12364,1531,1271.85,-513034,-516999,37.03063287723143,72.13809238117327,72.74627712314282,NaN,NaN,50
1689301800,1.12364,1.123765,1.12314,1.12354,1270,1260.95,-514304,-515665.2,36.56250488447246,70.84114230344488,72.18488843560576,NaN,NaN,50
1689303600,1.12354,1.12412,1.12337,1.12391,1338,1253.95,-512966,-514410.2,36.50507458307971,72.79039125910181,71.79693348204042,NaN,NaN,50
1689305400,1.12391,1.12432,1.12391,1.12414,1408,1255.3,-511558,-513285.4,36.65392890953223,73.95590364351565,71.48210335334528,NaN,NaN,50
1689307200,1.12414,1.12414,1.12328,1.12336,1017,1231.85,-512575,-512887.4,35.504925540042606,63.95138893811489,70.64221539460341,NaN,NaN,50
1689309000,1.12336,1.12378,1.12328,1.1233,1297,1220.3,-513872,-513055,34.43799383980223,63.242668920511264,69.72675883048201,NaN,NaN,50
1689310800,1.1233,1.12354,1.12305,1.12334,1181,1206.05,-512691,-512732.4,32.99786628647738,63.532817436610856,68.80595250127068,NaN,NaN,50
1689312600,1.12334,1.1234,1.12184,1.12193,2088,1240.5,-514779,-513095,31.483736028910446,48.884405970990116,66.98070717658165,NaN,NaN,50
1689314400,1.12193,1.12258,1.12148,1.12161,2339,1322,-517118,-514207,30.50698416942657,46.276633353140944,64.91576687970124,NaN,NaN,50
1689316200,1.12161,1.1219,1.12057,1.12102,2445,1418.9,-519563,-515604.6,30.518490867692677,41.8443924069447,62.84190816016916,NaN,NaN,50
1689318000,1.12102,1.12171,1.12041,1.12079,2324,1526.6,-521887,-517207.6,30.67166075083923,40.22691278837942,61.53983830119749,NaN,NaN,50
1689319800,1.12079,1.12218,1.12054,1.12218,2445,1610.85,-519442,-518557.8,30.023363746633496,52.2418320526349,60.650648466548226,NaN,NaN,50
1689321600,1.12218,1.12323,1.12214,1.12305,2055,1674.6,-517387,-519079.4,27.969522686726584,57.94044290056303,59.87827778417045,NaN,NaN,50
1689323400,1.12305,1.12361,1.12279,1.12312,1763,1734,-515624,-518780.6,26.323452249485257,58.37085287396761,59.016991230649516,NaN,NaN,50
1689325200,1.12312,1.12451,1.12311,1.12354,1890,1796.5,-513734,-517614.8,25.711441321020935,60.95277834874808,58.21804022833343,NaN,NaN,50
1689327000,1.12354,1.12364,1.12263,1.12266,1929,1849.55,-515663,-516370,24.538086284164592,53.46982531308476,56.977231871879134,NaN,NaN,50
1689328800,1.12266,1.12268,1.12175,1.12176,1993,1836.05,-517656,-516012.8,23.092979836078424,47.10106685746695,55.14228012890521,NaN,NaN,50
1689330600,1.12176,1.1223,1.12155,1.12204,1612,1830.05,-516044,-515744.2,21.953005764964587,49.131079485709634,53.36907840334764,NaN,NaN,50
1689332400,1.12204,1.12327,1.12194,1.12327,1767,1815.45,-514277,-515474.8,20.898263985693507,56.947104714689736,52.86877238738871,NaN,NaN,50
1689334200,1.12327,1.12344,1.12229,1.12244,1767,1772.95,-516044,-515936.8,20.081993713173777,51.22716540726149,52.01052213644228,NaN,NaN,50
1689336000,1.12244,1.1226,1.12155,1.12188,2355,1814.15,-518399,-516484,18.779794758196317,47.7428106009923,50.88266450532667,NaN,NaN,50
1689337800,1.12188,1.12271,1.12102,1.12257,3619,1931.6,-514780,-515908.8,18.08853686229415,52.068805893324786,51.110121642636294,NaN,NaN,50
1689339600,1.12257,1.12288,1.12175,1.12282,2827,2006.05,-511953,-515090.6,17.252730871174034,53.568585721631734,51.63097538324278,NaN,NaN,50
1689341400,1.12282,1.1244,1.12268,1.124,3129,2092.1,-508824,-514000,17.033023507273963,59.940139766098746,52.923528766039496,NaN,NaN,50
1689343200,1.124,1.124,1.12154,1.12344,6773,2379.9,-515597,-513910.6,15.905063823088073,56.01184523665963,54.05102394091666,NaN,NaN,50
1689345000,1.12344,1.12444,1.12264,1.12418,4783,2554.2,-510814,-512393.6,15.064636146749963,59.76438506317666,54.588349155955356,NaN,NaN,50
1689346800,1.12418,1.12444,1.12363,1.12379,2568,2623.55,-513382,-512114,14.28423901872172,57.0043467563,54.52148514565085,NaN,NaN,50
1689348600,1.12379,1.12433,1.123495,1.12357,1970,2617.65,-515352,-512793.8,13.42152176662122,55.448714660270504,54.31276098752962,NaN,NaN,50
1689350400,1.12357,1.12408,1.1234,1.12377,1459,2573.65,-513893,-513807.6,12.519164713580292,56.608026633618465,54.00242157930608,NaN,NaN,50
1689352200,1.12377,1.12432,1.12331,1.12394,1384,2520.6,-512509,-513190,11.938963878566106,57.617580367142146,54.29868979745303,NaN,NaN,50
1689354000,1.12394,1.12397,1.12265,1.1231,1535,2481.15,-514044,-513836,11.497155587123583,51.270127516347486,54.59647984451592,NaN,NaN,50
1689355800,1.1231,1.12362,1.1231,1.12343,1330,2425.4,-512714,-513702.4,11.086905030784095,53.44020320095009,54.904274395604524,NaN,NaN,50
1689357600,1.12343,1.12358,1.12314,1.12351,1282,2386.75,-511432,-512918.4,10.705958085611712,53.97529872074355,54.69200253889408,NaN,NaN,50
1689359400,1.12351,1.12367,1.12327,1.12341,1292,2363.2,-512724,-512684.6,10.229175461686017,53.152975570533066,54.82956040769919,NaN,NaN,50
1689361200,1.12341,1.12341,1.12294,1.123,1245,2330.95,-513969,-512976.6,10.200722052452612,49.8027841340547,54.97670137434651,NaN,NaN,50
1689363000,1.123,1.12308,1.12258,1.1226,1278,2298.4,-515247,-513217.2,10.601271580415663,46.70957839296055,54.59389941003478,NaN,NaN,50
1689364800,1.1226,1.1227,1.12245,1.12266,876,2242.55,-514371,-513548.6,11.124350479370829,47.23893058738546,54.14178118616004,NaN,NaN,50
1689366600,1.12266,1.12297,1.12254,1.12274,693,2196.6,-513678,-513997.8,11.161767702192297,47.98089294837404,53.287549270608274,NaN,NaN,50
1689541200,1.12274,1.12368,1.12262,1.12294,199,2118.2,-513479,-514148.8,10.57702547635326,49.878545262774296,52.84945641533075,NaN,NaN,50
1689543000,1.12294,1.12308,1.12288,1.12304,29,2031.3,-513450,-514045,10.034050552359867,50.84411568265335,52.212294316721945,NaN,NaN,50
1689544800,1.12304,1.12319,1.1226,1.12275,757,1951.4,-514207,-513837,9.520533198937189,47.95868758633882,51.56617580458186,NaN,NaN,50
1689546600,1.12275,1.12281,1.122455,1.12256,495,1795.2,-514702,-513903.2,9.2557552666232,46.11228463984213,50.899287945979836,NaN,NaN,50
1689548400,1.12256,1.12285,1.12236,1.12284,960,1701.85,-513742,-513916,9.151879504525825,49.215281646444836,50.37123473261029,NaN,NaN,50
1689550200,1.12284,1.122945,1.12267,1.12272,743,1582.55,-514485,-514117.2,8.884297049124493,47.941168209865516,49.68006243566196,NaN,NaN,50
1689552000,1.12272,1.12296,1.12232,1.12235,1078,1297.8,-515563,-514539.8,9.183331407700477,44.14621233851419,49.17121135153101,NaN,NaN,50
1689553800,1.12235,1.122785,1.12234,1.12245,863,1101.8,-514700,-514638.4,9.46100616923532,45.40409787491524,48.597203828242804,NaN,NaN,50
1689555600,1.12245,1.12274,1.12229,1.1224,1890,1067.9,-516590,-515016,9.801103036748653,44.860092307380704,47.946117655859744,NaN,NaN,50
1689557400,1.1224,1.12244,1.121735,1.1218,1484,1043.6,-518074,-515882.4,10.954515931710041,38.84539513833223,46.92414762498826,NaN,NaN,50
1689559200,1.1218,1.1225,1.12145,1.12244,1786,1059.95,-516288,-516243,12.397320254545608,47.00716205917142,46.724460333925165,NaN,NaN,50
1689561000,1.12244,1.12282,1.12214,1.12264,1082,1044.85,-515206,-516171.6,13.003234785310497,49.2850167461824,46.908420216298154,NaN,NaN,50
1689562800,1.12264,1.12286,1.12243,1.12256,1218,1029,-516424,-516516.4,13.475772762156094,48.38903234370309,46.99057034174941,NaN,NaN,50
1689564600,1.12256,1.12285,1.12252,1.12264,1215,1023.25,-515209,-516240.2,13.914558026369864,49.380073598868655,47.09051181678475,NaN,NaN,50
1689566400,1.12264,1.12264,1.12223,1.12244,713,994.8,-515922,-515809.8,14.7851205694176,46.95270865605672,46.881523487733496,NaN,NaN,50
1689568200,1.12244,1.12278,1.12231,1.12269,893,974.85,-515029,-515558,15.230977205835902,50.24511738762559,46.83873789523152,NaN,NaN,50
1689570000,1.12269,1.12287,1.12254,1.1226,961,960.65,-515990,-515714.8,15.410640568285693,49.064510835714295,46.91772527018691,NaN,NaN,50
1689571800,1.1226,1.12348,1.12222,1.12327,1488,971.15,-514502,-515330.4,14.431557268668973,57.13861739394205,47.705320466908326,NaN,NaN,50
1689573600,1.12327,1.12327,1.12226,1.12284,2060,1030.35,-516562,-515601,13.522408490453447,51.49664136374534,47.86827473242978,NaN,NaN,50
1689575400,1.12284,1.12402,1.12266,1.12334,1956,1093.5,-514606,-515337.8,14.016704608442824,56.83403458720697,48.503479473668456,NaN,NaN,50
1689577200,1.12334,1.124345,1.12297,1.1243,2341,1200.6,-512265,-514785,14.93994816277838,64.8351730177732,49.98126237932981,NaN,NaN,50
1689579000,1.1243,1.12451,1.12324,1.1245,1860,1292.15,-510405,-513668,16.02037141259551,66.23917221208492,51.46948197484193,NaN,NaN,50
1689580800,1.1245,1.1245,1.12363,1.12389,2191,1363.85,-512596,-513286.8,17.023621573139984,58.55953794681499,52.448013806230094,NaN,NaN,50
1689582600,1.12389,1.1249,1.12368,1.1238,2014,1439.8,-514610,-512896.4,18.49127410220673,57.5003010087348,53.78050708268743,NaN,NaN,50
1689584400,1.1238,1.12445,1.12361,1.12368,2277,1505.65,-516887,-513352.6,19.659298381238692,56.04466374864872,54.42604291765008,NaN,NaN,50
1689586200,1.12368,1.124485,1.12348,1.12434,2084,1572.7,-514803,-513860.2,20.376586235492006,61.77612236004256,55.31826474721152,NaN,NaN,50
1689588000,1.12434,1.12435,1.12366,1.1239,1702,1603.9,-516505,-515080.2,21.042639243012943,56.48798128238142,55.896761099974256,NaN,NaN,50
1689589800,1.1239,1.12399,1.123075,1.12312,1884,1654.95,-518389,-516238.8,20.123331274320538,48.55332726547466,55.83770779044612,NaN,NaN,50
1689591600,1.12312,1.12379,1.12291,1.12363,1717,1646.3,-516672,-516651.2,18.898821429513948,53.18382935149682,56.28278784012041,NaN,NaN,50
1689593400,1.12363,1.12376,1.12292,1.12338,2079,1676.05,-518751,-517024,17.761776573622114,50.77145386066769,56.32038330248056,NaN,NaN,50
1689595200,1.12338,1.12372,1.12252,1.12288,2756,1724.55,-521507,-518364.8,17.154836179882498,46.25271529572513,56.1195407639099,NaN,NaN,50
1689597000,1.12288,1.1236,1.122075,1.12354,4118,1876.35,-517389,-518541.6,17.399398302751198,52.28906211492102,55.77314395826554,NaN,NaN,50
1689598800,1.12354,1.12358,1.12202,1.12217,3135,1972.2,-520524,-518968.6,17.719108670047618,41.7957789202963,55.0802252123049,NaN,NaN,50
1689600600,1.12217,1.12232,1.12033,1.12214,4058,2114.35,-524582,-520550.6,19.973297736699195,41.59891419392682,53.9920023270706,NaN,NaN,50
1689602400,1.12214,1.12272,1.12192,1.12207,2548,2206.1,-527130,-522226.4,21.19141578173793,41.112317768369756,52.29751266639893,NaN,NaN,50
1689604200,1.12207,1.12335,1.12178,1.12318,2348,2278.85,-524782,-522881.4,21.126574619218545,50.91688932029265,51.20306388841377,NaN,NaN,50
1689606000,1.12318,1.1235,1.12254,1.12344,1979,2329.75,-522803,-523964.2,20.805358481730902,52.895243193507035,50.79847140603463,NaN,NaN,50
1689607800,1.12344,1.1238,1.12314,1.12354,1740,2342.35,-521063,-524072,19.995472323522755,53.6687379337958,50.52478832925327,NaN,NaN,50
1689609600,1.12354,1.12384,1.12328,1.12339,1555,2317.1,-522618,-523679.2,19.175086935599904,52.281918070023735,50.256020780780055,NaN,NaN,50
1689611400,1.12339,1.12348,1.12302,1.1233,1277,2283.15,-523895,-523032.2,18.790111050189577,51.42331064878776,49.51653422997614,NaN,NaN,50
1689613200,1.1233,1.1236,1.12322,1.12343,1431,2237.65,-522464,-522568.6,18.206191270692567,52.633354967139795,49.24120377888745,NaN,NaN,50
1689615000,1.12343,1.12445,1.12328,1.12405,1375,2213.4,-521089,-522225.8,17.532408234375787,58.006060107196575,49.916398981867594,NaN,NaN,50
1689616800,1.12405,1.12427,1.12393,1.124,1310,2169.35,-522399,-522493,16.906752557795915,57.440212584885934,50.220426355681106,NaN,NaN,50
1689618600,1.124,1.12442,1.12396,1.12433,1351,2136.2,-521048,-522179,16.551448247636333,60.199774852490314,50.893877855097,NaN,NaN,50
1689620400,1.12433,1.12462,1.12427,1.12452,1017,2073.2,-520031,-521406.2,16.519510636946872,61.73804376438875,51.99997274571583,NaN,NaN,50
1689622200,1.12452,1.12454,1.12415,1.12438,1066,2022.3,-521097,-521132.8,16.243549262852657,59.90091618337649,52.54367660774837,NaN,NaN,50
1689624000,1.12438,1.1244,1.12367,1.12387,1114,1992.9,-522211,-521357.2,15.09201524129502,53.63917172793928,53.38963323686572,NaN,NaN,50
1689625800,1.12387,1.12411,1.12384,1.12398,452,1921.3,-521759,-521229.2,14.022733649848648,54.7381802945445,54.328152244052696,NaN,NaN,50
1689627600,1.12398,1.12401,1.12336,1.12376,109,1840.9,-521868,-521393.2,13.859203898616284,52.07911986937189,55.11149525126713,NaN,NaN,50
1689629400,1.12376,1.123925,1.123635,1.12374,318,1752.85,-522186,-521824.2,13.707354843900522,51.83261078216943,55.176903927115475,NaN,NaN,50
1689631200,1.12374,1.12402,1.1237,1.12386,492,1639.65,-521694,-521943.6,13.358918803563322,53.26207937519722,55.203106511521916,NaN,NaN,50
1689633000,1.12386,1.12402,1.12382,1.12396,309,1449.2,-521385,-521778.4,13.035371051821636,54.47457167319146,55.260666064335894,NaN,NaN,50
1689634800,1.12396,1.12403,1.12386,1.12387,679,1326.4,-522064,-521839.4,12.710346519415513,53.13845099562621,55.32184698759321,NaN,NaN,50
1689636600,1.12387,1.12396,1.12371,1.12374,539,1150.45,-522603,-521986.4,12.726292996431424,51.18553035833614,55.30486268113238,NaN,NaN,50
1689638400,1.12374,1.12412,1.12346,1.12401,1179,1082,-521424,-521834,13.240163150421145,54.89337187489235,55.466292460257556,NaN,NaN,50
1689640200,1.12401,1.124665,1.12399,1.12418,1489,1039.05,-519935,-521482.2,12.359397833102518,57.10275885603585,55.40177094231751,NaN,NaN,50
1689642000,1.12418,1.12561,1.12387,1.12546,2271,1053.65,-517664,-520738,13.057971533608088,69.29706415797513,56.24868891182388,NaN,NaN,50
1689643800,1.12546,1.12548,1.12411,1.12456,2608,1097.05,-520272,-520379.6,13.706647112648973,57.02284655872961,56.02176546226955,NaN,NaN,50
1689645600,1.12456,1.1249,1.12436,1.12442,1962,1117.4,-522234,-520305.8,14.308988721758368,55.379613686986005,55.567591885312204,NaN,NaN,50
1689647400,1.12442,1.12476,1.12436,1.124705,1133,1110.2,-521101,-520241.2,14.86830593021709,58.03104214740896,55.434029454171664,NaN,NaN,50